price,bedrooms,bathrooms,sqft_living,sqft_lot,floors,waterfront,view,condition,grade,sqft_above,sqft_basement,yr_built,yr_renovated,zipcode,lat,long,sqft_living15,sqft_lot15,sqft_diff,sqft_diff_ratio,sqft_living_squared,sqft_lot_squared,sqft_diff_squared
221900.0,3,1.0,1180,5650,1.0,0,0,2,7,1180,0,1955,0.0,98178,47.5112,-122.257,1340,5650,4470,0.7911504424778761,1392400,31922500,30530100
538000.0,3,2.25,2570,7242,2.0,0,0,2,7,2170,400,1951,1991.0,98125,47.721000000000004,-122.319,1690,7639,4672,0.6451256558961613,6604900,52446564,45841664
180000.0,2,1.0,770,10000,1.0,0,0,2,6,770,0,1933,0.0,98028,47.7379,-122.23299999999999,2720,8062,9230,0.923,592900,100000000,99407100
604000.0,4,3.0,1960,5000,1.0,0,0,4,7,1050,910,1965,0.0,98136,47.5208,-122.39299999999999,1360,5000,3040,0.608,3841600,25000000,21158400
510000.0,3,2.0,1680,8080,1.0,0,0,2,8,1680,0,1987,0.0,98074,47.6168,-122.045,1800,7503,6400,0.7920792079207921,2822400,65286400,62464000
1230000.0,4,4.5,5420,101930,1.0,0,0,2,11,3890,1530,2001,0.0,98053,47.6561,-122.005,4760,101930,96510,0.9468262533110958,29376400,10389724900,10360348500
257500.0,3,2.25,1715,6819,2.0,0,0,2,7,1715,0,1995,0.0,98003,47.3097,-122.32700000000001,2238,6819,5104,0.7484968470450213,2941225,46498761,43557536
291850.0,3,1.5,1060,9711,1.0,0,0,2,7,1060,0,1963,0.0,98198,47.4095,-122.315,1650,9711,8651,0.8908454330141077,1123600,94303521,93179921
229500.0,3,1.0,1780,7470,1.0,0,0,2,7,1050,730,1960,0.0,98146,47.5123,-122.337,1780,8113,5690,0.7617135207496654,3168400,55800900,52632500
323000.0,3,2.5,1890,6560,2.0,0,0,2,7,1890,0,2003,0.0,98038,47.3684,-122.031,2390,7570,4670,0.711890243902439,3572100,43033600,39461500
662500.0,3,2.5,3560,9796,1.0,0,0,2,8,1860,1700,1965,0.0,98007,47.6007,-122.145,2210,8925,6236,0.6365863617803185,12673600,95961616,83288016
468000.0,2,1.0,1160,6000,1.0,0,0,3,7,860,300,1942,0.0,98115,47.69,-122.292,1330,6000,4840,0.8066666666666666,1345600,36000000,34654400
310000.0,3,1.0,1430,19901,1.5,0,0,3,7,1430,0,1927,0.0,98028,47.7558,-122.229,1780,12697,18471,0.9281443143560625,2044900,396049801,394004901
400000.0,3,1.75,1370,9680,1.0,0,0,3,7,1370,0,1977,0.0,98074,47.6127,-122.045,1370,10208,8310,0.8584710743801653,1876900,93702400,91825500
530000.0,5,2.0,1810,4850,1.5,0,0,2,7,1810,0,1900,0.0,98107,47.67,-122.39399999999999,1360,4850,3040,0.6268041237113402,3276100,23522500,20246400
650000.0,4,3.0,2950,5000,2.0,0,3,2,9,1980,970,1979,0.0,98126,47.5714,-122.375,2140,4000,2050,0.41,8702500,25000000,16297500
395000.0,3,2.0,1890,14040,2.0,0,0,2,7,1890,0,1994,0.0,98019,47.7277,-121.962,1890,14018,12150,0.8653846153846154,3572100,197121600,193549500
485000.0,4,1.0,1600,4300,1.5,0,0,3,7,1600,0,1916,0.0,98103,47.6648,-122.34299999999999,1610,4300,2700,0.627906976744186,2560000,18490000,15930000
189000.0,2,1.0,1200,9850,1.0,0,0,3,7,1200,0,1921,0.0,98002,47.3089,-122.21,1060,5095,8650,0.8781725888324873,1440000,97022500,95582500
230000.0,3,1.0,1250,9774,1.0,0,0,3,7,1250,0,1969,0.0,98003,47.3343,-122.306,1280,8850,8524,0.872109678739513,1562500,95531076,93968576
385000.0,4,1.75,1620,4980,1.0,0,0,3,7,860,760,1947,0.0,98133,47.7025,-122.34100000000001,1400,4980,3360,0.6746987951807228,2624400,24800400,22176000
2000000.0,3,2.75,3050,44867,1.0,0,4,2,9,2330,720,1968,0.0,98040,47.5316,-122.23299999999999,4110,20336,41817,0.9320213074197071,9302500,2013047689,2003745189
285000.0,5,2.5,2270,6300,2.0,0,0,2,8,2270,0,1995,0.0,98092,47.3266,-122.169,2240,7005,4030,0.6396825396825396,5152900,39690000,34537100
252700.0,2,1.5,1070,9643,1.0,0,0,2,7,1070,0,1985,0.0,98030,47.3533,-122.166,1220,8386,8573,0.889038680908431,1144900,92987449,91842549
329000.0,3,2.25,2450,6500,2.0,0,0,3,8,2450,0,1985,0.0,98030,47.3739,-122.17200000000001,2200,6865,4050,0.6230769230769231,6002500,42250000,36247500
233000.0,3,2.0,1710,4697,1.5,0,0,4,6,1710,0,1941,0.0,98002,47.3048,-122.21799999999999,1030,4705,2987,0.6359378326591442,2924100,22061809,19137709
937000.0,3,1.75,2450,2691,2.0,0,0,2,8,1750,700,1915,0.0,98119,47.6386,-122.36,1760,3573,241,0.08955778520995912,6002500,7241481,1238981
667000.0,3,1.0,1400,1581,1.5,0,0,4,8,1400,0,1909,0.0,98112,47.6221,-122.314,1860,3861,181,0.11448450347881088,1960000,2499561,539561
438000.0,3,1.75,1520,6380,1.0,0,0,2,7,790,730,1948,0.0,98115,47.695,-122.304,1520,6235,4860,0.7617554858934169,2310400,40704400,38394000
719000.0,4,2.5,2570,7173,2.0,0,0,2,8,2570,0,2005,0.0,98052,47.7073,-122.11,2630,6026,4603,0.6417119754635439,6604900,51451929,44847029
580500.0,3,2.5,2320,3980,2.0,0,0,2,8,2320,0,2003,0.0,98027,47.5391,-122.07,2580,3980,1660,0.41708542713567837,5382400,15840400,10458000
280000.0,2,1.5,1190,1265,3.0,0,0,2,7,1190,0,2005,0.0,98133,47.7274,-122.35700000000001,1390,1756,75,0.05928853754940711,1416100,1600225,184125
687500.0,4,1.75,2330,5000,1.5,0,0,3,7,1510,820,1929,0.0,98117,47.6823,-122.368,1460,5000,2670,0.534,5428900,25000000,19571100
535000.0,3,1.0,1090,3000,1.5,0,0,3,8,1090,0,1929,0.0,98117,47.6889,-122.375,1570,5080,1910,0.6366666666666667,1188100,9000000,7811900
322500.0,4,2.75,2060,6659,1.0,0,0,2,7,1280,780,1981,0.0,98058,47.4276,-122.15700000000001,2020,8720,4599,0.6906442408770086,4243600,44342281,40098681
696000.0,3,2.5,2300,3060,1.5,0,0,2,8,1510,790,1930,2002.0,98115,47.6827,-122.31,1590,3264,760,0.24836601307189543,5290000,9363600,4073600
550000.0,4,1.0,1660,34848,1.0,0,0,0,5,930,730,1933,0.0,98052,47.6621,-122.132,2160,11467,33188,0.9523645546372819,2755600,1214383104,1211627504
640000.0,4,2.0,2360,6000,2.0,0,0,3,8,2360,0,1904,0.0,98107,47.6702,-122.36200000000001,1730,4700,3640,0.6066666666666667,5569600,36000000,30430400
240000.0,4,1.0,1220,8075,1.0,0,0,1,7,890,330,1969,0.0,98001,47.3341,-122.28200000000001,1290,7800,6855,0.8489164086687306,1488400,65205625,63717225
605000.0,4,2.5,2620,7553,2.0,0,0,2,8,2620,0,1996,0.0,98056,47.5301,-122.18,2620,11884,4933,0.6531179663709784,6864400,57047809,50183409
625000.0,4,2.5,2570,5520,2.0,0,0,2,9,2570,0,2000,0.0,98074,47.6145,-122.027,2470,5669,2950,0.5344202898550725,6604900,30470400,23865500
775000.0,4,2.25,4220,24186,1.0,0,0,2,8,2600,1620,1984,0.0,98166,47.445,-122.34700000000001,2410,30617,19966,0.8255188952286446,17808400,584962596,567154196
861990.0,5,2.75,3595,5639,2.0,0,0,2,9,3595,0,2014,0.0,98053,47.6848,-122.016,3625,5639,2044,0.3624756162440149,12924025,31798321,18874296
685000.0,3,1.0,1570,2280,2.0,0,0,2,7,1570,0,1922,0.0,98119,47.6413,-122.36399999999999,1580,2640,710,0.31140350877192985,2464900,5198400,2733500
309000.0,3,1.0,1280,9656,1.0,0,0,3,6,920,360,1959,0.0,98058,47.4485,-122.175,1340,8808,8376,0.8674399337199669,1638400,93238336,91599936
488000.0,3,2.5,3160,13603,2.0,0,0,2,8,3160,0,2003,0.0,98019,47.7443,-121.977,3050,9232,10443,0.7676983018451812,9985600,185041609,175056009
210490.0,3,1.0,990,8528,1.0,0,0,2,6,990,0,1966,0.0,98023,47.3066,-122.37100000000001,1228,8840,7538,0.8839118198874296,980100,72726784,71746684
785000.0,4,2.5,2290,13416,2.0,0,0,3,9,2290,0,1981,0.0,98007,47.6194,-122.15100000000001,2680,13685,11126,0.8293082886106142,5244100,179989056,174744956
450000.0,3,1.75,1250,5963,1.0,0,0,3,7,1250,0,1953,0.0,98115,47.6796,-122.301,970,5100,4713,0.7903739728324669,1562500,35557369,33994869
1350000.0,3,2.5,2753,65005,1.0,1,2,4,9,2165,588,1953,0.0,98070,47.4041,-122.45100000000001,2680,72513,62252,0.9576494115837243,7579009,4225650025,4218071016
228000.0,3,1.0,1190,9199,1.0,0,0,2,7,1190,0,1955,0.0,98148,47.4258,-122.322,1190,9364,8009,0.870638112838352,1416100,84621601,83205501
345000.0,5,2.5,3150,9134,1.0,0,0,3,8,1640,1510,1966,0.0,98056,47.4934,-122.189,1990,9133,5984,0.6551346617035253,9922500,83429956,73507456
600000.0,3,1.75,1410,4080,1.0,0,0,3,7,1000,410,1950,0.0,98117,47.6808,-122.384,1410,4080,2670,0.6544117647058824,1988100,16646400,14658300
585000.0,2,1.75,1980,8550,1.0,0,0,2,7,990,990,1981,0.0,98117,47.6989,-122.369,1480,6738,6570,0.7684210526315789,3920400,73102500,69182100
920000.0,5,2.25,2730,6000,1.5,0,0,2,8,2130,600,1927,0.0,98105,47.6571,-122.281,2730,6000,3270,0.545,7452900,36000000,28547100
885000.0,4,2.5,2830,5000,2.0,0,0,2,9,2830,0,1995,0.0,98105,47.6597,-122.29,1950,5000,2170,0.434,8008900,25000000,16991100
292500.0,4,2.5,2250,4495,2.0,0,0,2,7,2250,0,2008,0.0,98042,47.3663,-122.11399999999999,2250,4500,2245,0.4994438264738598,5062500,20205025,15142525
301000.0,3,2.5,2420,4750,2.0,0,0,2,8,2420,0,2003,0.0,98042,47.3663,-122.12200000000001,2690,4750,2330,0.4905263157894737,5856400,22562500,16706100
951000.0,5,3.25,3250,14342,2.0,0,4,3,8,3250,0,1968,0.0,98008,47.588,-122.116,2960,11044,11092,0.7733928322409706,10562500,205692964,195130464
430000.0,4,3.0,1850,9976,2.0,0,0,2,8,1850,0,1991,0.0,98059,47.5059,-122.149,2270,8542,8126,0.8145549318364074,3422500,99520576,96098076
650000.0,3,2.25,2150,21235,1.0,0,3,3,8,1590,560,1959,0.0,98166,47.4336,-122.339,2570,18900,19085,0.8987520602778432,4622500,450925225,446302725
289000.0,3,1.75,1260,8400,1.0,0,0,2,7,1260,0,1954,0.0,98148,47.4366,-122.335,1290,8750,7140,0.85,1587600,70560000,68972400
505000.0,3,1.75,2519,8690,2.0,0,0,4,8,2519,0,1973,0.0,98166,47.4428,-122.344,2500,9500,6171,0.710126582278481,6345361,75516100,69170739
549000.0,3,1.75,1540,1044,3.0,0,0,2,8,1540,0,2014,0.0,98115,47.6765,-122.32,1580,3090,-496,-0.47509578544061304,2371600,1089936,-1281664
425000.0,3,2.25,1660,6000,1.0,0,0,2,7,1110,550,1979,0.0,98122,47.6113,-122.29700000000001,1440,4080,4340,0.7233333333333334,2755600,36000000,33244400
317625.0,3,2.75,2770,3809,1.5,0,0,4,7,1770,1000,1925,0.0,98144,47.5747,-122.304,1440,4000,1039,0.2727750065634025,7672900,14508481,6835581
975000.0,4,2.5,2720,11049,2.0,0,0,2,10,2720,0,1989,0.0,98004,47.5815,-122.19200000000001,2750,11049,8329,0.7538238754638429,7398400,122080401,114682001
287000.0,4,2.5,2240,4648,2.0,0,0,2,7,2240,0,2005,0.0,98001,47.3378,-122.257,2221,4557,2408,0.5180722891566265,5017600,21603904,16586304
204000.0,3,1.0,1000,12070,1.0,0,0,3,7,1000,0,1968,0.0,98042,47.3621,-122.11,1010,12635,11070,0.9171499585749793,1000000,145684900,144684900
1330000.0,5,2.25,3200,20158,1.0,0,0,2,8,1600,1600,1965,0.0,98004,47.6303,-122.215,3390,20158,16958,0.8412540926679234,10240000,406344964,396104964
1040000.0,5,3.25,4770,50094,1.0,0,0,3,11,3070,1700,1973,0.0,98005,47.6525,-122.16,3530,38917,45324,0.9047790154509522,22752900,2509408836,2486655936
325000.0,3,2.0,1260,5612,1.0,0,0,3,7,1260,0,1972,0.0,98034,47.7362,-122.179,1640,4745,4352,0.7754811119030649,1587600,31494544,29906944
571000.0,4,2.0,2750,7807,1.5,0,0,4,7,2250,500,1916,0.0,98125,47.7168,-122.287,1510,7807,5057,0.6477520174202639,7562500,60949249,53386749
360000.0,4,2.5,2380,5000,2.0,0,0,2,8,2380,0,2005,0.0,98038,47.3608,-122.036,2420,5000,2620,0.524,5664400,25000000,19335600
349000.0,3,1.75,1790,50529,1.0,0,0,4,7,1090,700,1965,0.0,98042,47.3511,-122.073,1940,50529,48739,0.9645747986304894,3204100,2553179841,2549975741
832500.0,4,4.0,3430,35102,2.0,0,0,3,10,2390,1040,1986,0.0,98075,47.5822,-121.98700000000001,3240,35020,31672,0.9022847700985699,11764900,1232150404,1220385504
380000.0,4,1.75,1760,7300,1.0,0,0,2,7,880,880,1956,0.0,98008,47.6034,-122.125,1680,7500,5540,0.7589041095890411,3097600,53290000,50192400
480000.0,3,1.0,1040,5060,1.0,0,0,2,7,1040,0,1941,0.0,98116,47.5636,-122.39399999999999,890,5060,4020,0.7944664031620553,1081600,25603600,24522000
410000.0,3,1.0,1410,5060,1.0,0,0,3,7,910,500,1956,0.0,98133,47.7073,-122.34,1130,5693,3650,0.7213438735177866,1988100,25603600,23615500
720000.0,4,2.5,3450,39683,2.0,0,0,2,10,3450,0,2002,0.0,98010,47.342,-122.025,3350,39750,36233,0.9130610084923015,11902500,1574740489,1562837989
390000.0,3,2.5,2350,5100,2.0,0,0,2,8,2350,0,2003,0.0,98038,47.3512,-122.008,2350,5363,2750,0.5392156862745098,5522500,26010000,20487500
360000.0,4,2.5,1900,5889,2.0,0,0,2,7,1900,0,1992,0.0,98038,47.349,-122.031,1870,6405,3989,0.6773645780268297,3610000,34680321,31070321
355000.0,2,1.0,2020,6720,1.0,0,0,2,7,1010,1010,1948,0.0,98118,47.5474,-122.291,1720,6720,4700,0.6994047619047619,4080400,45158400,41078000
356000.0,3,1.5,1680,8712,1.0,0,0,2,8,1680,0,1964,0.0,98059,47.4811,-122.149,1850,8797,7032,0.8071625344352618,2822400,75898944,73076544
315000.0,3,1.0,960,6634,1.0,0,0,2,6,960,0,1952,0.0,98125,47.7264,-122.31,1570,7203,5674,0.8552909255351221,921600,44009956,43088356
940000.0,3,1.5,2140,3600,2.0,0,0,2,9,1900,240,1925,0.0,98119,47.6337,-122.365,2020,4800,1460,0.40555555555555556,4579600,12960000,8380400
305000.0,5,2.25,2660,8400,1.5,0,0,4,7,2660,0,1961,0.0,98092,47.2909,-122.189,1590,8165,5740,0.6833333333333333,7075600,70560000,63484400
461000.0,3,3.25,2770,6278,2.0,0,0,2,9,1980,790,2006,0.0,98056,47.5228,-122.199,1900,7349,3508,0.5587766804714878,7672900,39413284,31740384
215000.0,2,2.25,1610,2040,2.0,0,0,3,7,1610,0,1979,0.0,98056,47.518,-122.194,1950,2025,430,0.2107843137254902,2592100,4161600,1569500
335000.0,2,1.75,1030,1066,2.0,0,0,2,7,765,265,2006,0.0,98136,47.5394,-122.387,1030,1106,36,0.03377110694183865,1060900,1136356,75456
243500.0,4,2.5,1980,7403,2.0,0,0,2,7,1980,0,1988,0.0,98023,47.2897,-122.37200000000001,1980,7510,5423,0.7325408618127786,3920400,54804409,50884009
1100000.0,5,2.75,3520,6353,2.0,0,0,3,10,3520,0,2001,0.0,98199,47.6506,-122.391,2520,6250,2833,0.44593105619392415,12390400,40360609,27970209
153000.0,3,1.0,1200,10500,1.0,0,0,2,7,1200,0,1962,0.0,98023,47.321999999999996,-122.351,1350,10500,9300,0.8857142857142857,1440000,110250000,108810000
430000.0,3,1.5,1580,5000,1.0,0,0,2,8,1290,290,1939,0.0,98117,47.687,-122.38600000000001,1570,4500,3420,0.684,2496400,25000000,22503600
700000.0,3,1.5,1580,5000,1.0,0,0,2,8,1290,290,1939,0.0,98117,47.687,-122.38600000000001,1570,4500,3420,0.684,2496400,25000000,22503600
905000.0,4,2.5,3300,10250,1.0,0,0,2,7,2390,910,1946,1991.0,98040,47.5873,-122.249,1950,6045,6950,0.6780487804878049,10890000,105062500,94172500
247500.0,3,1.75,1960,15681,1.0,0,0,2,7,1960,0,1967,0.0,98032,47.3576,-122.277,1750,15616,13721,0.8750079714303934,3841600,245893761,242052161
199000.0,4,1.5,1160,6400,1.0,0,0,3,7,1160,0,1975,0.0,98023,47.3036,-122.37799999999999,1160,6400,5240,0.81875,1345600,40960000,39614400
314000.0,3,1.75,1810,41800,1.0,0,0,4,7,1210,600,1980,0.0,98038,47.4109,-121.958,1650,135036,39990,0.9566985645933014,3276100,1747240000,1743963900
437500.0,3,2.5,2320,36847,2.0,0,2,2,9,2320,0,1992,0.0,98045,47.4838,-121.714,2550,35065,34527,0.9370369365212907,5382400,1357701409,1352319009
850830.0,3,2.5,2070,13241,1.5,0,0,4,9,1270,800,1910,0.0,98102,47.6415,-122.315,2200,4500,11171,0.843667396722302,4284900,175324081,171039181
555000.0,3,2.0,1980,3478,1.5,0,0,3,7,1440,540,1929,0.0,98117,47.6775,-122.37200000000001,1610,3478,1498,0.4307073030477286,3920400,12096484,8176084
699950.0,3,2.25,2190,107593,2.0,0,0,3,8,2190,0,1983,0.0,98077,47.7731,-122.08,2570,47777,105403,0.9796455159722287,4796100,11576253649,11571457549
1090000.0,3,2.5,2920,8113,2.0,0,0,2,8,2920,0,1950,2010.0,98004,47.5814,-122.196,2370,8113,5193,0.6400838160976211,8526400,65820769,57294369
290000.0,3,1.0,1210,33919,1.0,0,0,2,7,1210,0,1954,0.0,98058,47.4375,-122.184,1640,14910,32709,0.9643267785017247,1464100,1150498561,1149034461
375000.0,3,2.5,2340,10005,1.0,0,0,3,8,1460,880,1978,0.0,98058,47.4431,-122.133,2250,8162,7665,0.7661169415292354,5475600,100100025,94624425
460000.0,3,1.0,1670,4005,1.5,0,0,3,7,1170,500,1939,0.0,98117,47.6878,-122.38,1240,4005,2335,0.5830212234706617,2788900,16040025,13251125
188500.0,2,1.75,1240,2493,1.0,0,0,3,8,1240,0,1985,0.0,98198,47.3813,-122.322,1270,4966,1253,0.5026073004412355,1537600,6215049,4677449
680000.0,4,2.5,3140,28037,2.0,0,0,3,10,3140,0,1991,0.0,98077,47.7304,-122.08200000000001,2990,35001,24897,0.8880051360701929,9859600,786073369,776213769
470000.0,5,1.75,2030,12342,2.0,0,0,3,7,2030,0,1942,0.0,98052,47.6417,-122.109,2500,9433,10312,0.8355209852536055,4120900,152324964,148204064
597750.0,4,2.5,2310,9624,2.0,0,0,2,8,2310,0,1984,0.0,98027,47.5386,-122.053,1940,9636,7314,0.7599750623441397,5336100,92621376,87285276
570000.0,3,1.75,1260,3328,1.0,0,0,4,6,700,560,1905,0.0,98103,47.6823,-122.34899999999999,1380,3536,2068,0.6213942307692307,1587600,11075584,9487984
272500.0,3,1.75,1540,12600,1.0,0,0,3,7,1160,0,1980,0.0,98038,47.3624,-122.031,1540,11656,11060,0.8777777777777778,2371600,158760000,156388400
329950.0,3,1.75,2080,5969,1.0,0,2,2,7,1080,1000,1971,0.0,98108,47.5474,-122.295,2090,5500,3889,0.6515329200871167,4326400,35628961,31302561
480000.0,4,2.5,3230,16171,2.0,0,0,2,9,2520,710,2001,0.0,98001,47.3183,-122.25299999999999,2640,8517,12941,0.8002597241976378,10432900,261501241,251068341
740500.0,3,3.5,4380,6350,2.0,0,0,2,8,2780,0,1900,0.0,98117,47.6981,-122.368,1830,6350,1970,0.3102362204724409,19184400,40322500,21138100
518500.0,3,3.5,1590,1102,3.0,0,0,2,8,1590,0,2010,0.0,98103,47.6824,-122.34700000000001,1620,3166,-488,-0.44283121597096187,2528100,1214404,-1313696
205425.0,2,1.0,880,6780,1.0,0,0,3,6,880,0,1945,0.0,98178,47.5009,-122.24799999999999,1190,6780,5900,0.8702064896755162,774400,45968400,45194000
171800.0,4,2.0,1570,9600,1.0,0,0,2,6,1570,0,1950,0.0,98168,47.4965,-122.303,1880,9000,8030,0.8364583333333333,2464900,92160000,89695100
535000.0,4,1.0,1610,2982,1.5,0,0,3,7,1610,0,1925,0.0,98144,47.586999999999996,-122.294,1610,4040,1372,0.460093896713615,2592100,8892324,6300224
660000.0,3,2.5,2400,6474,1.0,0,2,2,8,1560,840,1964,0.0,98177,47.7728,-122.38600000000001,2340,10856,4074,0.629286376274328,5760000,41912676,36152676
391500.0,3,2.0,1450,9132,1.0,0,0,2,7,1450,0,1987,0.0,98034,47.7288,-122.226,1580,9104,7682,0.8412176960140166,2102500,83393424,81290924
395000.0,2,1.0,770,6000,1.0,0,0,2,6,770,0,1953,0.0,98117,47.6999,-122.36399999999999,1710,6000,5230,0.8716666666666667,592900,36000000,35407100
445000.0,4,1.75,2100,4400,1.5,0,0,4,7,1720,380,1924,0.0,98118,47.5299,-122.266,1850,4400,2300,0.5227272727272727,4410000,19360000,14950000
770000.0,3,2.25,2910,10204,2.0,0,0,2,9,2910,0,1990,0.0,98052,47.6897,-122.098,2700,13992,7294,0.7148177185417484,8468100,104121616,95653516
1450000.0,4,2.75,2750,17789,1.5,0,0,2,8,1980,770,1914,1992.0,98004,47.6141,-122.212,3060,11275,15039,0.845410084883917,7562500,316448521,308886021
445000.0,3,2.25,2100,8201,1.0,0,2,2,8,1620,480,1967,0.0,98178,47.5091,-122.244,2660,8712,6101,0.7439336666260212,4410000,67256401,62846401
260000.0,4,2.25,2160,8811,1.0,0,0,2,8,1360,800,1978,0.0,98023,47.3129,-122.39,2090,8400,6651,0.7548518896833504,4665600,77633721,72968121
822500.0,5,3.5,2320,4960,2.0,0,0,4,7,1720,600,1926,0.0,98103,47.6763,-122.352,1700,4960,2640,0.532258064516129,5382400,24601600,19219200
430000.0,4,2.5,2070,4310,2.0,0,0,2,7,2070,0,2004,0.0,98065,47.5319,-121.85,1970,3748,2240,0.5197215777262181,4284900,18576100,14291200
212000.0,3,1.75,1060,7875,1.0,0,0,3,7,1060,0,1986,0.0,98092,47.2761,-122.152,1420,7680,6815,0.8653968253968254,1123600,62015625,60892025
660500.0,4,2.25,2010,9603,1.0,0,0,2,8,1440,570,1986,0.0,98027,47.5343,-122.054,2060,9793,7593,0.7906904092471103,4040100,92217609,88177509
784000.0,3,3.5,3950,111078,1.5,0,0,2,9,2460,1490,1989,0.0,98052,47.696999999999996,-122.072,2480,88500,107128,0.9644394029420768,15602500,12338322084,12322719584
453246.0,3,2.5,2010,2287,2.0,0,0,2,8,1390,620,2014,0.0,98029,47.5517,-121.99799999999999,1690,1662,277,0.12111937035417578,4040100,5230369,1190269
675000.0,4,3.5,2140,2278,3.0,0,0,2,9,2140,0,2005,0.0,98107,47.6734,-122.38,1540,2285,138,0.06057945566286216,4579600,5189284,609684
199000.0,3,1.75,1320,17390,1.0,0,0,3,7,1320,0,1956,0.0,98003,47.3257,-122.296,1550,19265,16070,0.9240943070730305,1742400,302412100,300669700
220000.0,4,1.75,2020,7840,1.0,0,0,2,7,1010,1010,1968,0.0,98003,47.3309,-122.29899999999999,1750,8140,5820,0.7423469387755102,4080400,61465600,57385200
452000.0,4,2.25,2590,10002,1.0,0,0,3,8,1340,1250,1968,0.0,98028,47.7689,-122.266,1550,10436,7412,0.7410517896420716,6708100,100040004,93331904
382500.0,2,1.0,1190,4440,1.0,0,0,2,6,1190,0,1981,0.0,98125,47.7135,-122.287,1060,5715,3250,0.7319819819819819,1416100,19713600,18297500
519950.0,3,2.25,1170,1249,3.0,0,0,2,8,1170,0,2014,0.0,98107,47.6722,-122.381,1350,1310,79,0.0632506004803843,1368900,1560001,191101
665000.0,2,1.0,1110,3200,1.0,0,0,2,7,1110,0,1925,0.0,98119,47.6338,-122.35799999999999,1170,3600,2090,0.653125,1232100,10240000,9007900
527700.0,5,2.5,2820,9375,1.0,0,0,3,8,1550,1270,1968,0.0,98006,47.5707,-122.12799999999999,2820,9375,6555,0.6992,7952400,87890625,79938225
205000.0,3,1.0,1610,8579,1.0,0,0,3,7,1010,600,1962,0.0,98058,47.4563,-122.171,1610,8579,6969,0.8123324396782842,2592100,73599241,71007141
420000.0,3,1.0,1060,8097,1.0,0,0,3,7,940,120,1923,0.0,98133,47.7144,-122.351,1560,7940,7037,0.8690873162899839,1123600,65561409,64437809
500000.0,4,2.25,2030,8517,1.0,0,0,3,8,1380,650,1961,0.0,98006,47.5495,-122.17399999999999,2230,8824,6487,0.7616531642597159,4120900,72539289,68418389
921500.0,4,2.5,3670,315374,2.0,0,0,3,9,3670,0,1994,0.0,98077,47.7421,-122.02600000000001,2840,87991,311704,0.9883630229505286,13468900,99460759876,99447290976
890000.0,4,1.0,2550,4000,2.0,0,0,2,8,2370,180,1905,0.0,98109,47.6354,-122.353,2200,4000,1450,0.3625,6502500,16000000,9497500
430000.0,2,2.5,2420,60984,2.0,0,0,2,7,2420,0,2007,0.0,98027,47.5262,-121.943,1940,193842,58564,0.9603174603174603,5856400,3719048256,3713191856
258000.0,5,2.0,2260,12500,1.0,0,0,3,8,1130,1130,1960,0.0,98032,47.3887,-122.286,1360,18000,10240,0.8192,5107600,156250000,151142400
511000.0,3,1.0,1430,3455,1.0,0,0,2,7,980,450,1947,0.0,98103,47.6873,-122.336,1450,4599,2025,0.5861070911722142,2044900,11937025,9892125
532170.0,3,2.0,1360,3090,2.0,0,0,2,8,1360,0,1990,0.0,98103,47.6838,-122.353,1500,3090,1730,0.5598705501618123,1849600,9548100,7698500
560000.0,3,1.0,1110,5000,1.5,0,0,2,7,1110,0,1947,0.0,98107,47.655,-122.359,1420,5000,3890,0.778,1232100,25000000,23767900
282950.0,3,1.0,1250,8200,1.0,0,0,3,7,1250,0,1954,0.0,98003,47.3255,-122.304,1680,8633,6950,0.8475609756097561,1562500,67240000,65677500
2250000.0,4,3.25,5180,19850,2.0,0,3,2,12,3540,1640,2006,0.0,98006,47.562,-122.162,3160,9750,14670,0.7390428211586901,26832400,394022500,367190100
350000.0,1,1.0,700,5100,1.0,0,0,2,7,700,0,1942,0.0,98115,47.678999999999995,-122.3,1010,5100,4400,0.8627450980392157,490000,26010000,25520000
215000.0,3,1.0,1180,7669,1.0,0,0,3,7,1180,0,1967,0.0,98058,47.4479,-122.176,1190,7669,6489,0.8461337853696701,1392400,58813561,57421161
650000.0,5,3.5,3960,25245,2.0,0,0,2,9,2500,1460,1996,0.0,98056,47.525,-122.17200000000001,2640,13675,21285,0.8431372549019608,15681600,637310025,621628425
320000.0,4,2.75,2640,7500,1.0,0,0,2,8,1620,1020,1967,0.0,98023,47.3135,-122.369,1980,7875,4860,0.648,6969600,56250000,49280400
247000.0,3,2.0,1270,7198,1.5,0,0,2,7,1270,0,1916,2013.0,98022,47.2086,-121.99600000000001,1160,7198,5928,0.8235621005834954,1612900,51811204,50198304
320000.0,4,1.75,1760,11180,1.0,0,0,3,8,1760,0,1968,0.0,98059,47.4715,-122.118,1730,11180,9420,0.8425760286225402,3097600,124992400,121894800
255000.0,5,2.25,2060,8632,1.0,0,0,2,7,1030,1030,1962,0.0,98146,47.4877,-122.335,1010,11680,6572,0.7613531047265987,4243600,74511424,70267824
438000.0,3,1.75,1780,9660,1.0,0,0,2,7,1780,0,1962,0.0,98034,47.7171,-122.193,1200,9660,7880,0.8157349896480331,3168400,93315600,90147200
900000.0,3,2.5,3400,16603,2.0,0,0,2,10,3400,0,2000,0.0,98075,47.6012,-122.023,3400,12601,13203,0.7952177317352286,11560000,275659609,264099609
441000.0,3,2.75,1910,7280,1.0,0,0,2,7,1160,750,1979,0.0,98034,47.7319,-122.22399999999999,1710,8152,5370,0.7376373626373627,3648100,52998400,49350300
420000.0,3,2.0,2020,38332,1.0,0,0,3,7,1010,1010,1975,0.0,98027,47.4582,-122.023,2110,36590,36312,0.9473025148700824,4080400,1469342224,1465261824
370000.0,3,1.75,1580,7000,1.0,0,0,2,7,1180,400,1976,0.0,98034,47.7209,-122.16799999999999,1640,7500,5420,0.7742857142857142,2496400,49000000,46503600
269950.0,2,1.75,1340,7250,1.0,0,0,4,5,700,640,1949,0.0,98198,47.408,-122.32700000000001,1830,9750,5910,0.8151724137931035,1795600,52562500,50766900
807100.0,4,2.5,2680,4499,2.0,0,0,2,9,2680,0,1999,0.0,98006,47.565,-122.125,2920,4500,1819,0.40431206934874414,7182400,20241001,13058601
653000.0,3,2.5,2680,9750,1.0,0,0,3,8,1610,1070,1979,0.0,98034,47.7028,-122.23100000000001,2480,8750,7070,0.7251282051282051,7182400,95062500,87880100
371500.0,3,2.0,1370,8336,1.0,0,0,4,7,1370,0,1964,0.0,98133,47.7458,-122.331,1770,7288,6966,0.8356525911708254,1876900,69488896,67611996
284000.0,3,1.75,1560,21000,1.0,0,0,2,7,1560,0,1954,0.0,98166,47.4776,-122.337,1070,7920,19440,0.9257142857142857,2433600,441000000,438566400
272000.0,3,1.75,2160,7140,1.0,0,0,3,7,1670,490,1978,0.0,98023,47.3026,-122.374,1930,7350,4980,0.6974789915966386,4665600,50979600,46314000
313000.0,3,1.5,1340,7912,1.5,0,0,2,7,1340,0,1955,0.0,98133,47.7658,-122.339,1480,7940,6572,0.8306370070778564,1795600,62599744,60804144
917500.0,4,2.5,3880,35003,2.0,0,0,2,10,2570,1310,1984,0.0,98033,47.6477,-122.182,3740,35230,31123,0.8891523583692826,15054400,1225210009,1210155609
673000.0,4,2.25,2590,8190,2.0,0,0,3,8,2590,0,1980,0.0,98006,47.5619,-122.125,2260,8335,5600,0.6837606837606838,6708100,67076100,60368000
425000.0,3,2.5,1120,1100,2.0,0,0,2,8,820,300,2008,0.0,98122,47.6106,-122.31,1590,1795,-20,-0.01818181818181818,1254400,1210000,-44400
399950.0,5,2.75,1970,5400,1.0,0,0,2,7,1320,650,1986,0.0,98144,47.5868,-122.30799999999999,1280,2150,3430,0.6351851851851852,3880900,29160000,25279100
385000.0,3,1.0,1220,4800,1.0,0,0,2,6,1220,0,1901,0.0,98122,47.6101,-122.307,1200,4800,3580,0.7458333333333333,1488400,23040000,21551600
269950.0,3,1.5,1950,7560,1.0,0,2,3,7,1320,630,1975,0.0,98022,47.1976,-121.999,1950,8941,5610,0.7420634920634921,3802500,57153600,53351100
330000.0,2,1.0,1350,8220,1.0,0,0,2,7,1060,290,1949,0.0,98177,47.7224,-122.35799999999999,1540,8280,6870,0.8357664233576643,1822500,67568400,65745900
260000.0,3,2.5,1670,5797,2.0,0,0,2,7,1670,0,1988,0.0,98030,47.3505,-122.179,1670,6183,4127,0.7119199585992755,2788900,33605209,30816309
470000.0,4,3.0,2380,5125,1.5,0,0,3,7,1680,700,1925,0.0,98126,47.5384,-122.376,1410,5375,2745,0.535609756097561,5664400,26265625,20601225
589000.0,4,3.0,2440,9600,2.0,0,0,4,7,2440,0,1961,0.0,98034,47.7044,-122.2,2290,9600,7160,0.7458333333333333,5953600,92160000,86206400
163500.0,2,1.5,1050,3419,2.0,0,0,2,7,1050,0,1996,0.0,98038,47.3848,-122.039,1050,3417,2369,0.6928926586721263,1102500,11689561,10587061
835000.0,4,2.75,3130,13412,2.0,0,0,2,9,2140,990,1993,0.0,98052,47.6993,-122.102,2260,9984,10282,0.7666269012824336,9796900,179881744,170084844
1100000.0,5,3.0,4090,12850,1.0,0,2,3,10,2090,2000,1986,0.0,98033,47.6627,-122.18799999999999,2540,10270,8760,0.6817120622568094,16728100,165122500,148394400
269000.0,4,1.75,1490,10000,1.0,0,0,3,8,1100,390,1969,0.0,98023,47.3099,-122.37899999999999,2190,8910,8510,0.851,2220100,100000000,97779900
560000.0,3,2.5,1900,8744,2.0,0,0,2,8,1900,0,1987,0.0,98074,47.62,-122.04299999999999,2030,8744,6844,0.782708142726441,3610000,76457536,72847536
615000.0,4,1.0,1330,2400,1.5,0,0,3,6,1330,0,1901,0.0,98103,47.65,-122.34,1330,4400,1070,0.44583333333333336,1768900,5760000,3991100
585188.0,3,2.25,2230,10026,1.0,0,0,2,8,1430,800,1975,0.0,98052,47.6647,-122.15299999999999,2230,9340,7796,0.7775782964292839,4972900,100520676,95547776
305000.0,3,1.75,1650,9480,1.0,0,0,2,7,1220,430,1977,0.0,98034,47.726000000000006,-122.191,1540,8400,7830,0.8259493670886076,2722500,89870400,87147900
166950.0,3,1.0,1190,8820,1.0,0,0,2,6,1190,0,1959,0.0,98058,47.4616,-122.184,1230,7980,7630,0.8650793650793651,1416100,77792400,76376300
799000.0,3,2.5,2140,9897,1.0,0,0,3,8,2140,0,1959,0.0,98040,47.5505,-122.219,2680,10083,7757,0.7837728604627665,4579600,97950609,93371009
400000.0,3,2.5,2180,7508,1.0,0,0,3,7,1420,760,1962,0.0,98133,47.7606,-122.336,1900,7818,5328,0.7096430474160895,4752400,56370064,51617664
230000.0,3,1.0,1060,10228,1.0,0,0,2,7,1060,0,1948,0.0,98155,47.7481,-122.3,1570,10228,9168,0.8963629253030896,1123600,104611984,103488384
256883.0,3,2.5,1690,5025,2.0,0,0,2,8,1690,0,2003,0.0,98023,47.2779,-122.34700000000001,2550,5001,3335,0.663681592039801,2856100,25250625,22394525
423000.0,4,2.0,1970,6480,1.5,0,0,4,7,1130,840,1920,0.0,98108,47.5511,-122.31200000000001,1500,6480,4510,0.6959876543209876,3880900,41990400,38109500
465000.0,3,2.5,2150,4084,2.0,0,0,2,8,2150,0,2007,0.0,98126,47.5488,-122.37200000000001,1750,2385,1934,0.47355533790401566,4622500,16679056,12056556
440000.0,3,2.5,1910,66211,2.0,0,0,2,7,1910,0,1997,0.0,98024,47.5385,-121.911,2330,67268,64301,0.9711528295902494,3648100,4383896521,4380248421
385000.0,3,1.75,1350,155073,1.0,0,0,3,7,1350,0,1969,0.0,98038,47.4058,-121.994,1560,50965,153723,0.9912944226267629,1822500,24047635329,24045812829
210000.0,3,1.0,860,11725,1.0,0,0,3,6,860,0,1943,0.0,98056,47.5093,-122.184,1300,9514,10865,0.9266524520255863,739600,137475625,136736025
297000.0,3,2.5,1940,14952,2.0,0,0,2,8,1940,0,1994,0.0,98042,47.3777,-122.165,2030,10450,13012,0.8702514713750669,3763600,223562304,219798704
470000.0,3,1.0,1010,5000,1.0,0,0,2,7,1010,0,1952,0.0,98107,47.675,-122.39399999999999,1680,5000,3990,0.798,1020100,25000000,23979900
226500.0,3,1.5,1300,7370,1.0,0,0,3,7,900,400,1976,0.0,98023,47.3025,-122.37,1430,7500,6070,0.8236092265943012,1690000,54316900,52626900
274250.0,3,1.0,910,8450,1.0,0,0,3,6,910,0,1962,0.0,98059,47.4787,-122.15799999999999,1400,8040,7540,0.8923076923076924,828100,71402500,70574400
840000.0,4,1.75,2480,11010,1.0,0,0,3,9,1630,850,1966,0.0,98040,47.5378,-122.219,2770,10744,8530,0.7747502270663034,6150400,121220100,115069700
677900.0,3,2.5,2440,4587,2.0,0,0,2,8,2440,0,2010,0.0,98052,47.7073,-122.11399999999999,2750,4587,2147,0.4680619141050796,5953600,21040569,15086969
425000.0,3,1.0,1010,5864,1.0,0,0,2,7,1010,0,1915,0.0,98116,47.5733,-122.381,1290,5000,4854,0.827762619372442,1020100,34386496,33366396
180250.0,2,0.75,900,9600,1.0,0,0,2,6,900,0,1941,0.0,98166,47.4604,-122.339,1250,14280,8700,0.90625,810000,92160000,91350000
464000.0,6,3.0,2300,3404,2.0,0,0,2,7,1600,700,1920,1994.0,98133,47.7067,-122.34299999999999,1560,1312,1104,0.32432432432432434,5290000,11587216,6297216
320000.0,4,2.25,1550,7579,2.0,0,0,2,8,1550,0,1993,0.0,98038,47.354,-122.04700000000001,1630,6397,6029,0.7954875313365879,2402500,57441241,55038741
625504.0,3,2.25,1270,1566,2.0,0,0,2,8,1060,210,2014,0.0,98105,47.6647,-122.28399999999999,1160,1327,296,0.18901660280970625,1612900,2452356,839456
592500.0,4,2.5,2240,12032,1.0,0,0,2,9,2240,0,1983,0.0,98074,47.6143,-122.01700000000001,2520,12368,9792,0.8138297872340425,5017600,144769024,139751424
465000.0,3,2.5,2714,17936,2.0,0,0,2,9,2714,0,2005,0.0,98001,47.3185,-122.275,2590,18386,15222,0.8486842105263158,7365796,321700096,314334300
477000.0,4,2.75,1720,6270,2.0,0,0,2,8,1720,0,1978,0.0,98118,47.5458,-122.26799999999999,2130,8700,4550,0.7256778309409888,2958400,39312900,36354500
280000.0,2,1.0,850,16400,1.0,0,0,2,6,850,0,1923,0.0,98168,47.4889,-122.29899999999999,1100,14459,15550,0.948170731707317,722500,268960000,268237500
1510000.0,5,3.0,3300,33474,1.0,0,3,2,9,1870,1430,1957,1991.0,98040,47.5673,-122.21,3836,20953,30174,0.9014160243771285,10890000,1120508676,1109618676
445838.0,3,2.5,2250,5692,2.0,0,0,2,8,2250,0,2000,0.0,98146,47.5133,-122.37899999999999,1320,5390,3442,0.6047083626141954,5062500,32398864,27336364
1070000.0,2,2.25,3900,14864,1.0,0,3,2,8,1950,1950,1947,0.0,98144,47.5884,-122.291,2580,5184,10964,0.7376210979547901,15210000,220938496,205728496
467000.0,2,1.5,1320,10800,1.0,0,0,3,8,1320,0,1947,0.0,98177,47.7145,-122.367,2120,12040,9480,0.8777777777777778,1742400,116640000,114897600
686000.0,4,2.5,2760,6440,2.0,0,0,2,10,2760,0,1999,0.0,98075,47.5836,-122.02600000000001,3070,8127,3680,0.5714285714285714,7617600,41473600,33856000
279950.0,3,2.0,1750,9750,1.0,0,0,2,7,1350,400,1961,0.0,98198,47.398,-122.29899999999999,1900,10125,8000,0.8205128205128205,3062500,95062500,92000000
527000.0,4,2.25,2330,19436,2.0,0,0,2,8,2330,0,1987,0.0,98011,47.7663,-122.215,1910,10055,17106,0.880119366124717,5428900,377758096,372329196
325000.0,3,2.25,2220,16020,1.0,0,0,3,8,1780,440,1966,0.0,98030,47.3758,-122.21700000000001,2080,9583,13800,0.8614232209737828,4928400,256640400,251712000
328000.0,3,2.25,2020,8379,2.0,0,0,2,7,2020,0,1994,0.0,98038,47.3828,-122.023,2020,8031,6359,0.7589211123045709,4080400,70207641,66127241
390000.0,3,2.25,1250,7500,1.0,0,0,4,7,1250,0,1942,0.0,98146,47.5123,-122.37299999999999,1280,7392,6250,0.8333333333333334,1562500,56250000,54687500
479950.0,2,2.0,1510,6516,1.0,0,0,2,8,1510,0,2005,0.0,98053,47.7076,-122.01299999999999,1640,6009,5006,0.7682627378759975,2280100,42458256,40178156
264950.0,4,2.25,1720,9753,1.0,0,0,3,7,1120,600,1978,0.0,98023,47.2922,-122.37100000000001,1510,9753,8033,0.8236440069722136,2958400,95121009,92162609
235000.0,3,1.0,1430,15246,1.0,0,0,3,7,980,450,1961,0.0,98031,47.4075,-122.214,1960,13068,13816,0.9062049062049062,2044900,232440516,230395616
516500.0,3,2.5,1480,4729,2.0,0,0,2,7,1480,0,2004,0.0,98053,47.6794,-122.03399999999999,2250,4729,3249,0.687037428631846,2190400,22363441,20173041
655000.0,2,1.75,1450,15798,2.0,1,4,2,7,1230,220,1915,1978.0,98166,47.4497,-122.375,2030,13193,14348,0.9082162299025193,2102500,249576804,247474304
500000.0,4,2.75,2280,15347,1.0,0,0,4,7,2280,0,1960,0.0,98059,47.5218,-122.164,2280,15347,13067,0.8514367628852545,5198400,235530409,230332009
315000.0,6,2.75,2940,7350,1.0,0,0,2,8,1780,1160,1978,0.0,98023,47.3103,-122.339,2120,8236,4410,0.6,8643600,54022500,45378900
213000.0,2,1.0,1000,10200,1.0,0,0,2,6,1000,0,1961,0.0,98024,47.5687,-121.899,1150,13702,9200,0.9019607843137255,1000000,104040000,103040000
475000.0,3,1.5,2480,5280,1.5,0,0,4,7,1620,860,1947,0.0,98108,47.5575,-122.303,2090,4800,2800,0.5303030303030303,6150400,27878400,21728000
1030000.0,5,4.0,3760,28040,2.0,0,0,2,10,3760,0,1983,0.0,98033,47.6489,-122.18299999999999,3430,35096,24280,0.8659058487874465,14137600,786241600,772104000
416000.0,3,2.0,2220,94300,1.0,0,0,4,7,1640,580,1976,0.0,98010,47.3459,-121.95,2070,80100,92080,0.976458112407211,4928400,8892490000,8887561600
410000.0,4,1.0,1970,4740,1.5,0,0,2,7,1670,300,1904,2005.0,98122,47.6136,-122.303,1510,4740,2770,0.5843881856540084,3880900,22467600,18586700
800000.0,3,3.5,3830,221284,2.0,0,0,2,10,3530,300,1993,0.0,98077,47.7641,-122.023,2920,148539,217454,0.9826919253086531,14668900,48966608656,48951939756
472000.0,6,2.5,4410,14034,1.0,0,2,3,9,2350,2060,1965,0.0,98003,47.3376,-122.324,2600,13988,9624,0.685763146643865,19448100,196953156,177505056
225000.0,3,1.75,1430,8505,1.0,0,0,3,7,1430,0,1968,0.0,98003,47.3173,-122.319,1190,8640,7075,0.8318636096413874,2044900,72335025,70290125
210000.0,2,1.0,830,6000,1.0,0,0,2,6,830,0,1940,0.0,98126,47.5308,-122.376,830,4960,5170,0.8616666666666667,688900,36000000,35311100
455000.0,2,1.0,1430,5000,1.5,0,0,1,7,1430,0,1925,0.0,98115,47.6727,-122.29899999999999,1450,3750,3570,0.714,2044900,25000000,22955100
225000.0,3,1.0,1300,8316,1.0,0,0,3,6,1300,0,1954,0.0,98002,47.3221,-122.21600000000001,1260,8316,7016,0.8436748436748437,1690000,69155856,67465856
480000.0,2,1.0,1030,3060,1.0,0,2,3,7,790,240,1918,0.0,98103,47.6779,-122.353,1390,3060,2030,0.6633986928104575,1060900,9363600,8302700
363000.0,3,2.5,2740,11872,2.0,0,0,2,9,2740,0,1990,0.0,98023,47.3076,-122.395,2570,10377,9132,0.7692048517520216,7507600,140944384,133436784
2400000.0,4,2.5,3650,8354,1.0,1,4,2,9,1830,1820,2000,0.0,98074,47.6338,-122.072,3120,18841,4704,0.5630835527890831,13322500,69789316,56466816
181000.0,2,1.5,720,5120,1.0,0,0,2,6,720,0,1954,0.0,98106,47.5218,-122.35700000000001,1150,2566,4400,0.859375,518400,26214400,25696000
250000.0,4,2.0,2010,7312,1.0,0,0,3,7,2010,0,1976,0.0,98002,47.2785,-122.213,2010,7650,5302,0.725109409190372,4040100,53465344,49425244
481000.0,3,1.75,1560,3000,1.0,0,0,3,6,770,790,1918,0.0,98103,47.6846,-122.345,1390,3000,1440,0.48,2433600,9000000,6566400
260000.0,3,2.0,1810,7209,1.0,0,0,3,7,1240,570,1978,0.0,98032,47.3656,-122.27799999999999,1750,7209,5399,0.7489249549174642,3276100,51969681,48693581
455000.0,4,2.5,3360,7685,2.0,0,0,2,9,3360,0,2001,0.0,98058,47.4369,-122.111,3060,6567,4325,0.5627846454131424,11289600,59059225,47769625
415000.0,3,2.25,1510,36224,2.0,0,0,2,8,1510,0,1991,0.0,98045,47.4616,-121.711,1730,36224,34714,0.958314929328622,2280100,1312178176,1309898076
349500.0,3,1.0,1400,3538,1.0,0,0,2,7,800,600,1953,0.0,98118,47.5405,-122.27,1620,6331,2138,0.604296212549463,1960000,12517444,10557444
245000.0,3,2.5,1730,7442,2.0,0,0,2,7,1730,0,1987,0.0,98030,47.3507,-122.178,1630,6458,5712,0.7675356087073367,2992900,55383364,52390464
592500.0,2,2.0,1420,9191,1.5,0,2,4,7,1420,0,1928,0.0,98115,47.6979,-122.32,1420,6816,7771,0.8455010336198455,2016400,84474481,82458081
385000.0,4,1.75,2360,7620,1.0,0,0,3,7,1180,1180,1955,0.0,98106,47.5278,-122.345,1910,7620,5260,0.6902887139107612,5569600,58064400,52494800
315000.0,3,1.75,1580,11455,1.0,0,0,3,7,1200,380,1974,0.0,98059,47.4756,-122.147,1550,10650,9875,0.8620689655172413,2496400,131217025,128720625
255000.0,3,1.0,1230,10170,1.0,0,0,2,7,1230,0,1979,0.0,98045,47.4437,-121.772,1380,10098,8940,0.8790560471976401,1512900,103428900,101916000
693000.0,4,2.5,2460,4425,2.0,0,0,2,8,2460,0,2006,0.0,98052,47.7048,-122.109,2990,5659,1965,0.4440677966101695,6051600,19580625,13529025
780000.0,3,1.0,1660,4400,1.5,0,0,2,8,1460,200,1911,0.0,98112,47.6362,-122.302,1660,4400,2740,0.6227272727272727,2755600,19360000,16604400
237000.0,3,1.75,1270,8470,1.0,0,0,3,7,1270,0,1960,0.0,98198,47.4207,-122.29,1600,8470,7200,0.8500590318772137,1612900,71740900,70128000
525000.0,3,2.25,2100,40510,2.0,0,0,2,10,1320,780,1979,0.0,98074,47.6154,-122.04700000000001,2380,33450,38410,0.9481609479140953,4410000,1641060100,1636650100
425000.0,2,1.0,770,5040,1.0,0,0,2,5,770,0,1930,0.0,98144,47.5964,-122.29899999999999,1330,2580,4270,0.8472222222222222,592900,25401600,24808700
369900.0,1,0.75,760,10079,1.0,1,4,4,5,760,0,1936,0.0,98070,47.4683,-122.43799999999999,1230,14267,9319,0.9245956940172636,577600,101586241,101008641
290000.0,4,2.5,1700,7280,2.0,0,0,3,7,1700,0,1988,0.0,98031,47.4045,-122.171,1950,7475,5580,0.7664835164835165,2890000,52998400,50108400
285000.0,3,1.0,1120,10701,1.0,0,0,2,7,1120,0,1954,0.0,98106,47.5544,-122.35799999999999,1130,6350,9581,0.8953368844033268,1254400,114511401,113257001
415000.0,2,1.0,1070,4500,1.0,0,0,2,7,1070,0,1937,0.0,98115,47.6802,-122.29,1320,4465,3430,0.7622222222222222,1144900,20250000,19105100
272500.0,3,2.5,2070,9900,1.0,0,0,2,8,1420,650,1979,0.0,98023,47.2988,-122.37100000000001,2070,8250,7830,0.7909090909090909,4284900,98010000,93725100
2900000.0,4,3.25,5050,20100,1.5,0,2,2,11,4750,300,1982,0.0,98004,47.6312,-122.223,3890,20060,15050,0.7487562189054726,25502500,404010000,378507500
1370000.0,4,4.75,5310,57346,2.0,0,0,3,11,5310,0,1989,0.0,98077,47.7285,-122.042,4180,47443,52036,0.9074041781466885,28196100,3288563716,3260367616
436000.0,2,1.0,1040,7538,1.0,0,0,3,7,1040,0,1939,0.0,98133,47.7107,-122.352,1440,7530,6498,0.8620323693287344,1081600,56821444,55739844
210000.0,3,1.0,1700,11390,1.0,0,0,3,7,1700,0,1967,0.0,98003,47.3271,-122.323,1350,8164,9690,0.8507462686567164,2890000,129732100,126842100
236000.0,3,1.0,1300,5898,1.0,0,0,2,7,1300,0,1961,0.0,98178,47.5053,-122.255,1320,7619,4598,0.7795863004408274,1690000,34786404,33096404
331000.0,3,1.75,1080,1306,1.0,0,0,2,7,580,500,1954,2003.0,98199,47.6601,-122.4,1440,2225,226,0.17304747320061256,1166400,1705636,539236
365000.0,3,2.5,2653,4510,2.0,0,0,2,8,2653,0,2006,0.0,98031,47.4145,-122.166,2653,4927,1857,0.41175166297117516,7038409,20340100,13301691
450000.0,3,2.0,2290,16258,1.0,0,0,4,8,2290,0,1960,0.0,98058,47.4672,-122.165,1660,10530,13968,0.8591462664534383,5244100,264322564,259078464
770000.0,4,2.75,3820,26300,2.0,0,0,2,9,2850,970,2014,0.0,98028,47.7618,-122.26100000000001,1860,12136,22480,0.8547528517110267,14592400,691690000,677097600
455000.0,4,2.5,2210,49375,1.0,0,0,2,8,2210,0,1997,0.0,98038,47.3828,-122.071,2670,49385,47165,0.955240506329114,4884100,2437890625,2433006525
405000.0,3,1.75,2390,6000,1.0,0,0,2,6,1240,1150,1908,0.0,98118,47.5362,-122.26799999999999,2020,6000,3610,0.6016666666666667,5712100,36000000,30287900
304900.0,4,1.75,2600,11325,1.0,0,0,3,7,1610,990,1969,0.0,98031,47.3954,-122.206,1720,11088,8725,0.7704194260485652,6760000,128255625,121495625
170000.0,2,1.0,860,5265,1.0,0,0,2,6,860,0,1931,0.0,98178,47.5048,-122.272,1650,8775,4405,0.8366571699905033,739600,27720225,26980625
2050000.0,5,3.0,3830,8480,2.0,0,1,4,9,2630,1200,1905,1994.0,98122,47.6166,-122.287,3050,7556,4650,0.5483490566037735,14668900,71910400,57241500
780000.0,4,2.5,3500,7048,2.0,0,0,2,9,3500,0,2005,0.0,98053,47.6811,-122.025,3920,7864,3548,0.503405221339387,12250000,49674304,37424304
330000.0,3,3.0,2420,13959,1.0,0,0,3,8,1740,680,1988,0.0,98028,47.7486,-122.23,2570,13300,11539,0.8266351457840819,5856400,194853681,188997281
370000.0,4,2.5,2720,8666,2.0,0,0,2,9,2720,0,1992,0.0,98030,47.3846,-122.169,2410,8100,5946,0.6861297022847911,7398400,75099556,67701156
467000.0,5,2.25,2500,13500,1.0,0,0,2,7,1850,650,1979,0.0,98072,47.7564,-122.14399999999999,2300,9750,11000,0.8148148148148148,6250000,182250000,176000000
405000.0,3,1.75,1670,6720,1.0,0,0,2,7,1140,530,1980,0.0,98034,47.7198,-122.193,1670,7320,5050,0.7514880952380952,2788900,45158400,42369500
675000.0,5,2.25,2900,10300,1.0,0,0,2,8,1450,1450,1985,0.0,98006,47.5461,-122.15100000000001,2310,10300,7400,0.7184466019417476,8410000,106090000,97680000
500000.0,2,1.0,1640,14100,1.0,0,0,3,7,1140,500,1954,0.0,98006,47.5712,-122.14299999999999,1520,13527,12460,0.8836879432624114,2689600,198810000,196120400
389999.0,4,2.5,1890,15770,2.0,0,0,3,7,1890,0,1968,0.0,98166,47.4281,-122.34299999999999,2410,15256,13880,0.8801521876981611,3572100,248692900,245120800
630000.0,4,1.75,2950,9025,1.0,0,2,3,8,1780,1170,1975,0.0,98034,47.7128,-122.223,2120,9600,6075,0.6731301939058172,8702500,81450625,72748125
360000.0,4,2.5,2160,9528,2.0,0,0,2,9,2160,0,1992,0.0,98001,47.3341,-122.255,2280,9937,7368,0.7732997481108312,4665600,90782784,86117184
580000.0,4,3.0,3280,11060,2.0,0,0,2,8,2270,1010,1986,0.0,98056,47.5399,-122.181,2320,11004,7780,0.7034358047016275,10758400,122323600,111565200
550000.0,3,2.0,1970,4166,2.0,0,3,4,8,1270,700,1929,0.0,98126,47.5717,-122.375,2390,4166,2196,0.5271243398943831,3880900,17355556,13474656
879000.0,4,2.5,3360,22111,2.0,0,0,2,10,3360,0,1994,0.0,98075,47.5951,-122.01700000000001,3150,11374,18751,0.8480394373841075,11289600,488896321,477606721
265000.0,3,2.0,1320,8959,1.0,0,0,2,7,1320,0,1993,0.0,98042,47.3536,-122.14399999999999,1740,7316,7639,0.8526621274695837,1742400,80263681,78521281
446500.0,3,2.5,2650,7286,2.0,0,0,2,8,2650,0,1990,0.0,98059,47.5084,-122.154,2400,7220,4636,0.6362887729892945,7022500,53085796,46063296
404000.0,3,1.5,2030,8880,1.0,0,0,2,7,1330,700,1963,0.0,98108,47.5586,-122.311,2140,5592,6850,0.7713963963963963,4120900,78854400,74733500
267500.0,3,1.75,1590,11914,1.0,0,2,2,7,1090,500,1957,0.0,98188,47.4427,-122.274,1630,9052,10324,0.8665435621957361,2528100,141943396,139415296
3080000.0,4,5.0,4550,18641,1.0,1,4,2,10,2600,1950,2002,0.0,98074,47.6053,-122.07700000000001,4550,19508,14091,0.755914382275629,20702500,347486881,326784381
335000.0,3,2.5,2440,7632,2.0,0,0,2,8,2440,0,1998,0.0,98003,47.3494,-122.301,2510,7903,5192,0.6802935010482181,5953600,58247424,52293824
576000.0,3,2.5,1940,9000,1.0,0,0,3,7,970,970,1948,0.0,98117,47.6933,-122.39299999999999,2190,7310,7060,0.7844444444444445,3763600,81000000,77236400
208633.0,3,2.5,2040,3810,2.0,0,0,2,8,2040,0,2006,0.0,98038,47.3537,-122.0,2370,4590,1770,0.4645669291338583,4161600,14516100,10354500
315000.0,3,2.25,2200,8750,1.0,0,0,3,7,1120,1080,1964,0.0,98166,47.476000000000006,-122.337,1460,10139,6550,0.7485714285714286,4840000,76562500,71722500
725000.0,3,1.75,1920,3300,1.0,0,0,3,8,960,960,1913,0.0,98112,47.6239,-122.29799999999999,1740,4000,1380,0.41818181818181815,3686400,10890000,7203600
550000.0,4,2.75,1800,7750,1.0,0,0,3,8,1400,400,1965,0.0,98177,47.7776,-122.384,1800,8275,5950,0.7677419354838709,3240000,60062500,56822500
610750.0,4,2.25,2180,7297,2.0,0,0,2,8,2180,0,1984,0.0,98074,47.6459,-122.05799999999999,2250,9781,5117,0.7012470878443195,4752400,53246209,48493809
550700.0,2,1.0,1010,5000,1.5,0,0,3,6,1010,0,1908,0.0,98105,47.6692,-122.29700000000001,1460,5000,3990,0.798,1020100,25000000,23979900
665000.0,4,2.75,3320,10574,2.0,0,0,4,8,2220,0,1960,0.0,98056,47.5376,-122.18,2720,8330,7254,0.6860223188954038,11022400,111809476,100787076
834000.0,4,2.5,2370,4000,1.5,0,2,4,8,1980,390,1928,0.0,98144,47.601000000000006,-122.294,2440,5750,1630,0.4075,5616900,16000000,10383100
201000.0,5,1.75,1660,78408,1.5,0,0,2,6,1660,0,1915,0.0,98065,47.528999999999996,-121.837,1660,78408,76748,0.9788286909499031,2755600,6147814464,6145058864
2380000.0,5,2.5,3650,9050,2.0,0,4,4,10,3370,280,1921,0.0,98119,47.6345,-122.367,2880,5400,5400,0.5966850828729282,13322500,81902500,68580000
1380000.0,4,3.25,4290,12103,1.0,0,3,2,11,2690,1600,1997,0.0,98006,47.5503,-122.102,3860,11244,7813,0.6455424274973147,18404100,146482609,128078509
1400000.0,4,3.25,4290,12103,1.0,0,3,2,11,2690,1600,1997,0.0,98006,47.5503,-122.102,3860,11244,7813,0.6455424274973147,18404100,146482609,128078509
305000.0,4,2.25,1950,7700,1.0,0,0,2,8,1350,600,1979,0.0,98058,47.4441,-122.125,2150,7350,5750,0.7467532467532467,3802500,59290000,55487500
487000.0,3,2.0,2590,14052,1.0,0,0,4,8,1720,870,1948,0.0,98133,47.7357,-122.333,1570,8162,11462,0.8156846000569314,6708100,197458704,190750604
390000.0,3,2.5,1930,64904,1.0,0,0,3,8,1930,0,1988,0.0,98042,47.346000000000004,-122.15700000000001,2350,57500,62974,0.9702637741895723,3724900,4212529216,4208804316
548000.0,2,1.0,1470,3864,1.0,0,0,3,7,1170,300,1916,0.0,98103,47.6638,-122.345,1570,3864,2394,0.6195652173913043,2160900,14930496,12769596
268750.0,4,1.0,800,8775,1.0,0,0,2,6,800,0,1943,0.0,98166,47.48,-122.336,1310,8775,7975,0.9088319088319088,640000,77000625,76360625
819900.0,5,2.75,3150,7119,2.0,0,0,2,9,3150,0,2013,0.0,98052,47.6759,-122.15100000000001,1560,8384,3969,0.5575221238938053,9922500,50680161,40757661
520000.0,3,2.25,2030,16200,2.0,0,0,2,8,2030,0,1984,0.0,98027,47.5162,-122.057,2660,17958,14170,0.8746913580246913,4120900,262440000,258319100
230000.0,3,2.0,1450,11204,1.0,0,0,2,7,1450,0,2003,0.0,98001,47.2639,-122.25200000000001,1520,9518,9754,0.870581935023206,2102500,125529616,123427116
240000.0,3,1.75,1510,10248,1.0,0,0,2,7,1510,0,1969,0.0,98023,47.2929,-122.37100000000001,1510,9753,8738,0.8526541764246682,2280100,105021504,102741404
232000.0,2,1.0,1240,12092,1.0,0,0,2,6,960,280,1922,1984.0,98146,47.4957,-122.352,1820,7460,10852,0.8974528613959643,1537600,146216464,144678864
240500.0,2,1.0,1240,12092,1.0,0,0,2,6,960,280,1922,1984.0,98146,47.4957,-122.352,1820,7460,10852,0.8974528613959643,1537600,146216464,144678864
274975.0,3,2.5,3030,45004,2.0,0,0,2,9,3030,0,1987,0.0,98077,47.7721,-122.09299999999999,3080,35781,41974,0.9326726513198826,9180900,2025360016,2016179116
740000.0,4,2.0,2050,4400,1.5,0,0,3,9,2050,0,1922,0.0,98102,47.644,-122.319,2320,5500,2350,0.5340909090909091,4202500,19360000,15157500
186375.0,3,1.0,1000,7636,1.0,0,0,1,7,1000,0,1952,0.0,98166,47.472,-122.344,1150,7600,6636,0.8690413829229964,1000000,58308496,57308496
790000.0,3,2.25,2370,10289,1.0,0,0,3,9,1590,780,1977,0.0,98005,47.592,-122.166,2500,10004,7919,0.7696569151521042,5616900,105863521,100246621
880000.0,4,3.5,2800,6750,2.0,0,0,2,9,1890,910,1951,2002.0,98105,47.669,-122.275,2370,6120,3950,0.5851851851851851,7840000,45562500,37722500
279000.0,6,1.75,2240,11180,2.0,0,0,3,7,2240,0,1955,0.0,98198,47.42,-122.323,1590,7955,8940,0.7996422182468694,5017600,124992400,119974800
295000.0,3,2.0,1810,10530,1.0,0,2,2,8,1810,0,1991,0.0,98022,47.1913,-122.012,1910,10450,8720,0.8281101614434948,3276100,110880900,107604800
640000.0,2,1.0,1070,5000,1.0,0,0,2,7,1070,0,1924,0.0,98103,47.6666,-122.331,1710,5000,3930,0.786,1144900,25000000,23855100
940000.0,4,2.0,2490,9525,2.0,0,0,4,9,2490,0,1968,0.0,98040,47.5639,-122.21700000000001,2770,9525,7035,0.7385826771653543,6200100,90725625,84525525
260000.0,4,2.5,1960,5238,2.0,0,0,2,7,1960,0,2003,0.0,98038,47.3483,-122.052,1800,5894,3278,0.6258113783886979,3841600,27436644,23595044
559900.0,3,2.75,2930,5569,1.0,0,0,2,9,1860,1070,2004,0.0,98072,47.7648,-122.164,2580,11045,2639,0.4738732267911654,8584900,31013761,22428861
791500.0,4,2.0,1510,3500,1.5,0,0,4,7,1510,0,1911,0.0,98103,47.6794,-122.35700000000001,1820,3750,1990,0.5685714285714286,2280100,12250000,9969900
265000.0,3,1.75,1420,8250,1.0,0,0,2,7,1420,0,1954,0.0,98133,47.7535,-122.354,1740,8000,6830,0.8278787878787879,2016400,68062500,66046100
245000.0,3,1.75,1740,11547,1.0,0,0,2,7,1740,0,1954,0.0,98178,47.4945,-122.22,880,78408,9807,0.8493115094829826,3027600,133333209,130305609
485000.0,4,1.75,2560,43995,2.0,0,0,3,7,2560,0,1962,0.0,98052,47.6945,-122.09299999999999,2560,14764,41435,0.9418115694965337,6553600,1935560025,1929006425
684000.0,4,3.5,3040,8414,2.0,0,0,2,9,2420,620,2010,0.0,98059,47.5222,-122.15700000000001,3470,8066,5374,0.6386974090801046,9241600,70795396,61553796
425000.0,3,1.75,2500,6840,1.0,0,0,2,8,1300,1200,1957,0.0,98125,47.7222,-122.32,1580,8691,4340,0.6345029239766082,6250000,46785600,40535600
309600.0,4,1.75,1275,20000,1.0,0,0,3,6,1275,0,1991,0.0,98070,47.3796,-122.49,1660,20000,18725,0.93625,1625625,400000000,398374375
552250.0,4,2.5,2580,5823,2.0,0,0,2,8,2580,0,2002,0.0,98065,47.5374,-121.875,2380,5823,3243,0.5569294178258629,6656400,33907329,27250929
165000.0,4,1.0,1000,7134,1.0,0,0,2,6,1000,0,1943,0.0,98178,47.4897,-122.24,1020,7138,6134,0.8598261844687413,1000000,50893956,49893956
239900.0,4,1.0,1000,7134,1.0,0,0,2,6,1000,0,1943,0.0,98178,47.4897,-122.24,1020,7138,6134,0.8598261844687413,1000000,50893956,49893956
320000.0,2,1.0,1070,32633,1.0,0,0,3,6,1070,0,1930,0.0,98059,47.4716,-122.07799999999999,1360,32156,31563,0.9672111053228327,1144900,1064912689,1063767789
206600.0,3,2.0,1390,13464,1.0,0,0,3,7,1390,0,1987,0.0,98030,47.3581,-122.17299999999999,1720,12080,12074,0.8967617349970292,1932100,181279296,179347196
387000.0,4,1.75,2500,7690,1.0,0,0,2,7,1250,1250,1973,0.0,98155,47.7713,-122.307,2040,8646,5190,0.6749024707412223,6250000,59136100,52886100
299000.0,1,0.75,560,12120,1.0,0,0,2,4,560,0,1967,0.0,98014,47.675,-121.854,1300,19207,11560,0.9537953795379538,313600,146894400,146580800
855000.0,4,2.75,2270,10460,2.0,0,0,2,9,2270,0,1965,0.0,98040,47.5603,-122.22200000000001,2610,10180,8190,0.7829827915869981,5152900,109411600,104258700
315000.0,3,1.0,1900,14400,1.0,0,0,3,7,1300,600,1954,0.0,98166,47.4147,-122.337,1940,14400,12500,0.8680555555555556,3610000,207360000,203750000
437500.0,2,1.0,990,3120,1.0,0,2,4,7,790,200,1907,0.0,98103,47.68,-122.353,1930,3120,2130,0.6826923076923077,980100,9734400,8754300
252000.0,4,1.5,1550,19800,1.0,0,0,3,7,1050,500,1969,0.0,98001,47.3117,-122.27,1640,22654,18250,0.9217171717171717,2402500,392040000,389637500
375000.0,4,1.75,2200,7475,1.0,0,0,4,7,1100,1100,1955,0.0,98118,47.543,-122.28,1600,5766,5275,0.705685618729097,4840000,55875625,51035625
300000.0,4,2.5,1910,4862,2.0,0,0,2,7,1910,0,2005,0.0,98038,47.3607,-122.03399999999999,2010,5091,2952,0.6071575483340189,3648100,23639044,19990944
420000.0,4,1.0,1750,9600,1.5,0,0,3,7,1750,0,1954,0.0,98006,47.5759,-122.137,1750,10530,7850,0.8177083333333334,3062500,92160000,89097500
900000.0,3,1.0,1330,77972,1.0,0,0,2,7,1330,0,1928,1954.0,98033,47.6891,-122.15899999999999,1340,17689,76642,0.9829425947776125,1768900,6079632784,6077863884
679900.0,3,2.5,2440,5750,2.0,0,2,2,9,1980,460,2000,0.0,98116,47.565,-122.381,1520,5750,3310,0.5756521739130435,5953600,33062500,27108900
463000.0,3,2.5,1640,29970,2.0,0,0,2,7,1640,0,1992,0.0,98053,47.6359,-121.97399999999999,1580,28399,28330,0.9452786119452786,2689600,898200900,895511300
380000.0,5,2.5,2760,11340,2.0,0,0,3,9,2760,0,1978,0.0,98059,47.4769,-122.141,2470,11340,8580,0.7566137566137566,7617600,128595600,120978000
329500.0,4,2.5,1820,7912,2.0,0,0,2,7,1820,0,1994,0.0,98038,47.3845,-122.029,1820,8168,6092,0.7699696663296259,3312400,62599744,59287344
604950.0,3,2.5,2110,5608,1.0,0,0,2,8,1340,770,2013,0.0,98033,47.6743,-122.184,2040,9363,3498,0.6237517831669044,4452100,31449664,26997564
795000.0,5,2.5,3040,9570,1.0,0,2,3,8,1640,1400,1966,0.0,98006,47.5651,-122.164,2920,8800,6530,0.6823406478578893,9241600,91584900,82343300
465000.0,3,2.0,1840,40438,2.0,0,0,2,7,1840,0,1994,0.0,98045,47.4853,-121.709,1380,44049,38598,0.9544982442257283,3385600,1635231844,1631846244
673000.0,4,2.5,2990,10400,2.0,0,0,2,9,2990,0,2002,0.0,98166,47.4508,-122.359,2140,17449,7410,0.7125,8940100,108160000,99219900
810000.0,4,2.5,3520,15420,2.0,0,0,2,10,3520,0,1991,0.0,98074,47.6375,-122.016,3400,21455,11900,0.7717250324254216,12390400,237776400,225386000
785000.0,4,2.75,2440,69415,1.0,0,0,3,8,1910,530,1989,0.0,98075,47.5944,-122.042,2770,24361,66975,0.9648490960167111,5953600,4818442225,4812488625
338000.0,4,3.0,2090,7500,1.0,0,0,2,7,1370,720,1986,0.0,98056,47.4888,-122.182,1810,7650,5410,0.7213333333333334,4368100,56250000,51881900
280000.0,3,2.25,1430,7222,2.0,0,0,2,7,1430,0,1993,0.0,98056,47.5112,-122.19,1430,7220,5792,0.8019939075048463,2044900,52157284,50112384
315000.0,4,2.25,2180,10754,1.0,0,0,4,7,1100,1080,1954,0.0,98133,47.7711,-122.34100000000001,1810,6929,8574,0.797284731262786,4752400,115648516,110896116
530000.0,4,2.25,2180,10754,1.0,0,0,4,7,1100,1080,1954,0.0,98133,47.7711,-122.34100000000001,1810,6929,8574,0.797284731262786,4752400,115648516,110896116
380000.0,5,3.0,3450,9914,2.0,0,0,2,9,3450,0,2004,0.0,98023,47.2813,-122.345,2860,9721,6464,0.6520072624571314,11902500,98287396,86384896
297000.0,3,2.25,1450,7562,2.0,0,0,2,7,1450,0,1994,0.0,98056,47.5038,-122.189,1650,7625,6112,0.8082517852419995,2102500,57183844,55081344
730000.0,4,2.5,3230,7331,2.0,0,0,2,10,3230,0,2004,0.0,98075,47.5823,-121.97,3480,7447,4101,0.5594052653116901,10432900,53743561,43310661
450000.0,3,1.75,1640,13500,1.0,0,0,2,7,1110,530,1940,0.0,98125,47.7164,-122.304,1770,12600,11860,0.8785185185185185,2689600,182250000,179560400
275000.0,3,3.0,1590,7750,1.0,0,0,2,7,1060,530,1997,0.0,98038,47.3624,-122.045,1680,7500,6160,0.7948387096774193,2528100,60062500,57534400
595000.0,4,2.0,2020,2849,2.0,0,0,2,7,2020,0,1960,0.0,98115,47.6831,-122.329,1910,3120,829,0.290979290979291,4080400,8116801,4036401
435000.0,3,1.5,1300,3348,1.5,0,0,2,7,1300,0,1904,2014.0,98144,47.592,-122.307,1590,2577,2048,0.6117084826762246,1690000,11209104,9519104
270000.0,2,1.5,1380,209959,1.0,0,0,0,6,1380,0,1954,0.0,98011,47.7461,-122.195,3130,19868,208579,0.993427288184836,1904400,44082781681,44080877281
950000.0,3,3.0,4040,14338,2.0,0,0,2,10,3030,1010,1986,0.0,98077,47.7268,-122.06,3360,14142,10298,0.7182312735388479,16321600,205578244,189256644
389000.0,4,2.25,2130,5337,2.0,0,0,2,7,2130,0,2001,0.0,98019,47.7237,-121.959,2300,6930,3207,0.6008993816750984,4536900,28483569,23946669
560000.0,4,2.25,2550,7800,1.0,0,0,2,8,1580,970,1968,0.0,98052,47.6283,-122.095,2420,8050,5250,0.6730769230769231,6502500,60840000,54337500
1350000.0,5,3.5,4800,14984,2.0,0,2,2,11,3480,0,1998,0.0,98006,47.5543,-122.148,4050,19009,10184,0.6796583021890016,23040000,224520256,201480256
799000.0,4,2.25,2510,11585,2.0,0,0,3,8,2510,0,1969,0.0,98040,47.5483,-122.226,2450,9691,9075,0.7833405265429435,6300100,134212225,127912125
365500.0,3,2.0,1410,9600,1.0,0,0,3,7,1410,0,1983,0.0,98072,47.7591,-122.146,1410,9600,8190,0.853125,1988100,92160000,90171900
252350.0,3,2.0,1650,7352,1.0,0,0,2,7,1160,490,1979,0.0,98058,47.4612,-122.169,1710,7350,5702,0.7755712731229597,2722500,54051904,51329404
403950.0,4,2.5,2120,13780,2.0,0,0,2,8,2120,0,1993,0.0,98146,47.4987,-122.365,1880,12000,11660,0.8461538461538461,4494400,189888400,185394000
385000.0,4,1.5,2040,10726,1.0,0,0,2,7,1380,660,1954,0.0,98177,47.772,-122.35799999999999,1610,10020,8686,0.8098079433153086,4161600,115047076,110885476
345000.0,4,1.0,1550,7620,1.5,0,0,2,7,1550,0,1957,0.0,98106,47.5287,-122.35,1450,7620,6070,0.7965879265091863,2402500,58064400,55661900
490000.0,3,2.75,1980,3128,2.0,0,0,3,9,1980,0,1979,0.0,98008,47.6109,-122.11399999999999,1950,2856,1148,0.3670076726342711,3920400,9784384,5863984
330000.0,3,2.5,1600,26977,2.0,0,0,2,8,1600,0,2005,0.0,98019,47.7736,-121.90100000000001,1790,27743,25377,0.9406902175927642,2560000,727758529,725198529
927000.0,4,2.75,3300,12090,2.0,0,0,2,8,3300,0,1953,0.0,98004,47.6294,-122.21799999999999,3180,12239,8790,0.7270471464019851,10890000,146168100,135278100
1120000.0,4,2.5,3840,16619,2.0,0,1,3,10,3840,0,1983,0.0,98040,47.5634,-122.213,3600,16553,12779,0.7689391660148024,14745600,276191161,261445561
330000.0,2,1.0,1220,10000,1.0,0,0,4,7,1220,0,1950,0.0,98028,47.7405,-122.241,2000,9600,8780,0.878,1488400,100000000,98511600
530000.0,5,2.25,2720,8800,1.0,0,0,3,7,1500,1220,1958,0.0,98008,47.5976,-122.118,2110,8800,6080,0.6909090909090909,7398400,77440000,70041600
365000.0,4,2.0,1940,25600,1.0,0,0,0,8,1940,0,1962,0.0,98006,47.5722,-122.12899999999999,2000,10071,23660,0.92421875,3763600,655360000,651596400
378750.0,3,2.5,2160,3000,1.5,0,0,2,7,1260,900,1909,2011.0,98118,47.5644,-122.289,1060,3500,840,0.28,4665600,9000000,4334400
269900.0,4,1.75,1530,8750,1.5,0,0,3,7,1530,0,1968,0.0,98058,47.4556,-122.15700000000001,1390,8750,7220,0.8251428571428572,2340900,76562500,74221600
557000.0,3,3.5,1710,2096,2.0,0,0,2,8,1290,420,2008,0.0,98122,47.6055,-122.305,1630,1543,386,0.18416030534351144,2924100,4393216,1469116
360000.0,4,1.75,3730,16980,1.0,0,0,3,7,2150,1580,1974,0.0,98022,47.1775,-122.022,1880,16963,13250,0.7803297997644287,13912900,288320400,274407500
352000.0,2,1.0,940,5000,1.0,0,0,3,7,940,0,1937,0.0,98117,47.6879,-122.385,1560,4500,4060,0.812,883600,25000000,24116400
437000.0,3,2.5,1750,22357,2.0,0,0,2,8,1750,0,1994,0.0,98045,47.4807,-121.779,2430,22357,20607,0.9217247394552042,3062500,499835449,496772949
322500.0,4,2.5,1820,6753,2.0,0,0,2,7,1820,0,1994,0.0,98038,47.3845,-122.03200000000001,1820,7107,4933,0.7304901525248038,3312400,45603009,42290609
650000.0,3,3.25,1510,2000,2.0,0,0,2,9,1330,180,2001,0.0,98116,47.5815,-122.402,1510,1352,490,0.245,2280100,4000000,1719900
450000.0,3,2.0,1290,1213,3.0,0,0,2,8,1290,0,2001,0.0,98103,47.6609,-122.344,1290,3235,-77,-0.06347897774113767,1664100,1471369,-192731
278500.0,3,2.0,1570,5250,1.0,0,0,2,7,1570,0,1998,0.0,98092,47.3163,-122.18799999999999,1570,5250,3680,0.700952380952381,2464900,27562500,25097600
364950.0,4,2.5,1930,6957,2.0,0,0,2,8,1930,0,1995,0.0,98055,47.4309,-122.191,2090,6996,5027,0.7225815725168895,3724900,48399849,44674949
840000.0,4,3.5,2840,40139,1.0,0,4,3,10,2840,0,1986,0.0,98038,47.401,-122.02600000000001,3180,36852,37299,0.9292458705996661,8065600,1611139321,1603073721
268000.0,3,2.5,1550,8134,2.0,0,0,2,7,1550,0,1991,0.0,98031,47.403999999999996,-122.191,1550,8134,6584,0.8094418490287681,2402500,66161956,63759456
517534.0,2,1.0,833,143947,1.0,0,0,2,5,833,0,2006,0.0,98070,47.3889,-122.48200000000001,1380,143947,143114,0.9942131478947113,693889,20720738809,20720044920
632925.0,3,2.5,2990,32239,2.0,0,0,3,8,2990,0,1978,0.0,98077,47.7718,-122.095,2990,36497,29249,0.9072551878159992,8940100,1039353121,1030413021
577500.0,3,2.5,2000,7251,2.0,0,0,2,9,2000,0,1995,0.0,98034,47.7067,-122.2,2450,8118,5251,0.7241759757274858,4000000,52577001,48577001
339000.0,4,1.5,2390,7480,1.5,0,2,2,7,2390,0,1920,0.0,98178,47.504,-122.227,2850,6867,5090,0.68048128342246,5712100,55950400,50238300
570000.0,3,1.75,2910,37461,1.0,0,0,3,7,1530,1380,1967,0.0,98052,47.7015,-122.164,2520,18295,34551,0.9223192119804596,8468100,1403326521,1394858421
563500.0,4,1.75,2085,174240,1.0,0,0,2,7,1610,475,1964,0.0,98024,47.5753,-121.95,2690,174240,172155,0.9880337465564738,4347225,30359577600,30355230375
423000.0,4,2.25,2200,9351,1.0,0,0,4,7,1290,910,1962,0.0,98133,47.7448,-122.333,1910,8660,7151,0.7647310448080419,4840000,87441201,82601201
355000.0,3,2.25,1860,5028,2.0,0,0,2,8,1860,0,2012,0.0,98019,47.7318,-121.98200000000001,2320,5465,3168,0.630071599045346,3459600,25280784,21821184
1550000.0,5,4.25,6070,171626,2.0,0,0,2,12,6070,0,1999,0.0,98024,47.5954,-121.95,4680,211267,165556,0.9646323983545617,36844900,29455483876,29418638976
482000.0,2,1.0,950,3960,1.0,0,0,2,7,950,0,1941,0.0,98103,47.6885,-122.337,1320,4050,3010,0.76010101010101,902500,15681600,14779100
625000.0,3,1.75,1600,9135,1.0,0,0,4,7,1600,0,1955,0.0,98006,47.5724,-122.179,1580,9800,7535,0.8248494800218938,2560000,83448225,80888225
538000.0,3,2.5,2250,11632,2.0,0,0,2,8,2250,0,1988,0.0,98056,47.5272,-122.169,2360,11632,9382,0.8065680880330124,5062500,135303424,130240924
380000.0,3,2.5,2280,10255,2.0,0,0,3,8,2280,0,1985,0.0,98058,47.4334,-122.161,2310,10094,7975,0.7776694295465627,5198400,105165025,99966625
375000.0,2,1.0,940,5120,1.0,0,0,2,7,940,0,1909,0.0,98122,47.6073,-122.30799999999999,1300,5120,4180,0.81640625,883600,26214400,25330800
245000.0,3,2.5,1530,8500,1.0,0,0,4,7,1030,500,1996,0.0,98038,47.3592,-122.046,1850,8140,6970,0.82,2340900,72250000,69909100
310000.0,5,1.75,2190,27260,1.0,0,0,3,7,2190,0,1947,0.0,98166,47.4546,-122.337,1620,39480,25070,0.9196625091709465,4796100,743107600,738311500
1300000.0,3,2.0,2350,15021,1.0,0,0,3,8,1770,580,1976,0.0,98004,47.6408,-122.219,3530,15715,12671,0.8435523600292923,5522500,225630441,220107941
397000.0,4,2.0,1440,7680,1.0,0,0,2,7,1200,240,1971,0.0,98034,47.7245,-122.2,1460,9660,6240,0.8125,2073600,58982400,56908800
365000.0,3,2.5,2200,4052,2.0,0,0,2,8,2200,0,2005,0.0,98058,47.4362,-122.178,2310,5082,1852,0.4570582428430405,4840000,16418704,11578704
328500.0,4,3.0,2290,8250,2.0,0,0,2,9,2290,0,1990,0.0,98042,47.3739,-122.156,2290,8250,5960,0.7224242424242424,5244100,68062500,62818400
988000.0,4,3.0,4040,19700,2.0,0,0,2,11,4040,0,1987,0.0,98052,47.7205,-122.12700000000001,3930,21887,15660,0.7949238578680203,16321600,388090000,371768400
1000000.0,4,2.5,2610,3277,1.5,0,0,4,8,1920,690,1922,0.0,98103,47.6636,-122.33,1810,3277,667,0.20353982300884957,6812100,10738729,3926629
237000.0,3,2.5,1490,2138,2.0,0,0,2,7,1490,0,2005,0.0,98055,47.4324,-122.197,1490,2094,648,0.3030869971936389,2220100,4571044,2350944
525000.0,4,2.5,2450,5280,2.0,0,0,2,8,2450,0,2003,0.0,98011,47.7734,-122.22399999999999,2300,4674,2830,0.5359848484848485,6002500,27878400,21875900
749000.0,4,2.5,1710,9627,1.0,0,0,2,9,1440,270,1976,2014.0,98006,47.559,-122.164,2140,9131,7917,0.8223745715176067,2924100,92679129,89755029
722500.0,5,2.5,4870,11800,2.0,0,0,2,10,3470,1400,1983,0.0,98074,47.633,-122.041,3180,11398,6930,0.5872881355932204,23716900,139240000,115523100
843000.0,3,2.5,3130,8750,2.0,0,0,2,10,3130,0,1991,0.0,98052,47.6954,-122.103,2860,9003,5620,0.6422857142857142,9796900,76562500,66765600
438000.0,2,2.0,1270,1372,3.0,0,0,2,8,1270,0,2000,0.0,98115,47.6776,-122.318,1610,3090,102,0.07434402332361516,1612900,1882384,269484
578000.0,3,1.75,2120,10875,1.0,0,2,2,8,1540,580,1977,0.0,98146,47.504,-122.382,2460,11760,8755,0.8050574712643678,4494400,118265625,113771225
227950.0,3,1.5,1670,8230,1.0,0,0,4,7,1670,0,1954,0.0,98001,47.2613,-122.255,2077,4910,6560,0.7970838396111786,2788900,67732900,64944000
196000.0,3,2.25,2070,11576,2.0,0,0,2,7,2070,0,1974,0.0,98001,47.3417,-122.271,1890,7519,9506,0.8211817553559088,4284900,134003776,129718876
641000.0,2,1.0,1420,5332,1.0,0,0,2,8,1070,350,1953,0.0,98105,47.6694,-122.275,2400,5406,3912,0.7336834208552138,2016400,28430224,26413824
350000.0,3,1.5,1250,219978,1.0,0,0,3,6,1250,0,1980,0.0,98038,47.4056,-121.955,1930,210394,218728,0.9943176135795397,1562500,48390320484,48388757984
205000.0,3,1.0,940,7980,1.0,0,0,3,7,940,0,1960,0.0,98032,47.3838,-122.289,1150,8050,7040,0.8822055137844611,883600,63680400,62796800
400000.0,3,1.75,1920,9102,1.0,0,0,2,7,1920,0,1968,0.0,98072,47.7487,-122.08200000000001,1920,9760,7182,0.7890573500329597,3686400,82846404,79160004
1030000.0,3,2.5,3545,9816,1.0,0,0,2,10,2610,935,2005,0.0,98027,47.5534,-122.07799999999999,3630,7704,6271,0.6388549307253464,12567025,96353856,83786831
505000.0,3,2.0,1260,5460,1.0,0,0,2,7,1260,0,1972,0.0,98034,47.7355,-122.18,1510,5460,4200,0.7692307692307693,1587600,29811600,28224000
475000.0,5,2.5,2340,7200,1.0,0,0,2,7,1300,1040,1975,0.0,98034,47.7206,-122.211,1930,7221,4860,0.675,5475600,51840000,46364400
520000.0,3,2.25,2590,9263,1.0,0,0,4,8,1440,1150,1977,0.0,98028,47.7691,-122.262,2580,9450,6673,0.7203929612436576,6708100,85803169,79095069
1450000.0,3,4.5,3970,24920,2.0,0,2,2,10,3260,710,1977,0.0,98034,47.7183,-122.258,2610,13838,20950,0.8406902086677368,15760900,621006400,605245500
333500.0,3,1.75,1220,9732,1.0,0,0,2,7,1220,0,1965,0.0,98011,47.7736,-122.214,1630,10007,8512,0.8746403616933827,1488400,94711824,93223424
232000.0,3,1.0,1400,10403,1.0,0,0,3,6,1400,0,1976,0.0,98038,47.361999999999995,-122.029,1230,10209,9003,0.8654234355474383,1960000,108222409,106262409
691100.0,3,2.75,2360,16117,1.0,0,0,3,8,1710,650,1983,0.0,98006,47.5698,-122.12100000000001,2120,16117,13757,0.8535707637897871,5569600,259757689,254188089
811000.0,3,1.75,1870,9897,1.0,0,0,3,8,1870,0,1960,0.0,98040,47.5505,-122.221,1900,10005,8027,0.8110538547034455,3496900,97950609,94453709
551000.0,3,2.5,2830,5802,2.0,0,0,2,9,2830,0,2001,0.0,98028,47.7605,-122.234,2500,5788,2972,0.5122371596001379,8008900,33663204,25654304
496500.0,3,2.5,2260,3640,2.0,0,0,2,8,2260,0,1994,0.0,98072,47.7356,-122.15700000000001,2350,3710,1380,0.3791208791208791,5107600,13249600,8142000
705000.0,3,3.0,1970,20978,2.0,1,3,3,9,1770,200,1980,0.0,98070,47.3844,-122.43799999999999,2280,75396,19008,0.9060920964820288,3880900,440076484,436195584
578000.0,4,2.5,3140,9225,1.0,0,2,4,9,1770,1370,1966,0.0,98055,47.4904,-122.226,2460,9600,6085,0.659620596205962,9859600,85100625,75241025
255000.0,3,1.75,1240,8659,1.0,0,0,4,7,1240,0,1986,0.0,98042,47.3663,-122.089,1490,8223,7419,0.8567963968125649,1537600,74978281,73440681
1050000.0,4,3.5,3450,7832,2.0,0,0,2,10,3450,0,2007,0.0,98006,47.5637,-122.12299999999999,3220,8567,4382,0.5594994892747702,11902500,61340224,49437724
348000.0,3,2.25,2570,8491,2.0,0,0,3,8,2570,0,1989,0.0,98042,47.3759,-122.125,2400,8049,5921,0.6973265810858557,6604900,72097081,65492181
230000.0,3,2.0,1510,3413,2.0,0,0,2,7,1510,0,1985,0.0,98031,47.3912,-122.167,1570,3777,1903,0.5575739818341635,2280100,11648569,9368469
359500.0,4,2.25,2390,11250,2.0,0,0,2,9,2390,0,1988,0.0,98023,47.3305,-122.37100000000001,2480,11250,8860,0.7875555555555556,5712100,126562500,120850400
330000.0,3,1.0,980,7000,1.0,0,0,2,6,980,0,1953,0.0,98133,47.7617,-122.35700000000001,1220,7000,6020,0.86,960400,49000000,48039600
80000.0,1,0.75,430,5050,1.0,0,0,1,4,430,0,1912,0.0,98014,47.6499,-121.90899999999999,1200,7500,4620,0.9148514851485149,184900,25502500,25317600
465000.0,3,1.75,1480,6360,1.0,0,0,2,7,1480,0,1954,0.0,98133,47.7311,-122.353,1480,6360,4880,0.7672955974842768,2190400,40449600,38259200
325000.0,4,2.5,1850,7324,2.0,0,0,2,8,1850,0,1997,0.0,98042,47.3701,-122.10700000000001,2100,7329,5474,0.747405789186237,3422500,53640976,50218476
340500.0,3,2.0,2270,28025,1.0,0,0,3,7,1920,350,1947,0.0,98168,47.4857,-122.318,1770,14833,25755,0.9190008920606602,5152900,785400625,780247725
342500.0,3,2.5,1810,5192,2.0,0,0,2,8,1810,0,1993,0.0,98038,47.3724,-122.042,1810,6200,3382,0.651386748844376,3276100,26956864,23680764
290900.0,2,2.0,1610,17600,2.0,0,0,2,6,1610,0,1930,1983.0,98178,47.4855,-122.266,1310,12950,15990,0.9085227272727273,2592100,309760000,307167900
868700.0,3,4.25,3840,6161,2.0,0,0,2,10,3840,0,2000,0.0,98074,47.6336,-122.064,3230,7709,2321,0.3767245577016718,14745600,37957921,23212321
1200000.0,4,2.75,4110,8400,2.0,0,1,2,9,3130,980,1928,0.0,98125,47.717,-122.281,2820,8400,4290,0.5107142857142857,16892100,70560000,53667900
1150000.0,4,3.25,4190,10259,2.0,0,0,2,11,3150,1040,2000,0.0,98074,47.6332,-122.066,4300,11919,6069,0.591578126523053,17556100,105247081,87690981
859900.0,4,2.75,3390,6298,2.0,0,0,2,9,3390,0,2011,0.0,98074,47.5906,-122.06200000000001,3390,7111,2908,0.46173388377262625,11492100,39664804,28172704
520000.0,4,2.25,1890,3006,2.0,0,0,2,7,1890,0,2003,0.0,98029,47.5461,-121.99799999999999,1580,3000,1116,0.3712574850299401,3572100,9036036,5463936
460000.0,3,2.5,1610,2527,2.0,0,2,2,9,1080,530,2005,0.0,98118,47.5674,-122.29,1610,4173,917,0.3628808864265928,2592100,6385729,3793629
438924.0,3,1.5,1050,4590,1.0,0,0,2,7,850,200,1949,0.0,98115,47.6943,-122.29,1770,5400,3540,0.7712418300653595,1102500,21068100,19965600
315000.0,2,1.0,630,6550,1.0,0,0,2,5,630,0,1918,0.0,98126,47.5486,-122.38,1420,6550,5920,0.9038167938931297,396900,42902500,42505600
590000.0,4,2.75,2910,10650,1.0,0,2,2,8,1780,1130,1975,0.0,98033,47.6658,-122.18799999999999,2920,10988,7740,0.7267605633802817,8468100,113422500,104954400
378500.0,4,1.75,1700,8640,1.0,0,0,2,7,850,850,1955,0.0,98006,47.5772,-122.15299999999999,1620,9000,6940,0.8032407407407407,2890000,74649600,71759600
328500.0,3,2.5,1950,8130,2.0,0,0,3,9,1950,0,1990,0.0,98042,47.3875,-122.161,2350,7691,6180,0.7601476014760148,3802500,66096900,62294400
849950.0,3,3.0,2990,9773,2.0,0,0,3,8,2990,0,1973,0.0,98005,47.6344,-122.17399999999999,2230,11553,6783,0.6940550496265221,8940100,95511529,86571429
525000.0,3,1.5,1350,6000,1.0,0,2,2,7,900,450,1950,0.0,98136,47.5275,-122.391,1730,6012,4650,0.775,1822500,36000000,34177500
1390000.0,4,3.25,4860,181319,2.5,0,0,2,9,4860,0,1993,0.0,98074,47.6179,-122.005,3850,181319,176459,0.9731964107457023,23619600,32876579761,32852960161
295000.0,4,2.5,2160,7725,1.0,0,0,3,8,1460,700,1978,0.0,98023,47.3078,-122.37799999999999,2060,8250,5565,0.7203883495145631,4665600,59675625,55010025
1070000.0,6,3.5,4860,11793,2.0,0,0,2,11,3860,1000,1998,0.0,98006,47.5521,-122.137,3600,11793,6933,0.587891121851946,23619600,139074849,115455249
207950.0,2,2.0,890,5000,1.0,0,0,2,6,890,0,1917,0.0,98118,47.5158,-122.264,1860,5000,4110,0.822,792100,25000000,24207900
699900.0,4,2.75,2810,7302,2.0,0,0,2,9,2810,0,2002,0.0,98075,47.5985,-121.977,2820,7302,4492,0.6151739249520679,7896100,53319204,45423104
1280000.0,5,2.5,3400,9500,2.0,0,1,3,8,3400,0,1977,0.0,98027,47.5645,-122.08200000000001,3080,11081,6100,0.6421052631578947,11560000,90250000,78690000
452000.0,4,1.5,1580,7350,1.0,0,0,3,7,960,620,1963,0.0,98052,47.6734,-122.154,1560,7350,5770,0.7850340136054422,2496400,54022500,51526100
370000.0,3,2.0,1680,5036,1.0,0,1,3,7,1680,0,1987,0.0,98055,47.4734,-122.186,1680,4921,3356,0.6664019062748213,2822400,25361296,22538896
232000.0,3,1.75,1300,11230,1.0,0,0,4,7,1300,0,1968,0.0,98042,47.3811,-122.087,1300,10794,9930,0.8842386464826358,1690000,126112900,124422900
669950.0,5,2.5,2820,14062,2.0,0,0,3,7,2380,440,1960,0.0,98034,47.7081,-122.215,1910,10392,11242,0.7994595363390699,7952400,197739844,189787444
397500.0,3,2.0,1510,6710,1.0,0,0,2,7,1070,440,1972,0.0,98034,47.7193,-122.21600000000001,1660,6600,5200,0.7749627421758569,2280100,45024100,42744000
490000.0,2,2.5,1230,1391,2.0,0,0,2,8,870,360,2004,0.0,98112,47.6192,-122.301,1240,1350,161,0.11574406901509705,1512900,1934881,421981
725000.0,4,2.0,2110,4140,2.0,0,0,2,9,1710,400,1925,2003.0,98116,47.5836,-122.387,1440,4420,2030,0.49033816425120774,4452100,17139600,12687500
299000.0,3,2.75,3080,19635,1.0,0,2,3,7,1610,1470,1958,0.0,98032,47.3841,-122.28399999999999,2424,12410,16555,0.8431372549019608,9486400,385533225,376046825
625000.0,2,1.5,1490,5750,1.5,0,0,3,7,1190,300,1900,0.0,98116,47.5872,-122.39,1590,4025,4260,0.7408695652173913,2220100,33062500,30842400
437500.0,3,2.5,2120,4500,2.0,0,0,2,7,2120,0,2000,0.0,98065,47.5322,-121.88,2530,4816,2380,0.5288888888888889,4494400,20250000,15755600
650000.0,4,2.5,3180,5438,2.0,0,0,2,9,3180,0,2003,0.0,98065,47.5416,-121.86399999999999,3030,5335,2258,0.4152261860978301,10112400,29571844,19459444
475000.0,2,1.0,1490,3825,1.0,0,0,2,7,860,630,1929,0.0,98117,47.6799,-122.381,1460,3825,2335,0.6104575163398693,2220100,14630625,12410525
342000.0,3,2.0,1930,11947,1.0,0,0,3,8,1930,0,1966,0.0,98042,47.3672,-122.15100000000001,2200,12825,10017,0.8384531681593705,3724900,142730809,139005909
1200000.0,4,2.5,2770,7800,2.0,0,0,2,10,2770,0,1999,0.0,98033,47.684,-122.205,2720,10000,5030,0.6448717948717949,7672900,60840000,53167100
280000.0,3,1.5,1670,11610,1.0,0,0,3,7,1670,0,1963,0.0,98055,47.4404,-122.191,1930,10200,9940,0.8561584840654608,2788900,134792100,132003200
240000.0,2,1.75,1330,7200,1.0,0,0,2,7,1330,0,1993,0.0,98188,47.4467,-122.281,1450,11682,5870,0.8152777777777778,1768900,51840000,50071100
529000.0,3,1.0,1210,3328,1.5,0,0,3,7,1210,0,1924,0.0,98107,47.6729,-122.363,1640,3333,2118,0.6364182692307693,1464100,11075584,9611484
442000.0,3,1.0,1190,5100,1.0,0,0,3,7,1030,160,1941,0.0,98136,47.5346,-122.385,1690,5100,3910,0.7666666666666667,1416100,26010000,24593900
615000.0,2,1.0,1540,6872,1.0,0,0,3,7,820,0,1946,0.0,98119,47.6454,-122.37299999999999,1420,5538,5332,0.7759022118742724,2371600,47224384,44852784
1490000.0,4,3.75,4030,10800,2.0,0,0,2,10,4030,0,2006,0.0,98033,47.6821,-122.196,2160,7200,6770,0.6268518518518519,16240900,116640000,100399100
585000.0,4,1.75,2430,7559,1.0,0,0,3,8,1580,850,1981,0.0,98052,47.7206,-122.11,1980,8750,5129,0.6785289059399392,5904900,57138481,51233581
480000.0,4,2.5,2600,7787,2.0,0,0,2,8,2600,0,2005,0.0,98059,47.4877,-122.139,2830,7787,5187,0.666110183639399,6760000,60637369,53877369
1100000.0,5,3.5,4410,57063,2.0,0,0,3,9,4410,0,1990,0.0,98053,47.6554,-122.01799999999999,2900,50529,52653,0.9227169970033121,19448100,3256185969,3236737869
290000.0,4,1.0,1330,8184,1.5,0,0,2,7,1330,0,1949,0.0,98133,47.7343,-122.34700000000001,1220,660,6854,0.8374877810361682,1768900,66977856,65208956
615000.0,3,1.75,1900,5000,1.0,0,0,4,7,950,950,1951,0.0,98116,47.5789,-122.39299999999999,1770,5000,3100,0.62,3610000,25000000,21390000
300000.0,2,1.0,1100,7680,1.0,0,0,3,7,1100,0,1950,0.0,98133,47.7439,-122.339,1460,7680,6580,0.8567708333333334,1210000,58982400,57772400
308000.0,3,1.0,1980,39150,1.5,0,0,2,6,1580,400,1932,0.0,98030,47.3818,-122.225,1860,11811,37170,0.9494252873563218,3920400,1532722500,1528802100
750000.0,3,2.5,2400,7745,2.0,0,0,2,9,2400,0,2001,0.0,98033,47.6734,-122.17299999999999,2080,8615,5345,0.6901226597805036,5760000,59985025,54225025
2250000.0,4,2.25,4760,8036,2.5,0,0,4,9,3390,1370,1916,0.0,98112,47.6415,-122.285,2950,9323,3276,0.4076655052264808,22657600,64577296,41919696
890000.0,4,3.25,3180,194278,2.0,0,0,2,10,3180,0,2005,0.0,98059,47.4711,-122.084,2200,178160,191098,0.9836317030235024,10112400,37743941284,37733828884
288000.0,3,1.0,1190,7560,1.0,0,0,4,6,1190,0,1958,0.0,98058,47.452,-122.177,1190,7560,6370,0.8425925925925926,1416100,57153600,55737500
190000.0,2,1.0,630,6000,1.0,0,0,2,6,630,0,1943,2005.0,98178,47.4973,-122.221,1470,6840,5370,0.895,396900,36000000,35603100
515000.0,5,3.0,2530,5105,1.0,0,0,2,8,1520,1010,2005,0.0,98133,47.7546,-122.34100000000001,2290,4011,2575,0.5044074436826641,6400900,26061025,19660125
235000.0,4,1.5,1690,11054,1.0,0,0,3,5,1690,0,1930,0.0,98055,47.4667,-122.215,1690,9040,9364,0.8471141668174417,2856100,122190916,119334816
275000.0,2,1.0,940,5000,1.0,0,0,2,6,940,0,1951,0.0,98126,47.5186,-122.374,940,5000,4060,0.812,883600,25000000,24116400
727500.0,2,2.0,1240,9119,1.0,0,0,3,7,1240,0,1952,0.0,98004,47.6221,-122.193,1380,9121,7879,0.8640201776510582,1537600,83156161,81618561
650000.0,4,2.5,3040,6587,2.0,0,0,2,7,3040,0,2003,0.0,98053,47.683,-122.039,2740,6587,3547,0.5384848944891453,9241600,43388569,34146969
1600000.0,6,5.0,6050,230652,2.0,0,3,2,11,6050,0,2001,0.0,98024,47.6033,-121.943,4210,233971,224602,0.9737700084976502,36602500,53200345104,53163742604
365000.0,4,1.0,1590,7085,1.5,0,0,2,6,1590,0,1944,0.0,98125,47.7315,-122.305,1320,7085,5495,0.7755822159491884,2528100,50197225,47669125
662000.0,3,1.75,2500,36947,1.0,0,0,2,9,2500,0,1984,0.0,98052,47.6917,-122.084,2590,28837,34447,0.9323355076190218,6250000,1365080809,1358830809
270500.0,3,2.5,1780,7848,1.0,0,0,2,7,1320,460,1978,0.0,98038,47.3608,-122.056,1680,7848,6068,0.7731906218144751,3168400,61591104,58422704
200000.0,2,1.5,1360,1898,2.0,0,0,2,7,1360,0,1978,0.0,98092,47.2852,-122.19,1360,1898,538,0.2834562697576396,1849600,3602404,1752804
970000.0,4,3.25,4740,76230,2.0,0,0,2,10,4740,0,1987,0.0,98075,47.5931,-122.071,3340,49206,71490,0.9378197560015742,22467600,5811012900,5788545300
160000.0,3,1.5,1010,9600,1.0,0,0,3,7,1010,0,1962,0.0,98198,47.4097,-122.316,1400,9660,8590,0.8947916666666667,1020100,92160000,91139900
204000.0,3,1.0,1040,7405,1.0,0,0,3,6,1040,0,1971,0.0,98010,47.3105,-122.021,1580,7405,6365,0.8595543551654288,1081600,54834025,53752425
358000.0,3,2.25,1610,6655,2.0,0,0,3,7,1610,0,1985,0.0,98058,47.4296,-122.161,1780,7529,5045,0.758076634109692,2592100,44289025,41696925
452000.0,4,1.75,1570,8268,1.0,0,0,2,7,1570,0,1979,0.0,98011,47.7373,-122.197,1870,8190,6698,0.8101112723754234,2464900,68359824,65894924
595000.0,2,2.0,1510,4000,1.0,0,0,3,7,1010,500,1900,0.0,98103,47.6582,-122.345,1920,4000,2490,0.6225,2280100,16000000,13719900
249000.0,3,2.0,1360,6082,1.0,0,0,2,7,1360,0,1994,0.0,98042,47.3577,-122.16,1360,6987,4722,0.7763893456099967,1849600,36990724,35141124
346900.0,4,2.5,1970,5106,2.0,0,0,2,8,1970,0,1999,0.0,98055,47.449,-122.205,2230,5109,3136,0.6141793967880924,3880900,26071236,22190336
2130000.0,3,2.5,5403,24069,2.0,1,4,3,12,5403,0,1976,0.0,98166,47.4169,-122.348,3980,104374,18666,0.775520378910632,29192409,579316761,550124352
280000.0,4,2.5,1560,4350,2.0,0,0,2,7,1560,0,2003,0.0,98056,47.5025,-122.186,1560,4350,2790,0.6413793103448275,2433600,18922500,16488900
318888.0,4,1.75,2320,12000,1.0,0,0,3,8,2270,50,1973,0.0,98032,47.3644,-122.28,2120,9880,9680,0.8066666666666666,5382400,144000000,138617600
530000.0,3,2.25,2120,40518,1.0,0,0,2,8,2120,0,1967,0.0,98075,47.5896,-122.009,2480,13492,38398,0.9476775753985883,4494400,1641708324,1637213924
375000.0,3,2.25,2120,18500,2.0,0,0,3,8,2120,0,1983,0.0,98031,47.3914,-122.169,2120,14479,16380,0.8854054054054054,4494400,342250000,337755600
910000.0,4,2.5,3350,29242,2.0,0,0,2,11,3350,0,1988,0.0,98052,47.7197,-122.131,3920,24728,25892,0.8854387524793106,11222500,855094564,843872064
782000.0,4,2.5,2380,9614,2.0,0,0,3,10,2380,0,1991,0.0,98006,47.5623,-122.116,2560,9770,7234,0.7524443519866861,5664400,92428996,86764596
259950.0,2,2.0,1070,649,2.0,0,0,2,9,720,350,2008,0.0,98106,47.5213,-122.35700000000001,1070,928,-421,-0.6486902927580893,1144900,421201,-723699
315000.0,4,2.75,2300,18360,1.0,0,0,3,7,1560,740,1979,0.0,98058,47.4518,-122.16,1870,9588,16060,0.8747276688453159,5290000,337089600,331799600
215000.0,2,1.0,1320,8865,1.0,0,0,3,6,1320,0,1943,0.0,98168,47.4949,-122.3,1190,6490,7545,0.8510998307952623,1742400,78588225,76845825
705000.0,3,1.75,2180,10221,1.0,0,2,3,7,1140,1040,1946,0.0,98040,47.5885,-122.24799999999999,2180,8535,8041,0.7867136288034439,4752400,104468841,99716441
1450000.0,3,3.0,4380,6320,2.0,0,3,4,10,3580,800,1952,0.0,98199,47.6452,-122.411,3080,7680,1940,0.3069620253164557,19184400,39942400,20758000
451000.0,3,1.75,1790,9813,2.0,0,0,2,7,1790,0,1949,0.0,98155,47.748999999999995,-122.305,1520,10125,8023,0.8175889126668705,3204100,96294969,93090869
261000.0,2,1.0,750,8125,1.0,0,0,3,6,750,0,1943,0.0,98055,47.4727,-122.198,1340,8750,7375,0.9076923076923077,562500,66015625,65453125
396000.0,3,1.5,1300,8280,1.0,0,0,4,7,1300,0,1956,0.0,98028,47.7403,-122.256,1570,8692,6980,0.8429951690821256,1690000,68558400,66868400
725000.0,4,2.5,2990,29170,2.0,0,3,2,9,2990,0,1999,0.0,98059,47.5146,-122.117,3715,29170,26180,0.8974974288652725,8940100,850888900,841948800
1950000.0,7,3.5,4640,15235,2.0,0,1,2,11,2860,1780,1965,2003.0,98040,47.5666,-122.23100000000001,3230,20697,10595,0.6954381358713488,21529600,232105225,210575625
238000.0,4,1.0,1400,7242,1.5,0,0,2,7,1400,0,1959,0.0,98188,47.4339,-122.291,1310,7314,5842,0.8066832366749517,1960000,52446564,50486564
750000.0,6,1.75,2750,9563,2.0,0,0,3,8,2750,0,1973,0.0,98052,47.6368,-122.09700000000001,2040,9563,6813,0.7124333368189899,7562500,91450969,83888469
331500.0,4,2.5,2050,10271,2.0,0,0,2,7,2050,0,1998,0.0,98042,47.3628,-122.075,2050,8103,8221,0.8004089183136988,4202500,105493441,101290941
460000.0,4,3.0,2230,108900,1.0,0,0,2,7,1410,820,1978,0.0,98065,47.52,-121.845,1960,65340,106670,0.9795224977043159,4972900,11859210000,11854237100
404950.0,4,2.25,2340,217014,1.0,0,0,3,8,2340,0,1982,0.0,98092,47.2953,-122.083,2340,107898,214674,0.9892172855207498,5475600,47095076196,47089600596
880000.0,3,2.5,2870,5163,2.0,0,0,2,9,2870,0,2014,0.0,98103,47.6935,-122.352,1630,7995,2293,0.4441216347085028,8236900,26656569,18419669
863000.0,4,2.5,4120,22370,2.0,0,0,2,10,4120,0,1997,0.0,98074,47.6239,-122.023,3180,7257,18250,0.8158247653106839,16974400,500416900,483442500
638700.0,3,1.75,2080,9162,1.0,0,0,2,7,1370,710,1960,0.0,98005,47.5846,-122.16799999999999,1870,8944,7082,0.7729753328967475,4326400,83942244,79615844
435000.0,3,2.5,1840,5680,2.0,0,0,2,7,1840,0,2008,0.0,98053,47.6969,-122.02600000000001,1600,4697,3840,0.676056338028169,3385600,32262400,28876800
260000.0,3,1.0,1180,5350,1.5,0,0,3,6,1180,0,1959,0.0,98178,47.505,-122.259,1490,5350,4170,0.7794392523364486,1392400,28622500,27230100
671500.0,5,2.75,2160,4000,1.5,0,0,4,7,1530,630,1927,0.0,98105,47.667,-122.289,2040,4000,1840,0.46,4665600,16000000,11334400
610000.0,3,1.0,1180,3400,1.5,0,0,2,8,1180,0,1907,0.0,98109,47.6376,-122.353,1440,3400,2220,0.6529411764705882,1392400,11560000,10167600
405000.0,2,0.75,1160,15029,1.0,0,0,3,6,870,290,1937,0.0,98014,47.6929,-121.87,1870,25346,13869,0.9228158892807239,1345600,225870841,224525241
338900.0,4,2.5,1830,5612,2.0,0,0,2,7,1830,0,2003,0.0,98038,47.3572,-122.015,1830,5998,3782,0.6739130434782609,3348900,31494544,28145644
720000.0,4,4.0,3200,7708,2.0,0,0,2,10,3200,0,2004,0.0,98075,47.5816,-121.97,3480,7944,4508,0.5848469122989102,10240000,59413264,49173264
442000.0,5,3.0,2560,5445,1.5,0,0,3,7,1760,800,1927,0.0,98108,47.5502,-122.311,1080,5445,2885,0.5298438934802571,6553600,29648025,23094425
650000.0,5,2.75,2550,5040,1.5,0,0,4,8,2550,0,1902,0.0,98122,47.6136,-122.29899999999999,1590,3840,2490,0.49404761904761907,6502500,25401600,18899100
263500.0,3,1.75,1330,9917,1.0,0,0,2,7,1040,290,1981,0.0,98058,47.4478,-122.161,1330,9081,8587,0.8658868609458505,1768900,98346889,96577989
300000.0,2,1.0,1220,75794,1.0,0,0,3,7,1220,0,1963,0.0,98038,47.4219,-122.007,2010,98010,74574,0.9839037390822493,1488400,5744730436,5743242036
266000.0,3,2.5,1805,3402,2.0,0,0,2,7,1805,0,2009,0.0,98002,47.3521,-122.212,2095,3402,1597,0.469429747207525,3258025,11573604,8315579
930000.0,4,4.0,6050,84942,2.5,0,2,2,9,4150,1900,2009,0.0,98077,47.7466,-122.029,2700,199504,78892,0.9287749287749287,36602500,7215143364,7178540864
530000.0,4,2.5,2320,5493,2.0,0,0,2,8,2320,0,2004,0.0,98028,47.7727,-122.229,2450,5471,3173,0.5776442745312216,5382400,30173049,24790649
180000.0,3,1.0,1384,8960,1.0,0,0,3,6,1384,0,1965,0.0,98023,47.3062,-122.37100000000001,1000,8470,7576,0.8455357142857143,1915456,80281600,78366144
619000.0,3,2.5,2720,6439,2.0,0,0,2,9,2720,0,2005,0.0,98065,47.5422,-121.86,3180,7320,3719,0.5775741574778692,7398400,41460721,34062321
264000.0,3,1.5,1820,10608,1.0,0,0,3,7,1820,0,1962,0.0,98003,47.3366,-122.306,1380,8976,8788,0.8284313725490197,3312400,112529664,109217264
730000.0,2,2.25,2130,4920,1.5,0,4,3,7,1530,600,1941,0.0,98116,47.573,-122.40899999999999,2130,4920,2790,0.5670731707317073,4536900,24206400,19669500
439000.0,4,2.25,2060,10070,2.0,0,0,2,7,2060,0,1975,0.0,98034,47.7258,-122.177,2060,8155,8010,0.7954319761668321,4243600,101404900,97161300
268500.0,4,1.75,1420,7500,1.0,0,0,3,7,1080,340,1981,0.0,98031,47.4025,-122.176,1500,7260,6080,0.8106666666666666,2016400,56250000,54233600
330000.0,3,1.75,1510,15744,1.0,0,0,2,7,1510,0,1985,0.0,98045,47.476000000000006,-121.755,1470,15744,14234,0.9040904471544715,2280100,247873536,245593436
640000.0,3,2.5,2160,4000,1.5,0,0,2,8,1960,200,1903,2013.0,98122,47.6045,-122.307,2160,5120,1840,0.46,4665600,16000000,11334400
900000.0,3,2.5,3180,12600,2.0,0,0,3,11,3180,0,1978,0.0,98074,47.6366,-122.05799999999999,3030,12835,9420,0.7476190476190476,10112400,158760000,148647600
370000.0,3,2.25,2110,13300,2.0,0,0,3,8,2110,0,1985,0.0,98038,47.3725,-122.06,2470,14000,11190,0.8413533834586466,4452100,176890000,172437900
685000.0,3,2.0,2060,2900,1.5,0,0,4,8,1330,730,1931,0.0,98144,47.5897,-122.292,1910,3900,840,0.2896551724137931,4243600,8410000,4166400
505000.0,3,1.5,1830,217800,1.0,0,0,2,7,1010,820,1981,0.0,98053,47.6277,-121.97200000000001,2450,165963,215970,0.9915977961432507,3348900,47436840000,47433491100
265000.0,3,1.75,1820,32666,1.0,0,0,3,7,1820,0,1966,0.0,98022,47.1803,-121.97399999999999,2050,43560,30846,0.9442845772362701,3312400,1067067556,1063755156
290000.0,3,2.5,1610,2937,2.0,0,0,2,8,1610,0,2006,0.0,98055,47.4489,-122.18799999999999,1610,3049,1327,0.45182158665304734,2592100,8625969,6033869
296000.0,4,2.5,1780,3600,2.0,0,0,2,7,1780,0,2006,0.0,98038,47.3665,-122.01700000000001,2020,3802,1820,0.5055555555555555,3168400,12960000,9791600
360000.0,4,2.5,1840,9611,2.0,0,0,2,7,1840,0,1996,0.0,98178,47.4964,-122.251,1830,8505,7771,0.8085527000312143,3385600,92371321,88985721
240500.0,3,1.75,1460,10584,1.0,0,0,2,7,990,470,1997,0.0,98168,47.492,-122.31700000000001,1220,12012,9124,0.8620559334845049,2131600,112021056,109889456
372500.0,2,2.5,1400,2958,2.0,0,0,2,8,1400,0,2007,0.0,98126,47.5496,-122.37299999999999,1540,2385,1558,0.5267072346179851,1960000,8749764,6789764
595000.0,3,2.5,3370,14402,2.0,0,2,2,9,3370,0,2004,0.0,98045,47.5008,-121.77600000000001,3330,9691,11032,0.766004721566449,11356900,207417604,196060704
515000.0,4,3.0,3590,8249,2.0,0,0,2,9,3590,0,1997,0.0,98023,47.2846,-122.34100000000001,2860,7995,4659,0.564795732816099,12888100,68046001,55157901
1220000.0,4,2.25,3200,15367,2.0,0,0,3,9,3200,0,1962,0.0,98040,47.5494,-122.21600000000001,3070,15263,12167,0.7917615669942084,10240000,236144689,225904689
507000.0,2,1.75,1670,6460,1.0,0,0,2,8,1670,0,2004,0.0,98053,47.7123,-122.027,2170,6254,4790,0.7414860681114551,2788900,41731600,38942700
399950.0,4,2.0,2420,31465,1.0,0,0,2,9,2420,0,1984,0.0,98092,47.3131,-122.115,2560,32186,29045,0.9230891466709041,5856400,990046225,984189825
185000.0,3,1.75,1430,10816,2.0,0,0,2,7,1430,0,1994,0.0,98010,47.3122,-121.99600000000001,1560,10816,9386,0.8677884615384616,2044900,116985856,114940956
460000.0,3,1.75,1440,7070,1.0,0,0,2,7,1440,0,1980,0.0,98052,47.6947,-122.125,1440,7210,5630,0.7963224893917963,2073600,49984900,47911300
435500.0,3,2.25,1450,4789,2.0,0,0,2,7,1450,0,1985,0.0,98029,47.5665,-122.01799999999999,1560,4490,3339,0.6972228022551681,2102500,22934521,20832021
469000.0,4,2.75,3550,13938,1.0,0,0,4,8,2100,1450,1966,0.0,98188,47.425,-122.28299999999999,2050,9000,10388,0.7453006170182236,12602500,194267844,181665344
531000.0,2,3.0,1270,1175,2.0,0,0,2,8,1110,160,2000,0.0,98103,47.6634,-122.34,1290,1800,-95,-0.08085106382978724,1612900,1380625,-232275
443500.0,2,1.0,940,6804,1.0,0,0,2,7,940,0,1949,0.0,98177,47.7047,-122.37299999999999,1150,6930,5864,0.8618459729570841,883600,46294416,45410816
223000.0,3,2.0,1670,6824,1.0,0,0,2,7,1300,370,1990,0.0,98042,47.3666,-122.084,1660,7586,5154,0.7552754982415005,2788900,46566976,43778076
590000.0,4,3.5,3100,15842,2.0,0,0,2,8,2400,700,1996,0.0,98028,47.7466,-122.242,2200,19400,12742,0.8043176366620376,9610000,250968964,241358964
340000.0,2,2.5,1100,1760,3.0,0,0,2,7,1100,0,1997,0.0,98103,47.6972,-122.35,1200,1415,660,0.375,1210000,3097600,1887600
650000.0,3,2.0,1870,3388,1.0,0,0,3,8,1230,640,1925,0.0,98199,47.6372,-122.395,1780,4050,1518,0.44805194805194803,3496900,11478544,7981644
533600.0,3,2.5,1930,5080,2.0,0,0,3,8,1930,0,1990,0.0,98029,47.5694,-122.001,2190,5085,3150,0.6200787401574803,3724900,25806400,22081500
695000.0,3,2.75,2540,4694,2.0,0,0,2,9,2540,0,2005,0.0,98074,47.6214,-122.024,2600,6344,2154,0.4588836812952706,6451600,22033636,15582036
242000.0,3,1.75,1280,7524,1.5,0,0,3,7,1280,0,1988,0.0,98031,47.3961,-122.18799999999999,1500,7777,6244,0.8298777246145668,1638400,56610576,54972176
425000.0,3,2.25,1820,8814,1.0,0,0,2,7,1280,540,1967,0.0,98125,47.7162,-122.309,1810,7515,6994,0.7935103244837758,3312400,77686596,74374196
525000.0,3,2.25,1490,9414,2.0,0,0,2,7,1490,0,1981,0.0,98052,47.6844,-122.113,1290,10125,7924,0.8417250902910559,2220100,88623396,86403296
485000.0,3,2.5,1880,5502,2.0,0,0,2,8,1880,0,1988,0.0,98029,47.5737,-122.01799999999999,2040,5411,3622,0.6583060705198109,3534400,30272004,26737604
175000.0,3,1.0,1250,9775,1.0,0,0,2,7,1250,0,1971,0.0,98045,47.4474,-121.771,1390,9650,8525,0.8721227621483376,1562500,95550625,93988125
210000.0,3,2.0,1440,7210,1.0,0,0,2,8,1440,0,1983,0.0,98092,47.3128,-122.184,1700,7245,5770,0.8002773925104022,2073600,51984100,49910500
260000.0,3,2.5,1920,7415,2.0,0,0,2,7,1920,0,1989,0.0,98031,47.4022,-122.171,1930,7536,5495,0.7410654079568443,3686400,54982225,51295825
577000.0,3,2.5,2060,5750,1.0,0,0,2,7,1330,730,1976,0.0,98116,47.5671,-122.391,1920,5750,3690,0.6417391304347826,4243600,33062500,28818900
200000.0,3,1.5,1210,10588,1.0,0,0,3,7,1210,0,1958,0.0,98002,47.2876,-122.212,1408,10588,9378,0.8857196826596146,1464100,112105744,110641644
605000.0,2,1.75,1760,5000,1.0,0,0,3,7,940,820,1927,0.0,98117,47.681999999999995,-122.37200000000001,1530,5000,3240,0.648,3097600,25000000,21902400
325000.0,3,1.0,990,6750,1.0,0,0,3,6,990,0,1947,0.0,98133,47.7125,-122.331,1440,6860,5760,0.8533333333333334,980100,45562500,44582400
289500.0,3,1.0,960,6400,1.0,0,0,3,6,820,140,1944,0.0,98178,47.496,-122.23899999999999,1200,6600,5440,0.85,921600,40960000,40038400
559950.0,3,2.5,1660,1458,3.0,0,0,2,9,1660,0,2014,0.0,98144,47.5876,-122.309,1660,1784,-202,-0.13854595336076816,2755600,2125764,-629836
1040000.0,3,1.75,1900,9375,1.0,0,1,3,8,1330,570,1941,0.0,98115,47.6821,-122.273,2760,9375,7475,0.7973333333333333,3610000,87890625,84280625
543500.0,3,2.25,1270,2790,1.0,0,0,2,7,990,280,1970,0.0,98199,47.6581,-122.396,1920,4000,1520,0.5448028673835126,1612900,7784100,6171200
480000.0,4,2.25,3250,34293,2.0,0,0,3,9,3250,0,1983,0.0,98042,47.3496,-122.094,3110,35982,31043,0.9052284722829732,10562500,1176009849,1165447349
218000.0,3,1.0,960,9633,1.0,0,0,4,6,960,0,1982,0.0,98022,47.1951,-122.001,1080,8610,8673,0.9003425724073497,921600,92794689,91873089
565000.0,2,1.75,1330,6000,1.0,0,0,3,7,960,370,1914,1945.0,98199,47.6539,-122.396,1620,6000,4670,0.7783333333333333,1768900,36000000,34231100
426700.0,3,1.75,2080,7700,1.0,0,0,4,7,1600,480,1968,0.0,98056,47.5375,-122.178,1680,7700,5620,0.7298701298701299,4326400,59290000,54963600
650000.0,3,2.5,2690,11575,1.0,0,3,2,8,2130,0,1957,0.0,98028,47.7605,-122.26700000000001,2390,11782,8885,0.7676025917926566,7236100,133980625,126744525
542000.0,2,1.0,890,3060,1.0,0,0,2,7,770,120,1910,0.0,98105,47.6663,-122.32600000000001,1760,4080,2170,0.7091503267973857,792100,9363600,8571500
415000.0,3,1.75,1070,8000,1.0,0,0,2,7,1070,0,1977,0.0,98052,47.6978,-122.13,1200,7990,6930,0.86625,1144900,64000000,62855100
214000.0,3,1.0,1200,8316,1.0,0,0,3,6,1200,0,1953,0.0,98002,47.3221,-122.215,1200,8316,7116,0.8556998556998557,1440000,69155856,67715856
245000.0,3,1.5,1360,8910,2.0,0,0,4,7,1360,0,1949,0.0,98188,47.4488,-122.275,1220,8912,7550,0.8473625140291807,1849600,79388100,77538500
314500.0,3,2.0,2050,13303,1.0,0,0,2,8,2050,0,1993,0.0,98003,47.2681,-122.31,2180,11590,11253,0.8458994211831917,4202500,176969809,172767309
1120000.0,3,1.5,3000,5750,2.0,0,0,4,9,2000,1000,1924,0.0,98116,47.5821,-122.39,1820,5750,2750,0.4782608695652174,9000000,33062500,24062500
378000.0,2,2.0,1300,3850,1.0,0,0,2,7,800,500,1963,0.0,98136,47.5395,-122.39,950,5500,2550,0.6623376623376623,1690000,14822500,13132500
305000.0,4,2.5,2250,9091,1.0,0,0,2,7,1340,910,1982,0.0,98001,47.33600000000001,-122.26899999999999,1540,7802,6841,0.7525024749752502,5062500,82646281,77583781
595000.0,5,2.75,3740,6750,1.0,0,0,3,8,1980,1760,1978,0.0,98028,47.7679,-122.26100000000001,2620,7920,3010,0.44592592592592595,13987600,45562500,31574900
729500.0,3,2.5,1660,1091,3.0,0,1,2,9,1530,130,2015,0.0,98116,47.5818,-122.402,1510,1352,-569,-0.5215398716773603,2755600,1190281,-1565319
430000.0,3,2.5,2360,6699,2.0,0,0,2,7,2360,0,2003,0.0,98065,47.5317,-121.853,2360,4744,4339,0.6477086132258546,5569600,44876601,39307001
240000.0,3,1.75,1760,6500,1.0,0,0,2,7,1150,0,1987,0.0,98038,47.3647,-122.05,1760,8125,4740,0.7292307692307692,3097600,42250000,39152400
545000.0,3,1.75,1680,6200,1.5,0,0,2,7,1680,0,1916,0.0,98136,47.5338,-122.384,1680,5100,4520,0.7290322580645161,2822400,38440000,35617600
530000.0,3,1.75,1320,2500,1.0,0,0,2,7,870,450,1918,0.0,98105,47.6681,-122.305,1580,2750,1180,0.472,1742400,6250000,4507600
157000.0,1,1.0,870,26326,1.0,0,0,2,6,870,0,1939,0.0,98198,47.4152,-122.3,1250,10608,25456,0.9669528223049457,756900,693058276,692301376
425000.0,4,1.0,1260,7645,1.5,0,0,2,6,1260,0,1925,0.0,98146,47.5044,-122.35,1170,7649,6385,0.8351863963374755,1587600,58446025,56858425
220000.0,3,1.0,1000,6020,1.0,0,0,2,6,1000,0,1944,0.0,98166,47.4793,-122.346,1300,8640,5020,0.8338870431893688,1000000,36240400,35240400
521000.0,4,1.75,2020,36400,1.0,0,0,3,8,1550,470,1976,0.0,98077,47.7627,-122.07600000000001,2520,38255,34380,0.9445054945054945,4080400,1324960000,1320879600
325000.0,3,1.0,1920,6862,1.0,0,2,2,7,1120,800,1952,0.0,98118,47.5193,-122.274,2000,6900,4942,0.7201981929466628,3686400,47087044,43400644
597500.0,3,2.0,2150,5400,1.5,0,0,3,7,1380,770,1911,0.0,98126,47.555,-122.37899999999999,1940,6500,3250,0.6018518518518519,4622500,29160000,24537500
337000.0,3,2.5,1470,3976,2.0,0,0,2,7,1470,0,1999,0.0,98065,47.526,-121.82600000000001,1490,4400,2506,0.6302816901408451,2160900,15808576,13647676
1000000.0,3,2.5,3180,10492,2.0,0,2,2,10,3180,0,1991,0.0,98052,47.655,-122.124,3000,9812,7312,0.6969119329012581,10112400,110082064,99969664
3070000.0,3,2.5,3930,55867,1.0,1,4,3,8,2330,1600,1957,0.0,98034,47.7022,-122.22399999999999,2730,26324,51937,0.929654357670897,15444900,3121121689,3105676789
495000.0,3,1.0,990,6000,1.0,0,0,2,6,990,0,1943,0.0,98105,47.6718,-122.26700000000001,1250,6000,5010,0.835,980100,36000000,35019900
748000.0,4,3.5,2770,3330,2.0,0,0,2,8,1970,800,2001,0.0,98052,47.6327,-122.109,2180,3380,560,0.16816816816816818,7672900,11088900,3416000
888000.0,3,1.5,1250,8710,1.0,0,0,3,7,1250,0,1953,0.0,98004,47.6245,-122.198,1750,9185,7460,0.8564867967853043,1562500,75864100,74301600
269900.0,3,1.75,1140,22267,1.0,0,0,2,7,1140,0,1986,0.0,98045,47.4761,-121.758,1150,15625,21127,0.9488031616293169,1299600,495819289,494519689
496500.0,4,2.5,2250,14440,1.0,0,0,2,7,1550,700,1967,0.0,98027,47.5221,-122.045,2090,11400,12190,0.8441828254847645,5062500,208513600,203451100
475000.0,3,2.5,1640,5097,2.0,0,0,2,7,1640,0,1969,0.0,98155,47.7522,-122.27799999999999,1880,6000,3457,0.6782421031979596,2689600,25979409,23289809
312000.0,3,1.5,1255,1374,3.0,0,0,2,7,1255,0,2004,0.0,98125,47.7145,-122.311,1307,1232,119,0.08660844250363901,1575025,1887876,312851
323000.0,3,1.0,1290,12231,1.0,0,0,2,7,1290,0,1976,0.0,98072,47.7404,-122.11,1390,11632,10941,0.8945302918812853,1664100,149597361,147933261
331000.0,3,1.75,1300,9079,1.0,0,0,2,7,1300,0,1986,0.0,98059,47.4834,-122.15899999999999,1890,7369,7779,0.8568124242758013,1690000,82428241,80738241
306000.0,3,1.5,1220,1086,3.0,0,0,2,8,1220,0,2007,0.0,98133,47.7049,-122.353,1220,1422,-134,-0.12338858195211787,1488400,1179396,-309004
655000.0,4,2.5,2630,4000,3.0,0,0,2,8,2630,0,2002,0.0,98117,47.6915,-122.381,1640,4000,1370,0.3425,6916900,16000000,9083100
290000.0,3,1.5,1950,15954,1.0,0,0,3,8,1950,0,1959,0.0,98003,47.33600000000001,-122.319,1940,12667,14004,0.877773599097405,3802500,254530116,250727616
1250000.0,4,3.25,3160,5000,2.0,0,0,4,9,2360,800,1965,0.0,98105,47.6597,-122.274,2220,4000,1840,0.368,9985600,25000000,15014400
460000.0,3,1.75,1550,4708,1.0,0,0,3,7,860,690,1949,0.0,98115,47.6759,-122.286,1880,5600,3158,0.6707731520815633,2402500,22165264,19762764
435000.0,4,2.5,1700,6380,1.0,0,0,3,7,850,0,1940,0.0,98115,47.6988,-122.319,1380,6380,4680,0.7335423197492164,2890000,40704400,37814400
664000.0,4,2.75,2510,11880,1.0,0,0,4,8,1630,880,1978,0.0,98006,47.5427,-122.181,2390,11211,9370,0.7887205387205387,6300100,141134400,134834300
865000.0,4,1.75,1800,4180,2.0,0,3,3,8,1800,0,1921,0.0,98102,47.6462,-122.318,2180,4620,2380,0.569377990430622,3240000,17472400,14232400
385000.0,3,1.75,1800,18000,1.0,0,0,2,8,1200,600,1968,0.0,98058,47.4406,-122.146,1800,18000,16200,0.9,3240000,324000000,320760000
497000.0,3,2.25,1870,9315,1.0,0,0,2,7,1350,520,1975,0.0,98034,47.705,-122.20200000000001,2230,9579,7445,0.799248523886205,3496900,86769225,83272325
280000.0,2,1.0,1010,3000,1.0,0,0,3,7,1010,0,1925,0.0,98045,47.4965,-121.785,1150,7000,1990,0.6633333333333333,1020100,9000000,7979900
188000.0,2,1.5,1120,17487,1.0,0,0,2,6,1120,0,1924,0.0,98178,47.5024,-122.271,1690,8056,16367,0.9359524217990507,1254400,305795169,304540769
478500.0,3,1.0,2090,4755,1.0,0,2,2,8,1200,890,1969,0.0,98136,47.5304,-122.387,1850,5300,2665,0.5604626708727655,4368100,22610025,18241925
1150000.0,4,3.5,4370,18361,2.0,0,0,2,11,4370,0,2001,0.0,98065,47.544,-121.87200000000001,4190,13641,13991,0.7619955340123087,19096900,337126321,318029421
222000.0,3,2.0,1440,7187,1.0,0,0,3,7,970,470,1981,0.0,98023,47.291000000000004,-122.368,1440,7187,5747,0.7996382357033532,2073600,51652969,49579369
799000.0,4,3.0,2580,209523,2.0,0,0,2,8,2580,0,1984,0.0,98053,47.6932,-122.006,3440,213444,206943,0.9876863160607666,6656400,43899887529,43893231129
609900.0,4,2.5,3190,7399,2.0,0,0,2,10,3190,0,2006,0.0,98038,47.3558,-122.00399999999999,3250,7323,4209,0.5688606568455197,10176100,54745201,44569101
413000.0,4,3.5,2380,5809,2.0,0,0,3,7,1750,630,1995,0.0,98106,47.5536,-122.359,1620,5775,3429,0.5902909278705457,5664400,33744481,28080081
400000.0,4,1.0,1420,4875,1.5,0,0,2,7,1420,0,1930,0.0,98115,47.6942,-122.321,1110,5413,3455,0.7087179487179487,2016400,23765625,21749225
802541.0,5,2.75,2990,6768,2.0,0,0,2,9,2990,0,2014,0.0,98006,47.5462,-122.182,2870,6768,3778,0.5582151300236406,8940100,45805824,36865724
320000.0,3,2.5,2680,7757,2.0,0,0,2,8,2680,0,1990,0.0,98023,47.2918,-122.346,2430,8231,5077,0.6545056078380818,7182400,60171049,52988649
507000.0,4,2.5,2730,7649,2.0,0,0,2,7,2730,0,2006,0.0,98065,47.5441,-121.882,2730,6216,4919,0.6430906000784417,7452900,58507201,51054301
387500.0,3,1.0,1220,8329,1.0,0,0,2,6,1220,0,1946,0.0,98115,47.6982,-122.29799999999999,1490,8322,7109,0.8535238323928442,1488400,69372241,67883841
396000.0,3,1.0,1500,12616,1.0,0,0,2,7,1500,0,1967,0.0,98072,47.7415,-122.101,1820,13950,11116,0.8811033608116677,2250000,159163456,156913456
373000.0,3,1.75,1830,11788,1.0,0,1,2,8,1430,400,1958,0.0,98055,47.4862,-122.22399999999999,2140,11964,9958,0.8447573803868341,3348900,138956944,135608044
1480000.0,5,2.5,4570,19252,2.0,0,0,4,10,4570,0,1965,0.0,98040,47.5553,-122.22,3180,13314,14682,0.7626220652399751,20884900,370639504,349754604
359900.0,4,2.25,2470,7698,2.0,0,0,2,8,2470,0,1983,0.0,98058,47.4406,-122.141,2330,7986,5228,0.6791374382956612,6100900,59259204,53158304
410000.0,2,1.0,800,4342,1.0,0,0,2,6,670,130,1927,0.0,98115,47.6997,-122.316,1210,4343,3542,0.8157531091662829,640000,18852964,18212964
690000.0,4,2.5,2900,23488,2.0,0,0,2,9,2900,0,1992,0.0,98053,47.6726,-122.03,2900,34589,20588,0.8765326975476839,8410000,551686144,543276144
245000.0,3,2.0,1410,5760,1.0,0,0,2,7,1410,0,1985,0.0,98030,47.3702,-122.185,1670,6222,4350,0.7552083333333334,1988100,33177600,31189500
700000.0,5,2.5,2830,25958,1.0,0,1,4,8,1610,1220,1979,0.0,98075,47.5896,-122.083,2670,21567,23128,0.8909777332614223,8008900,673817764,665808864
268000.0,4,1.75,1680,9966,1.0,0,0,2,7,1100,580,1977,0.0,98198,47.3923,-122.311,2400,10369,8286,0.831426851294401,2822400,99321156,96498756
225000.0,3,1.75,1760,26055,1.0,0,0,2,7,920,840,1979,0.0,98042,47.3664,-122.1,1350,13475,24295,0.9324505853003262,3097600,678863025,675765425
980000.0,4,2.25,2240,11034,2.0,0,0,2,8,2240,0,1976,0.0,98004,47.5894,-122.195,2300,11550,8794,0.7969911183614283,5017600,121749156,116731556
795000.0,2,1.0,1380,5000,1.5,0,2,2,5,1380,0,1905,0.0,98106,47.5708,-122.359,1500,5000,3620,0.724,1904400,25000000,23095600
195000.0,2,1.0,820,5100,1.0,0,0,2,6,820,0,1953,0.0,98118,47.5156,-122.262,1170,5304,4280,0.8392156862745098,672400,26010000,25337600
480000.0,4,2.0,2180,10575,1.0,0,0,1,6,1730,450,1950,0.0,98005,47.589,-122.177,2180,12010,8395,0.7938534278959811,4752400,111830625,107078225
485000.0,4,2.0,1400,3600,1.0,0,0,2,7,1100,300,1900,0.0,98119,47.6385,-122.37,1630,2048,2200,0.6111111111111112,1960000,12960000,11000000
130000.0,2,1.0,880,9000,1.0,0,0,2,5,880,0,1928,0.0,98188,47.4672,-122.291,1410,10000,8120,0.9022222222222223,774400,81000000,80225600
325000.0,2,1.0,1060,5703,1.0,0,2,3,6,1060,0,1946,0.0,98198,47.3444,-122.32700000000001,2240,4416,4643,0.8141329125021918,1123600,32524209,31400609
440000.0,3,1.75,1530,7245,1.0,0,0,3,7,1530,0,1984,0.0,98034,47.731,-122.191,1530,7490,5715,0.7888198757763976,2340900,52490025,50149125
550000.0,4,1.75,2480,14782,1.0,0,3,2,8,1460,1020,1958,0.0,98155,47.7646,-122.271,2910,10800,12302,0.8322283858747125,6150400,218507524,212357124
310000.0,3,1.75,1490,7150,1.0,0,0,4,6,1490,0,1967,0.0,98059,47.5015,-122.124,1350,9100,5660,0.7916083916083916,2220100,51122500,48902400
530000.0,3,2.5,3660,39478,2.0,0,2,3,9,3260,400,1989,0.0,98022,47.2413,-121.97200000000001,2700,38312,35818,0.9072901362784336,13395600,1558512484,1545116884
390000.0,4,2.5,2340,8548,2.0,0,0,2,8,2340,0,1993,0.0,98031,47.4206,-122.18299999999999,1970,6818,6208,0.7262517547964437,5475600,73068304,67592704
243000.0,3,1.75,1450,12125,1.0,0,0,3,7,1450,0,1981,0.0,98001,47.3575,-122.28,1210,12125,10675,0.8804123711340206,2102500,147015625,144913125
639000.0,4,2.5,2210,9875,2.0,0,0,2,9,2210,0,1990,0.0,98074,47.6285,-122.025,2440,8799,7665,0.7762025316455696,4884100,97515625,92631525
215000.0,4,1.0,1130,7400,1.0,0,0,3,7,1130,0,1969,0.0,98003,47.3437,-122.316,1540,7379,6270,0.8472972972972973,1276900,54760000,53483100
405000.0,5,1.75,1550,10500,1.0,0,0,2,7,1100,450,1961,0.0,98011,47.7573,-122.22,1420,9823,8950,0.8523809523809524,2402500,110250000,107847500
250000.0,4,1.75,1710,7140,1.0,0,0,4,7,1010,700,1968,0.0,98032,47.3745,-122.275,1770,8960,5430,0.7605042016806722,2924100,50979600,48055500
405500.0,3,1.5,1010,8108,1.0,0,0,4,7,1010,0,1954,0.0,98155,47.7359,-122.309,1300,8108,7098,0.8754316724222989,1020100,65739664,64719564
452000.0,6,2.25,2660,13579,2.0,0,0,2,7,2660,0,1937,1990.0,98125,47.7142,-122.286,1120,8242,10919,0.8041092863981147,7075600,184389241,177313641
730000.0,6,2.25,2660,13579,2.0,0,0,2,7,2660,0,1937,1990.0,98125,47.7142,-122.286,1120,8242,10919,0.8041092863981147,7075600,184389241,177313641
267000.0,3,2.0,1300,9644,1.0,0,0,2,7,1300,0,1994,0.0,98010,47.3131,-121.99799999999999,1430,9656,8344,0.8652011613438407,1690000,93006736,91316736
289950.0,3,2.5,1670,6186,2.0,0,0,2,7,1670,0,2002,0.0,98038,47.3668,-122.031,2390,6924,4516,0.7300355641771743,2788900,38266596,35477696
565000.0,2,1.0,960,4080,1.0,0,0,4,7,960,0,1911,0.0,98103,47.6893,-122.34899999999999,1300,4080,3120,0.7647058823529411,921600,16646400,15724800
1580000.0,4,3.25,4670,51836,2.0,0,0,3,12,4670,0,1988,0.0,98005,47.635,-122.164,4230,41075,47166,0.9099081719268463,21808900,2686970896,2665161996
636000.0,3,2.5,2140,2770,2.0,0,0,2,8,1770,370,2007,0.0,98052,47.6664,-122.131,2510,2708,630,0.22743682310469315,4579600,7672900,3093300
350000.0,5,3.0,2520,5500,1.0,0,0,2,8,1550,970,2004,0.0,98178,47.4938,-122.255,1700,8000,2980,0.5418181818181819,6350400,30250000,23899600
320000.0,3,1.5,1650,9380,1.0,0,0,4,7,1130,520,1978,0.0,98058,47.4525,-122.162,1720,8856,7730,0.82409381663113,2722500,87984400,85261900
210000.0,2,1.75,1440,5680,1.0,0,0,3,8,1440,0,1978,0.0,98198,47.3825,-122.319,1320,3547,4240,0.7464788732394366,2073600,32262400,30188800
245000.0,2,1.0,1050,5900,1.0,0,0,2,7,1050,0,1950,0.0,98126,47.5326,-122.376,1280,5900,4850,0.8220338983050848,1102500,34810000,33707500
328000.0,3,1.75,1470,7650,1.0,0,0,2,7,1130,340,1983,0.0,98059,47.4818,-122.161,1590,7500,6180,0.807843137254902,2160900,58522500,56361600
985000.0,4,2.25,4230,37769,2.0,0,0,2,11,4230,0,1989,0.0,98077,47.7287,-122.07700000000001,3890,37034,33539,0.8880033890227436,17892900,1426497361,1408604461
501000.0,3,1.75,1970,7972,1.0,0,3,4,8,1370,600,1976,0.0,98055,47.4908,-122.225,2460,9796,6002,0.7528850978424486,3880900,63552784,59671884
315000.0,3,2.25,1540,17424,2.0,0,0,2,7,1540,0,1992,0.0,98045,47.4429,-121.759,1560,11439,15884,0.9116161616161617,2371600,303595776,301224176
403000.0,3,2.75,2090,8354,2.0,0,0,2,8,2090,0,2012,0.0,98019,47.7336,-121.965,2280,6348,6264,0.7498204452956667,4368100,69789316,65421216
550000.0,3,2.0,2380,17950,2.0,0,0,3,8,2110,270,1934,0.0,98155,47.7591,-122.28,2030,23900,15570,0.8674094707520892,5664400,322202500,316538100
347500.0,4,2.5,2156,3562,2.0,0,0,2,9,2156,0,2012,0.0,98030,47.3591,-122.20100000000001,1708,3539,1406,0.39472206625491296,4648336,12687844,8039508
365000.0,4,2.25,2070,8893,2.0,0,0,3,8,2070,0,1986,0.0,98058,47.4388,-122.162,2390,7700,6823,0.7672326548971101,4284900,79085449,74800549
588000.0,3,1.0,1910,8167,1.0,0,0,3,8,1270,640,1951,0.0,98117,47.7004,-122.368,1500,6816,6257,0.7661319946124648,3648100,66699889,63051789
605000.0,3,1.75,1920,7400,1.0,0,0,3,8,1260,660,1977,0.0,98006,47.5633,-122.131,2360,8048,5480,0.7405405405405405,3686400,54760000,51073600
1300000.0,3,3.25,3400,5979,2.0,0,0,3,9,2290,1110,1937,0.0,98105,47.6585,-122.273,3090,6435,2579,0.4313430339521659,11560000,35748441,24188441
233000.0,3,2.0,1400,9177,1.0,0,0,2,7,1400,0,1974,0.0,98001,47.3415,-122.272,2020,8547,7777,0.84744469870328,1960000,84217329,82257329
360000.0,4,2.5,2210,17715,2.0,0,0,2,8,2210,0,1997,0.0,98030,47.3818,-122.2,2210,16907,15505,0.8752469658481513,4884100,313821225,308937125
459000.0,2,1.75,1170,4887,1.0,0,0,2,6,1020,150,1929,0.0,98117,47.695,-122.366,1170,5441,3717,0.7605893186003683,1368900,23882769,22513869
740000.0,3,2.0,2100,72745,1.0,0,0,3,9,2100,0,1995,0.0,98077,47.7479,-122.06200000000001,2290,54885,70645,0.971132036566087,4410000,5291835025,5287425025
305000.0,3,1.0,1160,9750,1.0,0,0,2,7,1160,0,1967,0.0,98077,47.7422,-122.073,1160,9650,8590,0.8810256410256411,1345600,95062500,93716900
395000.0,3,1.0,1500,4000,1.0,0,0,2,6,900,600,1925,0.0,98117,47.6921,-122.38,950,4000,2500,0.625,2250000,16000000,13750000
560000.0,4,2.5,2940,6000,2.0,0,0,2,8,2940,0,2000,0.0,98011,47.7533,-122.198,2510,6600,3060,0.51,8643600,36000000,27356400
650000.0,4,1.75,2010,5070,1.0,0,1,3,7,1300,710,1963,0.0,98116,47.5793,-122.402,2180,5400,3060,0.6035502958579881,4040100,25704900,21664800
449950.0,3,2.5,2170,4912,2.0,0,0,2,7,2170,0,2003,0.0,98028,47.7767,-122.23899999999999,2010,4395,2742,0.5582247557003257,4708900,24127744,19418844
517500.0,3,1.5,1430,5200,1.0,0,3,3,7,1250,180,1940,0.0,98117,47.6988,-122.387,2210,6240,3770,0.725,2044900,27040000,24995100
435000.0,4,1.5,1510,6460,1.0,0,0,2,7,1070,440,1970,0.0,98034,47.7121,-122.214,1450,6630,4950,0.7662538699690402,2280100,41731600,39451500
329999.0,3,1.0,1150,6908,1.0,0,0,2,6,800,350,1952,0.0,98155,47.7447,-122.31299999999999,1150,6908,5758,0.8335263462651997,1322500,47720464,46397964
950000.0,3,1.75,2150,4200,1.0,0,4,4,8,1140,1010,1960,0.0,98116,47.5671,-122.405,2510,7500,2050,0.4880952380952381,4622500,17640000,13017500
447000.0,3,1.0,1370,6001,1.0,0,0,4,7,1230,140,1944,0.0,98108,47.5646,-122.31700000000001,1370,5520,4631,0.7717047158806866,1876900,36012001,34135101
699800.0,2,2.5,2380,6600,1.0,0,0,2,8,2380,0,2010,0.0,98053,47.717,-122.02,1870,6600,4220,0.6393939393939394,5664400,43560000,37895600
850000.0,3,1.75,1370,3850,1.0,0,0,4,7,770,600,1911,1988.0,98112,47.6374,-122.279,1390,3600,2480,0.6441558441558441,1876900,14822500,12945600
316500.0,3,1.75,1600,14250,1.0,0,0,2,7,1070,0,1979,0.0,98023,47.3272,-122.355,2140,14960,12650,0.887719298245614,2560000,203062500,200502500
942500.0,5,3.5,3750,9612,1.0,0,2,3,9,2030,1720,1981,0.0,98006,47.5511,-122.15700000000001,3270,9688,5862,0.6098626716604245,14062500,92390544,78328044
1310000.0,2,2.25,3950,3938,2.0,0,4,2,10,2910,1040,1991,0.0,98116,47.5912,-122.384,3220,4500,-12,-0.0030472320975114273,15602500,15507844,-94656
856600.0,4,2.25,2400,13430,1.0,0,0,3,9,2400,0,1964,0.0,98005,47.5987,-122.178,2580,10077,11030,0.8212956068503351,5760000,180364900,174604900
405600.0,5,1.5,2830,4000,2.5,0,0,3,8,2830,0,1918,0.0,98118,47.5132,-122.262,1480,4000,1170,0.2925,8008900,16000000,7991100
565000.0,4,2.5,2440,22594,2.0,0,0,2,8,2440,0,1996,0.0,98053,47.6333,-121.97,2560,33341,20154,0.8920067274497654,5953600,510488836,504535236
400000.0,3,2.25,1190,1149,2.0,0,0,2,8,1050,140,2008,0.0,98116,47.5818,-122.387,1210,1316,-41,-0.03568320278503046,1416100,1320201,-95899
330000.0,3,2.0,1400,218252,1.0,0,0,2,7,1400,0,1997,0.0,98019,47.7576,-121.934,2230,218222,216852,0.9935853966973957,1960000,47633935504,47631975504
374950.0,4,2.75,2730,4683,2.0,0,0,2,7,2730,0,2005,0.0,98038,47.3608,-122.04299999999999,2230,4924,1953,0.4170403587443946,7452900,21930489,14477589
405300.0,3,2.75,2390,7939,1.0,0,0,4,7,1610,780,1983,0.0,98056,47.4987,-122.166,1920,7939,5549,0.6989545282781207,5712100,63027721,57315621
560000.0,3,2.25,2060,31400,2.0,0,0,2,8,2060,0,1984,0.0,98074,47.6216,-122.056,2160,34500,29340,0.9343949044585987,4243600,985960000,981716400
824000.0,4,2.25,2490,9864,1.0,0,0,3,8,1290,1200,1961,0.0,98004,47.6051,-122.195,2360,9864,7374,0.7475669099756691,6200100,97298496,91098396
260000.0,3,1.75,1100,10968,1.0,0,0,4,7,1100,0,1984,0.0,98042,47.363,-122.08,1400,7799,9868,0.899708242159008,1210000,120297024,119087024
760000.0,4,2.5,2430,6099,1.0,0,0,4,8,1470,960,1965,0.0,98115,47.6777,-122.287,2180,6099,3669,0.6015740285292671,5904900,37197801,31292901
405000.0,3,2.5,3170,12750,2.0,0,0,2,10,2360,810,1995,0.0,98023,47.3384,-122.336,2970,13125,9580,0.7513725490196078,10048900,162562500,152513600
429900.0,4,2.5,2640,8625,2.0,0,0,2,8,2640,0,1987,0.0,98058,47.4598,-122.15,2240,8700,5985,0.6939130434782609,6969600,74390625,67421025
341500.0,3,1.5,1130,7223,1.0,0,0,3,7,1130,0,1961,0.0,98056,47.5089,-122.189,1320,7356,6093,0.8435553094282154,1276900,52171729,50894829
465250.0,5,2.0,1940,7642,1.5,0,0,2,7,1940,0,1957,0.0,98177,47.7751,-122.38,1940,8724,5702,0.7461397539911018,3763600,58400164,54636564
450000.0,2,2.0,1100,3000,1.5,0,0,2,7,1100,0,1912,2005.0,98117,47.6797,-122.36200000000001,1390,4000,1900,0.6333333333333333,1210000,9000000,7790000
390000.0,3,1.0,1200,10800,1.0,0,0,3,7,1200,0,1955,0.0,98006,47.5771,-122.14399999999999,1370,9950,9600,0.8888888888888888,1440000,116640000,115200000
420000.0,3,2.25,2000,8030,1.0,0,0,3,8,1000,1000,1963,0.0,98008,47.6188,-122.11399999999999,2070,8250,6030,0.75093399750934,4000000,64480900,60480900
269950.0,3,2.5,1890,4838,2.0,0,0,2,8,1730,160,2002,0.0,98168,47.4802,-122.279,1910,7409,2948,0.6093427035965275,3572100,23406244,19834144
493000.0,4,2.0,1910,2874,1.0,0,0,2,7,1060,850,1910,0.0,98122,47.6101,-122.295,1520,2874,964,0.3354210160055672,3648100,8259876,4611776
370000.0,4,2.5,2710,5880,2.0,0,0,2,9,2710,0,1998,0.0,98092,47.3314,-122.17200000000001,2520,6000,3170,0.5391156462585034,7344100,34574400,27230300
2250000.0,5,4.25,4860,9453,1.5,0,1,4,10,3100,1760,1905,0.0,98112,47.6196,-122.286,3150,8557,4593,0.48587749920660106,23619600,89359209,65739609
305000.0,3,1.0,1250,23680,1.0,0,0,4,7,1250,0,1967,0.0,98059,47.475,-122.11,1450,23680,22430,0.9472128378378378,1562500,560742400,559179900
400000.0,3,1.75,1590,8219,1.5,0,0,4,6,970,620,1938,0.0,98034,47.7146,-122.21700000000001,2030,7504,6629,0.8065458084925173,2528100,67551961,65023861
320000.0,3,1.5,1240,1221,2.0,0,0,2,8,1050,190,2009,0.0,98133,47.7073,-122.35600000000001,1180,887,-19,-0.015561015561015561,1537600,1490841,-46759
715000.0,4,1.0,2000,4800,2.0,0,0,3,7,2000,0,1911,0.0,98103,47.6583,-122.351,1260,1452,2800,0.5833333333333334,4000000,23040000,19040000
650000.0,6,2.75,3610,10003,1.5,0,0,3,8,3610,0,1966,0.0,98008,47.6261,-122.125,2560,10004,6393,0.639108267519744,13032100,100060009,87027909
218000.0,5,1.75,1930,8040,1.0,0,0,3,8,1930,0,1966,0.0,98023,47.3109,-122.376,2370,8000,6110,0.7599502487562189,3724900,64641600,60916700
500000.0,2,1.0,1280,5400,1.0,0,0,2,7,1280,0,1964,0.0,98117,47.6949,-122.37100000000001,1540,5670,4120,0.762962962962963,1638400,29160000,27521600
460000.0,4,2.0,2090,40419,1.0,0,0,3,7,2090,0,1984,0.0,98027,47.4691,-121.993,2380,63162,38329,0.9482916450184319,4368100,1633695561,1629327461
232500.0,3,1.5,1940,9887,1.0,0,0,3,7,1140,800,1969,0.0,98003,47.3289,-122.32700000000001,1410,9936,7947,0.8037827450187114,3763600,97752769,93989169
408200.0,3,2.5,1800,5761,2.0,0,0,3,7,1800,0,1990,0.0,98106,47.5293,-122.363,1800,5952,3961,0.6875542440548515,3240000,33189121,29949121
522000.0,3,1.75,1730,8400,1.0,0,0,3,7,1400,330,1980,0.0,98052,47.6792,-122.115,1830,8636,6670,0.794047619047619,2992900,70560000,67567100
675000.0,4,2.5,2810,11120,2.0,0,0,2,9,2810,0,1982,0.0,98074,47.6337,-122.044,3100,12672,8310,0.7473021582733813,7896100,123654400,115758300
1360000.0,4,3.5,3550,11000,1.0,0,2,2,11,2260,1290,1999,0.0,98006,47.5506,-122.134,4100,10012,7450,0.6772727272727272,12602500,121000000,108397500
249950.0,4,1.0,1330,7980,1.5,0,0,2,6,1330,0,1952,0.0,98168,47.492,-122.333,1570,8588,6650,0.8333333333333334,1768900,63680400,61911500
210000.0,2,1.0,750,34133,1.0,0,0,2,6,750,0,1950,0.0,98168,47.4781,-122.294,1460,25792,33383,0.9780271291711833,562500,1165061689,1164499189
429950.0,4,1.0,1760,7216,1.0,0,0,2,7,1090,670,1947,0.0,98133,47.7041,-122.355,1180,3844,5456,0.7560975609756098,3097600,52070656,48973056
737500.0,4,2.5,3200,36276,2.0,0,0,2,9,3200,0,1993,0.0,98053,47.6304,-121.994,2930,33171,33076,0.9117874076524424,10240000,1315948176,1305708176
710000.0,4,2.0,1740,9000,1.0,0,0,4,8,1740,0,1958,0.0,98033,47.6815,-122.198,1850,7700,7260,0.8066666666666666,3027600,81000000,77972400
470000.0,3,2.5,2100,4700,2.0,0,0,2,8,2100,0,1999,0.0,98065,47.5341,-121.867,2100,4700,2600,0.5531914893617021,4410000,22090000,17680000
1100000.0,4,3.5,4270,40097,1.0,0,0,3,12,4270,0,1993,0.0,98077,47.7354,-122.07799999999999,3510,36149,35827,0.8935082425119086,18232900,1607769409,1589536509
650000.0,3,2.0,1340,2720,1.5,0,0,2,7,1340,0,1913,0.0,98103,47.6518,-122.335,2030,4590,1380,0.5073529411764706,1795600,7398400,5602800
1220000.0,4,2.5,3190,8684,1.0,0,3,4,9,1680,1510,1967,0.0,98006,47.5619,-122.162,3160,8684,5494,0.6326577614002764,10176100,75411856,65235756
422120.0,3,2.5,1630,4534,2.0,0,0,2,8,1630,0,1987,0.0,98034,47.7148,-122.205,1380,4779,2904,0.6404940449933834,2656900,20557156,17900256
625000.0,5,2.5,2990,15085,2.0,0,0,2,9,2990,0,2007,0.0,98011,47.746,-122.21799999999999,3150,13076,12095,0.8017898574743122,8940100,227557225,218617125
385200.0,4,1.0,1550,7740,1.5,0,0,2,6,1550,0,1954,0.0,98126,47.5222,-122.375,1220,7740,6190,0.7997416020671835,2402500,59907600,57505100
500000.0,3,2.25,1690,4964,2.0,0,0,2,8,1690,0,1989,0.0,98029,47.5756,-122.01,1800,5036,3274,0.6595487510072522,2856100,24641296,21785196
308000.0,4,2.25,1960,12243,2.0,0,0,2,8,1960,0,1989,0.0,98042,47.3405,-122.05799999999999,1910,12230,10283,0.8399085191538022,3841600,149891049,146049449
565000.0,3,2.75,2390,9966,1.0,0,0,4,8,1360,1030,1977,0.0,98006,47.5433,-122.185,2140,10713,7576,0.7601846277342966,5712100,99321156,93609056
581000.0,3,2.5,2600,4438,2.0,0,0,2,7,2600,0,2004,0.0,98053,47.6799,-122.03399999999999,2600,4904,1838,0.41415051825146465,6760000,19695844,12935844
361000.0,3,2.0,1950,8698,1.0,0,0,2,8,1950,0,1999,0.0,98042,47.39,-122.15299999999999,2330,7212,6748,0.7758105311565877,3802500,75655204,71852704
345000.0,3,1.0,1250,7210,1.0,0,0,3,7,1250,0,1964,0.0,98008,47.6329,-122.12100000000001,1530,8800,5960,0.826629680998613,1562500,51984100,50421600
419000.0,2,2.25,1180,1253,2.0,0,0,2,8,840,340,2008,0.0,98122,47.6124,-122.309,1310,1963,73,0.05826017557861133,1392400,1570009,177609
347000.0,3,2.5,1680,4308,2.0,0,0,2,7,1680,0,2004,0.0,98056,47.4802,-122.179,2160,4182,2628,0.6100278551532033,2822400,18558864,15736464
625000.0,4,2.25,2220,36085,2.0,0,0,2,9,2220,0,1989,0.0,98075,47.5839,-121.991,3000,36906,33865,0.9384785922128308,4928400,1302127225,1297198825
2400000.0,4,4.25,4890,15188,2.0,0,2,2,11,3090,1800,1999,0.0,98040,47.5602,-122.227,3470,16201,10298,0.6780352910192257,23912100,230675344,206763244
379000.0,3,3.25,2660,17852,2.5,0,0,2,8,2660,0,2014,0.0,98010,47.3077,-122.01100000000001,1320,11876,15192,0.8509970871611025,7075600,318693904,311618304
310000.0,3,1.5,1150,3323,2.0,0,0,2,7,1150,0,1988,0.0,98029,47.5707,-122.01700000000001,1150,2980,2173,0.6539271742401445,1322500,11042329,9719829
250000.0,2,2.0,1130,5500,1.0,0,0,3,6,1130,0,1941,0.0,98030,47.3839,-122.225,1320,6600,4370,0.7945454545454546,1276900,30250000,28973100
682000.0,5,2.75,2760,5000,2.0,0,0,2,9,2760,0,2005,0.0,98059,47.538999999999994,-122.18799999999999,2870,5030,2240,0.448,7617600,25000000,17382400
246500.0,3,2.0,1430,8919,1.0,0,0,2,7,1430,0,1992,0.0,98022,47.2118,-121.98299999999999,1580,8919,7489,0.8396681242291737,2044900,79548561,77503661
325000.0,3,1.0,1490,57381,1.5,0,0,3,5,1490,0,1932,0.0,98092,47.2597,-122.228,1580,101529,55891,0.9740332165699448,2220100,3292579161,3290359061
310950.0,4,2.5,2030,4997,2.0,0,0,2,8,2030,0,2004,0.0,98031,47.393,-122.184,2095,5500,2967,0.5937562537522514,4120900,24970009,20849109
1100000.0,3,2.0,3010,5000,2.0,0,2,4,9,1890,1120,1931,0.0,98199,47.6347,-122.396,2688,5000,1990,0.398,9060100,25000000,15939900
287500.0,3,1.0,1810,7200,1.0,0,0,3,7,1130,680,1954,0.0,98133,47.7493,-122.351,1810,8100,5390,0.7486111111111111,3276100,51840000,48563900
431000.0,3,1.0,1810,7200,1.0,0,0,3,7,1130,680,1954,0.0,98133,47.7493,-122.351,1810,8100,5390,0.7486111111111111,3276100,51840000,48563900
226000.0,3,1.0,970,5000,1.0,0,0,2,6,970,0,1968,0.0,98118,47.5282,-122.279,1290,5875,4030,0.806,940900,25000000,24059100
825000.0,3,1.75,2010,3090,1.5,0,0,4,7,1510,500,1926,0.0,98103,47.681999999999995,-122.348,1600,3150,1080,0.34951456310679613,4040100,9548100,5508000
175000.0,4,1.0,1300,6030,1.5,0,0,2,6,1300,0,1947,0.0,98168,47.4778,-122.286,1240,6900,4730,0.7844112769485904,1690000,36360900,34670900
465750.0,3,1.5,1260,10350,1.0,0,0,2,7,1260,0,1959,0.0,98008,47.6357,-122.12299999999999,1800,10350,9090,0.8782608695652174,1587600,107122500,105534900
659000.0,4,2.25,2610,24931,2.0,0,0,2,8,2610,0,1983,0.0,98075,47.5771,-122.05,2550,18306,22321,0.8953110585215194,6812100,621554761,614742661
595000.0,3,1.75,1910,5753,1.0,0,3,2,8,1110,800,1941,0.0,98115,47.6898,-122.32700000000001,1630,5580,3843,0.6679993047105858,3648100,33097009,29448909
350000.0,3,2.25,1780,16290,2.0,0,0,3,8,1780,0,1987,0.0,98058,47.4622,-122.12700000000001,1780,8810,14510,0.8907305095150398,3168400,265364100,262195700
270000.0,4,2.25,1900,8600,1.0,0,0,3,8,1900,0,1975,0.0,98023,47.3102,-122.381,2120,8000,6700,0.7790697674418605,3610000,73960000,70350000
662500.0,6,2.25,2450,25600,1.0,0,2,2,7,1340,1110,1957,0.0,98008,47.6061,-122.117,1850,10230,23150,0.904296875,6002500,655360000,649357500
249900.0,3,1.75,1380,14000,1.0,0,0,3,5,1380,0,1939,0.0,98001,47.294,-122.281,1490,18503,12620,0.9014285714285715,1904400,196000000,194095600
324500.0,3,1.75,1920,11340,1.0,0,0,3,7,1230,690,1977,0.0,98023,47.3272,-122.36200000000001,1980,9638,9420,0.8306878306878307,3686400,128595600,124909200
430000.0,2,1.75,1350,4003,1.0,0,0,2,8,1350,0,2004,0.0,98053,47.7176,-122.03299999999999,1350,4479,2653,0.6627529352985261,1822500,16024009,14201509
419950.0,2,1.75,1350,4003,1.0,0,0,2,8,1350,0,2004,0.0,98053,47.7176,-122.03299999999999,1350,4479,2653,0.6627529352985261,1822500,16024009,14201509
285000.0,4,1.75,2510,7440,1.0,0,2,3,8,1290,1220,1962,0.0,98032,47.3748,-122.27600000000001,1790,8000,4930,0.6626344086021505,6300100,55353600,49053500
332000.0,4,2.5,2470,7780,2.0,0,0,2,8,2470,0,2002,0.0,98092,47.3337,-122.191,2100,5972,5310,0.6825192802056556,6100900,60528400,54427500
282000.0,4,1.75,1660,10725,1.0,0,0,2,7,960,700,1956,0.0,98168,47.5033,-122.3,1340,9023,9065,0.8452214452214453,2755600,115025625,112270025
320000.0,3,1.0,1340,5175,1.0,0,0,2,7,940,400,1987,0.0,98133,47.7321,-122.34,1020,5500,3835,0.7410628019323672,1795600,26780625,24985025
428750.0,3,1.0,1620,30736,1.5,0,0,3,7,1620,0,1911,1977.0,98006,47.5719,-122.119,2440,28826,29116,0.9472930765226445,2624400,944701696,942077296
330000.0,3,2.25,2300,35287,2.0,0,0,2,8,2300,0,1977,0.0,98022,47.2477,-121.93700000000001,1760,47916,32987,0.9348201887380622,5290000,1245172369,1239882369
456500.0,4,3.5,2000,2309,3.0,0,0,2,8,2000,0,2008,0.0,98177,47.7027,-122.361,1440,1548,309,0.13382416630576008,4000000,5331481,1331481
352000.0,3,2.25,1640,11050,1.0,0,0,3,8,1640,0,1972,0.0,98059,47.4723,-122.12100000000001,1870,11050,9410,0.8515837104072398,2689600,122102500,119412900
664000.0,4,2.0,1530,4080,1.5,0,0,3,7,1530,0,1912,0.0,98105,47.6645,-122.325,1860,4080,2550,0.625,2340900,16646400,14305500
628000.0,3,1.75,4000,11894,1.0,0,0,2,9,2190,1810,1987,0.0,98011,47.7738,-122.20299999999999,2530,8650,7894,0.6636959811669749,16000000,141467236,125467236
512000.0,3,1.75,1610,12555,1.0,0,0,2,7,1080,530,1977,0.0,98052,47.6618,-122.13600000000001,1780,10374,10945,0.8717642373556352,2592100,157628025,155035925
254000.0,3,2.0,2070,9000,1.0,0,0,3,7,1450,620,1969,0.0,98023,47.3085,-122.376,1630,7885,6930,0.77,4284900,81000000,76715100
535800.0,4,2.5,1900,5790,2.0,0,0,2,8,1900,0,1994,0.0,98029,47.5691,-121.99600000000001,2030,5790,3890,0.6718480138169257,3610000,33524100,29914100
287653.0,3,1.0,1050,16050,1.0,0,0,3,7,1050,0,1960,1981.0,98038,47.3841,-122.006,1610,27600,15000,0.9345794392523364,1102500,257602500,256500000
438000.0,3,2.5,1520,1304,2.0,0,0,2,8,1180,340,2006,0.0,98136,47.5446,-122.385,1270,1718,-216,-0.1656441717791411,2310400,1700416,-609984
450000.0,4,1.75,2390,23899,1.0,0,0,2,7,1750,640,1949,0.0,98028,47.7557,-122.23700000000001,1840,33900,21509,0.8999958157245073,5712100,571162201,565450101
327000.0,5,2.75,2400,8050,2.0,0,0,2,8,2400,0,1998,0.0,98092,47.2635,-122.209,2400,8050,5650,0.7018633540372671,5760000,64802500,59042500
370500.0,4,2.5,1790,6120,2.0,0,0,2,7,1790,0,2005,0.0,98059,47.4829,-122.12799999999999,1950,5660,4330,0.7075163398692811,3204100,37454400,34250300
265000.0,3,2.5,1720,6271,2.0,0,0,2,7,1720,0,1993,0.0,98038,47.3898,-122.04899999999999,1570,6587,4551,0.7257215755062988,2958400,39325441,36367041
450000.0,4,2.75,2980,13260,1.0,0,0,3,8,1800,1180,1979,0.0,98056,47.5152,-122.197,1920,10731,10280,0.77526395173454,8880400,175827600,166947200
425000.0,3,1.0,1520,213444,1.5,0,3,4,8,1520,0,1988,0.0,98027,47.5081,-122.09299999999999,2640,213444,211924,0.9928786941773955,2310400,45558341136,45556030736
166600.0,3,1.75,1150,8690,1.0,0,0,3,7,1150,0,1977,0.0,98042,47.3729,-122.115,1330,7040,7540,0.8676639815880323,1322500,75516100,74193600
245000.0,1,0.75,380,15000,1.0,0,0,2,5,380,0,1963,0.0,98168,47.481,-122.323,1170,15000,14620,0.9746666666666667,144400,225000000,224855600
565000.0,3,1.0,910,5212,1.0,0,0,2,7,910,0,1951,0.0,98115,47.6742,-122.28399999999999,1520,6300,4302,0.8254029163468918,828100,27164944,26336844
539900.0,3,1.75,1650,10150,1.0,0,0,2,8,1230,420,1976,0.0,98033,47.6963,-122.169,1930,8958,8500,0.8374384236453202,2722500,103022500,100300000
910000.0,3,3.5,2480,3200,2.0,0,0,2,10,2480,0,2010,0.0,98144,47.5951,-122.307,1980,3200,720,0.225,6150400,10240000,4089600
280000.0,4,2.5,2050,7416,2.0,0,0,2,8,2050,0,1990,0.0,98092,47.2658,-122.219,2050,7920,5366,0.7235706580366774,4202500,54997056,50794556
275000.0,3,2.25,1420,8549,2.0,0,0,3,7,1420,0,1989,0.0,98038,47.3576,-122.039,1560,7471,7129,0.8338987016025267,2016400,73085401,71069001
467000.0,3,2.5,3460,6590,2.0,0,0,2,7,3460,0,2001,0.0,98056,47.4802,-122.18799999999999,2490,6312,3130,0.47496206373292865,11971600,43428100,31456500
457500.0,3,2.5,1500,4445,2.0,0,0,2,8,1500,0,1996,0.0,98029,47.5682,-122.005,1730,4408,2945,0.6625421822272216,2250000,19758025,17508025
381156.0,2,1.0,1320,3090,1.0,0,0,3,7,1320,0,1908,0.0,98118,47.5517,-122.27600000000001,1270,4120,1770,0.5728155339805825,1742400,9548100,7805700
289999.0,5,2.5,2180,8240,1.0,0,0,3,8,1220,960,1977,0.0,98092,47.3122,-122.191,2050,7590,6060,0.7354368932038835,4752400,67897600,63145200
642450.0,3,1.75,1830,4160,1.0,0,0,2,7,1230,600,1919,0.0,98144,47.5962,-122.288,1950,4160,2330,0.5600961538461539,3348900,17305600,13956700
469950.0,3,2.25,1620,8701,1.0,0,0,2,7,1220,400,1962,0.0,98007,47.6071,-122.137,1600,7910,7081,0.8138145040799908,2624400,75707401,73083001
795000.0,3,2.0,2920,13650,1.0,0,2,4,8,1460,1460,1975,0.0,98033,47.6652,-122.18799999999999,2920,10988,10730,0.7860805860805861,8526400,186322500,177796100
785000.0,4,2.5,3300,10514,2.0,0,0,2,10,3300,0,1984,0.0,98074,47.6323,-122.036,2820,11462,7214,0.6861327753471562,10890000,110544196,99654196
860000.0,3,2.25,3060,12095,2.0,0,0,2,10,3060,0,1983,0.0,98006,47.5611,-122.10600000000001,3060,11455,9035,0.7470028937577511,9363600,146289025,136925425
147500.0,3,1.0,1530,8498,1.0,0,0,2,7,1530,0,1959,0.0,98031,47.403999999999996,-122.20299999999999,1380,8498,6968,0.8199576370910803,2340900,72216004,69875104
390000.0,3,2.0,1910,11576,1.0,0,0,2,7,1410,500,1978,0.0,98011,47.7356,-122.198,2040,8750,9666,0.8350034554250173,3648100,134003776,130355676
229000.0,3,1.0,1020,8100,1.0,0,0,2,7,1020,0,1954,0.0,98198,47.3586,-122.314,1020,8100,7080,0.8740740740740741,1040400,65610000,64569600
185000.0,3,1.0,1150,8100,1.0,0,0,2,6,1150,0,1932,0.0,98168,47.494,-122.307,1120,8100,6950,0.8580246913580247,1322500,65610000,64287500
414900.0,3,1.5,1260,9570,1.0,0,0,2,7,870,390,1941,0.0,98115,47.7004,-122.305,1620,7000,8310,0.8683385579937304,1587600,91584900,89997300
200000.0,4,2.0,1920,4822,1.0,0,0,1,6,920,1000,1914,0.0,98136,47.5507,-122.381,1120,4822,2902,0.6018249688925756,3686400,23251684,19565284
225000.0,4,2.25,1800,9350,1.0,0,0,2,8,1800,0,1969,0.0,98092,47.2959,-122.191,2060,8800,7550,0.8074866310160428,3240000,87422500,84182500
720000.0,3,1.75,2040,4000,2.0,0,0,4,7,1360,680,1924,0.0,98105,47.6675,-122.289,1610,4000,1960,0.49,4161600,16000000,11838400
930000.0,4,2.5,2200,4000,2.0,0,0,4,8,1430,770,1908,0.0,98119,47.6402,-122.37,2100,4000,1800,0.45,4840000,16000000,11160000
1270000.0,5,2.5,3200,17204,1.0,0,0,2,7,2160,1040,1952,0.0,98004,47.6209,-122.22200000000001,4090,15732,14004,0.8139967449430365,10240000,295977616,285737616
700000.0,5,3.25,2400,3118,2.0,0,0,3,7,1780,620,1928,0.0,98122,47.6094,-122.291,2100,3941,718,0.23027581783194356,5760000,9721924,3961924
466000.0,2,1.5,1140,1058,3.0,0,0,2,7,1140,0,2005,0.0,98103,47.6608,-122.333,1170,1116,-82,-0.07750472589792061,1299600,1119364,-180236
374000.0,3,1.5,1330,10640,1.0,0,0,2,7,1330,0,1976,0.0,98011,47.7364,-122.193,1460,8520,9310,0.875,1768900,113209600,111440700
480000.0,3,2.5,1940,10035,2.0,0,0,3,8,1940,0,1994,0.0,98072,47.7438,-122.17200000000001,2810,8333,8095,0.8066766317887394,3763600,100701225,96937625
740000.0,3,2.5,3000,25341,2.0,0,0,2,9,3000,0,1995,0.0,98053,47.6724,-122.01299999999999,3000,32417,22341,0.8816147744761453,9000000,642166281,633166281
1010000.0,4,1.0,1820,5400,1.5,0,0,2,8,1820,0,1923,2014.0,98102,47.6476,-122.318,1820,5400,3580,0.662962962962963,3312400,29160000,25847600
395000.0,4,2.5,2910,5000,2.0,0,0,2,8,2910,0,2002,0.0,98042,47.3782,-122.12700000000001,2740,5045,2090,0.418,8468100,25000000,16531900
340000.0,2,1.0,1090,6771,1.0,0,0,2,6,1090,0,1954,0.0,98106,47.5185,-122.352,1200,4992,5681,0.8390193472160685,1188100,45846441,44658341
209000.0,3,2.0,1230,1340,2.0,0,0,2,7,1020,210,2003,0.0,98106,47.526,-122.361,1260,1312,110,0.08208955223880597,1512900,1795600,282700
431650.0,5,2.5,1710,7700,1.5,0,0,2,7,1710,0,1962,0.0,98007,47.5922,-122.146,1530,7700,5990,0.7779220779220779,2924100,59290000,56365900
980000.0,5,2.5,3160,11470,1.0,0,0,3,9,1780,1380,1971,0.0,98040,47.5368,-122.21600000000001,3260,11470,8310,0.7244986922406277,9985600,131560900,121575300
660000.0,3,2.5,2680,28243,2.0,0,0,2,9,2680,0,1993,0.0,98077,47.7637,-122.05,2670,32130,25563,0.9051092306058138,7182400,797667049,790484649
730000.0,4,2.25,2190,9009,2.0,0,0,3,8,1840,350,1977,0.0,98033,47.6916,-122.18799999999999,2190,10251,6819,0.7569097569097569,4796100,81162081,76365981
291500.0,3,1.75,1260,9600,1.0,0,0,3,7,1260,0,1988,0.0,98042,47.3592,-122.07600000000001,1640,9946,8340,0.86875,1587600,92160000,90572400
905000.0,4,3.5,2970,14486,2.0,0,0,2,9,2340,630,1997,0.0,98040,47.5627,-122.215,3680,14486,11516,0.7949744580974735,8820900,209844196,201023296
800000.0,4,2.5,2570,50308,1.5,0,0,2,10,2570,0,1993,0.0,98077,47.7418,-122.039,3420,37891,47738,0.9489146855370915,6604900,2530894864,2524289964
839900.0,4,3.5,3810,13592,1.0,0,1,2,9,2560,1250,2013,0.0,98056,47.5134,-122.2,3230,9311,9782,0.7196880517951736,14516100,184742464,170226364
200000.0,1,1.5,1010,1157,2.0,0,0,2,8,950,60,2007,0.0,98126,47.5492,-122.37200000000001,1360,1688,147,0.12705272255834055,1020100,1338649,318549
300000.0,3,2.0,1480,6698,1.0,0,0,3,7,1080,400,1979,0.0,98058,47.4614,-122.16799999999999,1850,7348,5218,0.7790385189608838,2190400,44863204,42672804
530000.0,3,1.75,1250,6041,1.5,0,0,4,7,1250,0,1942,0.0,98115,47.69,-122.304,1180,6042,4791,0.7930806157920874,1562500,36493681,34931181
314950.0,3,2.25,1654,8479,2.0,0,0,2,7,1654,0,1995,0.0,98038,47.3627,-122.037,1654,8479,6825,0.8049298266304988,2735716,71893441,69157725
255000.0,3,1.75,1410,9315,1.0,0,0,4,7,1410,0,1960,0.0,98031,47.3969,-122.198,1630,8250,7905,0.8486312399355878,1988100,86769225,84781125
550000.0,5,2.75,2160,5720,1.0,0,0,4,7,1500,660,1950,0.0,98144,47.5728,-122.304,2160,4996,3560,0.6223776223776224,4665600,32718400,28052800
435000.0,3,1.0,1400,4800,1.0,0,0,3,6,700,700,1917,0.0,98136,47.5499,-122.391,1470,6000,3400,0.7083333333333334,1960000,23040000,21080000
234000.0,3,1.75,1420,8738,1.0,0,0,3,7,1420,0,1966,0.0,98002,47.3113,-122.20700000000001,1660,8738,7318,0.8374914168001831,2016400,76352644,74336244
615000.0,4,2.25,2500,10062,1.0,0,0,2,8,1600,900,1975,0.0,98052,47.638999999999996,-122.1,2500,9750,7562,0.7515404492148678,6250000,101243844,94993844
205000.0,3,2.0,1410,8384,1.0,0,0,2,7,1410,0,1985,0.0,98001,47.3315,-122.26299999999999,1410,9205,6974,0.8318225190839694,1988100,70291456,68303356
384000.0,4,1.75,2100,7135,1.0,0,0,3,7,1050,1050,1955,0.0,98106,47.5353,-122.34899999999999,1730,4000,5035,0.7056762438682551,4410000,50908225,46498225
324000.0,3,2.5,1750,7208,2.0,0,0,2,8,1750,0,1994,0.0,98055,47.4315,-122.19200000000001,2050,7524,5458,0.7572142064372919,3062500,51955264,48892764
645000.0,3,1.75,2070,5500,1.0,0,0,3,7,1130,940,1946,0.0,98115,47.6733,-122.301,1800,4400,3430,0.6236363636363637,4284900,30250000,25965100
570000.0,3,3.25,1570,1777,2.0,0,0,2,8,1260,310,2007,0.0,98107,47.6655,-122.369,1000,1777,207,0.11648846370287,2464900,3157729,692829
324000.0,3,2.5,1920,5322,2.0,0,0,2,8,1920,0,1999,0.0,98031,47.4095,-122.195,1920,5000,3402,0.6392333709131905,3686400,28323684,24637284
270000.0,2,1.0,1000,10320,1.0,0,0,2,6,1000,0,1943,0.0,98106,47.527,-122.35600000000001,1100,5160,9320,0.9031007751937985,1000000,106502400,105502400
290000.0,5,1.5,2120,7700,1.5,0,0,4,7,2120,0,1962,0.0,98058,47.4599,-122.17200000000001,1730,7700,5580,0.7246753246753247,4494400,59290000,54795600
250000.0,3,2.0,1440,9220,1.0,0,0,2,7,1440,0,1965,0.0,98198,47.3702,-122.31700000000001,1390,7830,7780,0.8438177874186551,2073600,85008400,82934800
342000.0,3,1.75,1660,16275,2.0,0,0,2,7,1660,0,1990,0.0,98014,47.6903,-121.915,1520,16275,14615,0.8980030721966206,2755600,264875625,262120025
255000.0,3,1.5,1340,8450,1.0,0,0,3,7,1340,0,1958,0.0,98188,47.4405,-122.28,1340,8920,7110,0.8414201183431953,1795600,71402500,69606900
800000.0,3,2.25,2380,11824,1.0,0,0,3,9,1450,930,1972,0.0,98040,47.5371,-122.21799999999999,2750,11491,9444,0.7987144790257105,5664400,139806976,134142576
451000.0,3,1.75,1560,4049,1.5,0,2,2,7,1000,560,1926,0.0,98126,47.5666,-122.375,1430,3738,2489,0.6147196838725612,2433600,16394401,13960801
990000.0,4,2.5,2780,10480,1.0,0,3,2,7,1390,1390,1967,0.0,98033,47.6597,-122.204,2860,10506,7700,0.7347328244274809,7728400,109830400,102102000
288400.0,4,2.5,1860,6687,1.0,0,0,3,7,1220,640,1983,0.0,98031,47.4046,-122.186,1860,6117,4827,0.7218483624943921,3459600,44715969,41256369
420000.0,3,1.5,2390,4600,2.0,0,0,2,8,1750,640,1920,1995.0,98118,47.5383,-122.26799999999999,1690,5220,2210,0.48043478260869565,5712100,21160000,15447900
359000.0,2,2.75,1370,1140,2.0,0,0,2,8,1080,290,2009,0.0,98133,47.7052,-122.34299999999999,1370,1090,-230,-0.20175438596491227,1876900,1299600,-577300
390000.0,4,3.0,2570,262018,1.0,0,0,2,7,1420,1150,1988,0.0,98058,47.4417,-122.09,2260,19811,259448,0.9901915135601371,6604900,68653432324,68646827424
300000.0,3,2.5,1320,2614,2.0,0,0,2,7,1320,0,2005,0.0,98118,47.5355,-122.28299999999999,1320,2533,1294,0.495026778882938,1742400,6832996,5090596
545000.0,5,2.5,2520,7863,1.0,0,0,2,7,1500,1020,1981,0.0,98034,47.7096,-122.199,2030,8580,5343,0.679511636779855,6350400,61826769,55476369
288349.0,3,1.0,1250,18616,1.0,0,0,3,6,1250,0,1972,0.0,98010,47.3414,-122.04700000000001,1920,15654,17366,0.9328534593897723,1562500,346555456,344992956
299900.0,3,2.25,1560,35026,1.0,0,0,2,7,1290,270,1985,0.0,98092,47.3023,-122.069,1660,35160,33466,0.9554616570547593,2433600,1226820676,1224387076
891000.0,4,2.0,2330,5000,1.5,0,0,4,7,1720,610,1925,0.0,98117,47.6804,-122.35799999999999,2090,5000,2670,0.534,5428900,25000000,19571100
1200000.0,3,2.0,3660,22410,1.0,0,3,3,9,1830,1830,1947,0.0,98117,47.6972,-122.4,2680,8250,18750,0.8366800535475234,13395600,502208100,488812500
378000.0,4,2.5,2790,4650,2.0,0,0,2,8,2790,0,2004,0.0,98038,47.3556,-122.02600000000001,2820,4650,1860,0.4,7784100,21622500,13838400
299995.0,2,1.0,1060,7200,1.0,0,0,3,6,1060,0,1951,0.0,98155,47.7463,-122.315,1850,8291,6140,0.8527777777777777,1123600,51840000,50716400
253000.0,3,2.5,2020,6564,1.0,0,0,2,7,1310,710,1994,0.0,98042,47.3545,-122.15799999999999,1710,5151,4544,0.692260816575259,4080400,43086096,39005696
350000.0,3,2.25,1580,47916,1.0,0,0,2,7,1580,0,1979,0.0,98024,47.5583,-121.852,1980,75358,46336,0.967025628182653,2496400,2295943056,2293446656
565000.0,4,3.0,2020,4300,1.5,0,0,2,6,2020,0,1900,0.0,98107,47.6653,-122.37200000000001,1290,3440,2280,0.5302325581395348,4080400,18490000,14409600
315000.0,2,1.0,970,5665,1.0,0,0,3,6,970,0,1908,0.0,98118,47.5513,-122.273,1490,4429,4695,0.8287731685789939,940900,32092225,31151325
570000.0,4,3.0,1490,6766,1.5,0,1,4,7,1490,0,1915,0.0,98136,47.5446,-122.382,1990,6526,5276,0.7797812592373633,2220100,45778756,43558656
971000.0,5,3.5,4390,10140,2.0,0,0,2,9,3350,1040,2005,0.0,98125,47.7174,-122.28200000000001,2010,8400,5750,0.5670611439842209,19272100,102819600,83547500
915000.0,5,2.5,2750,5589,1.5,0,0,4,9,1840,910,1910,0.0,98112,47.6364,-122.3,1460,4250,2839,0.5079620683485417,7562500,31236921,23674421
419000.0,4,1.5,2150,23568,1.0,0,0,3,7,2150,0,1950,0.0,98166,47.4522,-122.355,2150,10125,21418,0.9087746096401901,4622500,555450624,550828124
260000.0,4,1.75,1810,7480,1.0,0,0,2,7,1230,580,1977,0.0,98023,47.3275,-122.361,1870,9594,5670,0.7580213903743316,3276100,55950400,52674300
1320000.0,3,3.0,2230,12968,2.0,0,0,2,9,2230,0,1990,0.0,98004,47.6271,-122.197,2260,10160,10738,0.8280382479950648,4972900,168169024,163196124
369950.0,3,1.0,2430,10720,1.0,0,0,2,7,2430,0,1977,0.0,98045,47.4895,-121.787,1660,11560,8290,0.773320895522388,5904900,114918400,109013500
1030000.0,3,2.5,3680,13384,2.0,0,0,2,10,3680,0,1994,0.0,98006,47.5484,-122.119,3600,11306,9704,0.7250448296473401,13542400,179131456,165589056
435000.0,5,1.0,1410,6750,1.5,0,0,2,6,1410,0,1929,0.0,98118,47.5453,-122.27799999999999,1360,6750,5340,0.7911111111111111,1988100,45562500,43574400
601000.0,3,1.75,1330,6743,1.0,0,0,2,8,1330,0,1958,2002.0,98125,47.7012,-122.286,2600,7350,5413,0.8027584161352513,1768900,45468049,43699149
460500.0,3,1.0,1490,10650,1.0,0,0,2,7,1150,340,1963,0.0,98033,47.663000000000004,-122.178,1730,9800,9160,0.860093896713615,2220100,113422500,111202400
720000.0,3,2.5,2020,1159,3.0,0,3,2,8,2020,0,2000,0.0,98103,47.6617,-122.35600000000001,1920,3600,-861,-0.7428817946505608,4080400,1343281,-2737119
851000.0,4,2.5,3130,13202,2.0,0,0,2,10,3130,0,1996,0.0,98075,47.5878,-121.976,2840,10470,10072,0.7629147098924406,9796900,174292804,164495904
550000.0,4,3.0,2670,5000,2.0,0,2,2,7,2670,0,1916,0.0,98126,47.5784,-122.37700000000001,2300,5000,2330,0.466,7128900,25000000,17871100
700000.0,4,1.0,1980,4560,1.5,0,0,2,7,1980,0,1920,0.0,98103,47.6606,-122.331,1810,3245,2580,0.5657894736842105,3920400,20793600,16873200
323000.0,3,1.75,2100,14850,1.0,0,0,3,7,2100,0,1963,0.0,98042,47.3622,-122.059,1930,17238,12750,0.8585858585858586,4410000,220522500,216112500
345500.0,3,1.0,1350,8581,1.0,0,0,4,6,1350,0,1944,0.0,98177,47.7612,-122.36200000000001,2080,8451,7231,0.8426756788253117,1822500,73633561,71811061
378000.0,4,1.5,2140,7920,1.0,0,0,2,7,1190,950,1959,0.0,98118,47.5491,-122.272,2140,7238,5780,0.7297979797979798,4579600,62726400,58146800
650000.0,4,2.0,2208,5000,3.0,0,0,4,8,2208,0,1917,0.0,98116,47.5711,-122.383,1760,5000,2792,0.5584,4875264,25000000,20124736
385000.0,3,2.0,1010,7380,1.0,0,0,2,7,1010,0,1982,0.0,98074,47.6273,-122.06200000000001,1650,9030,6370,0.8631436314363143,1020100,54464400,53444300
425000.0,2,1.0,970,2970,1.0,0,0,2,7,970,0,1910,0.0,98102,47.6233,-122.319,1670,3000,2000,0.6734006734006734,940900,8820900,7880000
210000.0,4,2.0,1520,6174,1.5,0,0,4,6,1520,0,1920,0.0,98022,47.2105,-121.98899999999999,1390,5407,4654,0.7538062844185294,2310400,38118276,35807876
630000.0,4,2.5,2740,43101,2.0,0,0,2,9,2740,0,1993,0.0,98077,47.7649,-122.04899999999999,2740,33447,40361,0.9364283891325027,7507600,1857696201,1850188601
335000.0,3,1.75,1570,7500,1.0,0,1,2,7,1300,270,1953,0.0,98146,47.4999,-122.368,1590,7660,5930,0.7906666666666666,2464900,56250000,53785100
196500.0,3,1.0,1320,9000,1.0,0,0,2,7,1320,0,1966,0.0,98001,47.3461,-122.272,1320,9800,7680,0.8533333333333334,1742400,81000000,79257600
582800.0,4,2.75,2550,7636,1.0,0,0,2,8,1440,1110,1986,0.0,98074,47.6471,-122.06,2290,8223,5086,0.6660555264536406,6502500,58308496,51805996
440000.0,3,1.75,1560,7207,1.0,0,0,2,7,1250,310,1983,0.0,98034,47.7283,-122.22200000000001,1540,7485,5647,0.7835437768835855,2433600,51940849,49507249
752500.0,4,2.25,2360,8616,2.0,0,0,3,8,2360,0,1974,0.0,98033,47.6495,-122.198,2360,9337,6256,0.7260909935004642,5569600,74235456,68665856
532500.0,3,1.75,1330,5000,2.0,0,0,3,7,1210,120,1909,0.0,98116,47.5724,-122.384,1500,4000,3670,0.734,1768900,25000000,23231100
265000.0,3,1.0,1070,9000,1.0,0,0,3,7,1070,0,1950,0.0,98198,47.4061,-122.33,1840,12000,7930,0.8811111111111111,1144900,81000000,79855100
397500.0,3,1.25,1510,13737,1.0,0,3,3,6,810,700,1961,0.0,98125,47.7289,-122.28299999999999,2560,10202,12227,0.8900778918249982,2280100,188705169,186425069
524250.0,3,2.5,1710,3469,2.0,0,0,2,8,1710,0,1999,0.0,98029,47.54600000000001,-122.01100000000001,2120,3560,1759,0.5070625540501585,2924100,12033961,9109861
765000.0,4,2.75,2790,10819,2.0,0,0,2,10,2790,0,1996,0.0,98027,47.5515,-122.08,3080,12603,8029,0.7421203438395415,7784100,117050761,109266661
648000.0,4,2.5,2620,5450,2.0,0,0,2,9,2620,0,2001,0.0,98074,47.6301,-122.01899999999999,2590,5371,2830,0.5192660550458715,6864400,29702500,22838100
469500.0,5,2.5,2970,24759,1.0,0,0,3,8,1670,1300,1969,0.0,98031,47.3908,-122.17299999999999,2100,21803,21789,0.8800436205016358,8820900,613008081,604187181
237500.0,3,1.75,1050,7854,1.0,0,0,3,7,1050,0,1975,0.0,98023,47.3011,-122.369,1360,7668,6804,0.8663101604278075,1102500,61685316,60582816
216000.0,3,1.0,1280,8712,1.0,0,0,3,7,1280,0,1956,0.0,98003,47.3298,-122.29700000000001,1420,8800,7432,0.8530762167125804,1638400,75898944,74260544
427200.0,3,1.0,1030,8400,1.0,0,0,3,7,1030,0,1963,0.0,98056,47.5364,-122.17299999999999,1270,8400,7370,0.8773809523809524,1060900,70560000,69499100
280000.0,3,2.25,1900,7800,1.0,0,0,3,8,1390,510,1977,0.0,98055,47.4545,-122.208,1730,7800,5900,0.7564102564102564,3610000,60840000,57230000
718000.0,5,3.0,3070,9804,1.0,0,0,3,9,1740,1330,1968,0.0,98006,47.5702,-122.12799999999999,2550,9689,6734,0.6868625050999592,9424900,96118416,86693516
420000.0,2,2.75,1760,4139,2.0,0,0,2,8,1760,0,2010,0.0,98065,47.5175,-121.87799999999999,1870,3076,2379,0.5747765160666828,3097600,17131321,14033721
379000.0,2,1.0,930,5400,1.0,0,0,2,7,930,0,1952,0.0,98117,47.6971,-122.37200000000001,1050,5400,4470,0.8277777777777777,864900,29160000,28295100
326100.0,2,1.0,880,7683,1.0,0,0,2,6,880,0,1942,0.0,98177,47.7145,-122.361,1370,7695,6803,0.8854614083040478,774400,59028489,58254089
535000.0,3,2.5,1360,1016,3.0,0,0,2,7,1310,50,2003,0.0,98115,47.6774,-122.324,1365,1156,-344,-0.33858267716535434,1849600,1032256,-817344
283000.0,4,2.75,2130,8560,1.0,0,0,2,7,1560,570,1992,0.0,98022,47.1949,-122.01,2130,8560,6430,0.7511682242990654,4536900,73273600,68736700
260000.0,3,1.0,1480,7469,1.5,0,0,2,6,1120,360,1940,0.0,98168,47.5048,-122.301,1460,7379,5989,0.8018476368991833,2190400,55785961,53595561
399000.0,4,1.0,1500,6388,1.5,0,0,3,7,1500,0,1951,0.0,98126,47.5303,-122.37799999999999,980,5366,4888,0.765184721352536,2250000,40806544,38556544
484950.0,3,2.25,1670,5004,2.0,0,0,2,8,1670,0,1987,0.0,98029,47.5688,-122.01700000000001,1850,5276,3334,0.6662669864108713,2788900,25040016,22251116
640000.0,4,1.75,2060,9828,1.0,0,0,3,8,2060,0,1960,0.0,98005,47.5867,-122.17399999999999,2260,9996,7768,0.7903947903947904,4243600,96589584,92345984
585000.0,4,2.5,2160,8158,1.0,0,0,3,8,1660,500,1952,0.0,98115,47.6948,-122.32799999999999,1520,7208,5998,0.7352292228487375,4665600,66552964,61887364
645000.0,4,2.0,2780,11583,1.0,0,3,2,8,1190,1590,1955,0.0,98125,47.7293,-122.28399999999999,2580,10241,8803,0.7599930933264266,7728400,134165889,126437489
253000.0,3,2.0,1490,7651,1.0,0,0,2,7,1490,0,1988,0.0,98003,47.3211,-122.325,1590,7795,6161,0.8052542151352764,2220100,58537801,56317701
178500.0,2,1.0,740,6460,1.0,0,0,2,6,740,0,1953,0.0,98146,47.5077,-122.344,1170,6975,5720,0.8854489164086687,547600,41731600,41184000
291000.0,4,2.5,1860,6325,2.0,0,0,3,7,1860,0,1991,0.0,98038,47.3492,-122.03,1860,6449,4465,0.7059288537549407,3459600,40005625,36546025
199950.0,2,2.75,1590,20917,1.5,0,0,2,5,1590,0,1920,0.0,98001,47.2786,-122.25,1310,6000,19327,0.9239852751350576,2528100,437520889,434992789
553500.0,2,1.0,850,2340,1.0,0,0,2,7,850,0,1922,0.0,98105,47.6707,-122.32799999999999,1300,3000,1490,0.6367521367521367,722500,5475600,4753100
189950.0,2,1.0,1030,4188,1.0,0,0,2,8,1030,0,1981,0.0,98038,47.3738,-122.057,1450,3376,3158,0.7540592168099332,1060900,17539344,16478444
289000.0,3,2.0,1850,9550,1.0,0,0,2,8,1850,0,1988,0.0,98001,47.3225,-122.273,2250,9550,7700,0.806282722513089,3422500,91202500,87780000
700000.0,4,2.0,1830,4590,2.0,0,0,2,8,1830,0,1908,0.0,98105,47.6593,-122.32700000000001,1650,4590,2760,0.6013071895424836,3348900,21068100,17719200
270000.0,3,2.0,1560,8853,1.0,0,0,2,7,1560,0,1967,0.0,98058,47.4312,-122.171,1610,8750,7293,0.8237885462555066,2433600,78375609,75942009
258000.0,4,1.75,1730,8320,1.0,0,0,2,7,1230,500,1977,0.0,98023,47.327,-122.361,1840,9800,6590,0.7920673076923077,2992900,69222400,66229500
530000.0,3,2.5,1930,7214,2.0,0,0,2,8,1930,0,2005,0.0,98125,47.7191,-122.309,1930,7266,5284,0.7324646520654283,3724900,52041796,48316896
245000.0,3,2.25,1422,3677,2.0,0,0,2,7,1422,0,2012,0.0,98092,47.3204,-122.178,1677,3677,2255,0.6132716888768017,2022084,13520329,11498245
563000.0,3,2.0,1380,5000,1.5,0,0,3,7,1380,0,1917,0.0,98117,47.6807,-122.369,1350,5000,3620,0.724,1904400,25000000,23095600
515000.0,3,2.5,2430,4203,2.0,0,0,2,8,2430,0,2001,0.0,98065,47.5346,-121.875,2500,4798,1773,0.42184154175588867,5904900,17665209,11760309
325000.0,4,2.5,2610,7091,2.0,0,0,2,9,2610,0,1987,0.0,98023,47.3017,-122.34899999999999,2610,7773,4481,0.6319277957974898,6812100,50282281,43470181
540000.0,3,2.25,2000,217800,2.0,0,0,2,8,2000,0,1996,0.0,98024,47.5599,-121.911,2220,217800,215800,0.9908172635445363,4000000,47436840000,47432840000
280300.0,2,1.0,920,5000,1.0,0,0,3,6,490,430,1949,0.0,98103,47.7008,-122.338,1500,5000,4080,0.816,846400,25000000,24153600
460000.0,4,1.75,1750,5500,1.5,0,0,4,7,1050,700,1926,0.0,98117,47.6802,-122.38799999999999,1640,5500,3750,0.6818181818181818,3062500,30250000,27187500
475000.0,3,1.75,2020,8970,1.0,0,0,3,7,1180,840,1981,0.0,98072,47.7571,-122.145,2140,8008,6950,0.7748049052396878,4080400,80460900,76380500
900000.0,4,2.25,2460,44431,1.0,0,0,3,9,2460,0,1957,0.0,98007,47.6042,-122.147,2830,44431,41971,0.9446332515585965,6051600,1974113761,1968062161
538200.0,4,3.0,1780,7260,1.0,0,0,3,8,1780,0,1964,0.0,98008,47.626999999999995,-122.11399999999999,1810,7920,5480,0.7548209366391184,3168400,52707600,49539200
429000.0,2,1.0,1080,3600,1.0,0,0,2,7,1080,0,1922,0.0,98122,47.6078,-122.291,2230,4500,2520,0.7,1166400,12960000,11793600
164808.0,3,1.0,1250,5411,1.0,0,0,2,7,1250,0,1980,0.0,98178,47.5064,-122.265,1490,6320,4161,0.7689890962853446,1562500,29278921,27716421
520000.0,4,2.25,1870,7700,2.0,0,0,2,7,1870,0,1977,0.0,98052,47.6937,-122.12700000000001,1970,7700,5830,0.7571428571428571,3496900,59290000,55793100
475000.0,3,1.75,1700,8432,1.0,0,0,2,8,1230,470,1977,0.0,98125,47.7221,-122.31700000000001,1800,7842,6732,0.7983870967741935,2890000,71098624,68208624
283000.0,4,1.5,1480,47045,1.0,0,0,4,6,1480,0,1942,0.0,98168,47.4809,-122.3,1530,11000,45565,0.9685407588479116,2190400,2213232025,2211041625
321500.0,4,2.5,1930,6228,2.0,0,0,2,8,1930,0,2000,0.0,98030,47.3572,-122.191,1930,6168,4298,0.6901091843288375,3724900,38787984,35063084
840000.0,4,2.75,3130,21810,2.0,0,0,3,10,3130,0,1993,0.0,98077,47.7083,-122.073,3330,21810,18680,0.8564878496102705,9796900,475676100,465879200
287000.0,3,2.25,1370,6000,2.0,0,0,3,7,1370,0,1992,0.0,98038,47.3484,-122.03299999999999,1370,6200,4630,0.7716666666666666,1876900,36000000,34123100
375000.0,3,1.75,960,8106,1.0,0,0,2,7,960,0,1962,0.0,98052,47.6737,-122.156,1650,8035,7146,0.8815692079940785,921600,65707236,64785636
349500.0,3,1.75,1260,7128,1.0,0,0,3,7,1260,0,1969,0.0,98034,47.7263,-122.205,1330,7326,5868,0.8232323232323232,1587600,50808384,49220784
446450.0,3,1.5,1480,7749,1.0,0,0,4,7,1480,0,1960,0.0,98126,47.5144,-122.37899999999999,1140,5320,6269,0.8090076138856627,2190400,60047001,57856601
315000.0,4,2.5,1930,9643,2.0,0,0,3,7,1930,0,1992,0.0,98031,47.4065,-122.18,1930,7525,7713,0.7998548169656746,3724900,92987449,89262549
271310.0,2,1.0,870,5340,1.5,0,0,1,6,870,0,1906,0.0,98144,47.5849,-122.302,1190,4440,4470,0.8370786516853933,756900,28515600,27758700
315000.0,4,1.0,1300,8400,1.5,0,0,3,7,1300,0,1953,0.0,98133,47.7612,-122.33200000000001,1330,8400,7100,0.8452380952380952,1690000,70560000,68870000
245000.0,3,1.75,1490,6930,1.0,0,0,3,7,1490,0,1990,0.0,98030,47.3682,-122.179,1880,6861,5440,0.784992784992785,2220100,48024900,45804800
543115.0,2,1.0,1380,5484,1.0,0,0,2,8,1030,350,1947,0.0,98199,47.6382,-122.399,1380,5347,4104,0.7483588621444202,1904400,30074256,28169856
900000.0,4,2.0,1190,8190,1.5,0,0,2,7,1190,0,1945,0.0,98117,47.6908,-122.397,1190,1567,7000,0.8547008547008547,1416100,67076100,65660000
2450000.0,4,4.25,4250,6552,2.0,0,3,3,10,2870,1380,2008,0.0,98144,47.5747,-122.28299999999999,3640,8841,2302,0.3513431013431013,18062500,42928704,24866204
554000.0,2,2.0,1920,6045,1.0,0,0,2,8,1920,0,2003,0.0,98053,47.7107,-122.031,1670,5200,4125,0.6823821339950372,3686400,36542025,32855625
249900.0,3,1.75,2080,12522,1.0,0,0,4,6,2080,0,1950,0.0,98001,47.266999999999996,-122.25,1690,11200,10442,0.8338923494649417,4326400,156800484,152474084
768000.0,3,2.5,3220,54160,2.0,0,2,3,9,2690,530,1981,0.0,98006,47.5468,-122.109,3460,44374,50940,0.9405465288035451,10368400,2933305600,2922937200
980000.0,4,3.0,3680,5854,1.0,0,3,2,10,2060,1620,1967,0.0,98199,47.6327,-122.395,3140,5000,2174,0.37137000341646736,13542400,34269316,20726916
395000.0,5,2.5,2070,9600,1.0,0,0,2,7,1270,800,1962,0.0,98146,47.4997,-122.36399999999999,1950,7800,7530,0.784375,4284900,92160000,87875100
415000.0,3,1.75,1480,2200,2.0,0,0,2,7,1480,0,1995,0.0,98103,47.6969,-122.35,1360,2190,720,0.32727272727272727,2190400,4840000,2649600
380000.0,4,2.5,2000,6921,2.0,0,0,2,8,2000,0,2003,0.0,98038,47.3559,-122.014,2430,6339,4921,0.7110244184366421,4000000,47900241,43900241
566000.0,3,2.5,1560,5259,2.0,0,0,2,8,1560,0,1999,0.0,98075,47.5985,-122.016,2170,5461,3699,0.7033656588705077,2433600,27657081,25223481
218500.0,2,1.0,1600,8961,1.0,0,0,3,7,1390,210,1949,0.0,98002,47.3098,-122.21,1502,6798,7361,0.8214484990514451,2560000,80299521,77739521
550000.0,4,2.5,1940,10500,1.0,0,0,3,7,1140,800,1976,0.0,98052,47.683,-122.11399999999999,2200,10500,8560,0.8152380952380952,3763600,110250000,106486400
512031.0,3,1.75,1540,3000,1.0,0,2,2,7,770,770,1920,0.0,98117,47.6769,-122.36,1420,4200,1460,0.4866666666666667,2371600,9000000,6628400
197500.0,2,1.0,820,8860,1.0,0,0,2,6,820,0,1950,0.0,98055,47.452,-122.19,1660,15375,8040,0.90744920993228,672400,78499600,77827200
470000.0,3,2.25,1780,8784,1.0,0,0,2,7,1230,550,1977,0.0,98033,47.701,-122.17200000000001,1780,7704,7004,0.7973588342440802,3168400,77158656,73990256
590000.0,3,1.75,1560,242629,1.0,0,0,2,7,1560,0,1981,0.0,98053,47.6493,-121.956,2320,220654,241069,0.9935704305750755,2433600,58868831641,58866398041
465000.0,4,2.25,2210,8862,1.0,0,0,3,8,1270,940,1977,0.0,98011,47.7725,-122.198,2030,8862,6652,0.7506206273978786,4884100,78535044,73650944
499000.0,2,1.75,2040,114562,1.0,0,0,3,7,2040,0,1968,0.0,98027,47.4985,-122.09200000000001,1850,94960,112522,0.982193048305721,4161600,13124451844,13120290244
515000.0,3,2.25,1920,11500,1.0,0,0,2,8,1920,0,1972,2000.0,98006,47.5498,-122.18799999999999,2260,8866,9580,0.8330434782608696,3686400,132250000,128563600
716500.0,3,1.75,1930,5000,1.0,0,0,2,9,1230,700,1936,0.0,98105,47.6582,-122.27799999999999,2300,6000,3070,0.614,3724900,25000000,21275100
410000.0,3,2.0,1700,4250,1.0,0,0,2,6,890,810,1944,0.0,98199,47.6542,-122.385,1440,4250,2550,0.6,2890000,18062500,15172500
850000.0,4,3.25,3450,6500,2.0,0,0,2,8,2450,1000,1994,0.0,98136,47.5437,-122.38799999999999,1750,6500,3050,0.46923076923076923,11902500,42250000,30347500
1050000.0,4,3.25,3440,35021,2.0,0,0,2,10,3440,0,1983,0.0,98033,47.6476,-122.184,3440,35021,31581,0.901773221781217,11833600,1226470441,1214636841
648000.0,4,2.5,2380,13435,2.0,0,0,2,10,2380,0,1992,0.0,98075,47.5833,-122.02799999999999,2730,9677,11055,0.8228507629326386,5664400,180499225,174834825
620000.0,4,2.25,2400,5350,1.5,0,0,3,7,1460,940,1929,0.0,98117,47.6763,-122.37,1250,4880,2950,0.5514018691588785,5760000,28622500,22862500
935000.0,4,4.5,5670,84267,2.0,0,2,2,11,5670,0,2008,0.0,98010,47.323,-122.044,4100,83729,78597,0.9327138737584107,32148900,7100927289,7068778389
379000.0,3,1.0,1140,10320,1.0,0,0,3,7,1140,0,1963,0.0,98034,47.7168,-122.196,1140,10412,9180,0.8895348837209303,1299600,106502400,105202800
699000.0,3,1.75,1670,5375,1.0,0,0,2,7,1270,400,1952,0.0,98199,47.6416,-122.397,1460,6125,3705,0.6893023255813954,2788900,28890625,26101725
528000.0,4,2.25,1910,8005,1.0,0,0,2,8,1280,630,1960,0.0,98125,47.7259,-122.29799999999999,1860,8010,6095,0.7613991255465334,3648100,64080025,60431925
425000.0,3,1.75,1560,9452,1.0,0,0,3,8,1560,0,1974,0.0,98056,47.5197,-122.18,2200,9985,7892,0.8349555649597968,2433600,89340304,86906704
249500.0,2,1.75,1500,8645,1.0,0,0,3,7,1500,0,1963,0.0,98042,47.3643,-122.115,1220,8645,7145,0.8264893001735107,2250000,74736025,72486025
1040000.0,5,3.25,4475,6642,2.0,0,0,2,9,4475,0,2014,0.0,98053,47.6849,-122.01799999999999,3720,6633,2167,0.3262571514604035,20025625,44116164,24090539
790000.0,4,2.75,2840,11900,1.0,0,3,3,9,1640,1200,1961,0.0,98136,47.5271,-122.38600000000001,2790,10070,9060,0.761344537815126,8065600,141610000,133544400
399950.0,3,1.0,1020,18050,1.0,0,0,2,7,1020,0,1969,0.0,98027,47.5254,-122.04299999999999,1750,11640,17030,0.9434903047091413,1040400,325802500,324762100
275000.0,3,1.5,1410,9000,1.0,0,0,2,7,1410,0,1953,0.0,98133,47.7635,-122.35,1910,7214,7590,0.8433333333333334,1988100,81000000,79011900
550000.0,3,1.0,1520,2500,1.5,0,0,2,8,1520,0,1912,0.0,98109,47.6347,-122.352,1880,3600,980,0.392,2310400,6250000,3939600
140000.0,1,1.0,730,6890,1.0,0,0,3,4,730,0,1926,0.0,98055,47.467,-122.215,1790,7969,6160,0.8940493468795355,532900,47472100,46939200
250000.0,3,1.0,1190,6250,1.0,0,0,2,7,990,200,1954,0.0,98108,47.5658,-122.292,1760,6434,5060,0.8096,1416100,39062500,37646400
318000.0,3,2.25,1410,8909,2.0,0,2,2,7,1410,0,1988,0.0,98198,47.3983,-122.31,2050,8909,7499,0.8417330789089684,1988100,79370281,77382181
505000.0,2,1.0,1240,57000,1.0,0,0,2,7,1240,0,1962,0.0,98075,47.597,-122.059,3050,25545,55760,0.9782456140350877,1537600,3249000000,3247462400
470500.0,5,2.5,2500,9248,1.0,0,0,2,8,1300,1200,1966,0.0,98006,47.5415,-122.18,2090,8568,6748,0.7296712802768166,6250000,85525504,79275504
360000.0,3,1.0,1050,9206,1.5,0,0,2,7,1050,0,1954,0.0,98125,47.7071,-122.301,1380,6384,8156,0.8859439495980882,1102500,84750436,83647936
1240000.0,4,2.75,2680,8500,1.0,0,4,3,9,1480,1200,1962,0.0,98006,47.5634,-122.156,2940,8650,5820,0.6847058823529412,7182400,72250000,65067600
986000.0,3,2.5,2380,16080,1.0,0,2,3,9,1340,1040,1964,0.0,98136,47.5262,-122.38600000000001,2560,10070,13700,0.8519900497512438,5664400,258566400,252902000
515000.0,2,1.0,1060,4228,1.0,0,0,2,7,860,0,1906,0.0,98112,47.6231,-122.29299999999999,1060,4187,3168,0.7492904446546831,1123600,17875984,16752384
320000.0,3,1.75,2300,41900,1.0,0,0,3,8,1310,990,1939,0.0,98168,47.477,-122.292,1160,8547,39600,0.9451073985680191,5290000,1755610000,1750320000
310000.0,4,3.0,2010,7426,1.0,0,0,4,7,1090,920,1951,0.0,98178,47.5042,-122.265,1470,7426,5416,0.7293293832480474,4040100,55145476,51105376
356700.0,2,1.0,1090,5000,1.0,0,0,3,7,730,360,1942,0.0,98126,47.5258,-122.37799999999999,990,5250,3910,0.782,1188100,25000000,23811900
775000.0,4,1.75,2320,5595,1.0,0,0,2,7,1510,810,1956,0.0,98199,47.6397,-122.38799999999999,1840,5596,3275,0.5853440571939231,5382400,31304025,25921625
325000.0,3,1.0,1040,7541,1.0,0,0,2,6,1040,0,1951,0.0,98133,47.7565,-122.339,1140,6100,6501,0.8620872563320514,1081600,56866681,55785081
208000.0,4,2.75,1810,8677,1.5,0,0,2,7,1810,0,1962,0.0,98198,47.3668,-122.31,1740,8677,6867,0.7914025584879567,3276100,75290329,72014229
825000.0,2,1.0,1150,12775,1.0,1,4,3,6,1150,0,1908,0.0,98178,47.501999999999995,-122.22200000000001,2440,11852,11625,0.9099804305283757,1322500,163200625,161878125
515000.0,3,2.5,2360,11254,1.0,0,2,2,9,2360,0,1990,0.0,98003,47.3356,-122.333,2390,11254,8894,0.7902967833659144,5569600,126652516,121082916
490000.0,3,1.5,1970,3400,1.5,0,0,3,8,1420,550,1929,0.0,98122,47.6163,-122.292,1940,4000,1430,0.42058823529411765,3880900,11560000,7679100
675000.0,4,3.0,2690,28300,1.0,0,0,2,8,2690,0,1954,1999.0,98166,47.4458,-122.34299999999999,2820,27100,25610,0.9049469964664311,7236100,800890000,793653900
360000.0,4,2.5,2080,4080,1.0,0,0,4,7,1040,1040,1962,0.0,98144,47.571999999999996,-122.29,1340,4080,2000,0.49019607843137253,4326400,16646400,12320000
550000.0,4,2.5,2080,4080,1.0,0,0,4,7,1040,1040,1962,0.0,98144,47.571999999999996,-122.29,1340,4080,2000,0.49019607843137253,4326400,16646400,12320000
225000.0,3,1.5,1370,9000,1.0,0,0,2,7,1370,0,1962,0.0,98168,47.4973,-122.32799999999999,1400,9075,7630,0.8477777777777777,1876900,81000000,79123100
500000.0,3,2.75,3410,9360,1.5,0,0,3,8,3410,0,1967,0.0,98058,47.4497,-122.147,2260,10128,5950,0.6356837606837606,11628100,87609600,75981500
385000.0,4,2.0,1850,11700,1.0,0,0,3,8,1850,0,1969,0.0,98059,47.4702,-122.12,2110,11700,9850,0.8418803418803419,3422500,136890000,133467500
837700.0,5,2.75,3010,12611,2.0,0,0,2,10,3010,0,1994,0.0,98052,47.69600000000001,-122.102,2890,9456,9601,0.7613194829910396,9060100,159037321,149977221
448000.0,3,2.25,1530,3056,2.0,0,0,2,7,1530,0,2003,0.0,98053,47.6817,-122.035,1560,3064,1526,0.4993455497382199,2340900,9339136,6998236
730000.0,5,1.75,2690,21357,1.0,0,0,3,7,1420,1270,1952,0.0,98004,47.5831,-122.191,2600,17539,18667,0.8740459802406705,7236100,456121449,448885349
575000.0,4,1.5,2810,7140,1.0,0,2,2,8,1490,1320,1954,0.0,98136,47.5252,-122.382,2240,6825,4330,0.6064425770308123,7896100,50979600,43083500
430000.0,3,1.75,1810,7300,1.0,0,0,3,7,1240,570,1976,0.0,98034,47.7299,-122.19200000000001,1460,7560,5490,0.7520547945205479,3276100,53290000,50013900
435000.0,3,2.5,1560,3987,2.0,0,0,2,7,1560,0,2002,0.0,98053,47.687,-122.04299999999999,1600,3152,2427,0.6087283671933785,2433600,15896169,13462569
241000.0,3,1.0,1010,9611,1.0,0,0,3,6,1010,0,1973,0.0,98092,47.3006,-122.066,1200,9611,8601,0.8949120799084382,1020100,92371321,91351221
453500.0,2,1.75,1000,1760,1.0,0,0,3,6,600,400,1924,0.0,98109,47.6261,-122.355,2120,2802,760,0.4318181818181818,1000000,3097600,2097600
285000.0,2,1.5,990,1380,3.0,0,0,2,7,990,0,2001,0.0,98133,47.7218,-122.35600000000001,1050,1380,390,0.2826086956521739,980100,1904400,924300
151000.0,2,1.0,720,4222,1.0,0,0,3,5,720,0,1942,0.0,98056,47.4965,-122.186,860,4785,3502,0.8294647086688773,518400,17825284,17306884
1570000.0,5,4.5,6070,14731,2.0,0,0,2,11,6070,0,2004,0.0,98059,47.5306,-122.134,4750,13404,8661,0.5879437920032584,36844900,217002361,180157461
631000.0,5,2.0,2270,2400,2.0,0,0,2,7,2270,0,1905,0.0,98122,47.6051,-122.319,1320,2400,130,0.05416666666666667,5152900,5760000,607100
285000.0,2,2.5,1380,1073,2.0,0,0,2,7,1140,240,2011,0.0,98126,47.5462,-122.369,1580,2036,-307,-0.28611369990680335,1904400,1151329,-753071
195000.0,3,1.0,1260,8378,1.0,0,0,3,6,840,420,1959,1977.0,98023,47.3274,-122.348,1140,8496,7118,0.8496061112437336,1587600,70190884,68603284
817500.0,4,2.5,2910,35679,2.0,0,0,3,9,2910,0,1987,0.0,98075,47.5859,-121.991,2720,36728,32769,0.9184394181451274,8468100,1272991041,1264522941
550000.0,3,2.0,1810,12825,1.0,0,0,3,7,1810,0,1960,0.0,98007,47.5953,-122.14,1490,10800,11015,0.858869395711501,3276100,164480625,161204525
1130000.0,4,2.5,3160,8281,2.0,0,0,3,9,3160,0,1995,0.0,98033,47.6699,-122.195,3000,8281,5121,0.6184035744475305,9985600,68574961,58589361
609850.0,2,2.75,1910,1369,3.0,0,0,2,9,1910,0,2002,0.0,98119,47.6544,-122.37299999999999,1910,1879,-541,-0.3951789627465303,3648100,1874161,-1773939
200000.0,3,1.0,1230,4380,1.0,0,0,2,6,1230,0,1947,0.0,98106,47.5352,-122.361,1525,6026,3150,0.7191780821917808,1512900,19184400,17671500
367000.0,4,2.5,2960,6219,2.0,0,0,2,9,2960,0,2006,0.0,98038,47.3603,-122.037,2960,5361,3259,0.524039234603634,8761600,38675961,29914361
285167.0,3,2.25,2200,8375,2.0,0,0,2,8,2200,0,1988,0.0,98092,47.2626,-122.21799999999999,2200,10002,6175,0.7373134328358208,4840000,70140625,65300625
275000.0,2,1.5,1270,32175,1.0,0,0,3,7,1270,0,1947,0.0,98003,47.3347,-122.304,1270,10200,30905,0.9605283605283605,1612900,1035230625,1033617725
350900.0,4,2.5,2540,12843,2.0,0,0,2,9,2540,0,1992,0.0,98030,47.3866,-122.169,2410,9383,10303,0.8022268940278751,6451600,164942649,158491049
660000.0,4,3.25,3030,9273,2.0,0,0,4,8,3030,0,1988,0.0,98029,47.5747,-122.014,2360,7632,6243,0.6732449045616306,9180900,85988529,76807629
525000.0,3,1.75,1520,8835,1.0,0,0,3,7,1520,0,1957,0.0,98008,47.6054,-122.118,1760,8580,7315,0.8279569892473119,2310400,78057225,75746825
262000.0,4,2.5,1560,7800,2.0,0,0,2,7,1560,0,1997,0.0,98168,47.513999999999996,-122.316,1160,7800,6240,0.8,2433600,60840000,58406400
690000.0,2,1.0,970,4560,1.0,0,0,3,7,970,0,1907,0.0,98103,47.6561,-122.33200000000001,1500,4560,3590,0.7872807017543859,940900,20793600,19852700
624000.0,5,3.75,3570,14648,2.0,0,0,2,9,3570,0,2005,0.0,98019,47.7377,-121.97399999999999,3160,7882,11078,0.7562807209175314,12744900,214563904,201819004
353000.0,3,1.0,1350,7740,1.0,0,0,3,6,860,490,1947,0.0,98125,47.7098,-122.291,1130,7740,6390,0.8255813953488372,1822500,59907600,58085100
552500.0,4,3.5,3710,10400,2.0,0,0,2,8,2290,1420,2002,0.0,98056,47.5041,-122.186,1720,4276,6690,0.6432692307692308,13764100,108160000,94395900
224500.0,4,1.0,1430,8355,1.5,0,0,3,7,1430,0,1983,0.0,98092,47.3178,-122.17399999999999,1550,7938,6925,0.8288450029922202,2044900,69806025,67761125
239000.0,3,1.0,940,8571,1.0,0,0,2,6,940,0,1950,0.0,98146,47.5006,-122.336,1100,8573,7631,0.8903278497258196,883600,73462041,72578441
975000.0,5,4.5,4300,12250,2.0,0,0,2,10,4300,0,2004,0.0,98029,47.5557,-122.027,3950,12250,7950,0.6489795918367347,18490000,150062500,131572500
1200000.0,4,1.75,3990,13470,2.0,0,0,2,11,3990,0,2006,0.0,98059,47.5305,-122.131,5790,13709,9480,0.7037861915367484,15920100,181440900,165520800
505000.0,3,1.0,1380,4000,1.5,0,0,2,7,1380,0,1910,0.0,98112,47.6261,-122.296,1690,4000,2620,0.655,1904400,16000000,14095600
302000.0,4,1.75,2020,7865,1.0,0,0,3,7,1010,1010,1963,0.0,98059,47.5008,-122.162,1650,7865,5845,0.7431659249841068,4080400,61858225,57777825
170000.0,3,1.0,1480,5670,1.0,0,0,2,6,780,700,1944,0.0,98106,47.5175,-122.36,760,5040,4190,0.7389770723104057,2190400,32148900,29958500
195000.0,2,1.0,1190,27007,1.0,0,0,3,5,1190,0,1910,0.0,98027,47.523999999999994,-122.04,1730,12632,25817,0.9559373495760358,1416100,729378049,727961949
272000.0,5,1.5,2550,6300,1.0,0,0,3,7,1560,990,1959,0.0,98056,47.5014,-122.17200000000001,1380,6300,3750,0.5952380952380952,6502500,39690000,33187500
369000.0,5,1.5,2550,6300,1.0,0,0,3,7,1560,990,1959,0.0,98056,47.5014,-122.17200000000001,1380,6300,3750,0.5952380952380952,6502500,39690000,33187500
332500.0,3,1.5,1500,6332,1.0,0,0,2,7,1500,0,1953,0.0,98125,47.7274,-122.31200000000001,1500,6337,4832,0.7631080227416298,2250000,40094224,37844224
515000.0,3,2.5,3000,8250,1.0,0,0,3,8,1760,1240,1963,0.0,98008,47.6191,-122.11200000000001,2040,8250,5250,0.6363636363636364,9000000,68062500,59062500
269000.0,3,1.0,1690,4250,1.0,0,0,2,7,1020,670,1967,0.0,98178,47.4945,-122.258,1820,8865,2560,0.6023529411764705,2856100,18062500,15206400
1280000.0,4,4.0,4390,17832,1.0,0,0,3,11,2430,1960,1994,0.0,98059,47.5283,-122.14299999999999,3090,12369,13442,0.7538133692238672,19272100,317980224,298708124
303000.0,3,2.5,1560,4100,2.0,0,0,2,7,1560,0,1985,0.0,98055,47.4733,-122.189,1660,4400,2540,0.6195121951219512,2433600,16810000,14376400
420000.0,7,3.0,2940,8624,1.0,0,0,2,8,1690,1250,1977,0.0,98155,47.7555,-122.307,1850,8031,5684,0.6590909090909091,8643600,74373376,65729776
400000.0,3,1.0,1130,4100,1.0,0,0,2,7,990,140,1941,0.0,98117,47.6856,-122.385,1800,4100,2970,0.724390243902439,1276900,16810000,15533100
225000.0,3,1.0,1020,8437,1.0,0,0,4,6,1020,0,1987,0.0,98022,47.2093,-122.0,1420,8500,7417,0.879103946900557,1040400,71182969,70142569
219000.0,2,2.0,1310,2550,2.0,0,0,2,6,1310,0,2004,0.0,98038,47.3496,-122.022,1310,2550,1240,0.48627450980392156,1716100,6502500,4786400
605000.0,3,2.5,2570,9487,2.0,0,3,2,9,2570,0,1989,0.0,98011,47.7408,-122.21600000000001,2490,9898,6917,0.7291029830294087,6604900,90003169,83398269
625000.0,4,2.0,2020,6867,1.0,0,0,4,8,1010,1010,1942,0.0,98115,47.7,-122.292,1250,6842,4847,0.7058395223532838,4080400,47155689,43075289
380000.0,5,2.0,1680,3240,1.0,0,0,2,5,840,840,1906,0.0,98144,47.5965,-122.311,1380,1260,1560,0.48148148148148145,2822400,10497600,7675200
620000.0,4,2.0,1770,7700,1.5,0,0,3,7,1770,0,1962,0.0,98007,47.5916,-122.146,1710,7700,5930,0.7701298701298701,3132900,59290000,56157100
687500.0,4,2.75,3190,10970,2.0,0,0,2,10,3190,0,1994,0.0,98075,47.5862,-122.029,2850,8416,7780,0.7092069279854147,10176100,120340900,110164800
225500.0,4,2.0,1440,7950,1.0,0,0,4,6,1440,0,1962,0.0,98058,47.4517,-122.08200000000001,1530,20037,6510,0.8188679245283019,2073600,63202500,61128900
252500.0,3,2.0,1150,6000,1.0,0,0,4,7,1150,0,1956,0.0,98178,47.49800000000001,-122.26299999999999,1980,6360,4850,0.8083333333333333,1322500,36000000,34677500
510000.0,3,2.5,1860,3658,2.0,0,0,2,8,1860,0,1994,0.0,98029,47.5703,-122.00399999999999,1840,3739,1798,0.4915254237288136,3459600,13380964,9921364
510000.0,4,2.5,2430,5203,2.0,0,0,2,8,2430,0,2003,0.0,98155,47.7402,-122.31700000000001,2260,7474,2773,0.532961752834903,5904900,27071209,21166309
725000.0,3,2.5,1940,4000,1.5,0,0,4,7,1940,0,1906,0.0,98109,47.6372,-122.352,1440,4000,2060,0.515,3763600,16000000,12236400
492000.0,2,1.0,880,2970,1.0,0,0,2,7,880,0,1927,0.0,98103,47.6868,-122.34899999999999,1370,3060,2090,0.7037037037037037,774400,8820900,8046500
425000.0,4,2.5,1930,14196,1.0,0,0,3,7,1330,600,1977,0.0,98072,47.7407,-122.09700000000001,1470,12852,12266,0.8640462102000563,3724900,201526416,197801516
1960000.0,4,2.75,3120,7898,1.0,1,4,3,8,1560,1560,1963,0.0,98034,47.7165,-122.259,2630,13868,4778,0.6049632818435047,9734400,62378404,52644004
298900.0,3,2.5,1830,6162,2.0,0,0,2,8,1830,0,1994,0.0,98092,47.3291,-122.17,1860,7017,4332,0.7030185004868549,3348900,37970244,34621344
699000.0,4,2.5,3230,40319,2.0,0,0,3,10,3230,0,1987,0.0,98027,47.4856,-122.069,2990,40234,37089,0.9198888861330886,10432900,1625621761,1615188861
310000.0,2,1.0,700,3000,1.0,0,0,3,6,700,0,1918,0.0,98103,47.6846,-122.346,1560,4500,2300,0.7666666666666667,490000,9000000,8510000
350000.0,3,1.75,1010,8580,1.0,0,0,2,7,1010,0,1961,0.0,98033,47.6703,-122.17399999999999,1500,8580,7570,0.8822843822843823,1020100,73616400,72596300
790000.0,4,1.75,2460,10061,1.0,1,4,2,7,1410,1050,1961,0.0,98178,47.5105,-122.238,2300,10061,7601,0.7554915018387834,6051600,101223721,95172121
305000.0,4,2.5,2230,5000,2.0,0,0,2,8,2230,0,2003,0.0,98031,47.3919,-122.184,2230,6137,2770,0.554,4972900,25000000,20027100
315000.0,3,2.5,1570,2865,2.0,0,0,2,7,1570,0,2003,0.0,98118,47.5412,-122.288,1610,2582,1295,0.45200698080279234,2464900,8208225,5743325
267500.0,5,3.5,2390,6600,2.0,0,0,4,7,2390,0,1977,0.0,98042,47.3737,-122.115,1140,6600,4210,0.6378787878787879,5712100,43560000,37847900
1750000.0,4,3.25,3460,7749,2.0,0,1,2,10,3020,440,1950,1998.0,98115,47.6849,-122.273,3030,8680,4289,0.5534907730029681,11971600,60047001,48075401
435000.0,6,3.5,2400,8620,2.0,0,0,2,8,1640,760,1987,0.0,98034,47.7152,-122.162,1940,7350,6220,0.7215777262180975,5760000,74304400,68544400
482500.0,6,4.5,2940,7500,1.5,0,0,3,8,2940,0,1966,0.0,98034,47.7208,-122.182,2010,7500,4560,0.608,8643600,56250000,47606400
5110000.0,5,5.25,8010,45517,2.0,1,4,2,12,5990,2020,1999,0.0,98033,47.6767,-122.211,3430,26788,37507,0.8240217940549684,64160100,2071797289,2007637189
439995.0,3,1.75,1570,8400,1.0,0,0,3,7,1570,0,1959,0.0,98133,47.76,-122.34,1860,8639,6830,0.8130952380952381,2464900,70560000,68095100
460000.0,3,3.0,1520,7500,1.0,0,0,2,7,1180,340,1967,0.0,98034,47.7276,-122.181,2080,8000,5980,0.7973333333333333,2310400,56250000,53939600
194000.0,3,1.0,1070,6440,1.0,0,0,3,7,1070,0,1971,0.0,98023,47.3186,-122.37299999999999,1190,6532,5370,0.8338509316770186,1144900,41473600,40328700
290000.0,2,0.75,440,8313,1.0,1,3,3,5,440,0,1943,0.0,98070,47.4339,-122.512,880,26289,7873,0.9470708528810298,193600,69105969,68912369
274700.0,4,2.0,2440,9600,1.0,0,0,4,7,1220,1220,1963,0.0,98031,47.4142,-122.179,1370,9600,7160,0.7458333333333333,5953600,92160000,86206400
900000.0,4,2.5,2660,3672,2.0,0,0,4,8,1800,860,1910,0.0,98105,47.6609,-122.324,1510,3825,1012,0.275599128540305,7075600,13483584,6407984
1150000.0,4,4.0,4460,103382,2.0,0,0,2,11,4460,0,2001,0.0,98053,47.63399999999999,-121.99700000000001,3470,88519,98922,0.9568590276837361,19891600,10687837924,10667946324
605000.0,3,2.5,2010,3667,2.0,0,0,2,9,2010,0,2008,0.0,98027,47.545,-122.015,2350,3600,1657,0.4518680119989092,4040100,13446889,9406789
359000.0,3,2.5,1450,3850,2.0,0,0,2,7,1450,0,2004,0.0,98065,47.5318,-121.85,1970,3748,2400,0.6233766233766234,2102500,14822500,12720000
850000.0,3,1.75,1400,9900,1.0,0,0,2,7,1400,0,1951,0.0,98004,47.6272,-122.209,1810,10796,8500,0.8585858585858586,1960000,98010000,96050000
505000.0,3,2.0,1500,2500,2.0,0,0,2,8,1500,0,2002,0.0,98107,47.6748,-122.385,1550,5000,1000,0.4,2250000,6250000,4000000
565000.0,3,2.5,2500,7394,2.0,0,0,2,9,2500,0,1990,0.0,98072,47.7441,-122.17299999999999,2790,7642,4894,0.6618880173113335,6250000,54671236,48421236
585000.0,2,1.75,1280,7110,1.0,0,0,3,7,1000,280,1955,0.0,98118,47.5569,-122.273,1550,6835,5830,0.819971870604782,1638400,50552100,48913700
328000.0,4,3.25,3380,7500,2.0,0,3,2,7,2420,960,1990,0.0,98198,47.4092,-122.33,1920,7500,4120,0.5493333333333333,11424400,56250000,44825600
749950.0,4,2.75,2910,18700,1.0,0,0,2,9,2210,700,1957,0.0,98177,47.7557,-122.368,2420,26140,15790,0.8443850267379679,8468100,349690000,341221900
826000.0,4,2.5,3060,7140,2.0,0,0,2,9,3060,0,2006,0.0,98027,47.5393,-121.99799999999999,3240,6218,4080,0.5714285714285714,9363600,50979600,41616000
535000.0,3,1.0,1330,40259,1.0,0,0,3,7,1330,0,1977,0.0,98024,47.552,-121.89,1710,34787,38929,0.9669639086912243,1768900,1620787081,1619018181
925000.0,4,2.5,3300,101930,2.0,0,0,3,10,3300,0,1991,0.0,98029,47.576,-121.976,2880,213879,98630,0.9676248405768665,10890000,10389724900,10378834900
875000.0,3,3.5,3250,6000,2.0,0,0,2,10,2500,750,2001,0.0,98136,47.5533,-122.391,1650,6000,2750,0.4583333333333333,10562500,36000000,25437500
902000.0,4,2.25,2530,9200,1.0,0,0,4,9,1570,960,1976,0.0,98006,47.5612,-122.152,3030,9400,6670,0.725,6400900,84640000,78239100
423000.0,3,1.0,1830,13900,1.0,0,0,2,7,1830,0,1951,0.0,98133,47.7654,-122.352,1840,10667,12070,0.8683453237410071,3348900,193210000,189861100
235000.0,3,1.0,1170,11100,1.0,0,0,3,6,1170,0,1968,0.0,98059,47.4954,-122.164,2080,8481,9930,0.8945945945945946,1368900,123210000,121841100
545000.0,2,2.0,2930,14057,1.0,0,2,3,8,1680,1250,1980,0.0,98070,47.4025,-122.463,2234,61011,11127,0.7915629223874227,8584900,197599249,189014349
343000.0,2,1.0,1230,7560,1.0,0,0,2,7,1230,0,1961,0.0,98133,47.7298,-122.34,1270,7560,6330,0.8373015873015873,1512900,57153600,55640700
334950.0,3,2.5,1620,2930,2.0,0,0,2,8,1620,0,2002,0.0,98058,47.4491,-122.12,1900,2943,1310,0.447098976109215,2624400,8584900,5960500
405000.0,3,1.75,1760,5355,1.0,0,0,2,7,1160,600,1956,0.0,98118,47.5368,-122.26700000000001,1790,6225,3595,0.6713352007469654,3097600,28676025,25578425
220000.0,4,1.0,1440,8250,1.0,0,0,2,7,1440,0,1959,0.0,98188,47.4325,-122.291,1440,8466,6810,0.8254545454545454,2073600,68062500,65988900
173000.0,2,1.0,1740,8100,1.0,0,0,2,6,1050,690,1947,0.0,98168,47.4942,-122.304,960,8100,6360,0.7851851851851852,3027600,65610000,62582400
655000.0,3,1.0,1270,3600,1.5,0,0,2,7,1270,0,1906,0.0,98119,47.6368,-122.37,1710,3600,2330,0.6472222222222223,1612900,12960000,11347100
406000.0,2,1.0,880,3000,1.0,0,0,2,6,880,0,1924,0.0,98115,47.6749,-122.323,890,3000,2120,0.7066666666666667,774400,9000000,8225600
632000.0,6,2.5,2560,8320,1.0,0,0,2,7,1370,1190,1961,0.0,98125,47.7021,-122.287,2360,7800,5760,0.6923076923076923,6553600,69222400,62668800
357000.0,5,2.75,1540,4000,1.0,0,0,2,7,1140,400,1990,0.0,98106,47.533,-122.354,1630,4000,2460,0.615,2371600,16000000,13628400
361000.0,3,1.75,1150,17585,1.0,0,0,2,7,1150,0,1964,0.0,98014,47.6503,-121.90799999999999,1200,7500,16435,0.9346033551322149,1322500,309232225,307909725
277000.0,2,1.0,770,8149,1.0,0,0,2,6,770,0,1948,0.0,98155,47.7458,-122.29799999999999,1160,8149,7379,0.9055098785127009,592900,66406201,65813301
630000.0,4,3.75,4610,40202,1.0,0,0,3,10,2500,2110,1980,0.0,98027,47.4599,-122.0,3050,41056,35592,0.8853290881050694,21252100,1616200804,1594948704
254000.0,3,2.5,1850,4597,2.0,0,0,2,8,1850,0,2003,0.0,98042,47.3755,-122.13600000000001,2210,5000,2747,0.5975636284533391,3422500,21132409,17709909
472800.0,3,2.25,1840,8400,1.0,0,0,2,8,1290,550,1961,0.0,98006,47.5497,-122.17200000000001,2110,8400,6560,0.780952380952381,3385600,70560000,67174400
263000.0,3,1.75,1490,3800,1.0,0,0,2,6,700,790,1913,0.0,98118,47.5554,-122.27,2180,4000,2310,0.6078947368421053,2220100,14440000,12219900
510000.0,3,1.75,1490,3800,1.0,0,0,2,6,700,790,1913,0.0,98118,47.5554,-122.27,2180,4000,2310,0.6078947368421053,2220100,14440000,12219900
179950.0,3,1.0,960,10125,1.0,0,0,3,7,960,0,1952,0.0,98003,47.3335,-122.305,1250,9769,9165,0.9051851851851852,921600,102515625,101594025
525000.0,4,2.25,1580,7307,1.0,0,0,2,8,1160,420,1973,0.0,98027,47.568999999999996,-122.086,2020,7458,5727,0.7837689886410292,2496400,53392249,50895849
479000.0,3,2.5,1260,889,3.0,0,0,2,8,1260,0,2008,0.0,98109,47.6277,-122.345,1340,1324,-371,-0.41732283464566927,1587600,790321,-797279
651000.0,3,2.0,1940,6440,1.0,0,2,4,7,970,0,1940,0.0,98116,47.5664,-122.389,1730,4640,4500,0.6987577639751553,3763600,41473600,37710000
949000.0,4,1.75,2490,7834,1.0,0,3,3,8,1240,1250,1958,0.0,98033,47.6851,-122.209,3210,7834,5344,0.6821547102374266,6200100,61371556,55171456
392400.0,5,2.5,2520,27951,1.5,0,0,2,7,1890,630,1942,1970.0,98155,47.7733,-122.318,1830,14373,25431,0.9098422238918107,6350400,781258401,774908001
585000.0,4,1.75,1760,5356,1.0,0,0,3,7,920,840,1950,0.0,98115,47.678999999999995,-122.288,1680,5184,3596,0.671396564600448,3097600,28686736,25589136
460000.0,4,2.5,4190,7504,2.0,0,0,2,7,4190,0,2004,0.0,98058,47.4394,-122.11399999999999,2480,6727,3314,0.44163113006396587,17556100,56310016,38753916
470000.0,3,1.0,1170,4400,1.0,0,0,2,7,870,300,1951,0.0,98199,47.6584,-122.391,1240,4400,3230,0.7340909090909091,1368900,19360000,17991100
245000.0,3,2.5,1600,4271,2.0,0,0,2,7,1600,0,2003,0.0,98038,47.386,-122.036,1520,3225,2671,0.6253804729571529,2560000,18241441,15681441
500000.0,4,2.0,2760,27631,2.0,0,0,3,8,1800,960,1978,0.0,98155,47.7484,-122.291,2490,13158,24871,0.9001121928268974,7617600,763472161,755854561
455000.0,3,2.5,2090,8653,2.0,0,0,2,8,2090,0,1989,0.0,98011,47.7498,-122.184,2090,6396,6563,0.7584652721599445,4368100,74874409,70506309
485500.0,4,2.5,2320,3974,2.0,0,0,2,7,2320,0,1999,0.0,98065,47.532,-121.88,2620,4539,1654,0.41620533467539006,5382400,15792676,10410276
1880000.0,5,3.25,4110,7920,2.0,0,3,2,9,3150,960,1921,0.0,98122,47.617,-122.28200000000001,3890,7800,3810,0.4810606060606061,16892100,62726400,45834300
100000.0,2,1.0,770,17334,1.0,0,0,2,7,770,0,1978,0.0,98001,47.2997,-122.26899999999999,1480,17334,16564,0.9555786315910927,592900,300467556,299874656
307000.0,3,1.75,1410,16105,1.0,0,0,2,7,1410,0,1982,0.0,98014,47.6927,-121.913,1550,18615,14695,0.9124495498292455,1988100,259371025,257382925
475000.0,4,3.5,3660,14401,2.0,0,0,2,10,2660,1000,1994,0.0,98023,47.3076,-122.396,2780,10653,10741,0.7458509825706549,13395600,207388801,193993201
330000.0,4,2.5,2180,7210,1.0,0,0,2,7,1190,990,1972,0.0,98011,47.7419,-122.181,2070,7210,5030,0.6976421636615812,4752400,51984100,47231700
130000.0,3,1.0,1110,7520,1.0,0,0,3,7,1110,0,1960,0.0,98033,47.683,-122.176,1440,8400,6410,0.8523936170212766,1232100,56550400,55318300
320000.0,3,2.5,2280,7417,2.0,0,0,2,8,2280,0,1998,0.0,98001,47.3557,-122.27799999999999,2370,6443,5137,0.6925980854793043,5198400,55011889,49813489
735000.0,4,2.5,2820,6180,2.0,0,0,2,9,2050,770,2013,0.0,98118,47.5529,-122.281,1390,4635,3360,0.5436893203883495,7952400,38192400,30240000
365000.0,4,2.5,1570,9600,1.0,0,0,2,7,800,770,1972,0.0,98155,47.7757,-122.303,1340,9110,8030,0.8364583333333333,2464900,92160000,89695100
234000.0,3,1.5,1200,11935,1.0,0,0,3,7,1200,0,1968,0.0,98042,47.3434,-122.08200000000001,1350,11935,10735,0.8994553833263511,1440000,142444225,141004225
211000.0,4,2.0,1710,8288,1.5,0,0,2,7,1710,0,1970,0.0,98031,47.3947,-122.17399999999999,1710,7200,6578,0.7936776061776062,2924100,68690944,65766844
680000.0,6,3.5,3000,6320,2.0,0,2,2,8,2400,600,1969,0.0,98118,47.562,-122.279,1720,6360,3320,0.5253164556962026,9000000,39942400,30942400
457000.0,4,3.0,2800,7845,2.0,0,0,2,8,2800,0,2002,0.0,98038,47.3544,-122.01299999999999,2800,6977,5045,0.6430847673677501,7840000,61544025,53704025
349000.0,3,2.25,1640,7261,2.0,0,0,2,7,1640,0,1989,0.0,98034,47.7192,-122.176,1640,6789,5621,0.774135793967773,2689600,52722121,50032521
360000.0,3,2.75,2030,6840,1.0,0,0,2,7,1210,820,1979,0.0,98108,47.5413,-122.29899999999999,1910,6365,4810,0.7032163742690059,4120900,46785600,42664700
350000.0,4,2.5,2530,10155,2.0,0,0,2,8,2530,0,1998,0.0,98042,47.351000000000006,-122.146,2330,7205,7625,0.7508616445100935,6400900,103124025,96723125
208000.0,3,1.0,990,7420,1.0,0,0,4,6,990,0,1960,0.0,98002,47.2898,-122.221,1010,7420,6430,0.866576819407008,980100,55056400,54076300
250275.0,2,1.0,790,11234,1.0,0,0,3,6,790,0,1942,0.0,98166,47.4413,-122.34899999999999,1930,11871,10444,0.9296777639309239,624100,126202756,125578656
435000.0,2,1.0,790,11234,1.0,0,0,3,6,790,0,1942,0.0,98166,47.4413,-122.34899999999999,1930,11871,10444,0.9296777639309239,624100,126202756,125578656
270000.0,3,1.75,1800,7763,1.0,0,0,2,6,1470,330,1984,0.0,98030,47.3766,-122.184,1440,7483,5963,0.7681308772381811,3240000,60264169,57024169
438000.0,3,1.75,1650,12940,1.0,0,0,3,7,1650,0,1961,0.0,98028,47.7629,-122.26799999999999,2830,12600,11290,0.8724884080370943,2722500,167443600,164721100
659000.0,4,2.0,1980,23625,2.0,0,0,2,8,1980,0,1938,1984.0,98072,47.7553,-122.09200000000001,2300,24640,21645,0.9161904761904762,3920400,558140625,554220225
645000.0,4,2.75,2340,6350,1.0,0,0,3,7,1310,1030,1974,0.0,98126,47.5559,-122.37899999999999,2020,6350,4010,0.631496062992126,5475600,40322500,34846900
685100.0,4,2.5,2790,5423,2.0,0,0,2,9,2790,0,1999,0.0,98074,47.6085,-122.01700000000001,2450,6453,2633,0.48552461737045916,7784100,29408929,21624829
350000.0,7,3.0,2800,9569,1.0,0,2,2,7,1400,1400,1963,0.0,98056,47.5102,-122.18299999999999,2150,7333,6769,0.7073884418434528,7840000,91565761,83725761
375000.0,2,1.0,1840,81892,1.0,0,0,2,6,1840,0,1955,0.0,98072,47.7694,-122.124,2550,40089,80052,0.9775313827968544,3385600,6706299664,6702914064
170000.0,3,1.5,1350,81549,1.0,0,0,1,7,1350,0,1966,0.0,98092,47.3099,-122.09,2220,93825,80199,0.9834455358128242,1822500,6650239401,6648416901
880000.0,4,2.5,3030,3841,3.0,0,0,2,9,3030,0,2005,0.0,98117,47.6781,-122.369,1080,4922,811,0.21114293152824784,9180900,14753281,5572381
410500.0,4,2.5,1980,5000,2.0,0,0,2,8,1980,0,2008,0.0,98014,47.6492,-121.90799999999999,1400,8500,3020,0.604,3920400,25000000,21079600
780000.0,4,2.5,3690,13609,2.0,0,2,2,10,3690,0,1996,0.0,98075,47.5872,-121.97200000000001,3600,13609,9919,0.7288559041810566,13616100,185204881,171588781
1230000.0,5,4.5,3732,4426,2.5,0,0,2,10,2932,800,2001,0.0,98112,47.6189,-122.288,2950,4000,694,0.15680072300045186,13927824,19589476,5661652
449000.0,2,1.75,1510,6852,1.0,0,0,2,8,1510,0,2005,0.0,98053,47.7073,-122.012,1510,5912,5342,0.7796263864565091,2280100,46949904,44669804
546000.0,3,1.75,2000,5000,1.0,0,0,3,7,1110,890,1921,0.0,98117,47.6859,-122.399,1750,5000,3000,0.6,4000000,25000000,21000000
317000.0,3,2.0,1760,11410,1.0,0,0,4,7,1060,700,1977,0.0,98058,47.4528,-122.163,1680,9165,9650,0.845749342681858,3097600,130188100,127090500
276900.0,3,1.0,1270,7566,1.0,0,0,3,7,1270,0,1958,0.0,98056,47.5074,-122.175,1780,7520,6296,0.8321438012159662,1612900,57244356,55631456
399000.0,5,2.0,2620,7030,1.0,0,0,2,8,1420,1200,1965,0.0,98133,47.7338,-122.352,1360,7964,4410,0.6273115220483642,6864400,49420900,42556500
495000.0,5,2.75,2630,10165,1.0,0,0,3,8,1690,940,1976,0.0,98027,47.5196,-122.04899999999999,2440,10165,7535,0.7412690605017216,6916900,103327225,96410325
258000.0,3,1.75,2270,9000,1.0,0,0,3,8,1330,940,1978,0.0,98023,47.3077,-122.381,2090,8400,6730,0.7477777777777778,5152900,81000000,75847100
600000.0,2,2.5,2410,102366,1.0,0,0,3,7,1940,470,1912,1989.0,98024,47.5629,-121.91799999999999,2460,310582,99956,0.9764570267471622,5808100,10478797956,10472989856
265000.0,3,2.75,1120,881,3.0,0,0,2,8,1120,0,1999,0.0,98103,47.6914,-122.34299999999999,1120,1087,-239,-0.27128263337116915,1254400,776161,-478239
321000.0,5,2.75,3030,7000,1.0,0,0,3,7,1540,1490,1978,0.0,98032,47.3661,-122.28,1790,7330,3970,0.5671428571428572,9180900,49000000,39819100
682000.0,5,2.25,2120,4000,1.5,0,0,3,7,1720,400,1910,0.0,98109,47.644,-122.353,1960,4000,1880,0.47,4494400,16000000,11505600
295700.0,4,2.5,1720,5805,2.0,0,0,2,8,1720,0,2000,0.0,98092,47.3286,-122.208,2360,7700,4085,0.7037037037037037,2958400,33698025,30739625
609000.0,4,2.5,2150,37981,2.0,0,0,2,9,2150,0,1985,0.0,98052,47.7227,-122.098,2450,37981,35831,0.9433927490060819,4622500,1442556361,1437933861
995000.0,3,4.5,4380,47044,2.0,1,3,2,9,3720,660,1968,1990.0,98166,47.4734,-122.365,2460,18512,42664,0.9068956721367231,19184400,2213137936,2193953536
530000.0,3,2.25,2010,11817,2.0,0,0,3,8,2010,0,1986,0.0,98029,47.5665,-122.023,2190,10168,9807,0.8299060675298299,4040100,139641489,135601389
614000.0,5,2.5,3150,5150,2.0,0,0,4,8,1870,1280,1907,2004.0,98118,47.5506,-122.26899999999999,1550,5150,2000,0.3883495145631068,9922500,26522500,16600000
390000.0,3,2.5,2500,21780,1.0,0,0,2,8,1770,730,1986,0.0,98092,47.3282,-122.198,2670,23400,19280,0.8852157943067034,6250000,474368400,468118400
467000.0,3,2.5,1690,6642,2.0,0,0,2,7,1690,0,2004,0.0,98053,47.6793,-122.03299999999999,2120,5080,4952,0.7455585666967781,2856100,44116164,41260064
484000.0,6,2.5,3300,13501,1.0,0,0,2,8,2060,1240,1980,0.0,98059,47.5116,-122.163,2060,8745,10201,0.7555736612102807,10890000,182277001,171387001
340000.0,3,2.5,1240,1115,3.0,0,0,2,8,1240,0,2003,0.0,98103,47.6985,-122.34,1410,1355,-125,-0.11210762331838565,1537600,1243225,-294375
302495.0,3,2.5,2200,7201,2.0,0,0,2,8,2200,0,1994,0.0,98030,47.3821,-122.20700000000001,2250,7240,5001,0.6944868768226635,4840000,51854401,47014401
532500.0,3,1.75,1620,3360,1.0,0,0,4,7,980,640,1927,0.0,98117,47.6886,-122.361,1400,3840,1740,0.5178571428571429,2624400,11289600,8665200
441500.0,3,2.5,2420,9592,2.0,0,0,2,8,1780,640,1993,0.0,98059,47.5093,-122.15299999999999,2420,9145,7172,0.7477064220183486,5856400,92006464,86150064
470000.0,4,2.5,2680,8062,1.0,0,3,3,7,1530,1150,1967,0.0,98198,47.4132,-122.32799999999999,1920,8600,5382,0.6675762838005458,7182400,64995844,57813444
2300000.0,4,3.25,4250,8570,2.0,0,0,2,9,4250,0,2004,0.0,98004,47.6154,-122.21,2830,12821,4320,0.5040840140023337,18062500,73444900,55382400
590000.0,3,2.5,2400,99752,1.0,0,0,2,9,2400,0,1996,0.0,98058,47.3917,-122.084,2800,98010,97352,0.9759403320234181,5760000,9950461504,9944701504
320000.0,3,1.75,2300,12000,1.0,0,0,2,8,1770,530,1942,0.0,98133,47.7599,-122.34299999999999,2030,6000,9700,0.8083333333333333,5290000,144000000,138710000
363000.0,2,2.0,920,1201,2.0,0,0,2,8,800,120,2009,0.0,98144,47.5926,-122.295,1150,1161,281,0.23397169025811823,846400,1442401,596001
747500.0,4,2.25,2350,18600,2.0,0,0,3,9,2350,0,1977,0.0,98028,47.7473,-122.257,2880,14400,16250,0.8736559139784946,5522500,345960000,340437500
750000.0,2,2.5,2630,7957,2.0,0,0,2,8,2630,0,2003,0.0,98053,47.7106,-122.023,2305,7220,5327,0.669473419630514,6916900,63313849,56396949
831000.0,4,3.0,2170,4000,2.0,0,0,3,9,1610,560,1982,2011.0,98112,47.6196,-122.292,1670,4000,1830,0.4575,4708900,16000000,11291100
403000.0,3,2.5,1700,4125,2.0,0,0,2,7,1700,0,2004,0.0,98065,47.5305,-121.854,1970,4105,2425,0.5878787878787879,2890000,17015625,14125625
445000.0,3,2.5,2470,4565,2.0,0,0,2,7,2470,0,2005,0.0,98056,47.513999999999996,-122.189,2470,5064,2095,0.4589266155531216,6100900,20839225,14738325
345000.0,3,1.0,1250,17380,1.0,0,0,3,7,1250,0,1970,0.0,98072,47.7502,-122.10799999999999,1410,18200,16130,0.928078250863061,1562500,302064400,300501900
2260000.0,3,3.5,3110,14872,1.0,0,0,2,10,3110,0,2003,0.0,98004,47.6178,-122.209,3110,12433,11762,0.7908821947283485,9672100,221176384,211504284
371025.0,3,2.0,1530,8925,1.0,0,0,2,7,1530,0,1977,0.0,98011,47.736000000000004,-122.199,2040,8856,7395,0.8285714285714286,2340900,79655625,77314725
355000.0,2,1.0,960,6250,1.0,0,0,2,6,960,0,1916,0.0,98136,47.5491,-122.38600000000001,1350,6250,5290,0.8464,921600,39062500,38140900
270000.0,3,1.0,1240,14110,1.0,0,0,3,7,1240,0,1972,0.0,98058,47.4579,-122.09,2060,19350,12870,0.9121190644932672,1537600,199092100,197554500
425000.0,4,2.75,2440,15349,2.0,0,1,3,7,2440,0,1957,0.0,98198,47.4117,-122.333,2280,9250,12909,0.8410319890546616,5953600,235591801,229638201
364808.0,3,1.75,2320,7875,1.0,0,0,2,8,1620,700,1967,0.0,98058,47.4524,-122.146,1990,9720,5555,0.7053968253968254,5382400,62015625,56633225
320000.0,3,2.25,1580,6561,1.0,0,0,2,8,1200,380,1981,0.0,98058,47.4394,-122.14,1710,7241,4981,0.7591830513641213,2496400,43046721,40550321
325000.0,4,2.5,2963,5797,2.0,0,0,2,9,2963,0,2006,0.0,98030,47.3831,-122.185,2665,6119,2834,0.48887355528721754,8779369,33605209,24825840
350000.0,3,2.25,2470,10290,2.0,0,0,2,8,2230,240,1984,0.0,98058,47.4459,-122.124,1970,10150,7820,0.7599611273080661,6100900,105884100,99783200
170000.0,3,1.5,1370,10176,1.0,0,0,2,6,1370,0,1947,0.0,98168,47.4738,-122.26299999999999,1650,10176,8806,0.8653694968553459,1876900,103550976,101674076
255000.0,2,1.0,960,28717,1.0,0,0,3,6,960,0,1984,0.0,98070,47.3356,-122.50200000000001,1860,28717,27757,0.9665703241982101,921600,824666089,823744489
550000.0,3,1.0,1130,7500,1.0,0,0,2,7,880,250,1947,0.0,98117,47.6973,-122.389,2190,5250,6370,0.8493333333333334,1276900,56250000,54973100
835000.0,4,4.25,4930,25714,2.0,0,0,2,12,4930,0,2005,0.0,98092,47.3069,-122.148,3620,23035,20784,0.8082756475071945,24304900,661209796,636904896
420000.0,3,1.0,1150,5120,1.0,0,0,3,6,800,350,1946,0.0,98116,47.5588,-122.39200000000001,1220,5120,3970,0.775390625,1322500,26214400,24891900
925000.0,4,2.5,2190,7350,2.5,0,0,4,8,2190,0,1958,0.0,98040,47.5786,-122.236,1880,7350,5160,0.7020408163265306,4796100,54022500,49226400
389250.0,2,1.5,1490,4080,1.0,0,0,2,7,930,560,1956,0.0,98126,47.5344,-122.381,1320,4080,2590,0.6348039215686274,2220100,16646400,14426300
748000.0,3,2.5,2600,10183,1.0,0,0,2,8,1300,1300,2004,0.0,98033,47.6984,-122.20100000000001,1860,10401,7583,0.7446724933713051,6760000,103693489,96933489
284000.0,3,1.75,1530,9600,1.0,0,0,2,7,1200,330,1988,0.0,98042,47.3594,-122.07600000000001,1680,9680,8070,0.840625,2340900,92160000,89819100
588000.0,4,2.0,1680,5000,1.0,0,0,2,7,980,700,1950,0.0,98115,47.6858,-122.286,1680,6000,3320,0.664,2822400,25000000,22177600
372500.0,3,1.75,1680,8648,1.0,0,0,3,7,1680,0,1963,0.0,98133,47.7338,-122.33200000000001,1290,8147,6968,0.8057354301572618,2822400,74787904,71965504
285000.0,4,3.0,1900,7194,2.0,0,0,3,7,1900,0,1988,0.0,98042,47.3768,-122.117,1690,7194,5294,0.73589102029469,3610000,51753636,48143636
360000.0,3,1.0,1570,9467,1.0,0,0,2,7,1570,0,1954,0.0,98177,47.7683,-122.359,1570,9100,7897,0.8341607689870075,2464900,89624089,87159189
275000.0,3,1.0,1370,17859,1.0,0,0,3,7,1150,220,1930,0.0,98024,47.5617,-121.859,1460,47044,16489,0.9232879780502827,1876900,318943881,317066981
428000.0,2,2.0,1350,4225,1.0,0,0,2,8,1350,0,2003,0.0,98053,47.7106,-122.03,1660,4225,2875,0.6804733727810651,1822500,17850625,16028125
847000.0,6,2.5,3010,17864,2.0,0,0,2,8,3010,0,1969,0.0,98177,47.7209,-122.37200000000001,2560,11532,14854,0.8315047021943573,9060100,319122496,310062396
316000.0,3,1.0,1010,7838,1.0,0,0,3,6,1010,0,1977,0.0,98019,47.7422,-121.98100000000001,1380,8128,6828,0.8711405970910947,1020100,61434244,60414144
375000.0,3,2.5,2050,7205,2.0,0,0,2,8,2050,0,2000,0.0,98003,47.3487,-122.304,2050,7264,5155,0.7154753643303262,4202500,51912025,47709525
533000.0,3,1.0,1670,4080,1.0,0,0,2,7,1170,500,1967,0.0,98115,47.6899,-122.321,1560,4080,2410,0.5906862745098039,2788900,16646400,13857500
556000.0,5,2.5,3840,16905,2.0,0,0,2,11,3840,0,1991,0.0,98023,47.2996,-122.34200000000001,3270,12133,13065,0.7728482697426797,14745600,285779025,271033425
225000.0,4,2.0,2220,14120,1.0,0,0,2,7,1200,1020,1966,0.0,98042,47.361000000000004,-122.116,1300,9709,11900,0.8427762039660056,4928400,199374400,194446000
537250.0,4,2.5,2590,9530,1.0,0,0,3,8,1640,950,1978,0.0,98155,47.7752,-122.285,2710,10970,6940,0.7282266526757608,6708100,90820900,84112800
255000.0,3,1.0,1180,13650,1.0,0,0,3,7,1180,0,1967,0.0,98058,47.4551,-122.154,1460,11730,12470,0.9135531135531135,1392400,186322500,184930100
530000.0,4,2.5,2950,4836,2.0,0,0,2,7,2950,0,2006,0.0,98059,47.479,-122.12899999999999,2120,4750,1886,0.38999172870140614,8702500,23386896,14684396
5300000.0,6,6.0,7390,24829,2.0,1,0,3,12,5000,2390,1991,0.0,98040,47.5631,-122.21,4320,24619,17439,0.7023641709291554,54612100,616479241,561867141
595000.0,3,2.75,2150,31238,2.0,0,0,2,9,2150,0,1996,0.0,98014,47.6596,-121.96,2650,38307,29088,0.93117357065113,4622500,975812644,971190144
548000.0,4,2.0,2100,8880,1.0,0,0,3,7,2100,0,1958,0.0,98008,47.6115,-122.124,1280,9102,6780,0.7635135135135135,4410000,78854400,74444400
234975.0,3,1.75,1650,8073,1.0,0,0,2,7,1100,550,1980,0.0,98092,47.3187,-122.182,1280,8073,6423,0.7956150130063173,2722500,65173329,62450829
600000.0,3,1.75,1620,1325,2.5,0,0,2,9,1430,190,2005,0.0,98102,47.6498,-122.321,1750,1572,-295,-0.22264150943396227,2624400,1755625,-868775
432000.0,4,1.0,1750,12528,1.0,0,0,3,7,1750,0,1967,0.0,98072,47.743,-122.09700000000001,1550,14120,10778,0.8603128991060025,3062500,156950784,153888284
455000.0,3,1.5,1380,6657,2.0,0,0,2,7,1380,0,1986,0.0,98034,47.7085,-122.21700000000001,1420,8187,5277,0.7926994141505183,1904400,44315649,42411249
279950.0,3,1.75,1510,11234,1.0,0,0,2,7,1210,300,1965,0.0,98155,47.7571,-122.32799999999999,2080,9076,9724,0.8655866120705002,2280100,126202756,123922656
267500.0,3,1.5,1600,9072,1.0,0,0,3,7,1600,0,1963,0.0,98030,47.3737,-122.21600000000001,1710,8000,7472,0.8236331569664903,2560000,82301184,79741184
620000.0,4,2.5,1840,220308,2.0,0,0,2,8,1840,0,2000,0.0,98038,47.4306,-122.04899999999999,1890,65340,218468,0.9916480563574632,3385600,48535614864,48532229264
110000.0,2,1.0,830,7590,1.0,0,0,1,6,830,0,1943,0.0,98166,47.4784,-122.335,980,7590,6760,0.8906455862977603,688900,57608100,56919200
625000.0,3,3.5,1810,1846,2.0,0,0,3,8,1440,370,2009,0.0,98122,47.607,-122.305,1480,3600,36,0.01950162513542795,3276100,3407716,131616
389000.0,2,1.0,910,7000,1.0,0,0,2,7,910,0,1952,0.0,98115,47.6999,-122.305,1260,7528,6090,0.87,828100,49000000,48171900
1200000.0,4,2.0,2120,3360,2.0,0,0,2,9,2120,0,1905,0.0,98112,47.6227,-122.31,2090,3600,1240,0.36904761904761907,4494400,11289600,6795200
788500.0,4,2.25,2510,133729,2.0,0,0,3,8,2510,0,1977,0.0,98027,47.4569,-122.02,2510,69696,131219,0.98123069790397,6300100,17883445441,17877145341
567000.0,5,2.25,2100,6936,1.0,0,0,2,8,1600,500,1974,0.0,98033,47.6737,-122.169,2100,8661,4836,0.6972318339100346,4410000,48108096,43698096
515000.0,2,2.25,2690,15000,1.0,0,2,2,8,1870,820,1987,0.0,98023,47.3361,-122.353,2690,15000,12310,0.8206666666666667,7236100,225000000,217763900
605000.0,4,2.5,2430,11870,1.0,0,0,4,8,1590,840,1968,0.0,98155,47.7761,-122.285,2430,9600,9440,0.7952822240943556,5904900,140896900,134992000
430000.0,4,3.75,2452,4800,2.0,0,0,2,7,2452,0,1936,1994.0,98055,47.4744,-122.213,1180,4800,2348,0.4891666666666667,6012304,23040000,17027696
805000.0,2,1.75,1550,6000,1.0,0,1,2,7,1550,0,1920,0.0,98199,47.6712,-122.40899999999999,2360,6000,4450,0.7416666666666667,2402500,36000000,33597500
567500.0,3,2.5,2080,4556,2.0,0,0,2,8,2080,0,1999,0.0,98074,47.6036,-122.014,1530,5606,2476,0.543459174714662,4326400,20757136,16430736
647500.0,3,1.75,1290,3870,1.0,0,0,4,7,1290,0,1916,0.0,98144,47.5873,-122.29,2020,5850,2580,0.6666666666666666,1664100,14976900,13312800
495000.0,2,1.75,1850,2530,2.5,0,0,3,7,1850,0,1903,0.0,98122,47.6106,-122.31,1500,1795,680,0.26877470355731226,3422500,6400900,2978400
825000.0,4,2.5,3370,5000,2.0,0,0,2,9,3370,0,2006,0.0,98027,47.541000000000004,-121.99799999999999,3370,5237,1630,0.326,11356900,25000000,13643100
435000.0,4,2.25,2730,7506,2.0,0,0,3,8,2730,0,1987,0.0,98058,47.4627,-122.152,2390,8015,4776,0.636290967226219,7452900,56340036,48887136
445950.0,3,1.75,1300,7800,1.0,0,0,4,7,1300,0,1968,0.0,98034,47.7321,-122.195,1520,7344,6500,0.8333333333333334,1690000,60840000,59150000
960000.0,5,2.75,3040,10257,2.0,0,0,2,10,3040,0,1993,0.0,98006,47.5531,-122.119,2860,9327,7217,0.7036170420200838,9241600,105206049,95964449
780000.0,4,3.0,2440,3600,1.5,0,0,4,8,1480,960,1929,0.0,98103,47.6853,-122.331,1770,4000,1160,0.32222222222222224,5953600,12960000,7006400
274500.0,3,2.25,1720,9000,1.0,0,0,3,8,1320,400,1969,0.0,98023,47.3191,-122.383,1930,8000,7280,0.8088888888888889,2958400,81000000,78041600
729953.0,5,3.0,3230,5167,1.5,0,0,3,8,2000,1230,1909,0.0,98133,47.7053,-122.34,1509,1626,1937,0.3748790400619315,10432900,26697889,16264989
464950.0,3,1.5,1200,890,2.0,0,0,2,8,1030,170,2008,0.0,98109,47.6384,-122.34200000000001,1230,2120,-310,-0.34831460674157305,1440000,792100,-647900
620000.0,4,1.75,2350,18800,1.0,0,2,2,8,2350,0,1959,0.0,98005,47.5904,-122.177,3050,14640,16450,0.875,5522500,353440000,347917500
735000.0,4,3.5,3100,5600,2.0,0,0,2,9,3100,0,2005,0.0,98075,47.5968,-121.978,3080,5600,2500,0.44642857142857145,9610000,31360000,21750000
450000.0,4,2.25,2040,9565,1.0,0,0,2,8,1400,640,1959,0.0,98133,47.7356,-122.335,1890,8580,7525,0.7867224255096706,4161600,91489225,87327625
450000.0,4,1.0,2000,4676,1.5,0,0,2,7,1250,750,1916,1986.0,98118,47.5529,-122.26799999999999,1140,4676,2676,0.572284003421728,4000000,21864976,17864976
842500.0,4,2.5,2160,5298,2.5,0,0,3,9,2160,0,1902,0.0,98122,47.6106,-122.31,1720,2283,3138,0.5922989807474519,4665600,28068804,23403204
360000.0,3,2.0,1970,79714,1.0,0,0,2,7,1070,900,1979,0.0,98058,47.4674,-122.10700000000001,1890,36626,77744,0.9752866497729382,3880900,6354321796,6350440896
585000.0,3,2.5,2270,100545,2.0,0,0,2,8,2270,0,1998,0.0,98070,47.4815,-122.47,1277,100545,98275,0.9774230444079766,5152900,10109297025,10104144125
461000.0,3,2.25,1850,7923,1.0,0,0,3,7,1150,700,1977,0.0,98033,47.7011,-122.171,1780,7420,6073,0.7665025874037612,3422500,62773929,59351429
345000.0,2,1.0,1350,4494,1.0,0,0,2,7,920,430,1949,0.0,98126,47.5315,-122.38,1470,5225,3144,0.6995994659546061,1822500,20196036,18373536
1080000.0,3,2.5,3280,10302,1.0,0,0,2,10,1680,1600,1970,0.0,98115,47.6948,-122.286,1550,6300,7022,0.681615220345564,10758400,106131204,95372804
643000.0,4,2.5,2270,8391,2.0,0,0,2,8,2270,0,1988,0.0,98029,47.574,-122.01299999999999,2420,8391,6121,0.7294720533905374,5152900,70408881,65255981
690000.0,4,2.5,2820,8307,2.0,0,0,2,9,2820,0,1990,0.0,98074,47.6253,-122.027,2820,8307,5487,0.6605272661610689,7952400,69006249,61053849
282000.0,4,1.0,1200,11111,1.5,0,0,2,7,1200,0,1949,0.0,98155,47.7529,-122.306,1350,9113,9911,0.8919989199891999,1440000,123454321,122014321
549000.0,3,1.75,2000,6130,1.0,0,0,3,8,1120,880,1951,0.0,98117,47.6925,-122.38799999999999,2140,7150,4130,0.6737357259380098,4000000,37576900,33576900
815000.0,3,2.0,2310,6000,2.0,0,1,3,9,1560,750,1926,0.0,98199,47.648,-122.395,2000,6000,3690,0.615,5336100,36000000,30663900
2200000.0,5,4.25,4640,22703,2.0,1,4,4,8,2860,1780,1952,0.0,98052,47.6393,-122.09700000000001,3140,14200,18063,0.7956217240012333,21529600,515426209,493896609
700000.0,3,2.25,2330,11424,2.0,0,0,3,8,2330,0,1984,0.0,98052,47.6386,-122.11,2050,11448,9094,0.7960434173669467,5428900,130507776,125078876
933399.0,3,2.5,3940,10360,2.0,0,0,2,9,3110,830,1992,0.0,98052,47.6468,-122.116,2720,11941,6420,0.6196911196911197,15523600,107329600,91806000
290000.0,3,1.0,1440,11250,1.0,0,0,2,7,1440,0,1967,0.0,98055,47.4627,-122.213,2200,11250,9810,0.872,2073600,126562500,124488900
372000.0,4,1.75,1960,9300,1.0,0,0,4,7,1340,620,1979,0.0,98045,47.4487,-121.772,1500,9752,7340,0.789247311827957,3841600,86490000,82648400
450000.0,2,1.75,1250,2890,1.0,0,0,3,7,790,460,1920,0.0,98103,47.6795,-122.353,1500,3225,1640,0.5674740484429066,1562500,8352100,6789600
303700.0,3,2.5,1981,5700,2.0,0,0,2,8,1981,0,2010,0.0,98030,47.3668,-122.178,1981,5894,3719,0.6524561403508772,3924361,32490000,28565639
672000.0,4,2.5,2440,10049,2.0,0,0,3,9,2440,0,1989,0.0,98029,47.5744,-121.993,2820,8484,7609,0.7571897701263808,5953600,100982401,95028801
334000.0,4,1.5,1150,9360,1.5,0,0,2,6,1150,0,1970,0.0,98034,47.7197,-122.17299999999999,1480,8155,8210,0.8771367521367521,1322500,87609600,86287100
260000.0,2,1.0,1120,5650,1.0,0,0,2,6,1120,0,1944,0.0,98178,47.4979,-122.241,1270,6875,4530,0.8017699115044248,1254400,31922500,30668100
749950.0,3,1.75,1800,5700,1.0,0,0,3,8,1000,800,1941,0.0,98119,47.6491,-122.367,1680,5350,3900,0.6842105263157895,3240000,32490000,29250000
330000.0,4,2.25,2380,122038,2.0,0,0,3,8,2380,0,1984,0.0,98022,47.2624,-122.015,2030,48000,119658,0.9804978777102215,5664400,14893273444,14887609044
830000.0,5,3.0,2920,2808,2.0,0,0,2,8,2140,780,1960,0.0,98103,47.653999999999996,-122.34200000000001,1620,1544,-112,-0.039886039886039885,8526400,7884864,-641536
1130000.0,3,2.25,2790,13791,1.0,0,3,2,8,2790,0,2006,0.0,98166,47.4389,-122.351,2720,12600,11001,0.7976941483576245,7784100,190191681,182407581
320000.0,3,1.0,1560,7552,1.0,0,0,3,6,910,650,1948,0.0,98155,47.7552,-122.32700000000001,1200,8152,5992,0.7934322033898306,2433600,57032704,54599104
260000.0,2,1.0,1550,15250,1.5,0,0,4,7,1550,0,1920,0.0,98038,47.407,-122.045,1520,34929,13700,0.898360655737705,2402500,232562500,230160000
225000.0,3,2.0,1700,11475,1.0,0,0,4,6,970,730,1945,0.0,98146,47.4851,-122.338,1560,11475,9775,0.8518518518518519,2890000,131675625,128785625
279200.0,1,1.0,640,6350,1.0,0,0,2,5,640,0,1939,0.0,98117,47.6976,-122.359,1270,6350,5710,0.8992125984251969,409600,40322500,39912900
520000.0,4,3.5,2680,10000,2.0,0,0,2,8,2040,640,1942,2014.0,98125,47.726000000000006,-122.296,1530,8000,7320,0.732,7182400,100000000,92817600
505000.0,3,2.5,1860,8060,2.0,0,0,3,8,1860,0,1987,0.0,98029,47.5674,-122.01700000000001,1850,4661,6200,0.7692307692307693,3459600,64963600,61504000
234000.0,3,1.75,1490,8366,1.0,0,0,3,7,1010,480,1975,0.0,98042,47.375,-122.14,1490,7469,6876,0.8218981592158737,2220100,69989956,67769856
503000.0,4,2.5,2470,5044,2.0,0,0,2,9,2470,0,2005,0.0,98155,47.7728,-122.271,2790,5583,2574,0.5103092783505154,6100900,25441936,19341036
606000.0,4,2.25,2390,8858,1.0,0,0,3,8,1740,650,1979,0.0,98033,47.6925,-122.184,2240,8858,6468,0.7301874012192369,5712100,78464164,72752064
433500.0,3,1.0,1230,6000,1.0,0,0,3,7,780,450,1937,0.0,98115,47.6839,-122.281,1570,5000,4770,0.795,1512900,36000000,34487100
250000.0,3,1.5,2840,10182,1.0,0,0,2,8,1510,1330,1951,0.0,98056,47.523999999999994,-122.2,2210,9669,7342,0.7210764093498331,8065600,103673124,95607524
719000.0,3,2.5,2120,9307,2.0,0,0,3,9,2120,0,1984,0.0,98006,47.5477,-122.141,2290,11524,7187,0.772214462232728,4494400,86620249,82125849
381000.0,3,2.0,1770,14400,1.0,0,0,3,8,1770,0,1959,0.0,98166,47.415,-122.337,1900,14400,12630,0.8770833333333333,3132900,207360000,204227100
267000.0,3,2.5,2495,4400,2.0,0,0,2,8,2495,0,2007,0.0,98001,47.288000000000004,-122.28299999999999,2434,4400,1905,0.4329545454545455,6225025,19360000,13134975
275000.0,1,0.75,1170,14149,1.0,0,0,4,7,880,290,1962,0.0,98022,47.2653,-121.91,1130,24513,12979,0.9173086437204042,1368900,200194201,198825301
651000.0,4,2.5,2740,7140,2.0,0,0,2,8,2740,0,1993,0.0,98074,47.6334,-122.021,2260,7035,4400,0.6162464985994398,7507600,50979600,43472000
439000.0,2,1.0,1050,5671,1.0,0,0,2,7,850,200,1949,0.0,98115,47.6767,-122.286,1850,5243,4621,0.8148474695820843,1102500,32160241,31057741
325000.0,2,1.0,1130,5070,1.0,0,0,3,7,1130,0,1955,0.0,98146,47.5141,-122.37700000000001,860,6300,3940,0.777120315581854,1276900,25704900,24428000
490000.0,2,1.0,880,6380,1.0,0,0,2,7,880,0,1938,1994.0,98115,47.6924,-122.322,1340,6380,5500,0.8620689655172413,774400,40704400,39930000
519900.0,4,2.5,2403,6172,2.0,0,0,2,9,2403,0,1999,0.0,98028,47.7361,-122.234,2380,6075,3769,0.6106610499027868,5774409,38093584,32319175
545000.0,4,2.75,3410,35040,2.0,0,0,2,9,3410,0,1984,0.0,98038,47.4054,-122.03,2580,37263,31630,0.9026826484018264,11628100,1227801600,1216173500
1060000.0,4,4.0,5320,20041,2.0,0,0,2,11,5320,0,2003,0.0,98075,47.5852,-121.96600000000001,4640,17268,14721,0.734544184421935,28302400,401641681,373339281
542000.0,4,1.75,1900,8250,1.0,0,0,3,7,950,950,1955,0.0,98006,47.5765,-122.147,1480,8360,6350,0.7696969696969697,3610000,68062500,64452500
465000.0,4,1.75,1810,21650,2.0,0,0,3,7,1810,0,1961,0.0,98077,47.7358,-122.07600000000001,2700,29680,19840,0.9163972286374134,3276100,468722500,465446400
408000.0,2,2.0,1200,3900,1.0,0,0,2,8,1200,0,2006,0.0,98053,47.72,-122.024,1440,5580,2700,0.6923076923076923,1440000,15210000,13770000
292000.0,4,2.5,2060,5950,2.0,0,0,2,8,2060,0,2000,0.0,98030,47.3631,-122.19200000000001,2242,6406,3890,0.653781512605042,4243600,35402500,31158900
253000.0,3,1.75,1250,10122,1.0,0,0,2,7,1250,0,1994,0.0,98010,47.3277,-122.001,1980,10175,8872,0.8765066192452085,1562500,102454884,100892384
280000.0,2,1.0,910,4662,1.0,0,0,4,6,910,0,1942,0.0,98106,47.5232,-122.354,890,6050,3752,0.8048048048048048,828100,21734244,20906144
658588.0,3,2.25,2560,41346,2.0,0,0,2,10,2560,0,1986,0.0,98027,47.4871,-122.065,3040,35395,38786,0.9380834905432206,6553600,1709491716,1702938116
635000.0,4,2.25,1920,8910,1.0,0,0,3,8,1200,720,1969,0.0,98005,47.5897,-122.156,2250,8800,6990,0.7845117845117845,3686400,79388100,75701700
439000.0,4,2.25,2240,8300,2.0,0,0,2,8,2240,0,1978,0.0,98011,47.7746,-122.197,2340,8500,6060,0.7301204819277108,5017600,68890000,63872400
300000.0,3,2.5,1260,3855,2.0,0,0,2,8,1260,0,1999,0.0,98059,47.4908,-122.154,1310,3344,2595,0.6731517509727627,1587600,14861025,13273425
345000.0,3,1.5,1360,13496,1.0,0,0,3,8,1360,0,1960,0.0,98198,47.4032,-122.314,1900,10538,12136,0.8992294013040901,1849600,182142016,180292416
283500.0,4,2.25,2100,8050,2.0,0,0,2,8,2100,0,1978,0.0,98055,47.4391,-122.193,2190,7700,5950,0.7391304347826086,4410000,64802500,60392500
425000.0,2,1.0,2110,4920,1.5,0,0,2,7,1460,650,1911,0.0,98103,47.6872,-122.339,1390,4732,2810,0.5711382113821138,4452100,24206400,19754300
685000.0,3,1.75,2210,8955,1.0,0,1,2,8,1560,650,1974,0.0,98033,47.6621,-122.189,2210,8976,6745,0.7532104969290899,4884100,80192025,75307925
750000.0,3,2.5,2360,12987,2.0,0,0,2,8,2360,0,1983,0.0,98006,47.5471,-122.149,2480,11665,10627,0.8182798182798183,5569600,168662169,163092569
245000.0,4,1.5,1280,8000,1.0,0,0,2,6,1280,0,1960,0.0,98178,47.4949,-122.255,1420,8211,6720,0.84,1638400,64000000,62361600
585444.0,6,3.75,2740,6924,1.0,0,2,2,7,1640,1100,1962,0.0,98144,47.5816,-122.296,1940,6000,4184,0.6042749855574813,7507600,47941776,40434176
706000.0,4,2.5,2740,7571,2.0,0,0,2,9,2740,0,2009,0.0,98033,47.6962,-122.179,2880,7203,4831,0.6380927222295601,7507600,57320041,49812441
445000.0,4,2.0,2630,9099,1.5,0,0,2,7,1830,800,1944,0.0,98146,47.5067,-122.361,1430,6825,6469,0.7109572480492362,6916900,82791801,75874901
241000.0,3,2.0,1650,6000,1.0,0,0,2,7,1650,0,1990,0.0,98023,47.2904,-122.353,1870,6000,4350,0.725,2722500,36000000,33277500
1180000.0,2,2.5,1770,7155,2.0,1,4,2,8,1770,0,1957,0.0,98155,47.7345,-122.285,2410,10476,5385,0.7526205450733753,3132900,51194025,48061125
530000.0,3,1.0,1500,5750,1.5,0,0,3,7,1050,450,1927,0.0,98126,47.5677,-122.376,1500,5060,4250,0.7391304347826086,2250000,33062500,30812500
350000.0,3,1.5,1430,12199,1.0,0,0,2,7,1130,300,1948,0.0,98133,47.7352,-122.33,1490,8196,10769,0.8827772768259693,2044900,148815601,146770701
1700000.0,4,3.75,3190,17186,2.0,1,4,2,10,3190,0,1999,0.0,98178,47.5115,-122.24600000000001,2290,13496,13996,0.814383800768067,10176100,295358596,285182496
389000.0,3,1.0,1280,9630,1.0,0,0,2,7,1280,0,1968,0.0,98072,47.7677,-122.163,1300,9453,8350,0.8670820353063343,1638400,92736900,91098500
799000.0,4,2.75,2390,6820,2.0,0,0,3,7,2140,250,1945,0.0,98115,47.6788,-122.27,1980,6820,4430,0.6495601173020528,5712100,46512400,40800300
1400000.0,4,2.5,4040,9630,1.0,0,3,3,9,2020,2020,1951,0.0,98199,47.6408,-122.41,3160,8025,5590,0.5804776739356179,16321600,92736900,76415300
340895.0,2,1.0,920,8612,1.0,0,0,4,7,920,0,1947,0.0,98155,47.733999999999995,-122.301,1500,7956,7692,0.8931723176962378,846400,74166544,73320144
780000.0,4,2.5,2730,10281,2.0,0,2,2,9,2730,0,1996,0.0,98074,47.6227,-122.029,2750,7220,7551,0.7344616282462796,7452900,105698961,98246061
350000.0,2,1.5,1320,73600,1.0,0,0,2,7,1320,0,1993,0.0,98001,47.2755,-122.271,1320,33600,72280,0.9820652173913044,1742400,5416960000,5415217600
470000.0,3,2.5,2620,4874,2.0,0,0,2,7,2620,0,1999,0.0,98065,47.5328,-121.87899999999999,2360,4231,2254,0.4624538366844481,6864400,23755876,16891476
914600.0,4,3.0,3180,80837,2.0,0,0,2,11,3180,0,1985,0.0,98072,47.7336,-122.134,3180,38715,77657,0.9606615782376882,10112400,6534620569,6524508169
354000.0,4,2.5,2900,4762,2.0,0,0,2,8,2900,0,2005,0.0,98042,47.3663,-122.12899999999999,2900,5173,1862,0.3910121797564049,8410000,22676644,14266644
470000.0,5,2.0,1900,6000,1.5,0,0,3,6,1900,0,1920,0.0,98033,47.6831,-122.186,2110,8400,4100,0.6833333333333333,3610000,36000000,32390000
715000.0,3,2.0,1760,5400,1.0,0,0,4,7,1160,600,1927,0.0,98103,47.6558,-122.331,1640,5400,3640,0.674074074074074,3097600,29160000,26062400
265000.0,2,1.0,760,4000,1.0,0,0,3,6,760,0,1950,0.0,98108,47.5466,-122.304,1640,4500,3240,0.81,577600,16000000,15422400
2540000.0,4,3.0,3710,20000,2.0,0,2,4,10,2760,950,1936,0.0,98105,47.6696,-122.26100000000001,3970,20000,16290,0.8145,13764100,400000000,386235900
640000.0,3,1.0,1530,4944,1.0,0,0,2,7,1530,0,1950,0.0,98103,47.6857,-122.34100000000001,1500,4944,3414,0.6905339805825242,2340900,24443136,22102236
290000.0,4,1.75,1990,18900,2.0,0,0,3,7,1870,120,1929,0.0,98168,47.5131,-122.31299999999999,1710,12400,16910,0.8947089947089947,3960100,357210000,353249900
480000.0,5,4.75,3830,35000,1.0,0,0,2,8,2130,1700,1976,0.0,98077,47.7597,-122.079,2750,36150,31170,0.8905714285714286,14668900,1225000000,1210331100
535000.0,3,2.0,2040,5600,1.0,0,1,4,7,1120,920,1954,0.0,98144,47.5959,-122.29299999999999,2120,4958,3560,0.6357142857142857,4161600,31360000,27198400
907000.0,3,1.75,2170,12220,1.0,0,0,4,8,2170,0,1965,0.0,98033,47.6537,-122.195,1980,9000,10050,0.8224222585924713,4708900,149328400,144619500
459000.0,3,1.75,1620,7330,1.0,0,0,3,7,1090,530,1974,0.0,98034,47.7148,-122.213,1380,7191,5710,0.7789904502046384,2624400,53728900,51104500
1360000.0,3,2.5,3600,21399,1.0,0,3,2,9,2310,1290,1950,2007.0,98008,47.6191,-122.09899999999999,2830,17559,17799,0.8317678396186737,12960000,457917201,444957201
264950.0,3,1.5,1470,11599,1.0,0,0,2,7,1070,400,1967,0.0,98030,47.3632,-122.18799999999999,1580,9760,10129,0.8732649366324683,2160900,134536801,132375901
352950.0,3,1.0,1760,3000,1.5,0,0,0,6,1760,0,1900,0.0,98103,47.6598,-122.348,1320,1266,1240,0.41333333333333333,3097600,9000000,5902400
491500.0,3,2.25,2230,13100,1.0,0,0,3,8,1510,720,1974,0.0,98006,47.5413,-122.17399999999999,2010,10650,10870,0.8297709923664122,4972900,171610000,166637100
1230000.0,4,3.5,3770,37034,2.0,0,0,2,10,2830,940,1989,0.0,98007,47.6463,-122.15100000000001,3200,36342,33264,0.8982016525355079,14212900,1371517156,1357304256
369500.0,3,1.0,1200,9194,1.0,0,0,3,7,1200,0,1952,0.0,98155,47.7362,-122.319,1330,8650,7994,0.8694800957145965,1440000,84529636,83089636
566000.0,3,2.5,2090,6294,2.0,0,0,2,9,2090,0,2004,0.0,98052,47.68600000000001,-122.095,2520,5735,4204,0.6679377184620273,4368100,39614436,35246336
290000.0,3,2.25,1500,7308,1.0,0,0,3,7,1210,290,1968,0.0,98055,47.4621,-122.18700000000001,1480,7400,5808,0.7947454844006568,2250000,53406864,51156864
5350000.0,5,5.0,8000,23985,2.0,0,4,2,12,6720,1280,2009,0.0,98004,47.6232,-122.22,4600,21750,15985,0.6664582030435688,64000000,575280225,511280225
180000.0,3,1.0,870,5330,1.0,0,0,2,6,870,0,1969,0.0,98042,47.369,-122.07700000000001,840,5200,4460,0.8367729831144465,756900,28408900,27652000
215000.0,2,1.0,1010,6000,1.0,0,0,3,6,1010,0,1944,0.0,98133,47.771,-122.353,1610,7313,4990,0.8316666666666667,1020100,36000000,34979900
302000.0,2,1.0,1010,6000,1.0,0,0,3,6,1010,0,1944,0.0,98133,47.771,-122.353,1610,7313,4990,0.8316666666666667,1020100,36000000,34979900
352500.0,3,1.75,1860,7881,1.0,0,0,2,7,1160,700,1986,0.0,98198,47.3855,-122.322,1490,7527,6021,0.7639893414541302,3459600,62110161,58650561
235867.0,4,2.0,1330,5926,1.0,0,0,3,5,1330,0,1942,0.0,98056,47.496,-122.19,1150,5485,4596,0.7755653054336821,1768900,35117476,33348576
500000.0,3,2.25,1760,11946,2.0,0,0,2,8,1760,0,1978,0.0,98074,47.623999999999995,-122.05,2080,12068,10186,0.852670349907919,3097600,142706916,139609316
382000.0,3,2.25,1800,4500,2.0,0,0,2,7,1800,0,1995,0.0,98019,47.7462,-121.98,1760,6589,2700,0.6,3240000,20250000,17010000
515000.0,5,2.5,1690,2402,1.5,0,0,2,7,990,700,1930,0.0,98117,47.6903,-122.38,1200,4005,712,0.2964196502914238,2856100,5769604,2913504
250000.0,1,1.0,660,2600,1.0,0,0,2,6,660,0,1919,0.0,98144,47.5723,-122.304,1560,5445,1940,0.7461538461538462,435600,6760000,6324400
672500.0,3,2.25,2400,5300,1.5,0,0,3,7,1250,1150,1939,0.0,98117,47.6876,-122.384,1540,4800,2900,0.5471698113207547,5760000,28090000,22330000
755000.0,3,2.25,3020,13031,2.0,0,0,2,9,3020,0,1989,0.0,98052,47.6897,-122.098,2480,10204,10011,0.7682449543396516,9120400,169806961,160686561
707500.0,3,1.0,1500,2555,2.0,0,2,2,7,1500,0,1910,0.0,98109,47.626999999999995,-122.353,1820,2555,1055,0.41291585127201563,2250000,6528025,4278025
459000.0,4,2.0,1560,3840,1.0,0,0,3,6,960,600,1924,0.0,98117,47.6882,-122.365,1560,4800,2280,0.59375,2433600,14745600,12312000
140000.0,3,1.0,1090,10620,1.5,0,0,2,7,1090,0,1959,0.0,98032,47.3748,-122.294,1380,10620,9530,0.8973634651600754,1188100,112784400,111596300
495000.0,2,1.0,970,4284,1.0,0,0,2,7,970,0,1905,0.0,98103,47.6667,-122.333,2050,4284,3314,0.7735760971055089,940900,18352656,17411756
757000.0,3,3.25,3190,5283,2.0,0,0,2,9,3190,0,2007,0.0,98029,47.5534,-122.00200000000001,2950,5198,2093,0.39617641491576755,10176100,27910089,17733989
765000.0,3,3.25,3190,5283,2.0,0,0,2,9,3190,0,2007,0.0,98029,47.5534,-122.00200000000001,2950,5198,2093,0.39617641491576755,10176100,27910089,17733989
359000.0,4,1.5,1890,6052,1.0,0,0,3,7,1890,0,1955,0.0,98125,47.7055,-122.3,1510,6072,4162,0.6877065432914738,3572100,36626704,33054604
440000.0,3,1.0,1050,7500,1.0,0,0,2,6,1050,0,1900,0.0,98136,47.5473,-122.396,1380,7500,6450,0.86,1102500,56250000,55147500
400000.0,4,1.5,1390,7200,1.0,0,0,2,7,1140,250,1965,0.0,98133,47.7224,-122.33200000000001,1630,7702,5810,0.8069444444444445,1932100,51840000,49907900
652000.0,3,2.0,1700,4080,1.0,0,0,3,7,850,850,1941,0.0,98117,47.6785,-122.39299999999999,1480,5100,2380,0.5833333333333334,2890000,16646400,13756400
260000.0,3,1.75,1050,5850,1.0,0,0,2,7,1050,0,1980,0.0,98166,47.4574,-122.35799999999999,1220,8880,4800,0.8205128205128205,1102500,34222500,33120000
1330000.0,5,3.0,3340,10796,1.0,0,2,2,9,2120,1220,1964,1990.0,98040,47.5421,-122.229,3290,12955,7456,0.6906261578362356,11155600,116553616,105398016
519500.0,4,2.0,1540,17859,1.0,0,0,2,6,1540,0,1964,0.0,98027,47.5326,-122.03200000000001,1390,9688,16319,0.9137689680273252,2371600,318943881,316572281
650000.0,3,1.0,1710,5992,1.5,0,0,3,7,1560,150,1928,0.0,98103,47.6861,-122.354,1240,3001,4282,0.7146194926568759,2924100,35904064,32979964
280000.0,4,2.25,2100,8075,2.0,0,0,2,8,2100,0,1978,0.0,98003,47.3251,-122.329,2100,7464,5975,0.739938080495356,4410000,65205625,60795625
515000.0,4,1.75,1730,7980,1.0,0,0,3,8,1730,0,1965,0.0,98007,47.6219,-122.13799999999999,2080,8400,6250,0.7832080200501254,2992900,63680400,60687500
400000.0,3,2.25,1500,2692,2.0,0,0,2,7,1500,0,1986,0.0,98034,47.7159,-122.20299999999999,1470,2418,1192,0.4427934621099554,2250000,7246864,4996864
652100.0,3,2.5,2380,5017,2.0,0,0,2,9,2380,0,2003,0.0,98074,47.6297,-122.021,2670,6066,2637,0.5256129160853099,5664400,25170289,19505889
235000.0,6,3.0,2180,7956,2.0,0,0,2,7,2180,0,1980,0.0,98003,47.3054,-122.305,2214,7684,5776,0.7259929612870789,4752400,63297936,58545536
701000.0,4,1.5,1840,10080,2.0,0,0,2,8,1840,0,1907,0.0,98118,47.5575,-122.279,1830,5040,8240,0.8174603174603174,3385600,101606400,98220800
640000.0,4,2.5,2341,9594,2.0,0,0,2,9,2341,0,1997,0.0,98052,47.6993,-122.115,2850,9421,7253,0.7559933291640609,5480281,92044836,86564555
455800.0,3,2.5,1690,4584,2.0,0,0,2,7,1690,0,2002,0.0,98053,47.6866,-122.04299999999999,1600,3164,2894,0.631326352530541,2856100,21013056,18156956
504750.0,3,2.5,2490,21937,2.0,0,0,2,8,2490,0,1993,0.0,98014,47.6442,-121.898,2450,21937,19447,0.8864931394447737,6200100,481231969,475031869
483000.0,3,3.0,2440,15540,2.0,0,0,2,9,2440,0,1992,0.0,98074,47.6104,-122.06,2440,15283,13100,0.842985842985843,5953600,241491600,235538000
530000.0,3,0.75,920,20412,1.0,0,2,4,6,920,0,1950,0.0,98070,47.4781,-122.49,1162,54705,19492,0.9549284734469919,846400,416649744,415803344
250000.0,2,1.0,1030,8786,1.0,0,0,2,6,1030,0,1956,0.0,98146,47.4814,-122.34100000000001,1480,8121,7756,0.8827680400637378,1060900,77193796,76132896
229950.0,5,2.75,2000,5885,1.0,0,0,2,7,1260,740,1994,0.0,98023,47.3155,-122.34700000000001,1960,6514,3885,0.6601529311809685,4000000,34633225,30633225
884744.0,4,3.5,4210,9414,2.0,0,0,2,9,4210,0,2001,0.0,98074,47.6067,-122.022,3950,8880,5204,0.5527937114935203,17724100,88623396,70899296
514000.0,3,1.5,1610,9964,1.0,0,0,2,7,1080,530,1977,0.0,98052,47.6681,-122.14299999999999,1610,9964,8354,0.8384183059012444,2592100,99281296,96689196
532000.0,3,2.25,1910,35015,1.0,0,0,3,8,1430,480,1977,0.0,98027,47.4672,-122.006,2340,36680,33105,0.9454519491646437,3648100,1226050225,1222402125
423000.0,4,2.5,2660,5539,2.0,0,0,2,8,2660,0,2004,0.0,98059,47.4981,-122.162,2380,5539,2879,0.5197689113558404,7075600,30680521,23604921
420000.0,2,1.0,820,4025,1.0,0,2,4,6,820,0,1922,0.0,98126,47.5649,-122.38,1410,5750,3205,0.7962732919254658,672400,16200625,15528225
521000.0,3,1.75,1730,18250,1.0,0,0,2,8,1730,0,1988,0.0,98011,47.736999999999995,-122.20100000000001,2180,10027,16520,0.9052054794520548,2992900,333062500,330069600
577000.0,4,2.25,2360,7490,2.0,0,0,2,8,2360,0,1979,0.0,98033,47.6988,-122.169,2360,7490,5130,0.684913217623498,5569600,56100100,50530500
425000.0,3,1.0,970,8040,1.0,0,0,2,7,970,0,1956,0.0,98007,47.603,-122.132,1250,7000,7070,0.8793532338308457,940900,64641600,63700700
495000.0,4,2.5,2460,4862,2.0,0,0,2,8,2460,0,2004,0.0,98028,47.7719,-122.235,2900,4895,2402,0.49403537638831757,6051600,23639044,17587444
340000.0,3,2.5,2690,8577,2.0,0,0,2,9,2690,0,1987,0.0,98023,47.3026,-122.351,2570,8066,5887,0.6863705258248805,7236100,73564929,66328829
499950.0,3,3.5,1820,1991,2.0,0,0,2,8,1430,390,2014,0.0,98144,47.596000000000004,-122.29799999999999,1550,1460,171,0.08588648920140633,3312400,3964081,651681
1220000.0,4,3.0,3470,4750,2.0,0,2,2,9,2370,1100,2014,0.0,98116,47.5917,-122.38600000000001,2420,4761,1280,0.2694736842105263,12040900,22562500,10521600
720000.0,4,2.75,3370,7634,1.0,0,2,4,8,2110,1260,1977,0.0,98056,47.5259,-122.204,2460,7634,4264,0.558553838092743,11356900,58277956,46921056
249000.0,3,1.5,1700,8247,1.0,0,0,2,7,1010,690,1970,0.0,98031,47.4216,-122.17399999999999,1440,8400,6547,0.7938644355523221,2890000,68013009,65123009
206135.0,3,1.0,1340,11070,1.0,0,0,3,7,1340,0,1978,0.0,98030,47.3527,-122.178,1650,7630,9730,0.8789521228545619,1795600,122544900,120749300
300000.0,5,2.75,2000,9276,2.0,0,0,3,7,2000,0,1968,0.0,98055,47.443999999999996,-122.19,1240,8270,7276,0.784389823199655,4000000,86044176,82044176
612000.0,6,3.0,3840,14040,1.5,0,3,2,8,2460,1380,1949,0.0,98178,47.506,-122.241,2170,6765,10200,0.7264957264957265,14745600,197121600,182376000
1100000.0,5,2.5,3890,27311,2.0,0,2,2,10,3890,0,1950,1990.0,98177,47.7291,-122.363,3160,22641,23421,0.8575665482772509,15132100,745890721,730758621
230000.0,4,2.0,1220,9100,1.5,0,0,3,7,1220,0,1970,0.0,98023,47.2964,-122.376,1160,7700,7880,0.865934065934066,1488400,82810000,81321600
850000.0,3,1.0,2280,4600,1.0,0,2,2,8,1250,1030,1936,0.0,98119,47.6378,-122.37200000000001,1910,4000,2320,0.5043478260869565,5198400,21160000,15961600
355000.0,4,2.5,2770,7000,1.0,0,0,3,7,1940,830,1979,0.0,98001,47.3396,-122.256,2140,7684,4230,0.6042857142857143,7672900,49000000,41327100
442000.0,4,2.5,2520,7253,2.0,0,0,2,9,2520,0,1990,0.0,98059,47.5148,-122.15899999999999,2570,8359,4733,0.6525575623879774,6350400,52606009,46255609
399000.0,4,3.0,3060,5000,2.0,0,0,2,8,3060,0,2001,0.0,98042,47.3786,-122.126,3060,5668,1940,0.388,9363600,25000000,15636400
360000.0,4,2.5,2390,7115,2.0,0,0,2,9,2390,0,1999,0.0,98092,47.2593,-122.22200000000001,2600,7916,4725,0.6640899508081518,5712100,50623225,44911125
390000.0,3,1.75,1320,7725,1.0,0,0,2,8,1320,0,1978,0.0,98058,47.4425,-122.133,2020,7210,6405,0.829126213592233,1742400,59675625,57933225
413000.0,5,2.5,2900,8711,1.0,0,0,2,8,1650,1250,1977,0.0,98011,47.7752,-122.197,2340,8869,5811,0.6670875904029389,8410000,75881521,67471521
190000.0,2,1.0,700,9500,1.0,0,0,2,6,700,0,1951,0.0,98118,47.5294,-122.27600000000001,1020,5617,8800,0.9263157894736842,490000,90250000,89760000
432900.0,3,2.5,2210,9226,2.0,0,0,2,8,2210,0,1998,0.0,98045,47.4849,-121.78200000000001,2430,8902,7016,0.7604595707782354,4884100,85119076,80234976
621138.0,3,2.25,2180,7741,2.0,0,0,2,9,2180,0,1986,0.0,98074,47.6482,-122.072,2300,8581,5561,0.7183826379020798,4752400,59923081,55170681
270000.0,3,2.25,2080,4252,1.5,0,0,2,7,1550,530,2003,0.0,98042,47.4203,-122.15700000000001,2080,2275,2172,0.510818438381938,4326400,18079504,13753104
610000.0,4,2.25,2090,35040,1.0,0,0,2,8,1490,600,1980,0.0,98075,47.5739,-122.03200000000001,2910,21132,32950,0.9403538812785388,4368100,1227801600,1223433500
500000.0,3,2.0,1720,5525,1.0,0,2,4,7,960,760,1941,0.0,98108,47.559,-122.29799999999999,1760,5525,3805,0.6886877828054299,2958400,30525625,27567225
715000.0,4,2.25,2460,40635,1.0,0,0,4,8,2460,0,1968,0.0,98053,47.6627,-122.03200000000001,2250,40635,38175,0.9394610557401255,6051600,1651203225,1645151625
264000.0,3,1.5,1470,14821,1.0,0,0,3,7,1470,0,1958,0.0,98042,47.3658,-122.148,1760,15370,13351,0.9008164091491803,2160900,219662041,217501141
550000.0,3,1.75,1650,3200,1.5,0,0,2,8,1650,0,1901,0.0,98102,47.6209,-122.31700000000001,1500,2400,1550,0.484375,2722500,10240000,7517500
337000.0,3,2.0,1690,9087,1.0,0,0,2,8,1690,0,1997,0.0,98042,47.3724,-122.10799999999999,2090,8100,7397,0.8140200286123033,2856100,82573569,79717469
170000.0,3,1.0,970,8710,1.0,0,0,3,6,970,0,1962,0.0,98198,47.4167,-122.302,1280,11805,7740,0.8886337543053962,940900,75864100,74923200
405000.0,4,2.5,2030,9095,1.0,0,0,3,7,1130,900,1972,0.0,98034,47.7321,-122.185,1940,8000,7065,0.776800439802089,4120900,82719025,78598125
775000.0,4,2.5,2540,28563,1.0,0,0,2,10,2540,0,1984,0.0,98052,47.7185,-122.11399999999999,2790,20301,26023,0.9110737667611946,6451600,815844969,809393369
425000.0,3,2.25,1570,7475,1.0,0,0,3,7,1200,370,1983,0.0,98034,47.7223,-122.17399999999999,1700,7230,5905,0.7899665551839465,2464900,55875625,53410725
713000.0,5,2.75,2580,9242,2.0,0,2,3,8,1720,860,1967,0.0,98007,47.5943,-122.133,2240,9316,6662,0.7208396450984635,6656400,85414564,78758164
555000.0,5,2.5,2090,8712,1.0,0,0,2,8,1420,670,1966,0.0,98008,47.5968,-122.12700000000001,2490,8712,6622,0.76010101010101,4368100,75898944,71530844
810000.0,4,2.5,3260,5608,2.0,0,0,2,9,3260,0,2003,0.0,98029,47.5453,-121.995,3010,5608,2348,0.4186875891583452,10627600,31449664,20822064
1250000.0,4,3.75,3830,41263,2.0,0,0,3,11,3830,0,1990,0.0,98077,47.7237,-122.042,5600,56568,37433,0.9071807672733442,14668900,1702635169,1687966269
819000.0,3,3.5,2130,6150,2.0,0,2,4,8,1530,600,1908,0.0,98199,47.6491,-122.405,2040,5381,4020,0.6536585365853659,4536900,37822500,33285600
409900.0,3,2.5,1690,1200,2.0,0,0,2,8,1410,280,2013,0.0,98106,47.5389,-122.367,1690,1760,-490,-0.4083333333333333,2856100,1440000,-1416100
935000.0,2,2.5,1780,2067,2.0,0,0,4,9,1780,0,1974,0.0,98004,47.6132,-122.21,2320,2067,287,0.13884857281083696,3168400,4272489,1104089
657500.0,4,1.75,1620,7560,1.0,0,3,3,7,1380,240,1947,0.0,98117,47.6981,-122.4,2170,8650,5940,0.7857142857142857,2624400,57153600,54529200
900000.0,6,3.75,4210,6105,2.0,0,0,2,9,3280,930,2008,0.0,98059,47.5211,-122.15700000000001,3820,6368,1895,0.3104013104013104,17724100,37271025,19546925
932800.0,5,3.25,2980,7095,2.5,0,0,2,9,2980,0,1998,2007.0,98115,47.6919,-122.294,1670,7140,4115,0.5799859055673009,8880400,50339025,41458625
391000.0,3,2.0,1490,9000,1.0,0,0,3,8,1490,0,1977,0.0,98006,47.5455,-122.184,2190,9000,7510,0.8344444444444444,2220100,81000000,78779900
420000.0,4,2.5,2110,9825,2.0,0,0,2,8,2110,0,2000,0.0,98059,47.4979,-122.15299999999999,1650,9900,7715,0.7852417302798982,4452100,96530625,92078525
1300000.0,6,3.5,6563,32670,2.0,0,0,2,10,5153,1410,2002,0.0,98005,47.6078,-122.15700000000001,2610,22651,26107,0.7991123354759718,43072969,1067328900,1024255931
415000.0,3,1.5,1510,16800,1.0,0,0,4,8,1510,0,1956,0.0,98133,47.75100000000001,-122.338,1560,7276,15290,0.9101190476190476,2280100,282240000,279959900
350000.0,3,1.75,1830,9425,1.0,0,0,2,8,1590,240,1946,0.0,98146,47.5038,-122.37899999999999,1670,8430,7595,0.8058355437665783,3348900,88830625,85481725
375000.0,2,1.0,1230,1820,2.0,0,0,3,7,830,400,1948,0.0,98107,47.6684,-122.40100000000001,1660,3056,590,0.3241758241758242,1512900,3312400,1799500
860000.0,3,1.75,2180,14135,1.0,0,2,4,8,1300,880,1947,0.0,98033,47.673,-122.18700000000001,3540,10318,11955,0.8457729041386629,4752400,199798225,195045825
495000.0,4,2.25,2220,8872,1.0,0,0,3,8,1110,1110,1961,0.0,98006,47.5491,-122.17,2220,9106,6652,0.7497745716862038,4928400,78712384,73783984
250000.0,4,2.25,1730,8400,1.0,0,0,2,7,1730,0,1962,0.0,98001,47.3386,-122.288,1550,7920,6670,0.794047619047619,2992900,70560000,67567100
365000.0,4,2.25,1990,21312,1.0,0,0,3,8,1990,0,1968,0.0,98058,47.43899999999999,-122.14399999999999,2400,19210,19322,0.9066253753753754,3960100,454201344,450241244
503000.0,3,2.75,1540,6760,1.0,0,0,4,7,1210,330,1980,0.0,98034,47.7163,-122.212,1540,7416,5220,0.772189349112426,2371600,45697600,43326000
150000.0,2,1.0,1100,7200,1.0,0,0,3,6,1100,0,1944,0.0,98058,47.4752,-122.17200000000001,1390,7200,6100,0.8472222222222222,1210000,51840000,50630000
450000.0,4,1.75,1640,1480,1.0,0,0,3,7,820,820,1912,0.0,98105,47.6684,-122.314,1420,2342,-160,-0.10810810810810811,2689600,2190400,-499200
355000.0,4,3.0,2590,7213,2.0,0,0,2,8,2590,0,2001,0.0,98001,47.2609,-122.289,2550,6800,4623,0.6409261056425898,6708100,52027369,45319269
245000.0,3,2.0,1450,9333,2.0,0,0,3,7,1450,0,1972,0.0,98003,47.346000000000004,-122.315,1910,7701,7883,0.8446373084753027,2102500,87104889,85002389
265900.0,3,2.0,1180,7793,1.0,0,0,3,7,1180,0,1992,0.0,98031,47.4053,-122.181,1720,7793,6613,0.8485820608238163,1392400,60730849,59338449
299000.0,4,2.5,1820,7575,1.0,0,0,2,7,1220,600,1975,0.0,98058,47.4339,-122.167,1840,7650,5755,0.7597359735973598,3312400,57380625,54068225
957500.0,4,2.25,2360,11523,2.0,0,0,3,10,2360,0,1968,0.0,98040,47.5318,-122.22399999999999,2850,11362,9163,0.7951922242471579,5569600,132779529,127209929
343000.0,3,1.0,1120,7250,1.0,0,0,3,7,1120,0,1972,0.0,98034,47.7143,-122.211,1340,7302,6130,0.8455172413793104,1254400,52562500,51308100
307500.0,3,2.25,1646,7364,2.0,0,0,2,7,1646,0,1994,0.0,98038,47.3646,-122.037,1975,9161,5718,0.7764801738185768,2709316,54228496,51519180
937500.0,5,3.75,4210,14599,2.0,0,3,2,10,4210,0,2004,0.0,98065,47.5364,-121.85799999999999,3950,13591,10389,0.711624083841359,17724100,213130801,195406701
610000.0,3,3.0,2480,45302,1.0,0,0,3,8,1620,860,1976,0.0,98077,47.7591,-122.073,1260,14100,42822,0.9452562800759349,6150400,2052271204,2046120804
720000.0,3,1.5,1590,7080,1.0,0,2,2,8,1310,280,1952,0.0,98136,47.5244,-122.38600000000001,2080,7200,5490,0.7754237288135594,2528100,50126400,47598300
610000.0,4,2.0,2130,2620,1.5,0,0,4,7,1650,0,1919,0.0,98103,47.6515,-122.346,1330,2719,490,0.18702290076335878,4536900,6864400,2327500
434500.0,3,1.75,1650,7965,1.0,0,0,3,7,1650,0,1967,0.0,98034,47.7335,-122.193,1560,7350,6315,0.7928436911487758,2722500,63441225,60718725
602500.0,2,2.5,3090,47044,1.0,0,0,3,10,2250,840,1979,0.0,98058,47.4291,-122.177,1860,62829,43954,0.9343168097950855,9548100,2213137936,2203589836
607010.0,4,2.5,2180,4000,2.0,0,0,2,8,1700,480,2002,0.0,98118,47.5553,-122.26899999999999,2180,4000,1820,0.455,4752400,16000000,11247600
610000.0,3,1.0,1800,5750,1.0,0,0,2,7,1040,760,1947,0.0,98117,47.68600000000001,-122.395,1320,5625,3950,0.6869565217391305,3240000,33062500,29822500
828500.0,4,2.5,3720,35000,2.0,0,0,2,10,3720,0,1983,0.0,98072,47.7582,-122.13,3720,35000,31280,0.8937142857142857,13838400,1225000000,1211161600
199990.0,3,1.0,1100,8560,1.0,0,0,2,6,1100,0,1961,0.0,98023,47.32899999999999,-122.338,1120,8470,7460,0.8714953271028038,1210000,73273600,72063600
294000.0,3,1.75,1530,9362,1.0,0,0,2,7,1530,0,1987,0.0,98038,47.3643,-122.04899999999999,1480,8125,7832,0.836573381756035,2340900,87647044,85306144
789500.0,4,2.5,3010,6100,2.0,0,0,2,9,3010,0,2005,0.0,98052,47.6647,-122.08,2890,5176,3090,0.5065573770491804,9060100,37210000,28149900
797000.0,3,3.5,3500,9473,2.0,0,0,2,10,3500,0,2008,0.0,98075,47.5807,-121.97200000000001,3510,7833,5973,0.6305288715296105,12250000,89737729,77487729
539950.0,5,3.0,3100,5250,2.0,0,0,2,7,3100,0,2006,0.0,98065,47.5369,-121.88799999999999,2460,5250,2150,0.4095238095238095,9610000,27562500,17952500
284950.0,4,1.5,2000,6778,1.0,0,0,3,7,1170,830,1962,0.0,98198,47.3708,-122.311,1940,7531,4778,0.7049277072882856,4000000,45941284,41941284
776500.0,4,1.5,2290,10372,1.0,0,0,2,7,1510,780,1965,1987.0,98033,47.6888,-122.199,1900,8109,8082,0.779213266486695,5244100,107578384,102334284
525000.0,4,2.5,2400,10070,1.0,0,0,2,7,1510,890,1967,0.0,98034,47.7104,-122.24,2030,9964,7670,0.7616683217477657,5760000,101404900,95644900
303000.0,3,2.5,1850,4957,2.0,0,0,2,8,1850,0,1999,0.0,98092,47.3311,-122.17,2400,6367,3107,0.626790397417793,3422500,24571849,21149349
722080.0,3,3.25,3680,7650,2.0,0,0,2,9,2340,1340,1988,0.0,98074,47.6272,-122.03299999999999,2280,8515,3970,0.5189542483660131,13542400,58522500,44980100
140000.0,3,1.0,1060,7473,1.0,0,0,2,7,1060,0,1959,0.0,98198,47.3699,-122.309,1320,7912,6413,0.8581560283687943,1123600,55845729,54722129
235000.0,3,1.0,1060,7473,1.0,0,0,2,7,1060,0,1959,0.0,98198,47.3699,-122.309,1320,7912,6413,0.8581560283687943,1123600,55845729,54722129
440000.0,3,1.0,1610,5500,1.5,0,0,2,7,1610,0,1903,0.0,98103,47.698,-122.351,1200,5701,3890,0.7072727272727273,2592100,30250000,27657900
605000.0,3,1.75,2330,6000,1.5,0,0,3,7,1630,700,1940,0.0,98126,47.5765,-122.37799999999999,1600,4000,3670,0.6116666666666667,5428900,36000000,30571100
380000.0,2,1.0,1210,4800,1.0,0,0,2,8,1060,150,1950,0.0,98108,47.5625,-122.316,1380,4800,3590,0.7479166666666667,1464100,23040000,21575900
352000.0,4,1.0,1530,8890,1.0,0,0,2,7,980,550,1925,0.0,98106,47.5308,-122.35,1100,5203,7360,0.8278965129358831,2340900,79032100,76691200
420000.0,4,2.25,2270,12000,1.0,0,0,3,7,1360,910,1979,0.0,98072,47.7559,-122.148,2500,10120,9730,0.8108333333333333,5152900,144000000,138847100
1180000.0,4,2.0,2590,7220,2.0,0,2,3,10,2590,0,1930,0.0,98199,47.647,-122.41,2530,6380,4630,0.6412742382271468,6708100,52128400,45420300
1380000.0,3,1.5,1850,10572,1.0,0,0,3,8,1850,0,1953,0.0,98004,47.6194,-122.208,3030,12752,8722,0.8250094589481649,3422500,111767184,108344684
300000.0,3,1.5,1500,14750,1.5,0,0,3,6,1500,0,1933,0.0,98168,47.495,-122.318,1270,15100,13250,0.8983050847457628,2250000,217562500,215312500
1150000.0,4,3.25,4740,49091,2.0,0,0,2,11,4740,0,1990,0.0,98053,47.6624,-122.071,4800,42387,44351,0.9034446232506976,22467600,2409926281,2387458681
453500.0,2,1.5,1710,4189,1.0,0,1,4,7,1160,550,1951,0.0,98136,47.5286,-122.383,1530,5608,2479,0.5917880162329912,2924100,17547721,14623621
443500.0,3,2.0,1920,7598,1.0,0,0,3,8,1920,0,1972,0.0,98177,47.7735,-122.363,2220,7598,5678,0.7473019215583048,3686400,57729604,54043204
332000.0,2,1.0,1150,8138,1.0,0,0,2,7,1150,0,1954,0.0,98155,47.736999999999995,-122.325,1300,8139,6988,0.8586876382403539,1322500,66227044,64904544
655000.0,3,2.5,2320,4721,2.0,0,0,2,8,2320,0,2004,0.0,98075,47.591,-122.01700000000001,2250,4356,2401,0.5085786909553061,5382400,22287841,16905441
475000.0,4,1.0,1420,6000,1.5,0,0,2,7,1420,0,1950,0.0,98115,47.6844,-122.302,1420,6180,4580,0.7633333333333333,2016400,36000000,33983600
372500.0,3,1.75,1550,12956,1.0,0,0,2,7,1210,340,1988,0.0,98045,47.4711,-121.75200000000001,1630,15360,11406,0.8803643099722136,2402500,167857936,165455436
1050000.0,4,2.5,2920,7200,1.0,0,3,2,8,1470,1450,1921,2006.0,98144,47.5947,-122.288,3210,6825,4280,0.5944444444444444,8526400,51840000,43313600
500000.0,3,1.75,1620,4200,1.0,0,0,4,7,830,790,1945,0.0,98115,47.6743,-122.285,1580,5000,2580,0.6142857142857143,2624400,17640000,15015600
900000.0,6,2.75,2300,24773,1.5,0,0,3,9,2300,0,1950,1985.0,98040,47.5833,-122.242,2720,11740,22473,0.9071569854276834,5290000,613701529,608411529
327500.0,3,1.0,1070,7140,1.0,0,0,2,7,1070,0,1989,0.0,98118,47.5427,-122.288,1390,2374,6070,0.8501400560224089,1144900,50979600,49834700
390000.0,3,1.75,1790,7123,1.0,0,0,2,7,1790,0,1913,0.0,98019,47.7429,-121.98100000000001,1660,8128,5333,0.7487013898638214,3204100,50737129,47533029
451101.0,2,1.5,1510,1962,2.0,0,0,3,8,1510,0,1985,0.0,98007,47.6214,-122.15299999999999,1510,2182,452,0.23037716615698267,2280100,3849444,1569344
455000.0,4,1.0,1340,5800,1.5,0,2,2,7,1340,0,1914,0.0,98116,47.5658,-122.389,1900,5800,4460,0.7689655172413793,1795600,33640000,31844400
650000.0,4,2.5,3350,46748,2.0,0,0,2,10,3350,0,2004,0.0,98010,47.3432,-122.025,3350,39683,43398,0.9283391802857877,11222500,2185375504,2174153004
895000.0,3,2.5,2500,7746,2.0,0,0,3,10,1910,590,1993,0.0,98112,47.6393,-122.311,2480,5099,5246,0.6772527756261296,6250000,60000516,53750516
800000.0,4,2.25,2350,10664,1.0,0,1,1,7,1510,0,1952,0.0,98040,47.5743,-122.238,2350,10140,8314,0.7796324081020255,5522500,113720896,108198396
703770.0,4,2.25,2550,12918,2.0,0,0,2,9,2550,0,1987,0.0,98006,47.5623,-122.109,2550,11036,10368,0.8026010218300046,6502500,166874724,160372224
249950.0,3,1.75,1320,10454,1.0,0,0,3,7,1320,0,1968,0.0,98002,47.2844,-122.21600000000001,1680,10183,9134,0.8737325425674383,1742400,109286116,107543716
512000.0,2,2.0,1270,3881,1.0,0,0,3,6,610,660,1926,0.0,98105,47.6694,-122.29799999999999,1370,5000,2611,0.6727647513527442,1612900,15062161,13449261
780000.0,5,2.5,3480,74052,1.0,0,0,3,8,1980,1500,1972,0.0,98027,47.4961,-122.06299999999999,2610,65775,70572,0.9530059957867445,12110400,5483698704,5471588304
336000.0,3,2.25,2820,11625,2.0,0,0,2,8,2820,0,1986,0.0,98092,47.2621,-122.21799999999999,2290,8488,8805,0.7574193548387097,7952400,135140625,127188225
285000.0,3,2.0,2110,6900,1.5,0,0,4,6,1220,890,1955,0.0,98178,47.504,-122.26,1350,7683,4790,0.6942028985507246,4452100,47610000,43157900
229900.0,3,1.75,1100,7224,1.0,0,0,2,7,1100,0,1981,0.0,98032,47.3717,-122.277,1700,8447,6124,0.8477297895902547,1210000,52186176,50976176
667500.0,4,3.0,1920,4000,1.5,0,0,3,8,1540,380,1931,0.0,98116,47.5718,-122.385,1660,4000,2080,0.52,3686400,16000000,12313600
378000.0,4,2.5,1890,12236,1.0,0,0,2,7,1230,660,1978,0.0,98045,47.4491,-121.78,1390,11360,10346,0.8455377574370709,3572100,149719696,146147596
454000.0,3,2.5,2530,43733,2.0,0,0,2,8,1530,1000,1991,0.0,98045,47.46,-121.708,1730,43548,41203,0.942148949306016,6400900,1912575289,1906174389
537500.0,4,2.5,2550,4630,2.0,0,0,2,7,2550,0,2005,0.0,98075,47.5928,-122.00399999999999,2550,5151,2080,0.44924406047516197,6502500,21436900,14934400
425000.0,3,1.0,1550,4160,1.5,0,0,3,6,1550,0,1926,0.0,98118,47.5387,-122.265,1590,5000,2610,0.6274038461538461,2402500,17305600,14903100
290000.0,3,2.0,1760,6600,1.0,0,0,2,7,1760,0,1998,0.0,98030,47.3836,-122.184,2590,6600,4840,0.7333333333333333,3097600,43560000,40462400
349500.0,3,2.0,1270,3600,1.0,0,0,2,7,1270,0,1963,0.0,98122,47.6099,-122.29700000000001,1660,3600,2330,0.6472222222222223,1612900,12960000,11347100
370000.0,3,2.75,1250,1655,2.0,0,0,2,7,830,420,2006,0.0,98136,47.5554,-122.382,1520,3001,405,0.24471299093655588,1562500,2739025,1176525
549500.0,3,1.75,1620,8438,1.0,0,0,3,8,1620,0,1961,0.0,98125,47.703,-122.281,2040,9450,6818,0.8080113771035791,2624400,71199844,68575444
245000.0,2,1.0,710,6322,1.0,0,0,2,6,710,0,1942,0.0,98126,47.5165,-122.376,740,6720,5612,0.8876937677950015,504100,39967684,39463584
208000.0,3,1.75,1070,7200,1.0,0,0,2,7,1070,0,1994,0.0,98010,47.3134,-122.023,1480,7200,6130,0.8513888888888889,1144900,51840000,50695100
248000.0,4,2.25,2320,8760,1.0,0,0,3,8,1160,1160,1966,0.0,98032,47.3627,-122.285,1970,8690,6440,0.7351598173515982,5382400,76737600,71355200
610000.0,4,3.25,5450,37058,1.5,0,0,4,9,5450,0,1984,0.0,98042,47.351000000000006,-122.087,2800,35716,31608,0.852933239786281,29702500,1373295364,1343592864
550000.0,4,2.5,1670,5116,2.0,0,0,2,8,1670,0,1999,0.0,98155,47.7667,-122.33,1910,7210,3446,0.6735731039874903,2788900,26173456,23384556
750000.0,3,2.75,3010,206910,2.0,0,2,2,10,3010,0,2001,0.0,98045,47.4881,-121.721,1580,120675,203900,0.9854526122468706,9060100,42811748100,42802688000
192000.0,2,1.75,1340,7380,1.0,0,0,2,6,1340,0,1940,0.0,98055,47.4785,-122.229,1980,9600,6040,0.8184281842818428,1795600,54464400,52668800
169317.0,2,1.0,790,4000,1.0,0,2,2,7,790,0,1908,0.0,98112,47.6248,-122.301,1700,4200,3210,0.8025,624100,16000000,15375900
1200000.0,4,3.5,3400,3850,2.5,0,0,2,10,2790,610,2008,0.0,98112,47.6258,-122.302,2030,4000,450,0.11688311688311688,11560000,14822500,3262500
880000.0,2,1.0,1530,6350,1.5,0,0,3,7,1530,0,1923,0.0,98112,47.6325,-122.303,2640,6350,4820,0.7590551181102362,2340900,40322500,37981600
210000.0,1,1.0,930,7129,1.0,0,0,2,6,930,0,1948,0.0,98133,47.7234,-122.333,1300,8075,6199,0.869546921026792,864900,50822641,49957741
180500.0,3,1.5,1540,9800,1.0,0,0,2,7,1010,530,1973,0.0,98058,47.4676,-122.184,1600,8250,8260,0.8428571428571429,2371600,96040000,93668400
540000.0,4,2.0,1990,29078,2.0,0,0,2,9,1990,0,1984,0.0,98074,47.6471,-122.057,2310,28353,27088,0.9315633812504299,3960100,845530084,841569984
520000.0,3,1.75,2300,35722,1.0,0,0,2,9,2300,0,1984,0.0,98072,47.7455,-122.11200000000001,2600,34798,33422,0.9356139073960025,5290000,1276061284,1270771284
177500.0,3,1.5,1220,6000,1.0,0,0,2,7,1220,0,1968,0.0,98055,47.4904,-122.22200000000001,1660,6000,4780,0.7966666666666666,1488400,36000000,34511600
415000.0,3,1.75,2380,5650,1.0,0,2,3,8,1190,1190,1956,0.0,98118,47.5119,-122.255,2350,6554,3270,0.5787610619469027,5664400,31922500,26258100
495000.0,4,2.5,2020,7200,1.0,0,0,4,7,1010,1010,1968,0.0,98034,47.7289,-122.20100000000001,1620,7275,5180,0.7194444444444444,4080400,51840000,47759600
325000.0,3,2.25,1890,9646,1.0,0,0,2,8,1890,0,1966,0.0,98168,47.4838,-122.29899999999999,1580,9488,7756,0.8040638606676342,3572100,93045316,89473216
440000.0,2,1.75,1330,4903,1.0,0,0,2,7,1330,0,1985,0.0,98052,47.6819,-122.161,1470,2735,3573,0.7287375076483785,1768900,24039409,22270509
411000.0,3,1.75,1490,9844,1.0,0,0,3,7,1190,300,1959,0.0,98155,47.7626,-122.29700000000001,1840,10150,8354,0.8486387647297846,2220100,96904336,94684236
810000.0,5,3.5,3550,9600,2.0,0,0,2,9,2550,1000,1998,0.0,98118,47.5484,-122.26899999999999,2030,9600,6050,0.6302083333333334,12602500,92160000,79557500
561750.0,5,1.75,2040,8996,1.0,0,2,3,7,1020,1020,1962,0.0,98008,47.588,-122.118,1950,8270,6956,0.7732325477990218,4161600,80928016,76766416
835100.0,4,2.5,2380,12573,1.0,0,0,3,9,2380,0,1963,0.0,98005,47.5984,-122.176,2900,10700,10193,0.8107054799968186,5664400,158080329,152415929
450000.0,3,2.25,1780,9969,1.0,0,0,2,8,1450,330,1985,0.0,98034,47.7286,-122.16799999999999,1950,7974,8189,0.8214464841007122,3168400,99380961,96212561
238000.0,3,2.5,1650,2807,2.0,0,0,2,7,1650,0,2004,0.0,98055,47.4328,-122.196,1460,1875,1157,0.4121838261489134,2722500,7879249,5156749
299000.0,3,1.0,1510,142803,1.0,0,0,2,7,1510,0,1974,0.0,98001,47.3192,-122.287,1330,46609,141293,0.9894259924511389,2280100,20392696809,20390416709
570000.0,2,1.0,1100,6240,1.0,0,0,3,7,1100,0,1941,0.0,98199,47.6446,-122.40299999999999,1250,6240,5140,0.8237179487179487,1210000,38937600,37727600
340000.0,3,1.75,2190,12626,2.0,0,0,3,8,2190,0,1978,0.0,98042,47.3845,-122.154,3110,14592,10436,0.8265483922065578,4796100,159415876,154619776
450000.0,2,1.75,1760,2275,1.5,0,0,2,6,1040,720,1912,0.0,98116,47.5803,-122.39299999999999,1380,3750,515,0.22637362637362637,3097600,5175625,2078025
272750.0,4,1.5,1800,8786,1.0,0,0,2,7,1330,470,1966,0.0,98146,47.4982,-122.345,1780,8664,6986,0.7951286137036194,3240000,77193796,73953796
520000.0,4,2.0,2000,6380,2.0,0,0,3,6,1860,140,1949,0.0,98115,47.6956,-122.303,1600,6380,4380,0.6865203761755486,4000000,40704400,36704400
284950.0,3,1.0,990,10723,1.0,0,0,4,7,990,0,1960,0.0,98059,47.4887,-122.133,1460,10723,9733,0.9076750909260468,980100,114982729,114002629
255000.0,2,1.5,1480,9660,1.0,0,0,2,7,1480,0,1949,0.0,98188,47.4577,-122.289,1990,9660,8180,0.8467908902691511,2190400,93315600,91125200
231500.0,2,1.0,1200,9488,1.0,0,0,4,7,1200,0,1941,0.0,98168,47.4832,-122.29899999999999,1200,9488,8288,0.8735244519392917,1440000,90022144,88582144
415000.0,1,2.0,3000,204732,2.5,0,2,2,8,3000,0,1979,0.0,98014,47.6331,-121.945,2330,213008,201732,0.9853466971455366,9000000,41915191824,41906191824
330000.0,4,2.5,3504,6000,2.0,0,0,2,7,3504,0,2006,0.0,98001,47.3012,-122.285,2790,5231,2496,0.416,12278016,36000000,23721984
365000.0,3,1.5,1300,12240,1.0,0,0,2,7,1300,0,1963,0.0,98028,47.736999999999995,-122.243,2040,9326,10940,0.8937908496732027,1690000,149817600,148127600
425000.0,4,2.0,1330,9188,1.5,0,0,2,7,1330,0,1928,2004.0,98198,47.401,-122.319,1770,10419,7858,0.8552459730082717,1768900,84419344,82650444
400000.0,4,1.75,1850,6480,1.0,0,0,3,7,1120,730,1958,0.0,98108,47.5525,-122.31299999999999,1610,5040,4630,0.7145061728395061,3422500,41990400,38567900
335000.0,4,2.5,2240,9701,2.0,0,0,2,9,2240,0,1989,0.0,98023,47.3086,-122.39200000000001,2240,9410,7461,0.7690959694876817,5017600,94109401,89091801
342000.0,3,3.0,1260,1251,2.0,0,0,2,7,1040,220,2003,0.0,98144,47.5943,-122.296,1780,7715,-9,-0.007194244604316547,1587600,1565001,-22599
490000.0,8,5.0,2800,2580,2.0,0,0,2,8,1880,920,1997,0.0,98122,47.6086,-122.303,1800,2580,-220,-0.08527131782945736,7840000,6656400,-1183600
331500.0,4,1.75,1820,14319,1.0,0,0,3,7,1820,0,1969,0.0,98059,47.4757,-122.148,1440,10018,12499,0.8728961519659194,3312400,205033761,201721361
960000.0,3,2.5,1730,4102,3.0,1,4,2,8,1730,0,1996,0.0,98074,47.645,-122.084,2340,16994,2372,0.5782545099951243,2992900,16826404,13833504
720500.0,4,2.5,3350,35298,2.0,0,0,3,9,3350,0,1985,0.0,98053,47.6506,-122.036,2620,35604,31948,0.9050937730183013,11222500,1245948804,1234726304
830000.0,3,2.5,3370,6550,2.0,0,2,3,8,2840,0,1912,2001.0,98126,47.5442,-122.38,1500,6550,3180,0.4854961832061069,11356900,42902500,31545600
662990.0,3,1.75,1240,3600,1.5,0,0,4,7,1240,0,1926,0.0,98116,47.5797,-122.405,1660,3600,2360,0.6555555555555556,1537600,12960000,11422400
220000.0,4,2.0,2340,10507,1.5,0,0,3,6,2340,0,1959,0.0,98030,47.3578,-122.178,990,10507,8167,0.7772913295897973,5475600,110397049,104921449
349950.0,5,2.0,1880,4179,1.0,0,0,2,7,940,940,1952,2000.0,98118,47.5536,-122.28299999999999,1350,5150,2299,0.550131610433118,3534400,17464041,13929641
550000.0,3,2.0,1810,2159,1.0,0,0,2,7,1010,800,1922,0.0,98109,47.6273,-122.345,1810,2159,349,0.1616489115331172,3276100,4661281,1385181
396000.0,3,1.75,2340,5668,1.0,0,0,3,6,1200,1140,1941,0.0,98106,47.5588,-122.36399999999999,860,4800,3328,0.5871559633027523,5475600,32126224,26650624
635000.0,4,1.5,2820,4000,2.0,0,0,2,7,2820,0,1911,0.0,98103,47.6638,-122.348,1470,1627,1180,0.295,7952400,16000000,8047600
293000.0,3,1.0,1020,7650,1.0,0,0,2,7,1020,0,1940,0.0,98133,47.7198,-122.352,1440,7650,6630,0.8666666666666667,1040400,58522500,57482100
339000.0,3,2.25,2090,10120,1.0,0,0,3,7,1290,800,1979,0.0,98058,47.4654,-122.17399999999999,1820,7983,8030,0.7934782608695652,4368100,102414400,98046300
285000.0,4,2.25,1830,8734,2.0,0,0,3,7,1830,0,1991,0.0,98030,47.3679,-122.179,1870,7212,6904,0.7904740096175864,3348900,76282756,72933856
775000.0,6,2.75,2980,5000,1.5,0,0,2,7,2480,500,1916,0.0,98103,47.6684,-122.331,1470,5000,2020,0.404,8880400,25000000,16119600
224000.0,4,1.5,1600,9289,1.0,0,0,3,7,1600,0,1959,0.0,98002,47.3107,-122.212,1540,9918,7689,0.8277532565399935,2560000,86285521,83725521
2250000.0,4,3.5,4440,8125,2.0,0,3,4,10,3140,1300,1922,0.0,98144,47.5744,-122.28299999999999,3990,8505,3685,0.45353846153846156,19713600,66015625,46302025
165050.0,3,1.0,1200,8514,1.0,0,0,2,7,1200,0,1959,0.0,98022,47.2043,-122.008,1210,8985,7314,0.8590556730091614,1440000,72488196,71048196
275000.0,3,1.25,1230,4500,1.5,0,0,3,7,1230,0,1913,0.0,98118,47.5301,-122.271,1310,5000,3270,0.7266666666666667,1512900,20250000,18737100
445000.0,5,3.0,2930,5500,1.0,0,0,2,7,1750,1180,1951,0.0,98118,47.5572,-122.281,1400,5500,2570,0.4672727272727273,8584900,30250000,21665100
510000.0,3,2.25,2370,38639,1.0,0,0,2,8,1930,440,1978,0.0,98077,47.771,-122.09899999999999,2900,37452,36269,0.9386630088770413,5616900,1492972321,1487355421
1230000.0,4,2.5,3040,7000,2.0,0,0,2,9,3040,0,2001,0.0,98040,47.5934,-122.244,2320,17511,3960,0.5657142857142857,9241600,49000000,39758400
390000.0,3,1.5,1610,13500,1.0,0,0,2,7,1060,550,1970,0.0,98155,47.7674,-122.31,1540,11479,11890,0.8807407407407407,2592100,182250000,179657900
460000.0,3,2.25,2350,10450,1.0,0,0,2,8,1390,960,1977,0.0,98028,47.7433,-122.259,2250,10450,8100,0.7751196172248804,5522500,109202500,103680000
700000.0,3,1.75,2000,14733,1.0,0,0,3,8,2000,0,1958,0.0,98005,47.6001,-122.178,2620,14733,12733,0.8642503224054843,4000000,217061289,213061289
874150.0,4,3.5,3530,14406,2.0,0,1,2,10,2570,960,1987,0.0,98034,47.7073,-122.244,3170,15181,10876,0.7549632097737053,12460900,207532836,195071936
470000.0,3,2.25,2220,9800,2.0,0,0,2,8,2220,0,1987,0.0,98155,47.7635,-122.286,2420,10232,7580,0.773469387755102,4928400,96040000,91111600
374000.0,3,1.75,2000,9416,1.0,0,0,3,6,2000,0,1961,0.0,98033,47.696999999999996,-122.175,1440,9555,7416,0.7875955819881053,4000000,88661056,84661056
510000.0,2,1.75,1210,131115,1.5,0,0,4,7,1210,0,1950,0.0,98070,47.4599,-122.45,2020,185565,129905,0.9907714601685543,1464100,17191143225,17189679125
467000.0,2,2.5,1140,1181,3.0,0,0,2,8,1140,0,2007,0.0,98107,47.6713,-122.383,1220,1189,41,0.03471634208298052,1299600,1394761,95161
576000.0,4,2.5,2440,28405,2.0,0,0,2,8,2440,0,2002,0.0,98028,47.7386,-122.238,2480,11429,25965,0.9140996303467699,5953600,806844025,800890425
196440.0,3,2.0,1560,7352,1.0,0,0,2,6,1560,0,1992,0.0,98001,47.2804,-122.251,1120,7950,5792,0.7878128400435256,2433600,54051904,51618304
825000.0,4,2.5,3210,18901,2.0,0,0,2,10,3210,0,1993,0.0,98077,47.708999999999996,-122.073,3330,18901,15691,0.8301677159938627,10304100,357247801,346943701
281000.0,2,1.0,930,2600,1.0,0,0,2,7,930,0,1981,0.0,98034,47.7242,-122.161,1370,3488,1670,0.6423076923076924,864900,6760000,5895100
326000.0,3,2.5,1782,1577,3.0,0,0,2,7,1782,0,2000,0.0,98125,47.7114,-122.301,1550,1744,-205,-0.12999365884590997,3175524,2486929,-688595
340000.0,3,1.75,1740,46580,1.0,0,0,3,7,1740,0,1980,0.0,98010,47.3583,-121.927,1576,54685,44840,0.9626449119793903,3027600,2169696400,2166668800
440000.0,5,1.75,3690,36036,1.0,0,0,2,9,1890,1800,1985,0.0,98042,47.3473,-122.085,2680,44131,32346,0.8976023976023976,13616100,1298593296,1284977196
749000.0,4,2.5,2930,18199,2.0,0,0,2,9,2930,0,1998,0.0,98075,47.5937,-122.04700000000001,2930,33976,15269,0.8390021429748887,8584900,331203601,322618701
340000.0,4,1.0,1230,8316,1.5,0,0,2,7,1230,0,1963,0.0,98034,47.7269,-122.24,1490,8316,7086,0.8520923520923521,1512900,69155856,67642956
561000.0,3,2.0,2000,7000,2.0,0,0,2,7,2000,0,1916,1986.0,98136,47.5452,-122.39299999999999,1840,7000,5000,0.7142857142857143,4000000,49000000,45000000
270000.0,3,2.25,1520,7930,1.0,0,0,2,7,1160,360,1988,0.0,98038,47.3605,-122.04899999999999,1530,7930,6410,0.8083228247162674,2310400,62884900,60574500
600000.0,2,1.0,1040,3600,1.0,0,0,3,7,1040,0,1919,1980.0,98112,47.619,-122.311,2250,4800,2560,0.7111111111111111,1081600,12960000,11878400
219900.0,4,1.5,1120,5427,1.0,0,0,2,6,1120,0,1969,0.0,98042,47.3628,-122.087,1150,5304,4307,0.7936244702413857,1254400,29452329,28197929
617000.0,3,1.75,3020,360241,2.0,0,0,2,8,3020,0,1992,0.0,98092,47.2662,-122.088,1890,209959,357221,0.9916167232491582,9120400,129773578081,129764457681
469000.0,3,2.25,1820,8446,2.0,0,0,2,8,1820,0,1978,0.0,98034,47.7208,-122.236,1850,8437,6626,0.7845133791143737,3312400,71334916,68022516
229000.0,3,1.0,1370,56628,1.0,0,0,2,7,1370,0,1942,0.0,98003,47.3058,-122.306,1768,8702,55258,0.9758070212615667,1876900,3206730384,3204853484
1270000.0,4,3.0,3130,2646,2.5,0,0,4,9,2290,840,1906,0.0,98102,47.6272,-122.316,2920,4500,-484,-0.18291761148904007,9796900,7001316,-2795584
365000.0,3,1.5,1640,8301,1.0,0,0,2,7,1290,350,1958,0.0,98155,47.7443,-122.32700000000001,1640,8955,6661,0.8024334417540055,2689600,68906601,66217001
429000.0,4,2.5,2650,9301,2.0,0,0,2,9,2650,0,2001,0.0,98001,47.3477,-122.271,2730,8688,6651,0.7150843995269326,7022500,86508601,79486101
550000.0,4,2.5,2850,6809,2.0,0,0,2,9,2850,0,2003,0.0,98019,47.7353,-121.973,2820,7500,3959,0.5814363342634749,8122500,46362481,38239981
453000.0,3,2.5,1820,16300,1.0,0,0,3,7,1220,600,1955,0.0,98166,47.4582,-122.365,1870,16300,14480,0.8883435582822086,3312400,265690000,262377600
187500.0,3,1.5,1180,7000,1.0,0,0,3,7,1180,0,1977,0.0,98023,47.2966,-122.374,1180,7370,5820,0.8314285714285714,1392400,49000000,47607600
520500.0,6,2.5,1880,14350,1.0,0,0,4,7,1640,240,1955,0.0,98133,47.7556,-122.352,1510,9840,12470,0.8689895470383275,3534400,205922500,202388100
300000.0,3,1.75,1280,12776,1.0,0,0,3,7,1280,0,1977,0.0,98031,47.4212,-122.199,1680,11704,11496,0.8998121477770821,1638400,163226176,161587776
799000.0,4,3.25,3120,5000,2.0,0,0,2,9,2370,750,2005,0.0,98115,47.69,-122.29899999999999,2520,6000,1880,0.376,9734400,25000000,15265600
338000.0,3,2.5,2470,4948,2.0,0,0,2,8,2470,0,2003,0.0,98038,47.3438,-122.039,2500,4993,2478,0.5008084074373484,6100900,24482704,18381804
800000.0,3,1.0,1700,4400,1.5,0,0,3,8,1700,0,1906,0.0,98122,47.611999999999995,-122.292,1610,4180,2700,0.6136363636363636,2890000,19360000,16470000
360000.0,2,2.0,1180,3200,1.0,0,1,3,6,590,590,1945,0.0,98136,47.5275,-122.383,1350,4000,2020,0.63125,1392400,10240000,8847600
442500.0,6,2.5,2800,10490,1.0,0,0,2,7,1400,1400,1968,0.0,98177,47.7735,-122.37799999999999,2290,8716,7690,0.7330791229742613,7840000,110040100,102200100
700000.0,4,1.0,1300,1651359,1.0,0,3,3,6,1300,0,1920,0.0,98022,47.2313,-122.023,2560,425581,1650059,0.9992127696037022,1690000,2726986546881,2726984856881
830000.0,5,3.0,3040,9601,1.0,0,0,4,9,1970,1070,1968,0.0,98040,47.5562,-122.22,3180,12390,6561,0.6833663160087491,9241600,92179201,82937601
360400.0,3,2.5,1630,11592,2.0,0,0,2,8,1630,0,1987,0.0,98011,47.7574,-122.228,1700,8850,9962,0.8593857832988268,2656900,134374464,131717564
345000.0,3,1.0,1340,9339,1.0,0,0,4,7,1340,0,1960,0.0,98056,47.5407,-122.177,1310,9350,7999,0.8565156869043795,1795600,87216921,85421321
300000.0,3,1.75,1830,51836,1.0,0,0,3,7,1430,400,1966,0.0,98059,47.4774,-122.098,1320,51400,50006,0.9646963500270083,3348900,2686970896,2683621996
350000.0,3,1.0,1240,10800,1.0,0,0,4,7,1240,0,1959,0.0,98056,47.5233,-122.185,1810,10800,9560,0.8851851851851852,1537600,116640000,115102400
368000.0,4,2.0,2500,36900,1.0,0,0,2,7,1540,960,1972,0.0,98038,47.3708,-122.04899999999999,1960,36900,34400,0.9322493224932249,6250000,1361610000,1355360000
264000.0,3,1.75,1760,7482,1.0,0,0,3,8,1760,0,1966,0.0,98023,47.3129,-122.369,2000,7500,5722,0.7647687784014969,3097600,55980324,52882724
435000.0,3,2.0,2660,16677,1.0,0,0,2,9,2210,450,1990,0.0,98038,47.3689,-122.055,2660,11355,14017,0.8404988906877736,7075600,278122329,271046729
200000.0,3,1.5,2060,15837,1.5,0,0,2,6,2060,0,1903,0.0,98055,47.4819,-122.223,2190,8549,13777,0.8699248595062196,4243600,250810569,246566969
620000.0,5,2.5,2540,3832,2.0,0,0,4,8,1760,780,1929,0.0,98117,47.6848,-122.398,2000,5289,1292,0.33716075156576203,6451600,14684224,8232624
1680000.0,5,4.25,4830,11466,2.0,0,0,2,10,3720,1110,2014,0.0,98040,47.5774,-122.22200000000001,2180,11017,6636,0.5787545787545788,23328900,131469156,108140256
337000.0,3,1.75,1400,6000,1.0,0,0,3,7,700,700,1919,0.0,98108,47.5283,-122.321,1030,6000,4600,0.7666666666666667,1960000,36000000,34040000
1930000.0,4,3.25,4280,20296,2.0,0,0,3,11,4280,0,1984,0.0,98004,47.6377,-122.212,3420,16351,16016,0.7891210090658258,18318400,411927616,393609216
544500.0,4,2.5,2230,10414,1.0,0,0,4,7,1450,780,1974,0.0,98075,47.5816,-122.0,1960,10240,8184,0.7858651814864606,4972900,108451396,103478496
252000.0,1,1.0,680,1638,1.0,0,4,0,6,680,0,1910,1992.0,98116,47.5832,-122.399,1010,3621,958,0.5848595848595849,462400,2683044,2220644
445000.0,4,2.5,2340,3784,2.0,0,0,2,8,2340,0,2008,0.0,98106,47.535,-122.348,1730,4000,1444,0.38160676532769555,5475600,14318656,8843056
379500.0,3,2.25,2070,14196,2.0,0,0,2,7,2070,0,1989,0.0,98059,47.4617,-122.07,1550,13860,12126,0.8541842772612004,4284900,201526416,197241516
189950.0,4,2.0,1910,4225,1.0,0,0,3,6,910,1000,1919,0.0,98001,47.3084,-122.234,1060,4800,2315,0.5479289940828402,3648100,17850625,14202525
469000.0,3,1.0,950,4250,1.5,0,0,4,6,950,0,1948,0.0,98122,47.608999999999995,-122.307,2130,5120,3300,0.7764705882352941,902500,18062500,17160000
600000.0,5,2.75,2910,53898,1.0,0,0,4,7,1510,1400,1979,0.0,98077,47.7201,-122.06200000000001,3210,216928,50988,0.9460091283535568,8468100,2904994404,2896526304
785000.0,3,2.5,2930,33981,2.0,0,2,2,9,2930,0,2000,0.0,98059,47.5151,-122.12,3720,35230,31051,0.9137753450457609,8584900,1154708361,1146123461
372000.0,4,2.75,2610,8967,2.0,0,0,3,8,2610,0,1990,0.0,98042,47.3747,-122.124,2390,7852,6357,0.7089327534292406,6812100,80407089,73594989
445000.0,5,3.0,3880,7180,2.0,0,0,2,7,3880,0,2004,0.0,98056,47.4797,-122.179,2160,4793,3300,0.4596100278551532,15054400,51552400,36498000
508000.0,4,2.25,3320,53392,2.0,0,0,3,8,2000,1320,1986,0.0,98027,47.4724,-122.014,3230,43129,50072,0.9378183997602637,11022400,2850705664,2839683264
780000.0,5,1.5,1940,4800,2.0,0,0,2,8,1940,0,1905,0.0,98103,47.6845,-122.33200000000001,1750,4800,2860,0.5958333333333333,3763600,23040000,19276400
541100.0,4,2.25,2510,9800,2.0,0,0,2,9,2510,0,1978,0.0,98072,47.753,-122.145,2440,11000,7290,0.7438775510204082,6300100,96040000,89739900
729000.0,4,2.5,2660,5608,2.0,0,0,2,9,2660,0,2003,0.0,98029,47.5449,-121.995,3010,5608,2948,0.5256776034236804,7075600,31449664,24374064
397000.0,3,2.0,1710,134489,1.0,0,2,4,7,1710,0,1952,0.0,98022,47.2207,-121.984,1700,63823,132779,0.9872852054814892,2924100,18087291121,18084367021
451555.0,2,1.0,1320,4520,1.0,0,1,2,6,1320,0,1912,1971.0,98116,47.5655,-122.39399999999999,1420,4560,3200,0.7079646017699115,1742400,20430400,18688000
300000.0,2,1.0,960,8153,1.0,0,0,2,6,960,0,1947,0.0,98155,47.7341,-122.3,1160,8199,7193,0.8822519318042439,921600,66471409,65549809
416000.0,3,2.5,1790,11542,1.0,0,0,4,7,1190,600,1969,0.0,98059,47.5124,-122.16,1790,9131,9752,0.8449142263039334,3204100,133217764,130013664
490000.0,2,1.0,950,3060,1.0,0,0,2,6,810,140,1925,0.0,98105,47.6698,-122.323,1510,3780,2110,0.6895424836601307,902500,9363600,8461100
480000.0,6,3.75,2940,5054,2.0,0,0,2,7,2940,0,1942,2003.0,98146,47.5122,-122.385,1530,5320,2114,0.4182825484764543,8643600,25542916,16899316
368000.0,2,2.0,930,1662,1.0,0,0,2,7,670,260,2002,0.0,98199,47.6518,-122.4,1780,2343,732,0.4404332129963899,864900,2762244,1897344
1040000.0,3,2.5,4570,10615,2.0,0,0,2,12,4570,0,1991,0.0,98027,47.5533,-122.09700000000001,3860,11576,6045,0.569477154969383,20884900,112678225,91793325
545000.0,3,2.5,2370,9000,1.0,0,3,3,8,1570,800,1952,0.0,98146,47.4922,-122.365,2120,9500,6630,0.7366666666666667,5616900,81000000,75383100
850000.0,5,2.75,3430,15119,2.0,0,0,2,10,3430,0,1998,0.0,98075,47.5678,-122.03200000000001,3430,12045,11689,0.7731331437264369,11764900,228584161,216819261
550000.0,4,3.5,3540,4750,2.0,0,0,2,10,3540,0,2003,0.0,98055,47.473,-122.193,3310,5655,1210,0.25473684210526315,12531600,22562500,10030900
600000.0,3,2.25,2240,9314,2.0,0,0,2,9,2240,0,1984,0.0,98074,47.6216,-122.03200000000001,2240,9314,7074,0.7595018252093623,5017600,86750596,81732996
535000.0,4,2.5,2710,12138,1.0,0,0,2,8,1700,1010,1968,0.0,98155,47.7657,-122.29,2390,10052,9428,0.7767342231010052,7344100,147331044,139986944
599950.0,3,2.5,2660,4975,2.0,0,0,2,8,2660,0,2014,0.0,98118,47.5487,-122.272,1840,6653,2315,0.4653266331658292,7075600,24750625,17675025
531000.0,5,2.75,2540,5022,1.0,0,0,3,8,1540,1000,1955,0.0,98108,47.5593,-122.3,2510,5182,2482,0.4942254082039028,6451600,25220484,18768884
530000.0,4,2.25,2210,7665,2.0,0,0,3,8,2210,0,1968,0.0,98006,47.5424,-122.16799999999999,1960,7903,5455,0.7116764514024788,4884100,58752225,53868125
597326.0,4,4.0,3570,8250,2.0,0,0,2,10,2860,710,2015,0.0,98040,47.5784,-122.226,2230,10000,4680,0.5672727272727273,12744900,68062500,55317600
805000.0,4,2.5,3450,33460,2.0,0,0,2,9,3450,0,1997,0.0,98077,47.7673,-122.1,2820,35250,30010,0.8968918111177525,11902500,1119571600,1107669100
390000.0,4,1.75,2330,8364,1.0,0,0,3,8,2330,0,1968,0.0,98058,47.4568,-122.146,2180,9630,6034,0.7214251554280249,5428900,69956496,64527596
487250.0,4,2.0,1690,3250,1.5,0,0,2,7,1550,140,1901,0.0,98103,47.6637,-122.346,1620,3250,1560,0.48,2856100,10562500,7706400
301000.0,3,1.5,1030,8414,1.0,0,0,3,7,1030,0,1967,0.0,98155,47.7654,-122.29700000000001,1750,8414,7384,0.8775849774185881,1060900,70795396,69734496
1180000.0,5,2.75,2560,5618,1.5,0,2,2,8,2220,340,1923,0.0,98109,47.6416,-122.355,2740,4000,3058,0.5443218227127091,6553600,31561924,25008324
299000.0,4,2.5,1950,3000,2.0,0,0,2,7,1950,0,2002,0.0,98178,47.4977,-122.226,1170,6000,1050,0.35,3802500,9000000,5197500
2350000.0,4,2.25,4370,22863,2.5,0,3,3,10,3670,0,1907,1994.0,98033,47.6878,-122.215,2980,22863,18493,0.8088614792459432,19096900,522716769,503619869
400000.0,4,2.5,2350,3904,2.5,0,0,2,7,2350,0,1999,0.0,98106,47.5305,-122.351,1120,4000,1554,0.3980532786885246,5522500,15241216,9718716
467500.0,4,2.5,3160,7210,1.0,0,0,3,7,1880,1280,1969,0.0,98034,47.7368,-122.18299999999999,2070,7560,4050,0.5617198335644937,9985600,51984100,41998500
305000.0,4,2.5,2430,9103,2.0,0,0,2,8,2430,0,1990,0.0,98023,47.2939,-122.368,2260,8090,6673,0.7330550368010545,5904900,82864609,76959709
210000.0,3,1.0,1340,306848,1.0,0,0,2,5,1340,0,1953,0.0,98019,47.7534,-121.912,1800,128066,305508,0.9956330169986443,1795600,94155695104,94153899504
300000.0,3,1.0,1010,10168,1.0,0,0,2,6,1010,0,1979,0.0,98014,47.6453,-121.912,1180,10318,9158,0.9006687647521636,1020100,103388224,102368124
327500.0,3,2.25,1770,8755,1.0,0,0,2,8,1330,440,1981,0.0,98058,47.4464,-122.12299999999999,1910,8710,6985,0.797829811536265,3132900,76650025,73517125
269000.0,3,2.0,1210,7136,1.0,0,0,2,7,1210,0,2003,0.0,98031,47.3996,-122.20299999999999,1210,5765,5926,0.8304372197309418,1464100,50922496,49458396
975000.0,4,3.25,3330,17533,1.0,0,2,2,9,1750,1580,1969,0.0,98033,47.652,-122.2,3340,12798,14203,0.8100724348371642,11088900,307406089,296317189
355000.0,3,1.0,1240,5400,1.0,0,0,3,7,1060,180,1940,0.0,98133,47.7115,-122.355,1429,5400,4160,0.7703703703703704,1537600,29160000,27622400
712000.0,3,1.0,1250,4620,1.5,0,0,3,7,1150,100,1900,0.0,98103,47.651,-122.34100000000001,1900,4400,3370,0.7294372294372294,1562500,21344400,19781900
883000.0,4,2.5,2960,41656,2.0,0,0,2,10,2960,0,1985,0.0,98072,47.7319,-122.132,3900,35104,38696,0.9289418091031304,8761600,1735222336,1726460736
190000.0,2,1.0,840,12252,1.0,0,0,2,6,840,0,1994,0.0,98010,47.3069,-122.01299999999999,1010,11876,11412,0.931439764936337,705600,150111504,149405904
443000.0,3,1.75,1530,8028,1.0,0,0,2,7,1200,330,1967,0.0,98177,47.7768,-122.361,1530,8028,6498,0.8094170403587444,2340900,64448784,62107884
920000.0,4,3.0,3750,11025,2.0,0,0,2,10,3750,0,1976,0.0,98074,47.6367,-122.059,2930,12835,7275,0.6598639455782312,14062500,121550625,107488125
285000.0,4,2.25,2150,8250,1.0,0,0,3,7,1240,910,1978,0.0,98023,47.3045,-122.37799999999999,2050,7875,6100,0.7393939393939394,4622500,68062500,63440000
901000.0,4,3.25,1560,4080,1.0,0,0,2,7,1560,0,1916,0.0,98126,47.5347,-122.38,1370,4080,2520,0.6176470588235294,2433600,16646400,14212800
552500.0,3,1.75,2040,5775,1.0,0,0,2,7,1410,630,1958,0.0,98199,47.6592,-122.39299999999999,1360,4400,3735,0.6467532467532467,4161600,33350625,29189025
256000.0,2,1.0,860,5000,1.0,0,0,2,6,860,0,1915,1945.0,98146,47.5133,-122.35600000000001,1220,5000,4140,0.828,739600,25000000,24260400
341000.0,3,1.5,1720,7119,1.5,0,0,3,7,1720,0,1952,0.0,98155,47.7535,-122.314,1590,7616,5399,0.7583930327293159,2958400,50680161,47721761
279000.0,4,2.25,2090,8941,2.0,0,0,2,7,2090,0,1975,0.0,98058,47.4332,-122.167,1890,7946,6851,0.7662453864221004,4368100,79941481,75573381
686000.0,4,2.25,2130,10650,2.0,0,0,3,8,2130,0,1977,0.0,98006,47.5567,-122.15899999999999,3380,10050,8520,0.8,4536900,113422500,108885600
225000.0,2,1.0,1300,11867,1.5,0,0,3,6,1300,0,1975,0.0,98010,47.3221,-121.90299999999999,820,11867,10567,0.8904525153787815,1690000,140825689,139135689
215500.0,2,1.75,1220,15600,1.0,0,0,2,6,1220,0,1972,0.0,98001,47.2853,-122.265,1510,17818,14380,0.9217948717948717,1488400,243360000,241871600
950000.0,4,3.0,2420,4800,1.5,0,0,2,7,1520,900,1919,0.0,98119,47.6453,-122.35799999999999,1090,3800,2380,0.49583333333333335,5856400,23040000,17183600
503000.0,4,2.5,2940,156988,2.0,0,2,2,9,1870,1070,1996,0.0,98014,47.6214,-121.946,2940,71002,154048,0.9812724539455245,8643600,24645232144,24636588544
780000.0,3,2.5,2610,7567,2.0,0,0,2,9,2610,0,1997,0.0,98052,47.6654,-122.137,2610,8458,4957,0.6550812739526893,6812100,57259489,50447389
212000.0,4,2.0,1880,7500,1.0,0,0,4,6,980,900,1946,0.0,98178,47.495,-122.266,1670,14350,5620,0.7493333333333333,3534400,56250000,52715600
580000.0,4,2.75,2330,6703,1.5,0,0,2,7,1710,620,1983,0.0,98177,47.7066,-122.359,2060,7500,4373,0.6523944502461584,5428900,44930209,39501309
465000.0,4,2.5,2200,3141,2.0,0,0,2,7,2060,140,1994,0.0,98144,47.5726,-122.305,1660,3175,941,0.29958611907035976,4840000,9865881,5025881
206000.0,4,2.0,1720,7560,1.0,0,0,2,7,1720,0,1959,0.0,98001,47.2845,-122.25,1750,7988,5840,0.7724867724867724,2958400,57153600,54195200
615000.0,3,2.5,2250,10171,2.0,0,0,2,9,2250,0,1987,0.0,98006,47.5613,-122.11,2440,13390,7921,0.7787828138826074,5062500,103449241,98386741
519000.0,4,1.0,1640,6305,1.5,0,0,4,6,1640,0,1907,0.0,98118,47.5563,-122.28,1590,4816,4665,0.7398889770023791,2689600,39753025,37063425
1140000.0,4,3.25,4130,11444,2.0,0,0,2,11,4130,0,2001,0.0,98059,47.5208,-122.15,3720,11431,7314,0.6391121985319819,17056900,130965136,113908236
330000.0,5,2.5,2600,3839,2.0,0,0,2,7,2600,0,2005,0.0,98058,47.4324,-122.145,2180,4800,1239,0.32274029695233136,6760000,14737921,7977921
240000.0,4,1.5,1920,7973,1.0,0,0,2,8,1920,0,1955,0.0,98178,47.4961,-122.235,2020,8840,6053,0.7591872569923491,3686400,63568729,59882329
574000.0,3,2.0,2060,7000,1.0,0,0,3,9,2060,0,1988,0.0,98029,47.5644,-122.012,2110,7000,4940,0.7057142857142857,4243600,49000000,44756400
930000.0,4,4.25,5710,24663,2.0,0,0,2,11,5710,0,2007,0.0,98092,47.3065,-122.15799999999999,4060,23847,18953,0.7684790982443336,32604100,608263569,575659469
850000.0,4,3.0,2720,183823,2.0,0,0,2,8,2720,0,1975,2007.0,98053,47.6749,-122.00200000000001,2140,173804,181103,0.9852031573850932,7398400,33790895329,33783496929
415000.0,3,1.5,1490,7275,1.0,0,0,2,7,1090,400,1974,0.0,98034,47.7148,-122.213,1420,7330,5785,0.7951890034364261,2220100,52925625,50705525
480000.0,3,2.5,2360,9005,1.0,0,0,4,7,1340,1020,1929,0.0,98133,47.7076,-122.337,1520,9005,6645,0.7379233759022765,5569600,81090025,75520425
300000.0,5,1.0,1940,8875,1.0,0,0,2,7,1940,0,1957,0.0,98188,47.4407,-122.275,1380,8875,6935,0.7814084507042254,3763600,78765625,75002025
439000.0,4,2.25,2570,9503,2.0,0,0,2,8,2570,0,1980,0.0,98011,47.763999999999996,-122.167,1950,9600,6933,0.7295590866042302,6604900,90307009,83702109
450000.0,3,1.0,1160,36831,1.0,0,0,2,7,1160,0,1938,0.0,98028,47.7507,-122.23700000000001,1800,15640,35671,0.9685047921587793,1345600,1356522561,1355176961
589000.0,3,2.5,2660,206480,1.0,0,0,2,8,2660,0,1989,0.0,98024,47.6042,-121.956,2660,206736,203820,0.9871173963580008,7075600,42633990400,42626914800
477000.0,3,2.25,1260,3000,2.0,0,0,2,7,1260,0,2003,0.0,98029,47.5459,-121.99700000000001,1630,3023,1740,0.58,1587600,9000000,7412400
587500.0,4,2.25,1780,6120,1.0,0,0,2,8,1310,470,1951,0.0,98115,47.6955,-122.287,1780,6120,4340,0.7091503267973857,3168400,37454400,34286000
1320000.0,4,2.25,3180,6105,2.0,0,0,2,10,3180,0,1905,0.0,98112,47.6255,-122.314,3180,6029,2925,0.47911547911547914,10112400,37271025,27158625
1430000.0,4,2.5,3380,27589,2.0,0,0,2,10,3380,0,1966,0.0,98004,47.6292,-122.225,3390,20075,24209,0.8774874044003045,11424400,761152921,749728521
700000.0,4,2.25,2690,15000,2.0,0,0,2,9,1890,800,1978,0.0,98074,47.611999999999995,-122.064,2670,15030,12310,0.8206666666666667,7236100,225000000,217763900
275000.0,2,1.0,1180,6552,1.0,0,0,3,6,1180,0,1949,0.0,98133,47.7477,-122.34200000000001,1070,7200,5372,0.8199023199023199,1392400,42928704,41536304
367500.0,3,1.0,1660,11783,1.0,0,0,3,7,1160,500,1978,0.0,98077,47.7563,-122.075,1320,10541,10123,0.8591190698463889,2755600,138839089,136083489
453250.0,4,2.5,2260,6300,2.0,0,0,2,7,2260,0,2001,0.0,98019,47.7235,-121.958,2300,6300,4040,0.6412698412698413,5107600,39690000,34582400
607000.0,5,1.75,1910,5428,1.0,0,0,2,8,1390,520,1954,0.0,98136,47.5333,-122.39200000000001,1820,5900,3518,0.6481208548268239,3648100,29463184,25815084
255000.0,4,2.0,2430,8960,1.0,0,0,2,7,1430,1000,1960,0.0,98178,47.4979,-122.23200000000001,2430,8960,6530,0.7287946428571429,5904900,80281600,74376700
501000.0,2,2.0,1300,2500,1.0,0,0,3,7,770,530,1926,0.0,98117,47.6831,-122.37299999999999,1160,5000,1200,0.48,1690000,6250000,4560000
450000.0,3,1.0,1060,4650,1.0,0,0,2,7,910,150,1950,0.0,98116,47.5784,-122.39299999999999,1480,4750,3590,0.7720430107526882,1123600,21622500,20498900
360000.0,3,2.25,2200,8000,2.0,0,0,2,8,2200,0,1981,0.0,98055,47.4522,-122.208,2170,8000,5800,0.725,4840000,64000000,59160000
460000.0,4,1.75,1720,3050,1.5,0,0,4,7,1040,680,1929,0.0,98116,47.5654,-122.384,1570,6100,1330,0.4360655737704918,2958400,9302500,6344100
753000.0,3,1.75,2360,8290,1.0,0,0,3,7,1180,1180,1950,0.0,98115,47.6738,-122.281,1880,7670,5930,0.715319662243667,5569600,68724100,63154500
389950.0,2,1.0,820,4234,1.0,0,1,2,6,820,0,1951,0.0,98136,47.5294,-122.38600000000001,1550,4236,3414,0.8063297118564006,672400,17926756,17254356
469000.0,2,1.0,1030,4400,1.0,0,0,2,7,1030,0,1924,0.0,98117,47.681000000000004,-122.361,1400,4200,3370,0.7659090909090909,1060900,19360000,18299100
550000.0,4,1.75,2030,5688,2.0,0,4,3,9,1730,300,1939,0.0,98146,47.5071,-122.387,2320,11107,3658,0.6431082981715893,4120900,32353344,28232444
565000.0,5,3.5,2700,11675,1.5,0,2,3,6,1950,750,1948,0.0,98133,47.7172,-122.34899999999999,2160,8114,8975,0.7687366167023555,7290000,136305625,129015625
189650.0,2,1.75,1100,7600,1.0,0,0,2,6,1100,0,1980,0.0,98198,47.4136,-122.318,1230,7350,6500,0.8552631578947368,1210000,57760000,56550000
1530000.0,4,3.25,3620,5131,2.0,0,3,3,11,2350,1270,1927,0.0,98119,47.6499,-122.37,2550,5174,1511,0.2944845059442604,13104400,26327161,13222761
260000.0,3,1.75,1340,8000,1.0,0,0,2,7,1340,0,1980,0.0,98038,47.3651,-122.044,1690,8000,6660,0.8325,1795600,64000000,62204400
243000.0,3,1.75,1790,12000,1.0,0,0,2,7,1040,750,1960,0.0,98198,47.3945,-122.31299999999999,1840,12000,10210,0.8508333333333333,3204100,144000000,140795900
1100000.0,4,2.5,3830,13800,1.0,0,4,3,9,2030,1800,1969,0.0,98006,47.5671,-122.15700000000001,3460,9875,9970,0.722463768115942,14668900,190440000,175771100
249000.0,3,1.5,1580,7200,1.0,0,0,3,7,1080,500,1976,0.0,98092,47.2761,-122.152,1580,7470,5620,0.7805555555555556,2496400,51840000,49343600
720000.0,2,1.0,2020,7200,1.0,0,3,3,7,1700,320,1947,0.0,98146,47.506,-122.384,2020,7200,5180,0.7194444444444444,4080400,51840000,47759600
905000.0,4,2.5,3330,9557,2.0,0,0,2,10,3330,0,1995,0.0,98006,47.5526,-122.102,3360,9755,6227,0.6515642984200063,11088900,91336249,80247349
824500.0,4,2.5,2610,3500,1.5,0,0,4,7,1610,1000,1927,0.0,98115,47.6848,-122.32600000000001,1820,3900,890,0.2542857142857143,6812100,12250000,5437900
762500.0,4,2.75,2610,8760,1.0,0,0,3,8,1760,850,1978,0.0,98040,47.5875,-122.229,2550,10376,6150,0.702054794520548,6812100,76737600,69925500
580000.0,3,2.5,1740,1280,3.0,0,2,2,8,1740,0,2008,0.0,98116,47.589,-122.387,1740,1308,-460,-0.359375,3027600,1638400,-1389200
380000.0,3,2.0,1840,8580,1.0,0,0,2,8,1840,0,1990,0.0,98058,47.4626,-122.132,2190,8580,6740,0.7855477855477856,3385600,73616400,70230800
805000.0,3,1.75,1080,3200,1.0,0,0,3,7,880,200,1926,0.0,98103,47.6503,-122.338,1780,5200,2120,0.6625,1166400,10240000,9073600
520000.0,4,1.75,1240,4532,1.5,0,0,3,7,1240,0,1944,0.0,98117,47.6892,-122.37799999999999,1260,4468,3292,0.7263901147396293,1537600,20539024,19001424
1570000.0,5,4.5,5620,5800,3.0,0,3,2,11,4700,920,1999,0.0,98199,47.6482,-122.412,2360,5800,180,0.03103448275862069,31584400,33640000,2055600
175000.0,2,1.0,1170,8925,1.0,0,2,2,6,1170,0,1911,0.0,98198,47.4017,-122.321,1380,7440,7755,0.8689075630252101,1368900,79655625,78286725
353500.0,4,2.25,1760,9602,2.0,0,0,2,7,1760,0,1987,0.0,98058,47.4248,-122.15799999999999,1860,9656,7842,0.8167048531555926,3097600,92198404,89100804
500000.0,4,2.5,2230,26989,1.0,0,1,3,8,1400,830,1962,0.0,98166,47.4285,-122.345,2570,17702,24759,0.9173737448590167,4972900,728406121,723433221
386500.0,3,1.75,1520,7350,1.0,0,0,3,7,1140,380,1972,0.0,98034,47.7167,-122.17,1380,7350,5830,0.7931972789115647,2310400,54022500,51712100
210000.0,2,1.0,1450,4750,1.0,0,0,2,7,850,600,1950,0.0,98118,47.5293,-122.272,1190,5000,3300,0.6947368421052632,2102500,22562500,20460000
439500.0,3,2.5,1600,6510,1.0,0,0,2,7,940,0,1983,0.0,98155,47.7679,-122.30799999999999,1600,10507,4910,0.7542242703533026,2560000,42380100,39820100
315000.0,5,2.5,3220,5751,2.0,0,0,2,8,3220,0,2002,0.0,98042,47.3717,-122.104,2740,5500,2531,0.44009737436967483,10368400,33074001,22705601
339000.0,4,2.5,1830,8601,2.0,0,0,2,7,1830,0,2003,0.0,98038,47.3576,-122.016,1830,5184,6771,0.7872340425531915,3348900,73977201,70628301
655000.0,4,2.25,2200,9163,1.0,0,0,3,8,1430,770,1971,0.0,98006,47.5653,-122.146,2420,9163,6963,0.7599039615846338,4840000,83960569,79120569
740000.0,2,2.5,2170,8678,1.0,0,0,2,8,2170,0,2008,0.0,98053,47.7161,-122.014,2170,5890,6508,0.7499423830375662,4708900,75307684,70598784
685000.0,5,2.5,1900,7843,2.0,0,0,4,7,1900,0,1966,0.0,98008,47.6273,-122.12299999999999,1900,7350,5943,0.7577457605508097,3610000,61512649,57902649
550000.0,5,2.5,2960,9877,1.0,0,0,3,7,1480,1480,1960,0.0,98005,47.5866,-122.171,1900,9877,6917,0.7003138604839526,8761600,97555129,88793529
405000.0,2,1.75,1710,4234,2.0,0,0,2,7,1330,380,1920,1979.0,98136,47.5319,-122.38600000000001,1530,4556,2524,0.596126594237128,2924100,17926756,15002656
765000.0,4,2.25,2620,17366,1.0,0,3,2,9,1430,1190,1984,0.0,98075,47.583999999999996,-122.07700000000001,2620,15335,14746,0.8491304848554647,6864400,301577956,294713556
625000.0,3,2.0,2140,3600,2.0,0,0,2,8,1680,460,1911,1997.0,98116,47.5846,-122.383,2340,5400,1460,0.40555555555555556,4579600,12960000,8380400
207000.0,4,2.5,2100,19680,1.5,0,0,2,6,2100,0,1914,0.0,98055,47.4787,-122.23,1340,12300,17580,0.8932926829268293,4410000,387302400,382892400
370000.0,4,2.5,2100,19680,1.5,0,0,2,6,2100,0,1914,0.0,98055,47.4787,-122.23,1340,12300,17580,0.8932926829268293,4410000,387302400,382892400
475000.0,3,2.5,1460,4961,1.0,0,0,3,8,1150,310,1988,0.0,98033,47.6955,-122.18299999999999,1550,5449,3501,0.7057044950614796,2131600,24611521,22479921
365000.0,2,1.0,990,8250,1.0,0,0,2,7,990,0,1955,0.0,98133,47.7252,-122.331,1080,8168,7260,0.88,980100,68062500,67082400
411800.0,4,2.25,2190,6800,1.0,0,0,4,7,1340,850,1969,0.0,98011,47.7367,-122.195,1560,7611,4610,0.6779411764705883,4796100,46240000,41443900
668000.0,5,3.5,3990,42436,2.0,0,0,2,9,2710,1280,2002,0.0,98027,47.46100000000001,-122.0,3030,41684,38446,0.905976058063908,15920100,1800814096,1784893996
618000.0,3,2.5,2340,3630,2.0,0,0,2,9,2340,0,1998,0.0,98122,47.6059,-122.307,1820,5120,1290,0.35537190082644626,5475600,13176900,7701300
247500.0,4,2.0,2460,5921,1.0,0,0,3,7,1230,1230,1948,0.0,98002,47.308,-122.209,1260,6648,3461,0.584529640263469,6051600,35058241,29006641
345000.0,5,3.0,2080,6150,1.0,0,0,2,7,1040,1040,1950,0.0,98116,47.5707,-122.39399999999999,1420,6150,4070,0.6617886178861788,4326400,37822500,33496100
616300.0,3,2.0,1700,8400,2.0,0,2,2,7,1700,0,1927,0.0,98033,47.6825,-122.19,1820,9000,6700,0.7976190476190477,2890000,70560000,67670000
348000.0,3,1.5,1330,6768,1.0,0,0,3,7,1330,0,1952,0.0,98155,47.7366,-122.319,1320,6910,5438,0.8034869976359338,1768900,45805824,44036924
425000.0,3,2.5,1630,10762,1.0,0,0,2,7,1630,0,1994,0.0,98011,47.7508,-122.175,1770,10762,9132,0.8485411633525367,2656900,115820644,113163744
850000.0,5,2.75,2920,11880,1.0,0,0,4,8,1660,1260,1968,0.0,98027,47.5133,-122.031,3910,14491,8960,0.7542087542087542,8526400,141134400,132608000
820000.0,5,2.75,2830,6137,2.0,0,0,2,9,2830,0,2010,0.0,98074,47.5932,-122.05799999999999,3170,6285,3307,0.5388626364673293,8008900,37662769,29653869
832000.0,4,2.25,3190,52953,2.0,0,0,3,10,3190,0,1980,0.0,98075,47.5933,-122.075,3190,51400,49763,0.9397578985137763,10176100,2804020209,2793844109
835000.0,3,1.75,1490,3840,2.0,0,0,2,8,1490,0,1984,2014.0,98033,47.6916,-122.214,3450,8500,2350,0.6119791666666666,2220100,14745600,12525500
350000.0,3,2.5,1630,3425,2.0,0,0,2,8,1630,0,1999,0.0,98059,47.4913,-122.154,1420,3425,1795,0.5240875912408759,2656900,11730625,9073725
349000.0,4,2.5,2280,4096,2.0,0,0,2,7,2280,0,2003,0.0,98056,47.4834,-122.182,2280,3600,1816,0.443359375,5198400,16777216,11578816
1130000.0,6,3.75,3010,4360,2.0,0,0,2,9,2000,1010,2014,0.0,98103,47.6873,-122.333,1600,5160,1350,0.30963302752293576,9060100,19009600,9949500
320000.0,3,2.5,1590,3480,2.0,0,0,2,7,1590,0,2004,0.0,98056,47.4805,-122.178,1680,3480,1890,0.5431034482758621,2528100,12110400,9582300
150000.0,3,1.0,1250,7210,1.0,0,0,3,7,1250,0,1968,0.0,98031,47.4169,-122.16799999999999,1010,7210,5960,0.826629680998613,1562500,51984100,50421600
340000.0,3,1.0,1710,10190,1.0,0,0,2,6,1310,400,1949,0.0,98168,47.506,-122.331,1200,6251,8480,0.8321884200196271,2924100,103836100,100912000
785500.0,4,4.0,3280,8448,2.0,0,0,2,10,3280,0,2007,0.0,98075,47.5818,-121.973,3730,8030,5168,0.6117424242424242,10758400,71368704,60610304
410500.0,4,2.5,3362,8601,2.0,0,0,2,8,3362,0,2004,0.0,98003,47.2592,-122.304,2770,8601,5239,0.6091152191605628,11303044,73977201,62674157
580000.0,3,2.5,2200,11000,2.0,0,2,2,9,2200,0,1978,0.0,98008,47.5916,-122.11200000000001,2200,12851,8800,0.8,4840000,121000000,116160000
345000.0,2,1.5,830,920,2.0,0,0,2,7,830,0,2005,0.0,98144,47.5998,-122.306,830,1200,90,0.09782608695652174,688900,846400,157500
550000.0,3,2.25,2160,37000,1.5,0,0,3,7,1760,400,1933,0.0,98052,47.7297,-122.139,2540,37000,34840,0.9416216216216217,4665600,1369000000,1364334400
449500.0,4,3.0,2580,7299,2.0,0,0,2,8,2580,0,1998,0.0,98058,47.4646,-122.15,2250,6165,4719,0.6465269214960954,6656400,53275401,46619001
300000.0,3,1.0,2150,7007,1.0,0,0,2,6,2150,0,1954,0.0,98177,47.7615,-122.36200000000001,1720,9000,4857,0.6931639788782646,4622500,49098049,44475549
915000.0,4,2.5,3510,28052,2.0,0,0,2,10,3510,0,1988,0.0,98053,47.6671,-122.057,2890,28295,24542,0.8748752317125339,12320100,786914704,774594604
1580000.0,4,3.75,3810,9916,2.0,0,0,2,11,3810,0,1989,0.0,98040,47.5739,-122.234,3040,11250,6106,0.6157724889068172,14516100,98327056,83810956
599000.0,4,2.75,2020,2750,1.0,0,0,2,8,1010,1010,1917,2014.0,98122,47.6053,-122.291,1840,4000,730,0.26545454545454544,4080400,7562500,3482100
755000.0,4,2.5,2120,10202,1.0,0,0,3,7,1620,500,1960,0.0,98005,47.5858,-122.17,1570,10762,8082,0.7921976083120956,4494400,104080804,99586404
400000.0,3,1.0,1250,7157,1.0,0,0,2,7,1250,0,1944,2010.0,98125,47.7323,-122.304,1300,6796,5907,0.8253458152857343,1562500,51222649,49660149
133000.0,3,1.0,980,9115,1.0,0,0,2,7,980,0,1968,0.0,98198,47.3737,-122.31200000000001,1470,8716,8135,0.8924849149753155,960400,83083225,82122825
330000.0,4,1.5,1250,8400,1.0,0,0,2,7,960,290,1951,0.0,98155,47.7505,-122.315,1560,8400,7150,0.8511904761904762,1562500,70560000,68997500
330000.0,4,1.0,1100,5000,1.5,0,0,4,6,1100,0,1904,0.0,98055,47.4868,-122.204,1560,4838,3900,0.78,1210000,25000000,23790000
375000.0,3,1.75,1330,9417,1.0,0,0,4,6,710,620,1936,0.0,98125,47.7231,-122.301,1690,7937,8087,0.8587660613783583,1768900,88679889,86910989
485000.0,4,2.75,2560,8956,1.0,0,0,3,7,1500,1060,1968,0.0,98034,47.7278,-122.177,2280,9234,6396,0.7141581062974542,6553600,80209936,73656336
470000.0,4,2.5,1850,11250,1.5,0,0,2,7,1210,640,1981,0.0,98074,47.6264,-122.06200000000001,1650,7623,9400,0.8355555555555556,3422500,126562500,123140000
1050000.0,4,3.0,2790,3600,2.0,0,0,2,8,1880,910,1905,2013.0,98119,47.6362,-122.363,1360,3600,810,0.225,7784100,12960000,5175900
548800.0,4,1.0,1660,4704,1.5,0,0,2,7,1260,400,1930,0.0,98115,47.6918,-122.32,1360,5413,3044,0.6471088435374149,2755600,22127616,19372016
315000.0,2,1.0,1080,2674,1.0,0,0,3,6,720,360,1919,0.0,98108,47.5595,-122.31700000000001,1250,5000,1594,0.5961106955871354,1166400,7150276,5983876
590000.0,3,2.0,3030,9374,1.0,0,1,3,7,2100,930,1959,0.0,98136,47.5289,-122.391,1990,6012,6344,0.6767655216556433,9180900,87871876,78690976
439950.0,4,2.5,2380,12067,2.0,0,0,2,7,2380,0,2002,0.0,98059,47.4873,-122.14399999999999,2330,8621,9687,0.8027678793403498,5664400,145612489,139948089
325000.0,3,1.75,2250,26337,1.0,0,0,2,8,2250,0,1980,0.0,98092,47.3032,-122.12299999999999,1830,26337,24087,0.9145688575008543,5062500,693637569,688575069
400000.0,2,1.0,880,5111,1.0,0,0,2,6,880,0,1931,0.0,98115,47.6997,-122.314,1370,5111,4231,0.8278223439639992,774400,26122321,25347921
685000.0,4,2.5,2770,10051,2.0,0,0,2,10,2770,0,1987,0.0,98074,47.6288,-122.04299999999999,2730,10675,7281,0.7244055317878818,7672900,101022601,93349701
339950.0,3,2.0,1340,10200,1.5,0,0,2,7,1340,0,1953,0.0,98133,47.7756,-122.351,1420,10200,8860,0.8686274509803922,1795600,104040000,102244400
315000.0,3,1.75,1660,8160,1.0,0,0,3,7,1660,0,1951,0.0,98166,47.4608,-122.35799999999999,1490,8100,6500,0.7965686274509803,2755600,66585600,63830000
411753.0,3,2.5,1710,3795,2.0,0,0,2,7,1710,0,2009,0.0,98053,47.6968,-122.024,1600,3821,2085,0.549407114624506,2924100,14402025,11477925
577000.0,2,1.75,1620,4879,1.0,0,0,2,7,1040,580,1924,2011.0,98116,47.5703,-122.385,1500,5000,3259,0.6679647468743595,2624400,23804641,21180241
500000.0,3,1.75,1530,8829,1.0,0,0,4,8,1530,0,1972,0.0,98006,47.545,-122.171,2060,9226,7299,0.8267074413863404,2340900,77951241,75610341
210000.0,3,2.0,1440,10111,1.0,0,0,2,7,1440,0,1963,0.0,98001,47.345,-122.28299999999999,1580,10200,8671,0.857580852536841,2073600,102232321,100158721
640000.0,4,1.75,2020,16120,1.0,0,0,2,7,2020,0,1969,0.0,98010,47.3413,-122.04799999999999,1940,16350,14100,0.8746898263027295,4080400,259854400,255774000
460000.0,4,1.75,1870,8663,1.0,0,0,4,7,1870,0,1949,0.0,98133,47.7366,-122.35,1560,7800,6793,0.7841394436107584,3496900,75047569,71550669
265000.0,2,1.0,620,4760,1.0,0,0,2,6,620,0,1941,0.0,98126,47.5286,-122.376,620,4760,4140,0.8697478991596639,384400,22657600,22273200
740000.0,5,5.0,5774,31675,1.0,0,2,2,11,4490,1284,1984,0.0,98003,47.3466,-122.323,3260,13200,25901,0.8177111286503552,33339076,1003305625,969966549
230000.0,3,1.0,1240,6195,1.0,0,0,2,6,1240,0,1948,0.0,98028,47.7681,-122.266,1760,11080,4955,0.7998385794995965,1537600,38378025,36840425
315000.0,3,1.75,1890,10661,1.0,0,0,4,7,1460,430,1978,0.0,98038,47.3583,-122.056,1680,9604,8771,0.8227183191070256,3572100,113656921,110084821
432000.0,3,1.75,2410,51763,1.0,0,0,3,8,1410,1000,1981,0.0,98077,47.7429,-122.056,2410,49207,49353,0.9534416475088383,5808100,2679408169,2673600069
467000.0,3,2.5,1530,3984,2.0,0,0,2,8,1530,0,1995,0.0,98029,47.568999999999996,-122.007,1720,4005,2454,0.6159638554216867,2340900,15872256,13531356
255000.0,5,3.75,2800,9900,1.0,0,0,2,7,2800,0,1964,0.0,98023,47.318999999999996,-122.344,1700,13200,7100,0.7171717171717171,7840000,98010000,90170000
316500.0,3,1.75,1460,6360,1.0,0,2,2,7,1010,450,1979,0.0,98106,47.5311,-122.353,1400,4240,4900,0.7704402515723271,2131600,40449600,38318000
190000.0,4,2.0,1580,6250,1.0,0,0,2,7,860,720,1977,0.0,98155,47.7659,-122.31,1580,6250,4670,0.7472,2496400,39062500,36566100
490000.0,3,2.0,1450,2400,1.5,0,0,2,8,1450,0,1900,2003.0,98107,47.6726,-122.381,1450,4275,950,0.3958333333333333,2102500,5760000,3657500
378000.0,4,1.75,1990,23200,1.0,0,0,3,7,1990,0,1976,0.0,98059,47.486000000000004,-122.12899999999999,1950,17040,21210,0.9142241379310345,3960100,538240000,534279900
598800.0,6,4.0,4470,17877,3.0,0,3,2,9,3230,1240,2013,0.0,98188,47.4514,-122.273,1790,18260,13407,0.7499580466521228,19980900,319587129,299606229
333800.0,5,3.0,1980,3868,1.0,0,0,2,7,1220,760,1990,0.0,98118,47.5173,-122.275,1970,3868,1888,0.48810754912099275,3920400,14961424,11041024
690000.0,4,2.5,2920,9904,2.0,0,0,3,9,2920,0,1990,0.0,98029,47.5759,-121.995,1810,5617,6984,0.7051696284329564,8526400,98089216,89562816
320000.0,4,1.75,1660,6200,1.0,0,0,3,6,830,830,1948,0.0,98108,47.56,-122.316,1780,5968,4540,0.7322580645161291,2755600,38440000,35684400
1250000.0,4,3.5,3190,6000,1.5,0,3,3,9,2410,780,1912,0.0,98144,47.5846,-122.29,2840,4000,2810,0.4683333333333333,10176100,36000000,25823900
335000.0,3,1.5,1560,9600,1.0,0,0,3,7,1560,0,1961,0.0,98033,47.6918,-122.163,1520,10000,8040,0.8375,2433600,92160000,89726400
840000.0,3,2.5,3050,33920,1.0,0,0,2,8,3050,0,2004,0.0,98052,47.7034,-122.072,1970,60984,30870,0.9100825471698113,9302500,1150566400,1141263900
608250.0,4,2.75,3030,21780,2.0,0,0,2,8,3030,0,1986,0.0,98166,47.4481,-122.338,3020,28027,18750,0.8608815426997245,9180900,474368400,465187500
550000.0,3,2.5,2260,4165,2.0,0,0,2,7,2260,0,2005,0.0,98075,47.5922,-122.008,2770,4566,1905,0.45738295318127253,5107600,17347225,12239625
240000.0,3,1.0,1260,7920,1.0,0,0,2,7,1260,0,1966,0.0,98003,47.3452,-122.30799999999999,1300,7920,6660,0.8409090909090909,1587600,62726400,61138800
998000.0,3,2.25,3370,11757,2.0,0,2,3,9,3370,0,1980,0.0,98006,47.5573,-122.16,2690,10500,8387,0.7133622522752403,11356900,138227049,126870149
275000.0,3,1.75,1490,8000,1.0,0,0,2,8,1490,0,1978,0.0,98030,47.3817,-122.166,1740,8165,6510,0.81375,2220100,64000000,61779900
284200.0,3,2.5,1570,9292,1.0,0,0,2,7,1110,460,1977,0.0,98001,47.3386,-122.272,1470,9222,7722,0.8310374515712441,2464900,86341264,83876364
1720000.0,4,3.75,4490,7623,2.0,0,0,3,10,3090,1400,1941,0.0,98112,47.6315,-122.29,3760,7653,3133,0.41099304735668374,20160100,58110129,37950029
2400000.0,4,3.75,4090,24825,2.0,0,0,3,11,3400,690,1926,0.0,98102,47.6338,-122.319,3910,11500,20735,0.8352467270896274,16728100,616280625,599552525
930800.0,5,2.5,4150,96574,2.0,0,0,2,10,4150,0,1988,0.0,98053,47.6664,-122.045,3320,40803,92424,0.9570277714498726,17222500,9326537476,9309314976
930000.0,4,3.0,2900,10400,1.0,0,3,4,8,1530,1370,1959,0.0,98008,47.5854,-122.11399999999999,2820,10400,7500,0.7211538461538461,8410000,108160000,99750000
215000.0,4,1.5,1430,8775,1.0,0,0,2,7,1030,400,1979,0.0,98023,47.3034,-122.383,1390,7800,7345,0.837037037037037,2044900,77000625,74955725
480000.0,2,1.5,1008,26487,1.0,1,4,3,6,1008,0,1943,2002.0,98070,47.3853,-122.479,1132,24079,25479,0.9619435949711179,1016064,701561169,700545105
483945.0,2,1.75,1480,5120,1.0,0,0,3,6,840,640,1951,0.0,98116,47.558,-122.39200000000001,1090,5120,3640,0.7109375,2190400,26214400,24024000
347000.0,3,1.75,1240,8050,1.0,0,0,3,7,1240,0,1978,0.0,98074,47.6108,-122.044,1370,9856,6810,0.8459627329192546,1537600,64802500,63264900
232500.0,3,2.0,1370,9760,1.0,0,0,3,7,1110,260,1979,0.0,98023,47.3009,-122.384,1640,9040,8390,0.8596311475409836,1876900,95257600,93380700
390000.0,4,2.25,1770,33132,1.0,0,0,3,8,1190,580,1965,0.0,98058,47.4413,-122.15100000000001,2490,20000,31362,0.9465773270554148,3132900,1097729424,1094596524
550000.0,3,2.25,2160,15360,1.0,0,0,2,8,1410,750,1965,2000.0,98007,47.6232,-122.13799999999999,2180,8480,13200,0.859375,4665600,235929600,231264000
590000.0,4,2.5,2340,8971,2.0,0,0,2,9,2340,0,1987,0.0,98029,47.5679,-122.01100000000001,2510,9219,6631,0.7391595139895218,5475600,80478841,75003241
420850.0,1,1.0,960,40946,1.0,0,0,4,5,960,0,1945,0.0,98014,47.6951,-121.86399999999999,1320,20350,39986,0.9765544863967176,921600,1676574916,1675653316
345000.0,4,2.5,2280,8190,1.0,0,3,2,7,1390,890,1983,0.0,98188,47.4414,-122.272,1990,9000,5910,0.7216117216117216,5198400,67076100,61877700
429800.0,3,2.0,1970,7000,1.0,0,0,2,8,1970,0,1986,0.0,98038,47.3744,-122.04299999999999,1970,7365,5030,0.7185714285714285,3880900,49000000,45119100
302000.0,4,1.75,1530,17664,1.5,0,0,2,7,1530,0,1968,0.0,98058,47.4549,-122.155,1530,11625,16134,0.9133831521739131,2340900,312016896,309675996
800000.0,4,1.5,1790,3952,1.5,0,0,3,8,1790,0,1932,0.0,98103,47.68899999999999,-122.352,1200,3876,2162,0.5470647773279352,3204100,15618304,12414204
250000.0,3,2.5,1700,6000,2.0,0,0,2,8,1700,0,1997,0.0,98092,47.2615,-122.221,1940,6626,4300,0.7166666666666667,2890000,36000000,33110000
605000.0,3,2.0,2660,4500,1.0,0,0,3,7,1330,1330,1922,0.0,98199,47.6391,-122.40299999999999,1790,5000,1840,0.4088888888888889,7075600,20250000,13174400
412000.0,3,1.75,1950,52256,1.0,0,0,3,8,1950,0,1985,0.0,98042,47.3133,-122.07799999999999,2450,51836,50306,0.9626837109614207,3802500,2730689536,2726887036
252000.0,3,2.0,1340,5670,2.0,0,0,2,6,1340,0,1994,0.0,98055,47.4498,-122.194,1290,4892,4330,0.763668430335097,1795600,32148900,30353300
375000.0,3,1.0,1130,12500,1.5,0,0,2,7,1130,0,1954,0.0,98118,47.5491,-122.26799999999999,2280,8750,11370,0.9096,1276900,156250000,154973100
725000.0,2,1.75,1950,2719,1.0,0,0,4,7,1010,940,1919,0.0,98103,47.6513,-122.346,1360,1256,769,0.2828245678558293,3802500,7392961,3590461
471750.0,5,3.5,3790,8200,1.0,0,1,2,8,2120,1670,2001,0.0,98056,47.4891,-122.19,1740,8676,4410,0.5378048780487805,14364100,67240000,52875900
490000.0,4,2.25,2020,85813,2.0,0,0,2,7,2020,0,1995,0.0,98027,47.483000000000004,-122.02600000000001,2120,85813,83793,0.9764604430564133,4080400,7363870969,7359790569
439000.0,2,1.0,800,5100,1.0,0,0,2,7,800,0,1945,0.0,98117,47.6775,-122.38799999999999,1330,5100,4300,0.8431372549019608,640000,26010000,25370000
355000.0,4,2.0,1770,8890,1.0,0,0,4,6,1770,0,1949,0.0,98166,47.4589,-122.353,1010,7620,7120,0.8008998875140607,3132900,79032100,75899200
250000.0,1,0.75,940,87120,1.0,0,0,2,6,940,0,1944,0.0,98019,47.7182,-121.956,1930,165528,86180,0.9892102846648301,883600,7589894400,7589010800
780000.0,4,2.25,2260,16188,1.0,0,0,2,10,2260,0,1984,0.0,98006,47.5637,-122.11200000000001,2840,10158,13928,0.8603904126513466,5107600,262051344,256943744
409000.0,2,1.0,890,3271,1.0,0,0,3,6,890,0,1918,0.0,98116,47.5631,-122.381,1190,5175,2381,0.7279119535310302,792100,10699441,9907341
420000.0,2,1.0,860,3880,1.0,0,0,3,6,860,0,1916,0.0,98117,47.6862,-122.391,1230,4260,3020,0.7783505154639175,739600,15054400,14314800
200000.0,1,0.75,680,9600,1.0,0,0,2,5,680,0,1947,0.0,98115,47.6964,-122.306,1580,6624,8920,0.9291666666666667,462400,92160000,91697600
830000.0,2,1.5,2130,35679,1.0,0,0,3,7,2130,0,1963,0.0,98033,47.6638,-122.171,2670,35679,33549,0.9403010174051963,4536900,1272991041,1268454141
695000.0,3,2.5,2390,4555,2.0,0,0,2,9,2390,0,2006,0.0,98074,47.6199,-122.025,2540,4500,2165,0.47530186608122943,5712100,20748025,15035925
815000.0,4,2.75,3488,9614,2.0,0,0,2,10,3488,0,1998,0.0,98074,47.6055,-122.01299999999999,3600,10891,6126,0.6371957561888912,12166144,92428996,80262852
210000.0,3,1.75,1260,6223,1.0,0,0,2,7,820,440,1983,0.0,98042,47.3574,-122.15799999999999,1260,6553,4963,0.7975253093363329,1587600,38725729,37138129
635000.0,3,1.75,2940,6000,1.0,0,2,3,8,1590,1350,1957,0.0,98177,47.7235,-122.369,2880,8100,3060,0.51,8643600,36000000,27356400
562500.0,4,2.5,2440,7322,2.0,0,0,2,9,2440,0,1991,0.0,98056,47.5357,-122.179,2590,9927,4882,0.6667577164709095,5953600,53611684,47658084
402500.0,4,2.5,2600,11951,2.0,0,0,2,10,2600,0,1988,0.0,98023,47.3053,-122.34,2820,12093,9351,0.7824449836833738,6760000,142826401,136066401
555000.0,3,2.0,2080,7020,1.0,0,0,3,7,1040,1040,1951,0.0,98115,47.6768,-122.285,1920,7000,4940,0.7037037037037037,4326400,49280400,44954000
310000.0,3,1.0,1990,7173,1.0,0,0,2,7,1990,0,1972,0.0,98034,47.7116,-122.213,1320,7245,5183,0.7225707514289698,3960100,51451929,47491829
500000.0,4,2.5,2840,18001,2.0,0,0,2,9,2840,0,1994,0.0,98019,47.7359,-121.962,2500,18001,15161,0.8422309871673795,8065600,324036001,315970401
430000.0,6,3.0,2630,8800,1.0,0,0,2,7,1610,1020,1959,0.0,98125,47.7166,-122.29299999999999,1220,1173,6170,0.7011363636363637,6916900,77440000,70523100
1600000.0,3,4.25,2820,7200,2.0,0,0,3,10,2460,360,1930,0.0,98112,47.6298,-122.29,3300,7522,4380,0.6083333333333333,7952400,51840000,43887600
627500.0,4,1.0,1560,4080,1.5,0,0,2,7,1560,0,1923,0.0,98103,47.6711,-122.331,1890,4080,2520,0.6176470588235294,2433600,16646400,14212800
335000.0,4,2.5,2330,7050,2.0,0,0,2,8,2330,0,1998,0.0,98178,47.5001,-122.23100000000001,1810,5424,4720,0.6695035460992907,5428900,49702500,44273600
962000.0,4,2.25,3320,20100,1.0,0,0,3,8,1810,1510,1981,0.0,98006,47.5566,-122.15299999999999,2450,9821,16780,0.8348258706467662,11022400,404010000,392987600
299000.0,3,1.75,1730,14270,1.0,0,0,2,7,1730,0,1959,0.0,98065,47.5318,-121.833,1600,11232,12540,0.8787666433076384,2992900,203632900,200640000
399950.0,4,2.5,3110,5868,2.0,0,0,2,8,3110,0,2001,0.0,98042,47.3781,-122.126,2950,5924,2758,0.4700068166325835,9672100,34433424,24761324
322000.0,3,1.0,1230,9660,1.0,0,0,2,7,1230,0,1968,0.0,98053,47.6829,-122.06,1380,10125,8430,0.8726708074534162,1512900,93315600,91802700
430000.0,2,1.5,950,4625,1.0,0,0,3,7,950,0,1949,0.0,98103,47.6912,-122.34,1440,4625,3675,0.7945945945945946,902500,21390625,20488125
307000.0,3,1.75,1890,13860,1.0,0,0,4,7,1890,0,1966,0.0,98042,47.4156,-122.149,1500,14536,11970,0.8636363636363636,3572100,192099600,188527500
194000.0,3,1.5,1010,5000,1.0,0,0,2,6,1010,0,1943,0.0,98178,47.4925,-122.27799999999999,980,5000,3990,0.798,1020100,25000000,23979900
180000.0,3,1.0,1010,8581,1.0,0,0,3,6,1010,0,1920,0.0,98002,47.3043,-122.21600000000001,1060,10354,7571,0.8822981004544925,1020100,73633561,72613461
465000.0,4,2.25,2340,13383,1.0,0,0,2,8,1170,1170,1983,0.0,98074,47.6211,-122.037,1810,12532,11043,0.8251513113651647,5475600,179104689,173629089
722500.0,4,2.5,2460,9296,2.0,0,0,2,9,2460,0,1978,0.0,98007,47.6125,-122.152,2730,9900,6836,0.7353700516351118,6051600,86415616,80364016
470450.0,2,1.0,1010,3400,1.0,0,0,2,7,1010,0,1921,0.0,98103,47.6711,-122.329,1800,3600,2390,0.7029411764705882,1020100,11560000,10539900
280000.0,3,2.5,1650,6000,2.0,0,0,2,7,1650,0,1990,0.0,98030,47.36,-122.194,1750,6000,4350,0.725,2722500,36000000,33277500
176250.0,4,2.0,1440,6702,1.0,0,0,3,7,1440,0,1966,0.0,98002,47.3056,-122.21700000000001,1030,6702,5262,0.7851387645478961,2073600,44916804,42843204
560000.0,5,1.0,1710,9100,1.5,0,0,3,7,1320,390,1926,0.0,98126,47.5379,-122.37799999999999,1880,9100,7390,0.8120879120879121,2924100,82810000,79885900
830000.0,3,2.5,2760,11287,2.0,0,3,2,10,2000,760,1991,0.0,98028,47.739,-122.264,2760,13719,8527,0.7554708957207407,7617600,127396369,119778769
276900.0,2,1.0,1350,10096,1.0,0,2,3,7,1350,0,1952,0.0,98045,47.4967,-121.77799999999999,1280,10095,8746,0.866283676703645,1822500,101929216,100106716
625000.0,3,1.75,1660,4800,2.0,0,0,2,7,1660,0,1906,0.0,98112,47.6296,-122.30799999999999,1660,4800,3140,0.6541666666666667,2755600,23040000,20284400
1020000.0,4,2.5,2960,4760,2.0,0,0,2,8,2160,800,1900,0.0,98102,47.6367,-122.318,1600,4760,1800,0.37815126050420167,8761600,22657600,13896000
463500.0,1,1.0,1090,8750,1.0,0,0,3,6,1090,0,1924,0.0,98118,47.54,-122.26899999999999,1830,5000,7660,0.8754285714285714,1188100,76562500,75374400
485000.0,3,2.5,3110,9015,2.0,0,0,2,9,3110,0,1990,0.0,98058,47.4369,-122.147,2650,8960,5905,0.6550194120909595,9672100,81270225,71598125
272000.0,3,2.0,1380,7476,1.0,0,0,2,7,1380,0,1989,0.0,98001,47.3336,-122.272,1600,7227,6096,0.8154093097913323,1904400,55890576,53986176
305000.0,2,1.0,1290,3140,2.0,0,0,2,7,1290,0,2008,0.0,98053,47.6971,-122.02600000000001,1290,2628,1850,0.589171974522293,1664100,9859600,8195500
760000.0,3,2.5,1980,13964,1.0,0,0,4,7,1980,0,1959,0.0,98040,47.57100000000001,-122.227,2040,13964,11984,0.8582068175307934,3920400,194993296,191072896
387500.0,2,1.0,870,6126,1.0,0,0,3,7,870,0,1938,0.0,98125,47.7024,-122.322,1620,6126,5256,0.8579823702252694,756900,37527876,36770976
352000.0,4,2.5,2470,5015,2.0,0,0,2,8,2470,0,2004,0.0,98038,47.3457,-122.041,2470,5100,2545,0.5074775672981057,6100900,25150225,19049325
507000.0,3,1.75,2140,40098,1.0,0,0,4,8,1490,650,1950,0.0,98058,47.4296,-122.111,2220,35371,37958,0.9466307546511048,4579600,1607849604,1603270004
156000.0,3,1.0,770,9750,1.0,0,0,2,6,770,0,1941,0.0,98188,47.4509,-122.275,1560,10707,8980,0.921025641025641,592900,95062500,94469600
580000.0,3,3.25,1490,857,3.0,0,0,2,8,1220,270,2001,0.0,98102,47.6357,-122.324,1550,1092,-633,-0.7386231038506418,2220100,734449,-1485651
630000.0,4,2.5,2510,35020,1.0,0,0,3,8,1610,900,1977,0.0,98075,47.5834,-122.00299999999999,2080,34398,32510,0.9283266704740148,6300100,1226400400,1220100300
275000.0,5,1.5,1950,9000,1.0,0,0,2,7,1130,820,1964,0.0,98146,47.4882,-122.339,1680,9526,7050,0.7833333333333333,3802500,81000000,77197500
835000.0,5,4.0,3600,14720,1.0,0,2,4,8,1800,1800,1960,0.0,98034,47.7022,-122.227,3600,15358,11120,0.7554347826086957,12960000,216678400,203718400
340000.0,4,2.5,2380,7850,2.0,0,0,2,8,2380,0,1995,0.0,98055,47.4356,-122.20100000000001,1940,7334,5470,0.6968152866242038,5664400,61622500,55958100
329350.0,2,1.0,720,6687,1.0,0,0,2,6,720,0,1942,0.0,98117,47.7001,-122.36200000000001,840,6687,5967,0.892328398384926,518400,44715969,44197569
1480000.0,3,3.5,4070,26000,2.0,0,0,2,11,4070,0,1991,0.0,98033,47.659,-122.17399999999999,3770,26000,21930,0.8434615384615385,16564900,676000000,659435100
475000.0,3,1.0,1250,150117,1.0,0,0,2,7,1250,0,1975,0.0,98075,47.5956,-122.009,3060,50055,148867,0.9916731616006181,1562500,22535113689,22533551189
719950.0,3,2.25,2190,2416,3.0,0,0,2,8,2190,0,2014,0.0,98117,47.6758,-122.38,1510,3615,226,0.0935430463576159,4796100,5837056,1040956
235000.0,1,1.0,810,2451,1.0,0,0,4,7,810,0,1941,0.0,98126,47.5188,-122.376,980,1198,1641,0.6695226438188494,656100,6007401,5351301
875000.0,3,1.5,2440,5750,1.0,0,0,2,8,1320,1120,1939,0.0,98115,47.6991,-122.296,2160,6820,3310,0.5756521739130435,5953600,33062500,27108900
380000.0,4,1.75,1740,9150,1.0,0,0,2,7,1740,0,1974,0.0,98188,47.4498,-122.28,1540,9147,7410,0.8098360655737705,3027600,83722500,80694900
325000.0,3,2.25,1480,97138,1.5,0,0,2,7,1480,0,1984,0.0,98010,47.3317,-121.927,1730,176418,95658,0.9847639440795569,2190400,9435791044,9433600644
475000.0,4,2.5,2120,57050,2.0,0,0,2,9,2120,0,1989,0.0,98072,47.7611,-122.12799999999999,3320,39082,54930,0.9628396143733567,4494400,3254702500,3250208100
152900.0,1,1.0,900,4368,1.0,0,0,4,6,900,0,1915,1950.0,98022,47.2107,-121.99,1290,5000,3468,0.7939560439560439,810000,19079424,18269424
210000.0,2,2.0,1190,7570,1.0,0,0,2,6,1190,0,1939,0.0,98146,47.5113,-122.338,1190,7635,6380,0.8428005284015853,1416100,57304900,55888800
350000.0,4,1.0,1010,6000,1.0,0,0,2,6,750,260,1925,0.0,98136,47.5518,-122.383,1450,6000,4990,0.8316666666666667,1020100,36000000,34979900
505000.0,3,2.5,2100,17882,2.0,0,0,3,8,2100,0,1985,0.0,98059,47.4754,-122.119,2080,16686,15782,0.8825634716474667,4410000,319765924,315355924
464900.0,4,2.25,2020,8424,1.0,0,0,3,7,1380,640,1979,0.0,98034,47.7262,-122.23299999999999,2030,7236,6404,0.7602089268755935,4080400,70963776,66883376
650000.0,3,2.0,2520,5980,1.0,0,0,2,8,1790,730,1957,0.0,98116,47.5767,-122.383,1590,5750,3460,0.5785953177257525,6350400,35760400,29410000
369950.0,2,2.75,1370,1140,2.0,0,0,2,8,1080,290,2009,0.0,98133,47.7053,-122.34200000000001,1370,1090,-230,-0.20175438596491227,1876900,1299600,-577300
250000.0,3,2.5,1530,2890,2.0,0,0,2,7,1530,0,2001,0.0,98108,47.5434,-122.29299999999999,1540,2890,1360,0.47058823529411764,2340900,8352100,6011200
320000.0,3,2.5,1530,2890,2.0,0,0,2,7,1530,0,2001,0.0,98108,47.5434,-122.29299999999999,1540,2890,1360,0.47058823529411764,2340900,8352100,6011200
2530000.0,4,4.25,5040,16048,1.0,0,3,2,10,3420,1620,1950,0.0,98105,47.6702,-122.26,3960,14000,11008,0.6859421734795613,25401600,257538304,232136704
340000.0,4,2.25,2530,24700,2.0,0,0,2,7,2530,0,1974,0.0,98031,47.3939,-122.177,2650,24700,22170,0.8975708502024291,6400900,610090000,603689100
440000.0,2,1.5,1010,1968,1.5,0,0,4,5,1010,0,1906,0.0,98107,47.6757,-122.385,1760,4200,958,0.4867886178861789,1020100,3873024,2852924
219950.0,3,1.0,1200,7727,1.0,0,0,3,7,1200,0,1959,0.0,98022,47.2021,-121.999,1300,7718,6527,0.8447004011906303,1440000,59706529,58266529
940000.0,4,3.0,2720,11740,1.0,0,0,4,9,2720,0,1957,0.0,98040,47.5833,-122.242,2640,11740,9020,0.768313458262351,7398400,137827600,130429200
399950.0,4,1.5,1850,6125,1.5,0,0,2,6,1110,740,1945,0.0,98126,47.5352,-122.37,990,6125,4275,0.6979591836734694,3422500,37515625,34093125
1570000.0,3,2.75,2340,8828,1.0,0,0,3,9,2340,0,1954,0.0,98112,47.632,-122.289,3480,8526,6488,0.7349342999546896,5475600,77933584,72457984
528000.0,4,1.75,1860,9750,1.0,0,0,2,7,1460,400,1969,0.0,98034,47.7097,-122.20200000000001,1900,8913,7890,0.8092307692307692,3459600,95062500,91602900
545000.0,4,1.75,1940,8990,1.0,0,0,3,8,1560,380,1956,0.0,98034,47.7021,-122.241,2310,11745,7050,0.7842046718576196,3763600,80820100,77056500
575000.0,2,2.0,1680,6194,1.0,0,0,2,8,1680,0,2004,0.0,98053,47.7136,-122.03,1900,5850,4514,0.7287697772037456,2822400,38365636,35543236
235000.0,4,2.75,1770,10184,1.0,0,0,2,8,1250,520,1979,0.0,98023,47.3074,-122.385,2070,8320,8414,0.8261979575805185,3132900,103713856,100580956
272000.0,3,2.5,1790,6371,2.0,0,0,2,8,1790,0,1998,0.0,98092,47.3291,-122.16799999999999,1850,6371,4581,0.7190393972688746,3204100,40589641,37385541
380000.0,4,1.75,1720,9600,1.0,0,0,3,8,1720,0,1969,0.0,98059,47.4764,-122.155,1660,10720,7880,0.8208333333333333,2958400,92160000,89201600
195000.0,3,1.0,1280,6967,1.5,0,0,2,7,1280,0,1949,0.0,98155,47.7512,-122.329,1280,7245,5687,0.8162767331706617,1638400,48539089,46900689
297000.0,3,2.5,1690,4988,2.0,0,0,2,7,1690,0,2002,0.0,98038,47.3561,-122.015,1830,4733,3298,0.661186848436247,2856100,24880144,22024044
349000.0,4,2.5,2190,7294,2.0,0,0,2,8,2190,0,2003,0.0,98023,47.2923,-122.35700000000001,2240,7379,5104,0.6997532218261585,4796100,53202436,48406336
320000.0,2,1.0,710,5200,1.0,0,2,3,6,710,0,1942,0.0,98126,47.5376,-122.37100000000001,1610,5200,4490,0.8634615384615385,504100,27040000,26535900
319990.0,4,1.5,1890,10707,1.0,0,0,2,7,1890,0,1962,0.0,98148,47.428000000000004,-122.32600000000001,1610,8827,8817,0.8234799663771365,3572100,114639849,111067749
439900.0,2,2.0,1410,12282,1.5,0,0,4,8,1410,0,1909,0.0,98024,47.5242,-121.926,1410,8931,10872,0.8851978505129457,1988100,150847524,148859424
429000.0,3,3.25,2210,3600,2.0,0,0,2,8,1820,390,1995,0.0,98125,47.7031,-122.279,2010,6690,1390,0.3861111111111111,4884100,12960000,8075900
272500.0,3,2.0,1540,6250,1.0,0,0,2,7,1540,0,1998,0.0,98038,47.3539,-122.025,2070,6250,4710,0.7536,2371600,39062500,36690900
400000.0,4,2.0,1350,7255,1.0,0,0,3,7,1350,0,1959,0.0,98125,47.7287,-122.31,1050,7288,5905,0.8139214334941419,1822500,52635025,50812525
462000.0,5,2.0,1380,4300,1.5,0,0,2,7,1380,0,1916,0.0,98103,47.6647,-122.337,1830,3800,2920,0.6790697674418604,1904400,18490000,16585600
510000.0,2,1.0,890,6095,1.0,0,0,2,7,890,0,1947,0.0,98115,47.6823,-122.29799999999999,1450,5985,5205,0.8539786710418376,792100,37149025,36356925
550000.0,3,2.5,1900,3255,2.0,0,0,2,8,1900,0,1988,2000.0,98007,47.6075,-122.147,1880,3350,1355,0.4162826420890937,3610000,10595025,6985025
150000.0,3,1.0,1240,5200,1.0,0,0,2,6,1240,0,1969,0.0,98042,47.3701,-122.079,870,5200,3960,0.7615384615384615,1537600,27040000,25502400
460000.0,3,2.5,1730,8490,1.0,0,0,2,7,1210,520,1969,0.0,98034,47.7187,-122.219,1870,7400,6760,0.7962308598351001,2992900,72080100,69087200
632500.0,4,2.5,2090,10306,2.0,0,0,2,10,2090,0,1986,0.0,98074,47.6304,-122.051,2660,11481,8216,0.7972055113526101,4368100,106213636,101845536
361000.0,3,1.75,1650,11220,1.0,0,0,3,7,1650,0,1969,0.0,98077,47.7567,-122.071,1340,10129,9570,0.8529411764705882,2722500,125888400,123165900
437000.0,3,2.25,1130,1221,2.0,0,0,2,8,1030,100,2004,0.0,98117,47.6799,-122.375,1300,5000,91,0.07452907452907453,1276900,1490841,213941
370000.0,6,2.75,3240,5750,1.0,0,0,3,6,2160,1080,1950,0.0,98002,47.3054,-122.221,1230,5750,2510,0.4365217391304348,10497600,33062500,22564900
884250.0,4,2.5,3840,12151,2.0,0,0,2,10,3840,0,1998,0.0,98075,47.5953,-121.986,3560,11044,8311,0.683976627438071,14745600,147646801,132901201
225000.0,3,1.0,1200,9936,1.0,0,0,3,6,1200,0,1969,0.0,98038,47.3609,-122.029,1200,10189,8736,0.8792270531400966,1440000,98724096,97284096
235000.0,2,1.0,870,5000,1.0,0,0,2,6,870,0,1949,0.0,98126,47.5186,-122.375,820,5000,4130,0.826,756900,25000000,24243100
767500.0,6,3.5,2410,6000,2.0,0,4,2,9,2220,190,1916,1990.0,98136,47.54,-122.382,1980,6000,3590,0.5983333333333334,5808100,36000000,30191900
1200000.0,3,1.75,1560,8078,1.5,1,4,3,6,1560,0,1928,0.0,98040,47.5779,-122.24600000000001,2890,16710,6518,0.8068828918049022,2433600,65254084,62820484
715000.0,3,2.5,2410,46609,2.0,0,0,2,9,2410,0,1989,0.0,98053,47.6789,-122.04799999999999,3370,40072,44199,0.9482932480851338,5808100,2172398881,2166590781
417000.0,4,2.25,2300,7700,1.0,0,0,2,7,1380,920,1959,0.0,98125,47.7137,-122.322,2010,8820,5400,0.7012987012987013,5290000,59290000,54000000
199000.0,3,1.0,1390,12145,1.0,0,0,3,7,1390,0,1964,0.0,98042,47.4225,-122.15,1030,10800,10755,0.8855496088925484,1932100,147501025,145568925
875000.0,5,2.5,2920,5568,2.0,0,0,2,8,2320,600,1906,0.0,98112,47.6265,-122.31200000000001,2970,5568,2648,0.4755747126436782,8526400,31002624,22476224
545000.0,4,1.5,1370,3708,1.5,0,0,2,7,1370,0,1926,0.0,98117,47.6849,-122.363,2030,3708,2338,0.6305285868392665,1876900,13749264,11872364
192500.0,2,1.0,950,7692,1.0,0,0,2,6,950,0,1926,0.0,98168,47.4909,-122.29799999999999,1820,8221,6742,0.8764950598023921,902500,59166864,58264364
822500.0,3,2.5,3090,7708,2.0,0,0,2,10,3090,0,1999,0.0,98052,47.6868,-122.10799999999999,3140,8592,4618,0.5991177996886352,9548100,59413264,49865164
800000.0,4,2.5,2390,10000,1.0,0,0,2,9,1590,800,1975,0.0,98040,47.5801,-122.229,1900,9752,7610,0.761,5712100,100000000,94287900
1250000.0,3,2.5,2070,4944,2.0,0,0,2,9,2070,0,1930,0.0,98112,47.6256,-122.28399999999999,3300,6179,2874,0.5813106796116505,4284900,24443136,20158236
3850000.0,4,4.25,5770,21300,2.0,1,4,3,11,5770,0,1980,0.0,98040,47.585,-122.22200000000001,4620,22748,15530,0.7291079812206572,33292900,453690000,420397100
295000.0,3,2.5,1460,7936,2.0,0,0,2,7,1460,0,1995,0.0,98038,47.3673,-122.01700000000001,1830,7936,6476,0.8160282258064516,2131600,62980096,60848496
419000.0,2,1.75,1510,4980,1.0,0,0,2,8,1510,0,2006,0.0,98053,47.7191,-122.023,1350,4157,3470,0.6967871485943775,2280100,24800400,22520300
1200000.0,5,3.25,5180,19606,1.0,0,0,2,11,2610,2570,1993,0.0,98006,47.555,-122.11399999999999,4050,15296,14426,0.7357951647454861,26832400,384395236,357562836
750000.0,4,2.75,3430,13907,2.0,0,0,2,11,3430,0,1995,0.0,98075,47.5879,-121.993,3250,13851,10477,0.7533616164521464,11764900,193404649,181639749
502000.0,4,1.5,1700,8400,1.0,0,0,2,7,1700,0,1953,0.0,98177,47.7677,-122.359,1750,8475,6700,0.7976190476190477,2890000,70560000,67670000
1030000.0,3,1.75,2640,8000,1.0,0,3,3,9,1320,1320,1960,0.0,98040,47.5826,-122.24600000000001,2740,6000,5360,0.67,6969600,64000000,57030400
398500.0,3,1.0,1200,15960,1.5,0,0,2,6,1200,0,1945,0.0,98125,47.7163,-122.29899999999999,1120,7800,14760,0.924812030075188,1440000,254721600,253281600
700000.0,2,1.5,1850,4945,1.5,0,2,3,7,1850,0,1907,1969.0,98126,47.5742,-122.37899999999999,1850,4950,3095,0.6258847320525783,3422500,24453025,21030525
248000.0,5,1.5,1510,9078,1.0,0,0,3,7,1510,0,1959,0.0,98168,47.4852,-122.305,1480,9078,7568,0.8336638025996915,2280100,82410084,80129984
800000.0,4,2.0,2130,2800,1.0,0,0,4,7,1070,1060,1922,0.0,98103,47.6545,-122.333,1990,3990,670,0.2392857142857143,4536900,7840000,3303100
383000.0,4,2.5,2640,8055,2.0,0,0,2,9,2640,0,2004,0.0,98092,47.315,-122.193,1650,8055,5415,0.6722532588454376,6969600,64883025,57913425
688000.0,4,3.0,3000,4000,1.5,0,3,2,8,1970,1030,1913,2014.0,98144,47.5744,-122.307,1900,4000,1000,0.25,9000000,16000000,7000000
521000.0,3,2.0,1870,5455,1.0,0,0,4,7,1060,810,1926,0.0,98125,47.7029,-122.29700000000001,1870,7435,3585,0.6571952337305225,3496900,29757025,26260125
365000.0,2,1.0,990,9223,1.0,0,0,2,7,990,0,1949,0.0,98125,47.72,-122.32,1230,7244,8233,0.8926596552098016,980100,85063729,84083629
491000.0,3,2.0,2005,7000,1.0,0,0,2,7,1605,400,1980,0.0,98122,47.6039,-122.29799999999999,1750,4500,4995,0.7135714285714285,4020025,49000000,44979975
643000.0,3,2.75,2030,7700,1.0,0,0,4,8,1400,630,1965,0.0,98008,47.62600000000001,-122.11200000000001,1780,8160,5670,0.7363636363636363,4120900,59290000,55169100
279000.0,3,2.5,1500,7350,1.0,0,0,1,7,1060,440,1979,0.0,98023,47.3025,-122.382,1390,7770,5850,0.7959183673469388,2250000,54022500,51772500
583500.0,4,1.0,1530,3900,1.5,0,0,3,7,1530,0,1908,0.0,98107,47.6748,-122.37899999999999,1300,3900,2370,0.6076923076923076,2340900,15210000,12869100
310000.0,3,2.5,1990,3600,2.0,0,0,2,7,1990,0,2004,0.0,98038,47.3841,-122.041,1790,3600,1610,0.44722222222222224,3960100,12960000,8999900
310000.0,3,1.75,1420,7650,1.0,0,0,3,7,1100,320,1984,0.0,98056,47.4892,-122.182,1810,7650,6230,0.8143790849673203,2016400,58522500,56506100
280000.0,3,1.0,1400,13975,1.0,0,0,3,6,1400,0,1956,0.0,98198,47.4195,-122.33,1260,7500,12575,0.8998211091234347,1960000,195300625,193340625
272000.0,4,2.5,1870,5692,2.0,0,0,2,7,1870,0,2004,0.0,98058,47.4334,-122.148,2390,5293,3822,0.6714687280393534,3496900,32398864,28901964
870000.0,4,3.0,3040,36246,1.5,0,0,2,9,2680,360,1923,2014.0,98074,47.6093,-122.07,3520,13178,33206,0.9161286762677261,9241600,1313772516,1304530916
307000.0,3,2.0,1790,7259,1.0,0,0,2,7,1390,400,1980,0.0,98058,47.4643,-122.171,1790,7700,5469,0.7534095605455297,3204100,52693081,49488981
490000.0,2,1.5,1590,4500,1.0,0,0,3,7,920,670,1946,0.0,98116,47.5831,-122.39200000000001,1900,4450,2910,0.6466666666666666,2528100,20250000,17721900
399950.0,3,2.0,2050,9396,1.0,0,0,4,7,1170,880,1960,0.0,98155,47.7447,-122.32799999999999,1680,9391,7346,0.7818220519369945,4202500,88284816,84082316
1640000.0,5,3.5,4220,26784,1.0,0,0,2,10,2110,2110,1958,2006.0,98004,47.6003,-122.206,3450,33945,22564,0.8424432497013142,17808400,717382656,699574256
989000.0,5,4.5,4030,13474,2.0,0,0,2,11,4030,0,2000,0.0,98075,47.5812,-121.995,3860,12438,9444,0.7009054475285735,16240900,181548676,165307776
264950.0,4,1.75,1770,9011,1.0,0,0,4,7,1050,720,1983,0.0,98042,47.3646,-122.07600000000001,1410,8530,7241,0.8035734102763289,3132900,81198121,78065221
491500.0,4,2.75,2100,7236,1.0,0,0,2,8,1400,700,1979,0.0,98034,47.7267,-122.23200000000001,1900,7519,5136,0.7097844112769486,4410000,52359696,47949696
345000.0,3,2.25,2120,15003,2.0,0,0,2,7,2120,0,1984,0.0,98059,47.4745,-122.12,2070,15203,12883,0.8586949276811304,4494400,225090009,220595609
339900.0,4,1.75,2600,18042,1.0,0,0,3,8,2020,580,1969,0.0,98092,47.2969,-122.189,2200,9408,15442,0.8558918080035472,6760000,325513764,318753764
852000.0,3,3.0,2400,4000,2.0,0,0,2,7,1860,540,1905,0.0,98102,47.6288,-122.321,1750,3940,1600,0.4,5760000,16000000,10240000
585000.0,5,3.5,3180,40946,1.0,0,3,2,7,1690,1490,1968,0.0,98075,47.5833,-122.073,2430,29620,37766,0.9223367361891271,10112400,1676574916,1666462516
723000.0,4,2.0,2790,8793,1.0,0,0,3,8,1640,1150,1977,0.0,98006,47.5509,-122.16,2400,9286,6003,0.6827021494370522,7784100,77316849,69532749
594000.0,3,2.25,2080,70567,2.0,0,0,2,8,2080,0,1990,0.0,98072,47.7221,-122.124,3730,43560,68487,0.9705244661102215,4326400,4979701489,4975375089
405000.0,2,1.5,1370,4102,2.0,0,0,3,7,1370,0,1987,0.0,98033,47.6943,-122.184,1380,3211,2732,0.6660165772793759,1876900,16826404,14949504
725500.0,4,2.5,2790,74495,2.0,0,0,2,9,2790,0,1997,0.0,98053,47.6628,-122.056,2790,24643,71705,0.9625478220014766,7784100,5549505025,5541720925
800000.0,2,1.0,1740,5719,1.0,0,0,2,8,1740,0,1955,0.0,98103,47.6729,-122.335,1980,5000,3979,0.695751005420528,3027600,32706961,29679361
1330000.0,3,3.75,6400,76665,1.0,0,2,3,10,3810,0,1966,0.0,98177,47.7313,-122.37,3430,60548,70265,0.9165199243461815,40960000,5877522225,5836562225
180500.0,3,2.5,1800,8518,2.0,0,0,2,7,1800,0,1996,0.0,98030,47.3643,-122.185,1770,7570,6718,0.7886827893871801,3240000,72556324,69316324
325000.0,3,2.5,1800,8518,2.0,0,0,2,7,1800,0,1996,0.0,98030,47.3643,-122.185,1770,7570,6718,0.7886827893871801,3240000,72556324,69316324
235000.0,3,1.75,1190,7280,1.0,0,0,3,7,1190,0,1968,0.0,98092,47.3151,-122.19,1250,7800,6090,0.8365384615384616,1416100,52998400,51582300
330000.0,2,1.0,860,8308,1.0,0,0,3,7,860,0,1948,0.0,98146,47.5075,-122.37700000000001,1310,8308,7448,0.8964853153586905,739600,69022864,68283264
678500.0,3,2.0,2460,6600,1.0,0,2,3,8,1370,1090,1952,0.0,98136,47.5215,-122.383,2150,6600,4140,0.6272727272727273,6051600,43560000,37508400
463000.0,4,2.5,1980,6660,2.0,0,0,3,7,1980,0,1974,0.0,98034,47.7158,-122.167,1980,7150,4680,0.7027027027027027,3920400,44355600,40435200
250000.0,2,1.0,670,4640,1.0,0,0,2,6,670,0,1943,0.0,98106,47.53,-122.351,870,4501,3970,0.8556034482758621,448900,21529600,21080700
655000.0,3,2.0,1410,4800,1.5,0,0,3,8,1410,0,1927,0.0,98118,47.5597,-122.26700000000001,1820,7200,3390,0.70625,1988100,23040000,21051900
239900.0,4,2.25,1860,7000,1.0,0,0,2,8,1120,740,1979,0.0,98023,47.3127,-122.339,1990,8937,5140,0.7342857142857143,3459600,49000000,45540400
185000.0,3,1.0,980,9135,1.0,0,0,2,7,980,0,1955,0.0,98001,47.3496,-122.289,1780,9135,8155,0.89272030651341,960400,83448225,82487825
1740000.0,4,2.25,3040,5000,2.0,0,3,3,9,2080,960,1926,0.0,98105,47.6565,-122.27799999999999,2870,5000,1960,0.392,9241600,25000000,15758400
251700.0,3,2.25,1810,11800,1.0,0,0,2,7,1240,570,1977,0.0,98178,47.4997,-122.23100000000001,1810,5641,9990,0.8466101694915255,3276100,139240000,135963900
400000.0,4,2.0,1560,8250,1.0,0,0,2,8,1320,240,1964,0.0,98177,47.7565,-122.35799999999999,1870,8258,6690,0.8109090909090909,2433600,68062500,65628900
735000.0,4,1.75,2100,7960,1.0,0,0,2,8,1340,760,1955,0.0,98004,47.6079,-122.195,2060,7960,5860,0.7361809045226131,4410000,63361600,58951600
1700000.0,5,2.0,2500,15250,2.0,1,4,4,8,2500,0,1942,0.0,98008,47.5883,-122.111,1880,18782,12750,0.8360655737704918,6250000,232562500,226312500
82500.0,2,1.0,520,22334,1.0,0,0,1,5,520,0,1951,0.0,98168,47.4799,-122.296,1572,10570,21814,0.9767171129220024,270400,498807556,498537156
765000.0,4,4.0,3010,7221,2.0,0,0,2,10,3010,0,2004,0.0,98075,47.5833,-121.97,3490,7518,4211,0.583160227115358,9060100,52142841,43082741
292500.0,4,1.75,2140,8162,1.0,0,0,2,7,1420,720,1968,0.0,98023,47.3096,-122.37700000000001,2040,7632,6022,0.7378093604508699,4579600,66618244,62038644
270000.0,3,2.25,2390,7000,1.0,0,0,3,7,1990,400,1970,0.0,98058,47.4568,-122.169,1610,7000,4610,0.6585714285714286,5712100,49000000,43287900
415000.0,2,1.0,1510,6807,1.0,0,0,2,7,1090,420,1939,0.0,98133,47.71100000000001,-122.353,1460,6807,5297,0.7781695313647715,2280100,46335249,44055149
950000.0,4,1.75,2210,19025,1.0,0,0,3,7,1460,750,1952,0.0,98004,47.5927,-122.20299999999999,2640,14999,16815,0.8838370565045992,4884100,361950625,357066525
353000.0,3,2.75,2170,8396,2.0,0,0,2,7,2170,0,1995,0.0,98038,47.3812,-122.023,2170,8378,6226,0.7415435921867556,4708900,70492816,65783916
670950.0,3,2.5,1790,2375,3.0,0,0,2,8,1790,0,2007,0.0,98107,47.6726,-122.38,1450,2400,585,0.2463157894736842,3204100,5640625,2436525
280950.0,3,1.75,1390,8700,1.0,0,3,3,7,840,550,1912,0.0,98055,47.4725,-122.20200000000001,1390,10875,7310,0.8402298850574713,1932100,75690000,73757900
585000.0,3,1.75,1850,7735,1.0,0,0,3,8,1850,0,1983,0.0,98027,47.5608,-122.08200000000001,2220,7639,5885,0.7608274078862314,3422500,59830225,56407725
525000.0,2,1.5,1480,43645,1.0,0,0,2,8,1480,0,1974,0.0,98027,47.5484,-122.045,1600,34326,42165,0.9660900446786573,2190400,1904886025,1902695625
605000.0,3,1.75,1850,8823,1.0,0,0,3,8,1370,480,1973,0.0,98008,47.6379,-122.11200000000001,1880,7580,6973,0.790320752578488,3422500,77845329,74422829
1010000.0,4,3.5,3350,3752,2.0,0,0,2,9,2550,800,2007,0.0,98117,47.6782,-122.365,1050,4960,402,0.10714285714285714,11222500,14077504,2855004
245990.0,3,1.0,1040,8410,1.0,0,0,2,7,1040,0,1942,2014.0,98188,47.453,-122.289,1350,8410,7370,0.8763376932223543,1081600,70728100,69646500
535000.0,4,2.25,2810,12607,2.0,0,0,2,10,2810,0,1985,0.0,98058,47.4585,-122.13,2810,17400,9797,0.7771079558975172,7896100,158936449,151040349
410000.0,1,1.5,1010,5750,1.0,0,0,2,7,1010,0,1911,1948.0,98136,47.5411,-122.39200000000001,1230,5750,4740,0.8243478260869566,1020100,33062500,32042400
550000.0,3,2.5,2250,7752,2.0,0,0,3,8,2250,0,1988,0.0,98011,47.7489,-122.185,2080,7033,5502,0.7097523219814241,5062500,60093504,55031004
665000.0,3,1.75,1800,8000,1.0,0,0,2,8,1800,0,1972,0.0,98008,47.6357,-122.119,1950,8500,6200,0.775,3240000,64000000,60760000
455000.0,3,1.0,2400,17239,1.0,0,0,3,7,1890,510,1940,0.0,98028,47.75,-122.245,2390,7350,14839,0.8607807877487094,5760000,297183121,291423121
440000.0,4,1.0,1780,4000,1.5,0,0,2,7,1780,0,1922,0.0,98103,47.6624,-122.354,1750,4000,2220,0.555,3168400,16000000,12831600
332000.0,3,2.25,2120,14915,1.0,0,0,2,9,1720,400,1979,0.0,98001,47.3524,-122.285,2320,13100,12795,0.8578612135434127,4494400,222457225,217962825
280000.0,3,2.5,1860,6607,2.0,0,0,2,7,1860,0,1989,0.0,98023,47.2891,-122.351,1760,6766,4747,0.718480399576207,3459600,43652449,40192849
570000.0,3,3.5,1460,1021,2.0,0,0,2,8,1150,310,2006,0.0,98122,47.6169,-122.309,1460,1245,-439,-0.4299706170421156,2131600,1042441,-1089159
250000.0,3,1.0,1230,10350,1.0,0,0,3,7,1230,0,1957,0.0,98055,47.428000000000004,-122.199,1510,10427,9120,0.881159420289855,1512900,107122500,105609600
238000.0,2,1.0,1088,8453,1.0,0,0,2,6,1088,0,1952,2009.0,98001,47.2685,-122.23100000000001,1088,8016,7365,0.8712883000118301,1183744,71453209,70269465
265000.0,3,1.0,800,5760,1.0,0,0,2,6,700,0,1949,0.0,98155,47.7505,-122.31700000000001,1060,6628,4960,0.8611111111111112,640000,33177600,32537600
306000.0,3,1.0,1190,10350,1.0,0,0,3,7,1190,0,1959,0.0,98028,47.7428,-122.244,1850,10500,9160,0.885024154589372,1416100,107122500,105706400
345000.0,5,2.75,1940,4182,1.0,0,0,2,7,1240,700,2002,0.0,98056,47.4911,-122.17,1950,4182,2242,0.5361071257771401,3763600,17489124,13725524
765000.0,4,2.5,3300,10764,1.0,0,0,3,9,1720,1580,1971,0.0,98177,47.7119,-122.365,2290,10975,7464,0.693422519509476,10890000,115863696,104973696
346300.0,4,2.5,2590,11018,2.0,0,0,2,8,2590,0,1998,0.0,98092,47.2634,-122.211,2400,8042,8428,0.7649301143583227,6708100,121396324,114688224
342500.0,3,2.0,2080,11375,1.0,0,0,2,8,2080,0,2002,0.0,98022,47.214,-121.993,1080,12899,9295,0.8171428571428572,4326400,129390625,125064225
501000.0,4,2.25,2680,5439,2.0,0,0,2,7,2680,0,2000,0.0,98011,47.7534,-122.21799999999999,2460,4473,2759,0.5072623644052215,7182400,29582721,22400321
270000.0,3,2.5,1670,8364,1.0,0,0,3,7,1300,370,1990,0.0,98042,47.369,-122.084,1490,8143,6694,0.8003347680535629,2788900,69956496,67167596
638000.0,3,1.0,1830,4400,1.5,0,0,3,8,1720,110,1930,0.0,98122,47.6052,-122.3,1650,4400,2570,0.5840909090909091,3348900,19360000,16011100
460000.0,3,1.75,1400,2003,1.0,0,0,3,8,700,700,1908,2006.0,98119,47.6508,-122.368,1370,1281,603,0.30104842735896153,1960000,4012009,2052009
760000.0,4,1.75,2770,8521,1.0,0,0,3,7,1470,1300,1953,0.0,98004,47.6255,-122.199,1910,9380,5751,0.6749207839455463,7672900,72607441,64934541
1090000.0,3,2.5,3630,11019,1.0,0,0,3,9,2150,1480,1972,0.0,98040,47.56100000000001,-122.226,3150,13555,7389,0.6705690171521916,13176900,121418361,108241461
234000.0,3,1.0,1040,8128,1.0,0,0,2,6,1040,0,1983,0.0,98019,47.7425,-121.98100000000001,1520,7500,7088,0.8720472440944882,1081600,66064384,64982784
1650000.0,3,2.75,2690,8890,2.0,1,4,3,10,2690,0,1975,0.0,98006,47.5487,-122.197,2940,8890,6200,0.6974128233970753,7236100,79032100,71796000
488000.0,5,2.0,2020,5000,1.5,0,0,3,7,2020,0,1938,0.0,98117,47.6949,-122.37,1510,6600,2980,0.596,4080400,25000000,20919600
1550000.0,5,2.5,2450,20805,2.0,0,0,3,9,2450,0,1963,0.0,98004,47.6275,-122.227,3020,20324,18355,0.8822398461908195,6002500,432848025,426845525
499000.0,4,3.0,2030,12675,2.0,0,0,2,7,2030,0,1982,0.0,98177,47.7689,-122.37899999999999,1990,7705,10645,0.8398422090729784,4120900,160655625,156534725
150000.0,3,1.0,1450,6776,1.0,0,0,2,7,1450,0,1952,0.0,98178,47.5056,-122.244,1680,7200,5326,0.7860094451003542,2102500,45914176,43811676
333000.0,4,2.5,2400,7270,2.0,0,0,2,8,2400,0,1993,0.0,98003,47.2697,-122.31200000000001,2150,6584,4870,0.6698762035763411,5760000,52852900,47092900
700000.0,4,2.75,2870,8625,1.0,0,1,3,8,1860,1010,1959,0.0,98155,47.7425,-122.289,2430,8479,5755,0.6672463768115942,8236900,74390625,66153725
275000.0,4,1.0,1340,22500,1.5,0,0,2,7,1340,0,1926,0.0,98168,47.489,-122.316,1620,10800,21160,0.9404444444444444,1795600,506250000,504454400
330000.0,3,2.5,1680,11312,1.0,0,0,2,7,1080,600,1959,0.0,98146,47.5051,-122.344,1390,10700,9632,0.8514851485148515,2822400,127961344,125138944
360000.0,4,2.0,1850,8827,1.0,0,0,2,7,1850,0,1969,0.0,98155,47.7406,-122.31299999999999,1310,6901,6977,0.7904157697972131,3422500,77915929,74493429
467000.0,3,1.0,1220,8040,1.5,0,0,2,7,1220,0,1965,0.0,98125,47.7133,-122.30799999999999,1360,8040,6820,0.8482587064676617,1488400,64641600,63153200
568000.0,3,2.5,2320,57063,1.0,0,0,3,9,1790,530,1979,0.0,98074,47.6163,-122.056,3290,7314,54743,0.9593431820969806,5382400,3256185969,3250803569
605000.0,5,2.25,3220,9603,2.0,0,0,2,8,3220,0,1972,0.0,98052,47.6474,-122.11,2260,10093,6383,0.6646881182963658,10368400,92217609,81849209
750000.0,4,2.75,3190,9023,2.0,0,0,2,9,3190,0,2005,0.0,98075,47.5898,-121.98899999999999,3159,5615,5833,0.6464590490967528,10176100,81414529,71238429
760000.0,3,2.75,3530,69834,2.0,0,0,2,10,3530,0,1994,0.0,98053,47.6377,-121.995,3560,74256,66304,0.9494515565483862,12460900,4876787556,4864326656
265000.0,3,1.75,2050,10519,1.0,0,0,2,7,1240,810,1979,0.0,98058,47.4257,-122.146,1770,9605,8469,0.8051145546154578,4202500,110649361,106446861
490000.0,3,1.75,1720,12540,1.0,0,0,3,7,1720,0,1956,0.0,98006,47.5699,-122.177,1440,11850,10820,0.8628389154704944,2958400,157251600,154293200
360000.0,4,2.5,2850,4650,2.0,0,0,2,8,2850,0,2004,0.0,98038,47.3552,-122.02600000000001,2850,4650,1800,0.3870967741935484,8122500,21622500,13500000
311750.0,4,2.25,2270,12000,1.0,0,0,3,7,1290,980,1976,0.0,98023,47.3287,-122.353,2030,23980,9730,0.8108333333333333,5152900,144000000,138847100
399000.0,3,2.25,1880,12473,1.0,0,0,2,8,1420,460,1958,0.0,98028,47.7623,-122.256,2300,10469,10593,0.8492744327747935,3534400,155575729,152041329
347000.0,4,2.5,2770,9751,2.0,0,0,2,8,2770,0,1989,0.0,98042,47.3739,-122.126,2370,6950,6981,0.7159265716336786,7672900,95082001,87409101
1680000.0,4,3.75,4490,34982,2.0,0,0,2,12,4490,0,1998,0.0,98005,47.6406,-122.156,4470,37525,30492,0.8716482762563604,20160100,1223740324,1203580224
585000.0,4,2.5,3110,6479,2.0,0,0,2,9,3110,0,2005,0.0,98065,47.5408,-121.861,3110,7075,3369,0.5199876524154963,9672100,41977441,32305341
340000.0,4,2.5,2360,7475,2.0,0,0,2,8,2360,0,1992,0.0,98031,47.4052,-122.17,2280,7570,5115,0.6842809364548496,5569600,55875625,50306025
612000.0,3,2.5,2180,5496,2.0,0,0,2,8,2180,0,1994,0.0,98029,47.5723,-122.007,2120,5496,3316,0.6033478893740902,4752400,30206016,25453616
230000.0,2,1.75,1910,3376,2.0,0,0,2,8,1910,0,1980,0.0,98038,47.3733,-122.057,1470,3623,1466,0.43424170616113744,3648100,11397376,7749276
604000.0,4,2.5,2260,7753,2.0,0,0,2,9,2260,0,1989,0.0,98029,47.5752,-121.995,2690,8924,5493,0.7084999355088353,5107600,60109009,55001409
250000.0,3,1.75,1770,8868,1.0,0,0,3,7,1770,0,1959,0.0,98002,47.3188,-122.212,1630,9706,7098,0.800405953991881,3132900,78641424,75508524
258500.0,3,2.0,1460,7930,1.0,0,0,2,7,1460,0,1989,0.0,98038,47.358999999999995,-122.04899999999999,1630,7930,6470,0.8158890290037831,2131600,62884900,60753300
783000.0,4,2.75,2080,5000,1.0,0,0,4,8,1470,610,1940,0.0,98199,47.6422,-122.40299999999999,1970,5000,2920,0.584,4326400,25000000,20673600
1050000.0,5,2.25,2960,7680,1.0,0,2,4,8,1550,1410,1958,0.0,98199,47.6456,-122.389,2860,7680,4720,0.6145833333333334,8761600,58982400,50220800
760000.0,4,2.5,3220,4031,2.0,0,0,2,9,3220,0,2002,0.0,98033,47.688,-122.163,3150,5083,811,0.20119077152071446,10368400,16248961,5880561
276000.0,3,1.0,1140,5000,1.0,0,0,2,7,1140,0,1960,0.0,98106,47.5535,-122.36200000000001,1140,5000,3860,0.772,1299600,25000000,23700400
550000.0,4,2.0,1660,12377,1.0,0,0,2,8,1660,0,1966,0.0,98008,47.6231,-122.102,1820,8968,10717,0.8658802617758746,2755600,153190129,150434529
398000.0,4,1.0,1430,6240,1.5,0,0,4,7,1430,0,1953,0.0,98125,47.7272,-122.311,1410,6240,4810,0.7708333333333334,2044900,38937600,36892700
775000.0,3,3.0,1820,4300,1.5,0,0,3,8,1620,200,1914,1983.0,98107,47.6711,-122.36399999999999,1440,4300,2480,0.5767441860465117,3312400,18490000,15177600
1030000.0,4,3.0,3540,10202,2.0,0,0,2,8,2720,820,1988,0.0,98006,47.5471,-122.155,2780,10714,6662,0.6530092138796314,12531600,104080804,91549204
327000.0,4,1.0,1620,6000,1.5,0,0,4,7,1620,0,1905,0.0,98055,47.4763,-122.206,1310,6000,4380,0.73,2624400,36000000,33375600
564500.0,4,2.75,3100,14568,2.0,0,0,2,8,3100,0,1995,0.0,98019,47.7302,-121.97399999999999,2860,14396,11468,0.7872048325096102,9610000,212226624,202616624
782000.0,4,1.75,1500,6820,1.5,0,0,4,7,1500,0,1905,0.0,98117,47.6794,-122.37,1360,4125,5320,0.7800586510263929,2250000,46512400,44262400
398000.0,4,2.5,2820,5510,2.0,0,0,2,9,2820,0,2005,0.0,98038,47.3477,-122.024,2820,5510,2690,0.4882032667876588,7952400,30360100,22407700
257000.0,3,1.75,1850,10920,1.5,0,0,2,6,1850,0,1915,0.0,98034,47.7244,-122.22200000000001,1510,7871,9070,0.8305860805860806,3422500,119246400,115823900
235000.0,4,2.0,1570,9415,2.0,0,0,3,7,1570,0,1984,0.0,98092,47.3168,-122.17399999999999,1550,8978,7845,0.8332448220924057,2464900,88642225,86177325
453000.0,4,2.75,2300,37533,1.0,0,3,4,8,1550,750,1979,0.0,98070,47.3714,-122.431,2130,10092,35233,0.9387205925452269,5290000,1408726089,1403436089
535000.0,2,1.0,920,9000,1.0,0,0,0,6,920,0,1954,0.0,98033,47.6831,-122.189,1760,8400,8080,0.8977777777777778,846400,81000000,80153600
275000.0,3,2.5,1600,7000,2.0,0,0,3,8,1600,0,1993,0.0,98038,47.3534,-122.057,1700,7000,5400,0.7714285714285715,2560000,49000000,46440000
665000.0,3,2.5,2630,10047,2.0,0,0,2,9,2630,0,1996,0.0,98027,47.5515,-122.083,2640,10620,7417,0.7382303175077137,6916900,100942209,94025309
670000.0,4,2.75,3020,13530,1.0,0,0,3,8,1540,1480,1977,0.0,98052,47.6299,-122.09899999999999,2230,11896,10510,0.7767923133776792,9120400,183060900,173940500
465000.0,3,1.75,1490,10757,1.0,0,0,2,7,1060,430,1966,0.0,98034,47.72,-122.229,1490,10609,9267,0.861485544296737,2220100,115713049,113492949
210000.0,3,1.5,1160,5200,1.0,0,0,4,7,1160,0,1970,0.0,98042,47.364,-122.094,1170,5200,4040,0.7769230769230769,1345600,27040000,25694400
265000.0,4,2.5,2040,4443,2.0,0,0,2,8,2040,0,2001,0.0,98092,47.3182,-122.189,2040,4637,2403,0.5408507765023632,4161600,19740249,15578649
426000.0,2,2.5,1550,2657,2.0,0,0,3,8,1550,0,1987,0.0,98033,47.7034,-122.18799999999999,1570,2442,1107,0.4166353029732781,2402500,7059649,4657149
529219.0,4,2.25,1990,7610,1.0,0,0,3,8,1290,700,1966,0.0,98008,47.6236,-122.103,1820,8198,5620,0.7385019710906702,3960100,57912100,53952000
600000.0,3,2.25,1900,46609,1.5,0,0,3,7,1440,460,1969,0.0,98072,47.7529,-122.116,2460,43560,44709,0.9592353408140059,3610000,2172398881,2168788881
875000.0,5,3.5,3840,8279,2.0,0,0,2,9,3840,0,2001,0.0,98074,47.6039,-122.059,3570,8279,4439,0.5361758666505617,14745600,68541841,53796241
608000.0,4,3.0,2400,7680,1.0,0,0,2,7,1200,1200,1956,0.0,98199,47.6466,-122.389,2670,6342,5280,0.6875,5760000,58982400,53222400
220000.0,3,1.0,1660,21514,1.0,0,0,3,7,1660,0,1973,0.0,98022,47.2159,-121.964,1660,21600,19854,0.9228409407827461,2755600,462852196,460096596
1760000.0,4,5.0,6055,21630,1.0,0,3,3,12,3555,2500,1996,0.0,98006,47.5524,-122.11200000000001,4890,19223,15575,0.7200647249190939,36663025,467856900,431193875
295450.0,3,2.0,2030,17120,1.0,0,2,3,8,1890,140,1966,0.0,98092,47.2953,-122.185,1870,13662,15090,0.8814252336448598,4120900,293094400,288973500
315000.0,2,1.0,840,5087,1.0,0,0,2,7,840,0,1925,0.0,98118,47.5557,-122.27799999999999,1590,5087,4247,0.8348732062119127,705600,25877569,25171969
205000.0,4,2.0,1450,8175,1.0,0,0,3,7,1450,0,1967,0.0,98031,47.3933,-122.195,1570,9024,6725,0.8226299694189603,2102500,66830625,64728125
310000.0,3,1.5,1460,9908,1.0,0,0,2,7,1460,0,1952,0.0,98148,47.4275,-122.331,1420,9582,8448,0.8526443278159064,2131600,98168464,96036864
1000000.0,5,1.0,2010,5210,1.5,0,0,2,9,1890,120,1927,0.0,98119,47.6501,-122.37,2330,5000,3200,0.6142034548944337,4040100,27144100,23104000
525000.0,4,2.5,2910,7631,2.0,0,2,2,9,2910,0,2006,0.0,98038,47.3552,-122.001,3190,5552,4721,0.6186607259861093,8468100,58232161,49764061
284000.0,4,1.75,1880,8800,1.0,0,0,2,7,1130,750,1960,0.0,98168,47.5137,-122.333,1340,8733,6920,0.7863636363636364,3534400,77440000,73905600
510000.0,3,1.75,2170,26460,1.0,0,0,2,8,1450,720,1986,0.0,98074,47.6147,-122.045,2090,29075,24290,0.917989417989418,4708900,700131600,695422700
405000.0,2,1.0,1260,4377,1.0,0,0,3,7,1260,0,1947,0.0,98103,47.6988,-122.354,1420,6376,3117,0.7121315969842358,1587600,19158129,17570529
509950.0,3,2.5,1970,9153,2.0,0,0,2,8,1970,0,2007,0.0,98028,47.7698,-122.26799999999999,1800,9800,7183,0.7847700207582213,3880900,83777409,79896509
600000.0,4,2.25,2090,45738,2.0,0,0,2,8,2090,0,1987,0.0,98053,47.6876,-122.04899999999999,3420,45738,43648,0.9543049543049543,4368100,2091964644,2087596544
990000.0,4,3.75,3450,4940,2.0,0,0,2,10,2570,880,2006,0.0,98103,47.692,-122.338,1880,5387,1490,0.3016194331983806,11902500,24403600,12501100
280005.0,3,1.5,1130,7200,1.0,0,0,2,7,1130,0,1954,0.0,98178,47.5041,-122.25299999999999,1130,7200,6070,0.8430555555555556,1276900,51840000,50563100
700000.0,3,1.75,2600,7668,1.0,0,0,3,8,1300,1300,1968,0.0,98010,47.3402,-122.046,1980,13664,5068,0.6609285341679708,6760000,58798224,52038224
330000.0,3,1.0,1030,7620,1.0,0,0,2,7,1030,0,1953,0.0,98126,47.5281,-122.375,1030,7560,6590,0.8648293963254593,1060900,58064400,57003500
340000.0,2,1.0,1700,6718,1.0,0,2,2,7,1230,470,1956,0.0,98198,47.4131,-122.331,2040,7500,5018,0.746948496576362,2890000,45131524,42241524
468000.0,2,2.5,1480,2167,2.0,0,0,2,8,1390,90,2007,0.0,98052,47.6658,-122.132,2130,2556,687,0.31702814951545916,2190400,4695889,2505489
1340000.0,4,2.5,4250,19387,2.0,0,2,3,9,3260,990,1972,0.0,98040,47.5578,-122.212,3690,17024,15137,0.7807809356785474,18062500,375855769,357793269
515000.0,3,1.75,1600,20873,1.0,0,0,2,8,1600,0,1955,0.0,98006,47.5632,-122.182,2640,18364,19273,0.923345949312509,2560000,435682129,433122129
245000.0,4,2.0,1870,8750,1.0,0,2,2,7,1870,0,1977,0.0,98022,47.1985,-122.001,1770,8207,6880,0.7862857142857143,3496900,76562500,73065600
265000.0,3,2.5,1440,7741,1.0,0,0,3,7,1000,440,1983,0.0,98031,47.4042,-122.194,1680,7316,6301,0.8139775222839426,2073600,59923081,57849481
372400.0,3,2.5,2720,11937,2.0,0,0,2,9,2720,0,1990,0.0,98031,47.4185,-122.212,2590,9683,9217,0.7721370528608528,7398400,142491969,135093569
390000.0,3,1.5,1240,8410,1.0,0,0,4,6,1240,0,1948,0.0,98155,47.753,-122.32799999999999,1630,8410,7170,0.8525564803804994,1537600,70728100,69190500
208000.0,3,1.0,1020,6120,1.0,0,0,3,7,1020,0,1967,0.0,98002,47.278,-122.205,1370,8000,5100,0.8333333333333334,1040400,37454400,36414000
273000.0,2,0.5,1180,7750,1.0,0,0,3,6,590,590,1945,0.0,98155,47.769,-122.316,1380,8976,6570,0.847741935483871,1392400,60062500,58670100
455000.0,5,3.5,3080,7759,2.0,0,0,2,8,2310,770,2003,0.0,98019,47.7454,-121.977,2980,8223,4679,0.6030416290759119,9486400,60202081,50715681
270000.0,4,2.5,1750,6397,2.0,0,0,2,7,1750,0,1988,0.0,98023,47.3082,-122.35799999999999,1940,6502,4647,0.7264342660622166,3062500,40921609,37859109
618000.0,4,2.25,2530,8736,1.0,0,0,3,7,1210,1320,1958,0.0,98008,47.6049,-122.126,1720,8500,6206,0.7103937728937729,6400900,76317696,69916796
213550.0,3,2.5,1580,8541,2.0,0,0,2,7,1580,0,1990,0.0,98001,47.3334,-122.289,1640,7542,6961,0.8150099519962534,2496400,72948681,70452281
210000.0,5,1.75,2340,9148,2.0,0,0,2,7,2340,0,1957,0.0,98198,47.4232,-122.324,1390,10019,6808,0.7442063839090511,5475600,83685904,78210304
2750000.0,5,4.0,6300,16065,2.0,0,1,2,12,4360,1940,2004,0.0,98004,47.5922,-122.20700000000001,3260,17287,9765,0.6078431372549019,39690000,258084225,218394225
403500.0,4,2.75,2400,3844,1.0,0,0,4,7,1200,1200,1974,0.0,98133,47.7027,-122.34700000000001,1100,3844,1444,0.3756503642039542,5760000,14776336,9016336
235000.0,3,1.5,1300,7600,1.0,0,0,3,7,1300,0,1963,0.0,98022,47.2083,-122.005,1570,7600,6300,0.8289473684210527,1690000,57760000,56070000
287500.0,3,2.0,1760,7147,1.0,0,0,3,6,880,880,1936,0.0,98055,47.4799,-122.23200000000001,1720,7147,5387,0.7537428291590877,3097600,51079609,47982009
546800.0,4,1.5,1520,5910,1.0,0,0,2,7,1020,500,1946,0.0,98115,47.6904,-122.295,1710,5910,4390,0.7428087986463621,2310400,34928100,32617700
183000.0,3,1.75,1070,8100,1.0,0,0,3,6,1070,0,1957,0.0,98002,47.2853,-122.22,1260,8100,7030,0.8679012345679012,1144900,65610000,64465100
560000.0,3,2.0,2560,216777,1.0,0,0,2,8,2560,0,1986,0.0,98092,47.295,-122.086,2360,108463,214217,0.9881906290796533,6553600,46992267729,46985714129
299500.0,3,1.0,1280,6726,1.0,0,0,2,6,1280,0,1958,0.0,98144,47.5724,-122.301,1630,5000,5446,0.8096937258400237,1638400,45239076,43600676
610000.0,4,2.25,1660,7350,1.0,0,0,2,8,1660,0,1965,2014.0,98008,47.6263,-122.124,1790,7455,5690,0.7741496598639456,2755600,54022500,51266900
288350.0,3,1.5,1860,7963,1.0,0,0,2,7,1200,660,1963,0.0,98188,47.4513,-122.26799999999999,1800,10400,6103,0.7664196910712043,3459600,63409369,59949769
500000.0,2,1.0,950,4500,1.0,0,2,2,7,850,100,1926,0.0,98103,47.6562,-122.354,1670,4000,3550,0.7888888888888889,902500,20250000,19347500
625000.0,4,2.75,2140,4000,1.0,0,0,2,7,1190,950,1951,0.0,98115,47.6792,-122.287,2140,4770,1860,0.465,4579600,16000000,11420400
418000.0,2,1.5,1480,1349,2.0,0,0,2,7,1240,240,2007,0.0,98136,47.5439,-122.38600000000001,1550,1349,-131,-0.09710896960711639,2190400,1819801,-370599
660000.0,3,3.0,2260,1825,2.0,0,0,2,8,1660,600,2002,0.0,98122,47.6108,-122.30799999999999,2260,1834,-435,-0.23835616438356164,5107600,3330625,-1776975
775000.0,4,2.5,2300,6158,2.0,0,0,2,9,2300,0,1999,0.0,98115,47.6943,-122.29899999999999,2170,6434,3858,0.6265021110750244,5290000,37920964,32630964
429500.0,3,2.75,1650,7272,1.0,0,0,3,7,1230,420,1972,0.0,98034,47.7232,-122.17399999999999,1770,7272,5622,0.773102310231023,2722500,52881984,50159484
569000.0,3,2.0,1990,3000,1.5,0,0,2,7,1230,760,1908,1970.0,98112,47.6272,-122.29,1600,4080,1010,0.33666666666666667,3960100,9000000,5039900
250000.0,4,2.0,1960,7560,1.0,0,0,4,7,1160,800,1978,0.0,98031,47.4081,-122.178,1950,7560,5600,0.7407407407407407,3841600,57153600,53312000
225000.0,3,1.5,1310,10491,1.0,0,0,3,7,1310,0,1969,0.0,98042,47.3682,-122.148,1430,9664,9181,0.8751310647221427,1716100,110061081,108344981
530000.0,4,2.75,2450,15002,1.0,0,0,4,9,2450,0,1974,0.0,98166,47.4268,-122.34299999999999,2650,15055,12552,0.8366884415411279,6002500,225060004,219057504
306000.0,3,1.0,910,8658,1.0,0,0,2,7,910,0,1955,0.0,98155,47.7586,-122.303,1170,10200,7748,0.8948948948948949,828100,74960964,74132864
517100.0,3,1.75,1580,9719,1.0,0,0,4,7,1580,0,1962,0.0,98056,47.5396,-122.18,1760,8539,8139,0.8374318345508798,2496400,94458961,91962561
354950.0,3,1.75,1780,9689,1.0,0,0,2,7,1130,650,1976,0.0,98072,47.7628,-122.163,1660,9786,7909,0.8162865104757973,3168400,93876721,90708321
348000.0,3,1.5,1040,1824,1.0,0,0,2,6,1040,0,1925,0.0,98115,47.6793,-122.3,1010,5100,784,0.4298245614035088,1081600,3326976,2245376
522250.0,4,2.5,2340,41600,1.0,0,0,2,8,1640,700,1977,0.0,98077,47.7466,-122.07700000000001,2340,34960,39260,0.94375,5475600,1730560000,1725084400
275000.0,3,2.5,1720,8755,1.0,0,0,2,8,1000,720,1983,0.0,98023,47.3186,-122.391,1720,8690,7035,0.8035408338092519,2958400,76650025,73691625
390000.0,3,1.5,1600,10440,1.0,0,0,2,7,1600,0,1954,0.0,98125,47.7109,-122.311,1600,8816,8840,0.8467432950191571,2560000,108993600,106433600
260000.0,3,1.5,1320,9750,1.0,0,0,2,7,1320,0,1954,0.0,98148,47.4267,-122.331,1530,9750,8430,0.8646153846153846,1742400,95062500,93320100
585000.0,5,2.75,2350,4178,1.5,0,0,2,8,1520,830,1922,2015.0,98112,47.6388,-122.3,1920,4178,1828,0.43752991862134993,5522500,17455684,11933184
605000.0,5,2.75,2740,5616,1.5,0,0,4,7,1670,1070,1925,0.0,98115,47.6866,-122.31700000000001,1600,4592,2876,0.5121082621082621,7507600,31539456,24031856
342000.0,4,2.5,2300,6448,2.0,0,0,2,8,2300,0,2001,0.0,98030,47.3813,-122.204,1860,5872,4148,0.6433002481389578,5290000,41576704,36286704
900000.0,5,3.0,4350,37169,2.0,0,0,2,10,2950,1400,1972,0.0,98005,47.6518,-122.16,3280,41631,32819,0.8829669886195486,18922500,1381534561,1362612061
252000.0,3,1.75,1430,7700,1.0,0,0,3,7,980,450,1981,0.0,98031,47.3993,-122.18299999999999,1430,8625,6270,0.8142857142857143,2044900,59290000,57245100
357000.0,3,1.75,2400,14012,1.0,0,0,2,9,2400,0,1971,0.0,98003,47.3371,-122.325,2800,13988,11612,0.8287182415072795,5760000,196336144,190576144
370000.0,3,1.0,940,7910,1.0,0,0,3,6,940,0,1959,0.0,98008,47.6181,-122.117,1000,7700,6970,0.8811630847029077,883600,62568100,61684500
322500.0,3,1.0,1020,13504,1.0,0,0,4,7,1020,0,1959,0.0,98056,47.5121,-122.17,1110,11158,12484,0.9244668246445498,1040400,182358016,181317616
210000.0,2,2.0,1680,5756,2.0,0,0,3,7,1680,0,1910,0.0,98002,47.3065,-122.22200000000001,1340,5447,4076,0.7081306462821404,2822400,33131536,30309136
290000.0,2,1.0,1340,9840,1.0,0,0,2,7,1340,0,1949,0.0,98133,47.7202,-122.339,1610,8949,8500,0.8638211382113821,1795600,96825600,95030000
860000.0,4,3.25,3960,7012,2.0,0,0,2,10,3960,0,2005,0.0,98075,47.5854,-122.08,3680,8522,3052,0.4352538505419281,15681600,49168144,33486544
302000.0,6,2.0,2650,4621,1.5,0,0,2,8,2650,0,1911,0.0,98118,47.5543,-122.275,1640,4879,1971,0.42653105388444057,7022500,21353641,14331141
369160.0,4,2.25,2120,9680,2.0,0,2,3,8,2120,0,1965,0.0,98003,47.3367,-122.33200000000001,2360,9647,7560,0.78099173553719,4494400,93702400,89208000
1190000.0,4,2.75,2850,3000,2.5,0,0,2,9,2530,320,2003,0.0,98112,47.6406,-122.304,2083,4500,150,0.05,8122500,9000000,877500
993000.0,4,2.0,2850,14810,2.0,0,0,4,8,2490,360,1954,0.0,98004,47.5892,-122.20299999999999,2430,10454,11960,0.8075624577987845,8122500,219336100,211213600
380000.0,6,2.0,1870,6969,1.0,0,0,3,7,1870,0,1968,0.0,98027,47.5342,-122.036,1500,6969,5099,0.7316688190558186,3496900,48566961,45070061
635000.0,4,2.0,2660,8160,1.0,0,0,3,7,1380,1280,1949,0.0,98177,47.7229,-122.359,1660,8160,5500,0.6740196078431373,7075600,66585600,59510000
260000.0,3,1.0,1190,11120,1.0,0,0,2,6,1190,0,1947,0.0,98024,47.5687,-121.898,1230,12720,9930,0.8929856115107914,1416100,123654400,122238300
243000.0,2,1.0,1770,5522,1.5,0,0,3,7,960,810,1943,0.0,98178,47.4974,-122.23100000000001,1830,7378,3752,0.6794639623324882,3132900,30492484,27359584
1400000.0,4,2.5,2770,8879,2.0,0,0,2,9,2770,0,2001,0.0,98004,47.5831,-122.193,2770,8882,6109,0.688027931073319,7672900,78836641,71163741
665000.0,4,2.5,2080,8100,1.0,0,2,4,8,1220,860,1952,0.0,98177,47.7228,-122.369,2090,8100,6020,0.7432098765432099,4326400,65610000,61283600
898000.0,5,2.25,2700,9000,2.0,0,0,4,9,2700,0,1987,0.0,98007,47.6599,-122.146,2630,9000,6300,0.7,7290000,81000000,73710000
583000.0,4,2.75,2200,9453,1.0,0,0,4,8,1100,1100,1955,0.0,98144,47.5744,-122.305,1390,5355,7253,0.7672696498466095,4840000,89359209,84519209
429000.0,4,1.75,2160,7700,2.0,0,0,1,8,2160,0,1977,0.0,98033,47.6976,-122.169,2080,7700,5540,0.7194805194805195,4665600,59290000,54624400
471000.0,3,2.5,2010,4059,2.0,0,0,2,8,2010,0,1998,0.0,98034,47.7317,-122.197,2010,5779,2049,0.5048041389504804,4040100,16475481,12435381
1810000.0,3,3.5,3780,8295,2.0,0,0,2,9,2430,1350,1951,0.0,98112,47.6394,-122.29,3780,9127,4515,0.5443037974683544,14288400,68807025,54518625
739500.0,3,3.25,4460,51177,2.0,0,0,2,9,4460,0,2005,0.0,98042,47.3648,-122.14299999999999,2670,38925,46717,0.9128514762490962,19891600,2619085329,2599193729
450000.0,3,1.5,1770,17208,1.0,0,0,2,8,1160,610,1959,0.0,98006,47.5659,-122.117,2450,17118,15438,0.8971408647140865,3132900,296115264,292982364
552500.0,3,1.0,1430,5000,1.0,0,0,2,7,1430,0,1949,0.0,98117,47.6895,-122.37,1210,5000,3570,0.714,2044900,25000000,22955100
437000.0,4,1.75,1700,10642,1.0,0,0,3,7,850,850,1954,0.0,98006,47.5674,-122.14200000000001,1610,11200,8942,0.8402555910543131,2890000,113252164,110362164
270000.0,4,2.0,1830,5220,1.5,0,0,2,7,1830,0,1951,0.0,98118,47.5331,-122.27799999999999,1760,5757,3390,0.6494252873563219,3348900,27248400,23899500
226740.0,3,1.5,1410,8800,1.0,0,0,3,7,1410,0,1965,0.0,98092,47.2927,-122.18299999999999,2180,10108,7390,0.8397727272727272,1988100,77440000,75451900
446500.0,4,2.5,3060,7920,1.0,0,0,2,8,1810,0,1974,0.0,98028,47.7675,-122.26100000000001,2690,7767,4860,0.6136363636363636,9363600,62726400,53362800
283000.0,3,2.0,1820,15068,2.0,0,2,2,7,1520,300,1920,0.0,98022,47.2103,-121.999,1490,9589,13248,0.8792142288293071,3312400,227044624,223732224
445000.0,4,1.75,2430,13211,1.5,0,0,3,7,2430,0,1909,1978.0,98024,47.5245,-121.926,1330,10500,10781,0.8160623722655364,5904900,174530521,168625621
250000.0,2,1.0,740,6840,1.0,0,0,4,6,740,0,1942,0.0,98126,47.5172,-122.375,740,6840,6100,0.8918128654970761,547600,46785600,46238000
307000.0,3,1.0,770,6552,1.0,0,0,2,6,670,100,1942,0.0,98146,47.5133,-122.37200000000001,920,7200,5782,0.8824786324786325,592900,42928704,42335804
315000.0,4,2.75,2200,8580,1.0,0,0,2,8,1860,340,1991,0.0,98023,47.295,-122.37,2290,7816,6380,0.7435897435897436,4840000,73616400,68776400
555000.0,3,3.0,2920,23085,1.5,0,2,2,7,1540,1380,1908,0.0,98136,47.5159,-122.395,2270,18180,20165,0.8735109378384233,8526400,532917225,524390825
264900.0,4,2.5,2040,7000,1.0,0,0,2,7,1250,790,1979,0.0,98031,47.4056,-122.176,1900,7378,4960,0.7085714285714285,4161600,49000000,44838400
510000.0,3,2.0,1600,4510,1.0,0,0,2,7,990,610,1978,0.0,98103,47.6939,-122.34,1580,4561,2910,0.6452328159645233,2560000,20340100,17780100
328000.0,4,2.5,1990,3980,2.0,0,0,2,7,1990,0,2002,0.0,98058,47.4445,-122.17,1990,4373,1990,0.5,3960100,15840400,11880300
358000.0,4,2.5,1830,7308,2.0,0,0,2,7,1830,0,2002,0.0,98038,47.3565,-122.015,1830,5692,5478,0.7495894909688013,3348900,53406864,50057964
325000.0,3,2.5,2540,4260,2.0,0,0,2,7,2540,0,2005,0.0,98042,47.3989,-122.164,2190,4260,1720,0.40375586854460094,6451600,18147600,11696000
1370000.0,2,3.25,2700,3444,3.0,1,3,2,9,2700,0,1990,0.0,98075,47.5684,-122.06,2710,3444,744,0.21602787456445993,7290000,11861136,4571136
230000.0,4,2.0,1440,10800,1.0,0,0,3,7,1440,0,1967,0.0,98001,47.3417,-122.28299999999999,1190,7380,9360,0.8666666666666667,2073600,116640000,114566400
545000.0,3,2.0,1550,4000,1.0,0,0,2,7,940,610,1955,0.0,98199,47.6379,-122.387,1880,4000,2450,0.6125,2402500,16000000,13597500
705380.0,3,2.5,2490,4343,2.0,0,0,2,9,2490,0,2003,0.0,98029,47.5493,-121.993,2130,4106,1853,0.42666359659221736,6200100,18861649,12661549
459000.0,5,2.5,2650,12987,1.0,0,0,3,7,1350,1300,1979,0.0,98028,47.7482,-122.244,2160,12726,10337,0.795949795949796,7022500,168662169,161639669
815000.0,4,2.25,2000,3800,2.0,0,0,2,8,2000,0,2001,0.0,98115,47.6852,-122.311,1610,3800,1800,0.47368421052631576,4000000,14440000,10440000
495000.0,6,5.0,3440,4500,2.0,0,0,2,8,3280,160,2007,0.0,98055,47.4871,-122.219,1400,5500,1060,0.23555555555555555,11833600,20250000,8416400
520000.0,3,2.5,2280,58712,2.5,0,3,2,9,2280,0,1987,0.0,98010,47.3053,-122.0,2240,24332,56432,0.9611663714402507,5198400,3447098944,3441900544
430000.0,2,1.5,1320,1194,3.0,0,0,2,7,1320,0,2001,0.0,98107,47.6704,-122.39,1320,1250,-126,-0.10552763819095477,1742400,1425636,-316764
255000.0,4,2.5,2070,7800,2.0,0,0,2,8,2070,0,1989,0.0,98003,47.3487,-122.315,1950,7815,5730,0.7346153846153847,4284900,60840000,56555100
588000.0,3,2.0,1860,4777,2.0,0,0,4,7,1860,0,1908,0.0,98115,47.6892,-122.311,1580,3822,2917,0.6106342893029097,3459600,22819729,19360129
350000.0,3,1.0,940,7811,1.0,0,0,2,6,940,0,1959,0.0,98008,47.6195,-122.118,1180,7490,6871,0.8796568941236718,883600,61011721,60128121
625000.0,4,2.75,2290,21486,1.0,0,2,4,7,2290,0,1963,0.0,98006,47.5515,-122.189,2540,15936,19196,0.8934189704924137,5244100,461648196,456404096
172500.0,2,2.0,1510,20685,1.0,0,0,1,6,1250,260,1958,0.0,98059,47.481,-122.116,1490,29527,19175,0.9270002417210539,2280100,427869225,425589125
554000.0,3,2.0,1830,3500,1.5,0,0,4,7,1290,540,1909,0.0,98116,47.573,-122.383,1530,4000,1670,0.47714285714285715,3348900,12250000,8901100
775000.0,4,2.5,3090,7112,2.0,0,0,2,9,3090,0,2001,0.0,98052,47.705,-122.118,3050,6000,4022,0.5655230596175478,9548100,50580544,41032444
1190000.0,4,3.5,4340,217800,2.0,0,0,2,11,4340,0,2003,0.0,98053,47.6471,-122.01299999999999,3430,219106,213460,0.9800734618916437,18835600,47436840000,47418004400
618000.0,3,2.75,3200,12682,2.0,0,1,2,9,3200,0,1977,0.0,98028,47.7443,-122.26,2880,10432,9482,0.7476738684750039,10240000,160833124,150593124
305000.0,4,1.0,1560,8450,1.5,0,0,3,6,1560,0,1954,0.0,98166,47.4552,-122.354,1380,8100,6890,0.8153846153846154,2433600,71402500,68968900
232000.0,3,2.0,1280,13356,1.0,0,0,2,7,1280,0,1994,0.0,98042,47.3715,-122.074,1590,8071,12076,0.9041629230308476,1638400,178382736,176744336
262000.0,4,2.5,2020,6236,2.0,0,0,2,7,2020,0,2002,0.0,98001,47.2796,-122.24700000000001,1940,5076,4216,0.6760744066709429,4080400,38887696,34807296
234000.0,3,1.0,1040,8122,1.0,0,0,4,7,1040,0,1971,0.0,98198,47.3731,-122.31200000000001,1470,8676,7082,0.8719527210046787,1081600,65966884,64885284
500000.0,4,2.75,2260,7209,1.0,0,3,2,7,1330,930,2002,0.0,98125,47.7088,-122.302,1790,10860,4949,0.6865029823831322,5107600,51969681,46862081
278000.0,3,1.0,860,7632,1.0,0,0,2,6,860,0,1920,0.0,98166,47.4623,-122.345,890,7632,6772,0.8873165618448637,739600,58247424,57507824
230000.0,5,1.0,1920,19040,1.0,0,0,2,7,1160,760,1961,0.0,98168,47.4756,-122.294,1920,11520,17120,0.8991596638655462,3686400,362521600,358835200
500000.0,4,1.75,2290,9215,1.0,0,0,4,8,1270,1020,1969,0.0,98027,47.5328,-122.051,2290,10200,6925,0.7514921323928377,5244100,84916225,79672125
366500.0,4,2.75,2070,9300,1.0,0,0,4,7,1120,950,1945,0.0,98155,47.7416,-122.32,1010,8308,7230,0.7774193548387097,4284900,86490000,82205100
665000.0,6,3.0,4250,4400,2.5,0,0,3,7,3020,1230,1902,0.0,98118,47.5584,-122.28299999999999,1520,4950,150,0.03409090909090909,18062500,19360000,1297500
1100000.0,3,1.5,2220,4830,2.0,0,3,2,9,1790,430,1928,0.0,98116,47.5825,-122.4,1670,4830,2610,0.5403726708074534,4928400,23328900,18400500
575000.0,2,1.75,1840,4076,1.0,0,0,2,8,1140,700,1957,0.0,98117,47.6875,-122.39299999999999,1540,4076,2236,0.5485770363101079,3385600,16613776,13228176
674750.0,4,2.5,2590,9753,2.0,0,0,2,10,2590,0,1993,0.0,98075,47.5848,-122.027,2800,9917,7163,0.7344406849174613,6708100,95121009,88412909
719000.0,5,2.0,3110,6131,1.0,0,0,4,7,1560,1550,1940,0.0,98118,47.5615,-122.279,1720,6600,3021,0.49274180394715383,9672100,37589161,27917061
482000.0,3,1.75,2600,105587,1.0,0,0,3,7,1300,1300,1980,0.0,98070,47.4464,-122.49700000000001,1941,208438,102987,0.9753757564851734,6760000,11148614569,11141854569
254000.0,2,1.0,1060,8187,1.0,0,0,3,6,1060,0,1952,0.0,98133,47.7508,-122.34899999999999,1260,8188,7127,0.8705264443630145,1123600,67026969,65903369
443725.0,3,1.75,1250,3880,1.0,0,0,3,7,750,500,1944,0.0,98117,47.6869,-122.39200000000001,1240,3880,2630,0.6778350515463918,1562500,15054400,13491900
575000.0,4,2.5,2520,35636,2.0,0,0,2,8,2520,0,1980,0.0,98053,47.652,-122.031,2230,35673,33116,0.9292849927040072,6350400,1269924496,1263574096
469000.0,3,2.25,2070,9957,1.0,0,0,2,8,1440,630,1977,0.0,98155,47.7766,-122.277,2070,10158,7887,0.7921060560409762,4284900,99141849,94856949
175000.0,2,1.0,1300,44431,1.0,0,0,4,6,1300,0,1958,0.0,98001,47.327,-122.26700000000001,1470,14850,43131,0.9707411491976323,1690000,1974113761,1972423761
437000.0,5,2.0,2190,8316,1.0,0,0,2,7,1390,800,1961,0.0,98108,47.5488,-122.29799999999999,2010,8316,6126,0.7366522366522367,4796100,69155856,64359756
550000.0,4,3.0,2760,13113,1.0,0,0,3,8,1760,1000,1974,0.0,98028,47.7669,-122.26799999999999,1900,13113,10353,0.7895218485472432,7617600,171950769,164333169
172040.0,3,2.25,1710,7134,1.0,0,0,3,7,1130,580,1979,0.0,98031,47.3911,-122.191,1790,7455,5424,0.7603027754415476,2924100,50893956,47969856
363000.0,3,2.0,1750,7000,1.0,0,0,2,8,1750,0,1993,0.0,98038,47.3693,-122.041,1840,6969,5250,0.75,3062500,49000000,45937500
282000.0,3,2.25,1552,3600,2.0,0,0,2,7,1552,0,2012,0.0,98092,47.3198,-122.178,1677,3600,2048,0.5688888888888889,2408704,12960000,10551296
400000.0,6,2.0,2350,6554,2.0,0,1,2,8,2000,350,1905,0.0,98178,47.5115,-122.256,1560,6554,4204,0.6414403417760146,5522500,42954916,37432416
650000.0,5,3.5,5110,10018,2.0,0,0,2,10,3850,1260,2003,0.0,98034,47.7261,-122.17,1790,10018,4908,0.4899181473347974,26112100,100360324,74248224
365000.0,3,2.5,1720,99916,2.0,0,0,3,7,1720,0,1990,0.0,98042,47.3391,-122.09299999999999,1340,73180,98196,0.9827855398534769,2958400,9983207056,9980248656
269950.0,4,2.5,1960,7230,2.0,0,0,2,8,1960,0,2002,0.0,98023,47.2855,-122.36,1850,7208,5270,0.7289073305670816,3841600,52272900,48431300
260000.0,2,1.0,1270,19602,1.0,0,0,2,6,1270,0,1977,0.0,98010,47.3375,-122.04799999999999,1270,17699,18332,0.9352106927864504,1612900,384238404,382625504
193000.0,3,1.5,1180,7000,1.0,0,0,3,7,1180,0,1977,0.0,98023,47.2959,-122.37299999999999,1630,7500,5820,0.8314285714285714,1392400,49000000,47607600
340000.0,4,2.25,2230,6791,2.0,0,0,2,8,2230,0,2005,0.0,98038,47.3769,-122.02799999999999,2420,6297,4561,0.6716242085112649,4972900,46117681,41144781
900000.0,4,3.25,4700,38412,2.0,0,0,2,10,3420,1280,1978,0.0,98005,47.6445,-122.167,3640,35571,33712,0.8776424034155993,22090000,1475481744,1453391744
371000.0,3,2.5,2150,8361,2.0,0,0,2,8,2150,0,1991,0.0,98058,47.4627,-122.12899999999999,2150,9368,6211,0.7428537256309053,4622500,69906321,65283821
592000.0,3,2.5,2400,81892,2.0,0,0,2,8,2400,0,1985,0.0,98045,47.5028,-121.76899999999999,1370,37270,79492,0.970693107995897,5760000,6706299664,6700539664
300000.0,3,2.5,1830,12750,2.0,0,0,2,7,1830,0,1991,0.0,98168,47.5003,-122.32799999999999,1610,10000,10920,0.8564705882352941,3348900,162562500,159213600
449950.0,4,3.0,2800,6977,2.0,0,0,2,8,2800,0,2003,0.0,98038,47.3542,-122.014,2800,6600,4177,0.5986813816826716,7840000,48678529,40838529
299500.0,3,2.5,2090,7163,2.0,0,0,2,8,2090,0,1989,0.0,98003,47.2735,-122.295,2320,8634,5073,0.7082228116710876,4368100,51308569,46940469
995000.0,4,2.25,2340,13406,1.0,0,0,3,9,2340,0,1963,0.0,98040,47.5377,-122.221,2340,10743,11066,0.8254512904669551,5475600,179720836,174245236
335000.0,4,1.75,1670,9472,1.0,0,0,2,7,1100,570,1960,0.0,98106,47.5299,-122.35700000000001,1080,5195,7802,0.8236908783783784,2788900,89718784,86929884
280000.0,4,2.25,1990,7350,1.0,0,0,3,8,1180,810,1978,0.0,98003,47.3258,-122.32799999999999,2030,7210,5360,0.7292517006802721,3960100,54022500,50062400
446000.0,4,2.25,2270,7800,1.0,0,0,2,7,1290,980,1977,0.0,98034,47.7278,-122.19200000000001,1480,7280,5530,0.708974358974359,5152900,60840000,55687100
1540000.0,4,2.75,4910,15139,1.0,0,0,3,10,2560,2350,1964,0.0,98004,47.6444,-122.22,3980,15139,10229,0.6756721051588612,24108100,229189321,205081221
325000.0,3,1.0,950,4500,1.0,0,0,3,6,950,0,1943,0.0,98118,47.5273,-122.265,1140,4500,3550,0.7888888888888889,902500,20250000,19347500
450000.0,3,1.75,1610,11200,1.0,0,0,2,7,1610,0,1955,0.0,98033,47.6641,-122.176,1610,11200,9590,0.85625,2592100,125440000,122847900
322500.0,4,2.5,1940,7107,2.0,0,0,2,7,1940,0,2000,0.0,98038,47.3843,-122.03200000000001,1850,5705,5167,0.7270296890389757,3763600,50509449,46745849
453000.0,3,1.0,1210,9473,1.0,0,0,4,7,1210,0,1955,0.0,98006,47.5637,-122.139,1700,11465,8263,0.8722685527288082,1464100,89737729,88273629
655000.0,4,2.5,2570,4412,2.0,0,0,2,9,2570,0,2001,0.0,98034,47.7076,-122.23200000000001,2460,5470,1842,0.41749773345421576,6604900,19465744,12860844
603000.0,3,2.25,1700,2800,2.0,0,0,4,7,1150,550,1926,0.0,98115,47.6819,-122.311,1500,3400,1100,0.39285714285714285,2890000,7840000,4950000
235000.0,4,1.0,1610,24000,1.5,0,0,2,6,1610,0,1947,0.0,98001,47.2751,-122.25200000000001,1270,9600,22390,0.9329166666666666,2592100,576000000,573407900
968933.0,4,3.5,4120,7304,2.0,0,0,2,11,3070,1050,2006,0.0,98033,47.681000000000004,-122.167,2470,9600,3184,0.4359255202628697,16974400,53348416,36374016
1020000.0,3,3.5,2880,11340,1.0,0,0,2,8,1690,1190,1980,0.0,98074,47.6113,-122.05799999999999,2530,11340,8460,0.746031746031746,8294400,128595600,120301200
435000.0,4,2.25,1990,8548,2.0,0,0,2,8,1990,0,1973,0.0,98033,47.667,-122.178,2320,8926,6558,0.7671970051474029,3960100,73068304,69108204
242000.0,3,2.0,1260,8092,1.0,0,0,2,7,1260,0,1986,0.0,98038,47.3635,-122.054,1950,8092,6832,0.8442906574394463,1587600,65480464,63892864
487000.0,6,3.25,4750,248600,2.0,0,0,3,8,4750,0,1947,0.0,98022,47.1879,-121.973,2230,311610,243850,0.9808930008045053,22562500,61801960000,61779397500
810000.0,4,2.75,3010,10450,2.0,0,0,2,9,3010,0,1996,0.0,98052,47.6979,-122.11200000000001,3010,10530,7440,0.7119617224880382,9060100,109202500,100142400
625000.0,3,2.5,2410,64073,1.0,0,0,3,8,1820,590,1976,0.0,98072,47.7457,-122.141,2980,48760,61663,0.9623866527242364,5808100,4105349329,4099541229
165000.0,3,1.5,1280,7742,1.0,0,0,2,7,1280,0,1973,0.0,98001,47.3323,-122.27600000000001,1566,7696,6462,0.834668044432963,1638400,59938564,58300164
335000.0,3,1.0,2320,6750,1.0,0,0,2,7,1160,1160,1960,0.0,98118,47.5327,-122.27600000000001,1230,6075,4430,0.6562962962962963,5382400,45562500,40180100
286700.0,3,1.0,1220,6600,1.0,0,0,2,6,1220,0,1958,0.0,98065,47.5297,-121.82700000000001,1100,6600,5380,0.8151515151515152,1488400,43560000,42071600
699000.0,2,1.5,1400,4050,1.0,0,0,3,8,1400,0,1954,0.0,98115,47.6768,-122.26899999999999,1900,5940,2650,0.654320987654321,1960000,16402500,14442500
280000.0,3,1.75,1590,7280,1.0,0,0,2,7,1140,450,1974,0.0,98058,47.4288,-122.15299999999999,1590,9634,5690,0.7815934065934066,2528100,52998400,50470300
580000.0,4,2.5,2220,7064,2.0,0,0,2,8,2220,0,1988,0.0,98029,47.5716,-122.022,2220,7451,4844,0.6857304643261608,4928400,49900096,44971696
754800.0,2,2.5,2770,7781,2.0,0,0,2,8,2770,0,2006,0.0,98053,47.7072,-122.01700000000001,1870,5984,5011,0.6440046266546716,7672900,60543961,52871061
525000.0,4,2.5,2303,16801,2.0,0,0,2,8,2303,0,1995,0.0,98019,47.7266,-121.96600000000001,2080,14013,14498,0.8629248259032201,5303809,282273601,276969792
562000.0,3,1.75,1600,10530,1.0,0,2,2,8,1600,0,1962,0.0,98155,47.7437,-122.291,2590,8274,8930,0.8480531813865148,2560000,110880900,108320900
575000.0,4,1.75,1280,6060,1.0,0,0,2,7,860,420,1926,0.0,98117,47.6805,-122.36399999999999,1490,4680,4780,0.7887788778877888,1638400,36723600,35085200
808900.0,5,2.5,2900,5901,2.0,0,0,2,9,2900,0,2006,0.0,98027,47.5396,-121.99799999999999,3200,5775,3001,0.5085578715471953,8410000,34821801,26411801
992000.0,3,2.25,2950,15207,1.0,0,0,3,10,2070,880,1966,0.0,98040,47.5571,-122.21600000000001,2950,22000,12257,0.8060103899519958,8702500,231252849,222550349
335000.0,3,2.5,1700,6698,2.0,0,0,2,7,1700,0,1997,0.0,98038,47.3826,-122.02799999999999,2190,7346,4998,0.7461928934010152,2890000,44863204,41973204
473000.0,3,2.75,1050,7200,1.0,0,0,2,7,1050,0,1985,0.0,98125,47.7163,-122.303,1860,9000,6150,0.8541666666666666,1102500,51840000,50737500
350000.0,4,2.75,2990,11210,1.0,0,1,3,8,1880,1110,1977,0.0,98023,47.3357,-122.336,2790,9858,8220,0.7332738626226584,8940100,125664100,116724000
1600000.0,5,2.5,3100,5374,2.5,0,0,3,9,3100,0,1906,0.0,98122,47.6154,-122.28299999999999,2180,5800,2274,0.4231484927428359,9610000,28879876,19269876
305500.0,3,1.0,1240,6090,1.0,0,0,3,7,1240,0,1950,0.0,98155,47.7542,-122.307,1550,9096,4850,0.7963875205254516,1537600,37088100,35550500
306000.0,2,1.0,780,13500,1.0,0,0,3,7,780,0,1946,1989.0,98077,47.7383,-122.074,2200,67518,12720,0.9422222222222222,608400,182250000,181641600
233000.0,2,2.25,850,1656,2.0,0,0,2,8,850,0,2001,0.0,98133,47.7064,-122.344,850,1312,806,0.4867149758454106,722500,2742336,2019836
490000.0,3,1.75,1540,9000,1.0,0,0,2,8,1540,0,1971,0.0,98125,47.7152,-122.322,1710,7488,7460,0.8288888888888889,2371600,81000000,78628400
445000.0,4,2.5,2280,42077,2.0,0,0,2,8,2280,0,1994,0.0,98042,47.3424,-122.07700000000001,2280,36236,39797,0.9458136273973905,5198400,1770473929,1765275529
355000.0,3,2.25,2550,9674,1.0,0,0,2,7,1850,700,1959,0.0,98178,47.4856,-122.24700000000001,2240,9674,7124,0.736406863758528,6502500,93586276,87083776
360000.0,2,2.0,1770,7607,1.0,0,0,3,8,1770,0,1987,0.0,98058,47.4287,-122.163,2090,7109,5837,0.7673195740765085,3132900,57866449,54733549
737500.0,3,1.75,2320,10900,2.0,0,0,2,7,2320,0,1935,1974.0,98115,47.6877,-122.28299999999999,1610,5800,8580,0.7871559633027523,5382400,118810000,113427600
985000.0,3,3.5,2600,11920,2.0,0,0,4,8,2600,0,1969,0.0,98004,47.582,-122.194,2430,10050,9320,0.7818791946308725,6760000,142086400,135326400
349950.0,2,3.25,1570,2031,2.0,0,0,2,8,1310,260,2006,0.0,98126,47.548,-122.375,1570,2039,461,0.22698178237321517,2464900,4124961,1660061
520000.0,4,2.5,3060,7161,2.0,0,0,2,8,2860,200,2005,0.0,98065,47.5383,-121.87899999999999,2950,6822,4101,0.572685379136992,9363600,51279921,41916321
355950.0,4,2.5,1960,8540,1.0,0,0,2,7,1220,740,1955,0.0,98177,47.7654,-122.359,1910,9120,6580,0.7704918032786885,3841600,72931600,69090000
485000.0,5,2.5,3270,6129,2.0,0,0,2,9,3270,0,2004,0.0,98055,47.4461,-122.208,2980,5928,2859,0.4664708761625061,10692900,37564641,26871741
143000.0,3,1.0,1090,3315,1.0,0,0,3,6,1090,0,1969,0.0,98092,47.3159,-122.18299999999999,960,3120,2225,0.6711915535444947,1188100,10989225,9801125
3280000.0,2,1.75,6840,10000,2.5,1,4,2,11,4350,2490,2001,0.0,98008,47.6042,-122.11200000000001,3120,12300,3160,0.316,46785600,100000000,53214400
355000.0,3,1.0,940,8512,1.0,0,0,3,7,940,0,1967,0.0,98033,47.7002,-122.191,1060,8512,7572,0.8895676691729323,883600,72454144,71570544
1130000.0,5,3.5,3880,13885,2.0,0,3,3,9,2540,1340,1979,0.0,98006,47.5696,-122.156,3690,13885,10005,0.7205617572920417,15054400,192793225,177738825
200000.0,5,1.75,1770,15525,1.0,0,0,3,7,1770,0,1959,0.0,98059,47.5025,-122.14200000000001,1370,10395,13755,0.8859903381642512,3132900,241025625,237892725
913000.0,4,2.5,3640,10576,2.0,0,0,2,11,3640,0,1999,0.0,98075,47.5899,-121.979,3370,10351,6936,0.6558245083207261,13249600,111851776,98602176
1600000.0,3,2.5,3160,12824,1.0,0,2,3,9,1820,1340,1966,0.0,98004,47.6151,-122.21600000000001,3390,11985,9664,0.7535870243293824,9985600,164454976,154469376
409900.0,2,2.5,1590,1845,2.0,0,0,2,9,1590,0,1997,0.0,98033,47.6897,-122.175,2320,3174,255,0.13821138211382114,2528100,3404025,875925
265000.0,4,1.0,1290,6034,1.0,0,0,2,6,1050,240,1950,0.0,98118,47.5223,-122.286,1060,6034,4744,0.7862114683460392,1664100,36409156,34745056
740000.0,5,3.0,3655,51836,1.0,0,0,4,8,2174,1481,1955,0.0,98008,47.6434,-122.115,2530,8606,48181,0.929489158114052,13359025,2686970896,2673611871
306000.0,4,2.5,2490,8124,2.0,0,0,2,7,2490,0,2001,0.0,98092,47.3347,-122.17,2760,6300,5634,0.6935007385524372,6200100,65999376,59799276
381000.0,3,2.5,1470,3999,2.0,0,0,2,7,1470,0,2003,0.0,98065,47.5328,-121.87100000000001,1960,4444,2529,0.6324081020255063,2160900,15992001,13831101
1220000.0,3,3.25,3960,6132,2.0,0,3,2,10,2600,1360,1933,0.0,98199,47.6396,-122.40899999999999,2730,5221,2172,0.3542074363992172,15681600,37601424,21919824
1050000.0,3,3.5,3190,29982,1.0,0,3,3,8,2630,560,1941,0.0,98166,47.458,-122.368,2600,19878,26792,0.8936028283636849,10176100,898920324,888744224
408000.0,2,1.0,810,7440,1.0,0,0,4,6,810,0,1948,0.0,98133,47.7346,-122.352,830,7500,6630,0.8911290322580645,656100,55353600,54697500
739900.0,5,2.5,2980,5377,2.0,0,0,2,9,2980,0,2006,0.0,98052,47.7074,-122.101,3150,6593,2397,0.44578761391110283,8880400,28912129,20031729
674250.0,4,2.5,2780,35000,1.0,0,0,3,9,2780,0,1985,0.0,98072,47.7386,-122.09100000000001,2740,35072,32220,0.9205714285714286,7728400,1225000000,1217271600
438400.0,2,1.0,1340,8100,1.0,0,0,3,7,1340,0,1953,0.0,98177,47.7218,-122.37,1700,8100,6760,0.8345679012345679,1795600,65610000,63814400
1700000.0,5,5.0,4930,14649,2.0,0,3,2,11,4160,770,2000,0.0,98040,47.5829,-122.24700000000001,3030,8479,9719,0.6634582565362823,24304900,214593201,190288301
703000.0,3,2.0,1360,5980,1.5,0,0,2,8,1360,0,1945,2008.0,98116,47.5852,-122.38799999999999,1520,4440,4620,0.7725752508361204,1849600,35760400,33910800
262000.0,3,1.75,1320,6530,1.0,0,0,3,7,1320,0,1989,0.0,98023,47.2871,-122.354,1620,6817,5210,0.7978560490045942,1742400,42640900,40898500
353000.0,3,2.0,1210,14499,1.0,0,0,2,7,1210,0,1984,0.0,98045,47.4705,-121.75399999999999,1570,15360,13289,0.9165459686874957,1464100,210221001,208756901
500000.0,4,2.5,1940,7607,2.0,0,0,2,8,1940,0,1995,0.0,98052,47.685,-122.15799999999999,2250,7600,5667,0.7449717365584331,3763600,57866449,54102849
1280000.0,4,2.5,3160,4620,1.5,0,4,2,9,2020,1140,1917,0.0,98116,47.5875,-122.382,2790,5308,1460,0.31601731601731603,9985600,21344400,11358800
332000.0,4,2.5,1980,6566,2.0,0,0,2,8,1980,0,2004,0.0,98042,47.3809,-122.09700000000001,2590,6999,4586,0.698446542796223,3920400,43112356,39191956
824000.0,4,2.5,2320,14240,1.0,0,0,3,9,1620,700,1974,0.0,98008,47.6269,-122.09,2810,13200,11920,0.8370786516853933,5382400,202777600,197395200
290000.0,4,2.0,1660,4788,1.0,0,0,2,7,1660,0,1968,0.0,98144,47.5878,-122.31200000000001,1150,5000,3128,0.6532999164578112,2755600,22924944,20169344
700000.0,3,2.5,1660,1545,2.0,0,2,2,9,1400,260,2002,0.0,98109,47.6268,-122.353,1820,2570,-115,-0.0744336569579288,2755600,2387025,-368575
550000.0,2,1.0,1080,3420,1.0,0,0,3,7,780,300,1922,0.0,98107,47.6715,-122.39299999999999,1380,3656,2340,0.6842105263157895,1166400,11696400,10530000
549000.0,2,1.0,1510,11165,1.5,0,0,3,7,1510,0,1921,0.0,98133,47.7212,-122.331,2210,8851,9655,0.864755933721451,2280100,124657225,122377125
1870000.0,4,2.5,2950,43560,1.0,0,2,3,9,2550,400,1951,0.0,98004,47.5988,-122.20700000000001,3260,41016,40610,0.932277318640955,8702500,1897473600,1888771100
858000.0,4,2.25,3070,13720,2.0,0,0,2,9,3070,0,1978,0.0,98007,47.6133,-122.152,3010,9657,10650,0.7762390670553936,9424900,188238400,178813500
345000.0,2,1.0,970,10423,1.0,0,0,2,7,970,0,1947,0.0,98133,47.7252,-122.331,1200,7857,9453,0.9069365825578048,940900,108638929,107698029
340000.0,4,1.75,2140,11651,2.5,0,0,2,8,2140,0,1930,2001.0,98022,47.19600000000001,-122.006,2030,10978,9511,0.816324778988928,4579600,135745801,131166201
1220000.0,4,2.25,2570,9600,2.5,0,0,3,9,2570,0,1962,0.0,98040,47.5791,-122.241,2570,13200,7030,0.7322916666666667,6604900,92160000,85555100
275000.0,3,2.25,1260,1488,3.0,0,0,2,7,1260,0,2009,0.0,98133,47.7071,-122.336,1190,1095,228,0.1532258064516129,1587600,2214144,626544
405000.0,3,1.0,1220,7771,1.0,0,0,2,7,1220,0,1963,0.0,98008,47.6326,-122.119,1420,7674,6551,0.8430060481276541,1488400,60388441,58900041
432500.0,3,2.0,1720,8145,2.0,0,0,4,7,1720,0,1949,0.0,98155,47.7393,-122.325,1400,8138,6425,0.7888275015346838,2958400,66341025,63382625
236500.0,4,1.0,2140,4217,1.5,0,0,2,6,1320,820,1925,0.0,98118,47.5484,-122.287,1720,5413,2077,0.4925302347640503,4579600,17783089,13203489
679000.0,4,1.5,1420,4923,1.5,0,0,3,8,1420,0,1928,0.0,98103,47.6901,-122.339,1470,4923,3503,0.7115579930936421,2016400,24235929,22219529
543000.0,4,2.5,2060,8451,2.0,0,0,2,8,2060,0,1995,0.0,98133,47.7168,-122.333,2060,9460,6391,0.756241864868063,4243600,71419401,67175801
294000.0,3,1.0,1320,9520,1.0,0,0,2,7,990,330,1953,0.0,98178,47.4857,-122.25299999999999,1460,10610,8200,0.8613445378151261,1742400,90630400,88888000
340500.0,3,1.75,1810,10463,1.0,0,0,3,7,1810,0,1969,0.0,98058,47.4581,-122.162,1620,8551,8653,0.8270094619134092,3276100,109474369,106198269
1010000.0,4,2.5,2980,16263,2.0,0,0,2,9,2980,0,1989,0.0,98006,47.5457,-122.15299999999999,2730,10018,13283,0.8167619750353563,8880400,264485169,255604769
335000.0,2,2.0,1350,2560,1.0,0,0,2,8,1350,0,1976,0.0,98052,47.6344,-122.10700000000001,1790,2560,1210,0.47265625,1822500,6553600,4731100
425000.0,3,2.0,1540,8011,1.0,0,0,2,7,1540,0,1988,0.0,98011,47.7342,-122.20200000000001,1630,7141,6471,0.8077643240544252,2371600,64176121,61804521
353000.0,3,2.5,2510,9240,2.0,0,0,3,8,2510,0,2001,0.0,98022,47.1896,-122.01299999999999,2690,9240,6730,0.7283549783549783,6300100,85377600,79077500
540000.0,3,2.5,1670,5146,2.0,0,0,2,8,1670,0,1991,0.0,98029,47.5707,-121.999,1940,5146,3476,0.6754760979401477,2788900,26481316,23692416
640000.0,5,3.5,3690,11928,2.0,0,0,2,9,2540,1150,2006,0.0,98074,47.6108,-122.06,2640,11928,8238,0.6906438631790744,13616100,142277184,128661084
339950.0,3,1.0,1320,11457,1.0,0,0,2,8,1320,0,1959,0.0,98028,47.7738,-122.26100000000001,1900,9800,10137,0.8847865933490443,1742400,131262849,129520449
195000.0,3,1.75,1510,8400,1.0,0,0,1,7,980,530,1979,0.0,98045,47.4476,-121.771,1500,10125,6890,0.8202380952380952,2280100,70560000,68279900
322000.0,3,1.75,1510,8400,1.0,0,0,1,7,980,530,1979,0.0,98045,47.4476,-121.771,1500,10125,6890,0.8202380952380952,2280100,70560000,68279900
660000.0,4,1.75,1870,10450,1.0,0,0,2,8,1620,250,1978,0.0,98005,47.5938,-122.154,2060,10450,8580,0.8210526315789474,3496900,109202500,105705600
280000.0,6,3.0,2400,9373,2.0,0,0,2,7,2400,0,1991,0.0,98002,47.3262,-122.214,2060,7316,6973,0.7439453750133361,5760000,87853129,82093129
300000.0,6,3.0,2400,9373,2.0,0,0,2,7,2400,0,1991,0.0,98002,47.3262,-122.214,2060,7316,6973,0.7439453750133361,5760000,87853129,82093129
207500.0,3,1.0,1170,8816,1.0,0,0,3,6,1170,0,1966,0.0,98023,47.3059,-122.368,1200,9108,7646,0.8672867513611615,1368900,77721856,76352956
195000.0,3,1.5,1190,8726,1.0,0,0,2,7,1190,0,1956,0.0,98146,47.4887,-122.34299999999999,1390,8741,7536,0.8636259454503782,1416100,76143076,74726976
700000.0,3,2.0,2080,3880,1.0,0,0,4,7,1160,920,1954,0.0,98117,47.68600000000001,-122.391,1330,3880,1800,0.4639175257731959,4326400,15054400,10728000
560000.0,4,1.75,2150,8555,1.0,0,2,3,7,1460,690,1982,0.0,98106,47.5344,-122.345,1480,7405,6405,0.7486849795441263,4622500,73188025,68565525
260000.0,3,1.75,1580,7344,1.0,0,0,4,7,1580,0,1911,0.0,98126,47.5256,-122.38,1580,6207,5764,0.7848583877995643,2496400,53934336,51437936
575000.0,3,1.75,1580,7344,1.0,0,0,4,7,1580,0,1911,0.0,98126,47.5256,-122.38,1580,6207,5764,0.7848583877995643,2496400,53934336,51437936
475000.0,3,2.5,2370,3239,2.0,0,0,2,8,1950,420,2006,0.0,98072,47.7515,-122.17399999999999,2520,3431,869,0.2682926829268293,5616900,10491121,4874221
285000.0,3,1.75,1840,8601,1.0,0,0,2,7,920,920,1905,2014.0,98118,47.5359,-122.27600000000001,1390,7452,6761,0.7860713870480177,3385600,73977201,70591601
753888.0,4,2.5,2660,5500,2.0,0,2,2,9,2660,0,2003,0.0,98029,47.5439,-121.99600000000001,3620,5500,2840,0.5163636363636364,7075600,30250000,23174400
650000.0,3,2.5,2190,3600,2.0,0,0,2,9,2190,0,2003,0.0,98029,47.5506,-121.993,2300,3600,1410,0.39166666666666666,4796100,12960000,8163900
620000.0,3,2.25,1660,3478,1.5,0,0,3,7,1100,560,1929,0.0,98117,47.6773,-122.37200000000001,1610,3478,1818,0.5227142035652674,2755600,12096484,9340884
526000.0,3,1.75,1780,37801,1.0,0,0,2,7,1300,480,1977,0.0,98075,47.5858,-122.015,2380,47480,36021,0.952911298642893,3168400,1428915601,1425747201
155000.0,2,1.0,700,5200,1.0,0,0,4,6,700,0,1952,0.0,98056,47.4924,-122.175,1030,5200,4500,0.8653846153846154,490000,27040000,26550000
342000.0,4,2.0,1570,11200,1.0,0,0,2,7,1120,450,1959,0.0,98011,47.7573,-122.21700000000001,1570,11200,9630,0.8598214285714286,2464900,125440000,122975100
390000.0,3,1.75,1220,216332,1.0,0,0,2,7,1220,0,1981,0.0,98019,47.7224,-121.926,1540,61419,215112,0.9943605199415713,1488400,46799534224,46798045824
685000.0,3,2.75,3150,219978,2.0,0,0,3,9,3000,150,1990,0.0,98024,47.553000000000004,-121.946,3180,218235,216828,0.9856803862204402,9922500,48390320484,48380397984
608000.0,4,2.5,2690,4736,2.0,0,0,2,7,2690,0,2001,0.0,98053,47.6869,-122.036,2690,4791,2046,0.43201013513513514,7236100,22429696,15193596
179900.0,2,1.0,680,6400,1.0,0,0,2,6,680,0,1943,0.0,98168,47.5136,-122.316,1240,7800,5720,0.89375,462400,40960000,40497600
1250000.0,6,3.25,3750,14150,2.0,0,2,4,9,2750,1000,1936,1968.0,98117,47.6999,-122.39299999999999,2140,7968,10400,0.734982332155477,14062500,200222500,186160000
166000.0,3,1.0,1010,11675,1.0,0,0,2,7,1010,0,1957,0.0,98168,47.4849,-122.301,1370,10042,10665,0.913490364025696,1020100,136305625,135285525
462000.0,3,1.5,1710,4500,1.5,0,0,2,8,1410,300,1928,0.0,98118,47.5366,-122.26799999999999,1860,6000,2790,0.62,2924100,20250000,17325900
545000.0,4,2.5,2090,6023,2.0,0,0,2,8,2090,0,1990,0.0,98029,47.5713,-121.99700000000001,2090,6023,3933,0.6529968454258676,4368100,36276529,31908429
415000.0,3,1.0,1560,4500,1.5,0,0,2,7,1560,0,1903,0.0,98122,47.6118,-122.306,1660,4500,2940,0.6533333333333333,2433600,20250000,17816400
269000.0,3,2.5,1560,4200,2.0,0,0,2,7,1560,0,2003,0.0,98038,47.3838,-122.02600000000001,1560,4200,2640,0.6285714285714286,2433600,17640000,15206400
356500.0,4,2.5,2570,11473,2.0,0,0,2,8,2570,0,2008,0.0,98003,47.2809,-122.296,2430,5997,8903,0.7759958162642726,6604900,131629729,125024829
225000.0,3,1.0,1010,7633,1.0,0,0,3,6,1010,0,1961,0.0,98198,47.3781,-122.314,1190,8386,6623,0.8676798113454736,1020100,58262689,57242589
175000.0,2,1.0,1020,5130,1.0,0,0,3,6,1020,0,1948,0.0,98002,47.301,-122.226,1200,6497,4110,0.8011695906432749,1040400,26316900,25276500
549000.0,5,2.5,1710,9720,2.0,0,0,3,8,1710,0,1974,0.0,98005,47.5903,-122.15700000000001,2270,9672,8010,0.8240740740740741,2924100,94478400,91554300
535000.0,3,2.75,2300,12197,2.0,0,0,2,8,2300,0,1989,0.0,98166,47.4369,-122.338,1710,11220,9897,0.8114290399278511,5290000,148766809,143476809
627000.0,4,2.25,1990,7712,1.0,0,0,2,8,1210,0,1973,0.0,98027,47.5688,-122.087,1720,7393,5722,0.7419605809128631,3960100,59474944,55514844
565000.0,3,2.0,2730,15677,2.5,0,3,2,9,2730,0,1976,0.0,98166,47.4612,-122.365,2040,12209,12947,0.8258595394527014,7452900,245768329,238315429
392450.0,4,2.0,2195,2681,1.0,0,0,2,7,1060,1135,1912,0.0,98103,47.6965,-122.34200000000001,1710,1280,486,0.18127564341663557,4818025,7187761,2369736
509000.0,2,2.0,1560,4675,1.0,0,0,2,8,1560,0,2006,0.0,98053,47.7086,-122.01899999999999,1870,6361,3115,0.6663101604278074,2433600,21855625,19422025
340000.0,3,2.5,1400,4800,1.0,0,0,2,7,1200,200,1921,0.0,98117,47.6865,-122.37899999999999,1440,3840,3400,0.7083333333333334,1960000,23040000,21080000
537000.0,3,2.5,1400,4800,1.0,0,0,2,7,1200,200,1921,0.0,98117,47.6865,-122.37899999999999,1440,3840,3400,0.7083333333333334,1960000,23040000,21080000
865000.0,4,3.0,3690,9892,2.0,0,0,2,10,3690,0,1998,0.0,98075,47.5937,-121.98200000000001,3430,11294,6202,0.6269712899312576,13616100,97851664,84235564
358000.0,2,1.0,1140,8340,1.0,0,0,2,7,1140,0,1948,0.0,98155,47.7448,-122.3,1030,8149,7200,0.8633093525179856,1299600,69555600,68256000
595000.0,4,2.25,1920,3225,1.5,0,0,4,7,1300,620,1923,0.0,98116,47.5848,-122.384,1960,3750,1305,0.4046511627906977,3686400,10400625,6714225
661000.0,4,2.5,2496,8058,2.0,0,0,2,9,2496,0,1998,0.0,98052,47.6791,-122.149,2496,7757,5562,0.6902457185405808,6230016,64931364,58701348
419950.0,3,2.25,2280,8500,1.0,0,0,3,7,1680,600,1977,0.0,98034,47.7211,-122.166,1890,7700,6220,0.731764705882353,5198400,72250000,67051600
490000.0,4,3.5,3200,6420,2.0,0,0,2,9,3200,0,2006,0.0,98038,47.3545,-122.001,3200,6291,3220,0.5015576323987538,10240000,41216400,30976400
525000.0,2,1.0,880,4000,1.0,0,0,2,7,880,0,1940,0.0,98117,47.6847,-122.387,1310,4000,3120,0.78,774400,16000000,15225600
350000.0,3,2.0,1320,1298,3.0,0,0,2,7,1320,0,1995,0.0,98117,47.6959,-122.376,1380,1503,-22,-0.01694915254237288,1742400,1684804,-57596
552500.0,3,2.5,2450,3582,2.0,0,0,2,9,2450,0,2008,0.0,98072,47.7749,-122.15899999999999,2490,5449,1132,0.3160245672808487,6002500,12830724,6828224
210000.0,3,1.0,1040,8970,1.0,0,0,3,6,1040,0,1961,0.0,98023,47.3283,-122.337,1040,8450,7930,0.8840579710144928,1081600,80460900,79379300
390000.0,3,2.5,2480,53250,2.0,0,0,2,9,2480,0,1990,0.0,98042,47.3323,-122.079,2510,36549,50770,0.9534272300469484,6150400,2835562500,2829412100
336800.0,5,1.75,1830,16650,1.5,0,0,2,7,1610,220,1958,0.0,98155,47.7734,-122.315,1790,12743,14820,0.8900900900900901,3348900,277222500,273873600
465000.0,3,2.5,1440,4473,2.0,0,0,2,7,1440,0,2003,0.0,98053,47.6825,-122.036,1650,3322,3033,0.6780684104627767,2073600,20007729,17934129
299900.0,4,2.5,1580,3632,2.0,0,0,2,7,1580,0,2011,0.0,98038,47.3672,-122.01899999999999,1950,3800,2052,0.5649779735682819,2496400,13191424,10695024
715000.0,3,3.25,3230,5000,2.0,0,0,2,9,3230,0,2006,0.0,98029,47.5558,-122.00200000000001,2670,3977,1770,0.354,10432900,25000000,14567100
235000.0,4,2.5,1810,39639,1.0,0,0,2,7,1230,580,1970,0.0,98042,47.3472,-122.11,1810,44866,37829,0.954337899543379,3276100,1571250321,1567974221
276000.0,3,2.5,2495,4400,2.0,0,0,2,8,2495,0,2007,0.0,98001,47.2877,-122.28299999999999,2434,4400,1905,0.4329545454545455,6225025,19360000,13134975
265000.0,4,1.5,1740,12728,1.0,0,0,3,7,1180,560,1964,0.0,98003,47.2808,-122.3,1830,11125,10988,0.8632935260842237,3027600,162001984,158974384
425000.0,3,1.75,1680,3000,1.0,0,2,3,6,840,840,1900,0.0,98103,47.68600000000001,-122.346,1540,3700,1320,0.44,2822400,9000000,6177600
313000.0,4,2.5,2460,10320,2.0,0,0,2,8,2460,0,1993,0.0,98092,47.2599,-122.215,2210,9024,7860,0.7616279069767442,6051600,106502400,100450800
715000.0,3,2.5,3050,6000,1.0,0,3,2,8,1720,1330,1984,0.0,98177,47.7701,-122.389,2340,7200,2950,0.49166666666666664,9302500,36000000,26697500
265000.0,3,2.25,1630,10969,2.0,0,0,2,7,1630,0,1991,0.0,98001,47.3305,-122.285,1410,7920,9339,0.8513993983043121,2656900,120318961,117662061
646000.0,3,2.75,2460,6413,2.0,0,0,2,9,2460,0,2004,0.0,98028,47.7497,-122.245,2440,6092,3953,0.6164041790113831,6051600,41126569,35074969
175000.0,3,1.0,1030,6600,1.0,0,0,2,7,1030,0,1954,0.0,98146,47.4941,-122.34,1220,9040,5570,0.843939393939394,1060900,43560000,42499100
649000.0,3,2.5,3410,13809,1.0,0,3,3,10,2450,960,1973,0.0,98003,47.3424,-122.32600000000001,3410,14245,10399,0.7530595988123687,11628100,190688481,179060381
785000.0,3,2.75,2310,5200,1.0,0,0,3,7,1520,790,1940,0.0,98199,47.6357,-122.397,2310,5200,2890,0.5557692307692308,5336100,27040000,21703900
890000.0,4,2.75,2610,4400,1.0,0,0,4,8,1260,1350,1920,0.0,98122,47.6158,-122.29299999999999,1770,4400,1790,0.4068181818181818,6812100,19360000,12547900
612000.0,3,3.0,2330,10327,1.0,0,0,2,9,2330,0,1998,0.0,98034,47.7239,-122.164,2200,4629,7997,0.7743778444853298,5428900,106646929,101218029
330000.0,4,2.5,2980,5674,2.0,0,0,2,8,2980,0,2003,0.0,98023,47.277,-122.34700000000001,2610,5495,2694,0.47479732111385264,8880400,32194276,23313876
493000.0,3,2.25,1790,11393,1.0,0,0,2,8,1790,0,1978,0.0,98052,47.6297,-122.09899999999999,2290,11894,9603,0.8428859826209075,3204100,129800449,126596349
1600000.0,4,2.25,2940,5735,1.0,0,0,2,9,1470,1470,1957,0.0,98112,47.6381,-122.304,2230,5659,2795,0.4873583260680035,8643600,32890225,24246625
1620000.0,4,3.0,3900,9750,1.0,0,4,4,10,2520,1380,1972,0.0,98006,47.5605,-122.15799999999999,3410,9450,5850,0.6,15210000,95062500,79852500
1650000.0,4,3.0,3900,9750,1.0,0,4,4,10,2520,1380,1972,0.0,98006,47.5605,-122.15799999999999,3410,9450,5850,0.6,15210000,95062500,79852500
499000.0,3,2.5,1750,2150,2.5,0,0,2,7,1230,520,1900,2014.0,98122,47.6037,-122.311,1410,3300,400,0.18604651162790697,3062500,4622500,1560000
603500.0,6,2.75,2660,8400,1.0,0,0,4,8,1550,1110,1962,0.0,98006,47.549,-122.17299999999999,2280,8400,5740,0.6833333333333333,7075600,70560000,63484400
530000.0,2,1.5,1580,3680,1.0,0,2,2,8,1280,300,1941,0.0,98126,47.5762,-122.37700000000001,1730,3680,2100,0.5706521739130435,2496400,13542400,11046000
895000.0,5,2.5,2350,14197,1.0,0,0,3,8,1220,1130,1962,0.0,98004,47.6005,-122.204,2470,11629,11847,0.834472071564415,5522500,201554809,196032309
267345.0,4,2.25,2510,8165,1.0,0,0,3,7,1610,900,1972,0.0,98023,47.3092,-122.37200000000001,1940,8250,5655,0.6925903245560319,6300100,66667225,60367125
275000.0,3,2.5,1480,15639,2.0,0,0,2,8,1480,0,1987,0.0,98045,47.4723,-121.74600000000001,1480,16454,14159,0.9053647931453418,2190400,244578321,242387921
439950.0,3,1.75,1720,223377,1.0,0,0,2,7,1240,480,1950,0.0,98019,47.7329,-121.92,2530,221442,221657,0.9923000129825362,2958400,49897284129,49894325729
455000.0,3,2.25,1470,4653,2.0,0,0,3,7,1470,0,1985,0.0,98029,47.5667,-122.01799999999999,1560,4119,3183,0.6840747904577692,2160900,21650409,19489509
630000.0,3,1.75,1540,6930,1.0,0,0,2,7,1250,290,1944,0.0,98115,47.6782,-122.27799999999999,1760,6930,5390,0.7777777777777778,2371600,48024900,45653300
690000.0,3,2.5,2820,5001,2.0,0,0,2,9,2820,0,2004,0.0,98029,47.5533,-121.992,2660,5001,2181,0.4361127774445111,7952400,25010001,17057601
212000.0,4,1.75,1250,12705,1.0,0,0,3,7,1250,0,1971,0.0,98023,47.302,-122.382,1390,8550,11455,0.9016135379771744,1562500,161417025,159854525
231500.0,4,2.25,2080,7526,1.0,0,0,3,7,1280,800,1985,0.0,98030,47.3762,-122.18299999999999,1200,7500,5446,0.723624767472761,4326400,56640676,52314276
1240000.0,4,3.25,5180,49936,2.0,0,0,3,10,5180,0,1991,0.0,98053,47.6676,-122.069,4240,35363,44756,0.8962672220442166,26832400,2493604096,2466771696
378500.0,3,2.5,2860,43821,2.0,0,0,3,9,2860,0,1990,0.0,98092,47.3163,-122.14200000000001,2370,65340,40961,0.9347344880308528,8179600,1920280041,1912100441
482000.0,4,2.5,2710,35868,2.0,0,0,2,9,2710,0,1989,0.0,98038,47.375,-122.022,2780,36224,33158,0.9244451879112301,7344100,1286513424,1279169324
695000.0,2,1.0,1140,3990,1.0,0,0,2,7,1140,0,1924,0.0,98103,47.6554,-122.333,1800,5700,2850,0.7142857142857143,1299600,15920100,14620500
965000.0,4,2.5,4070,57587,2.0,0,0,2,10,4070,0,1989,0.0,98052,47.6908,-122.052,3890,35960,53517,0.92932432667095,16564900,3316262569,3299697669
675000.0,3,1.75,1710,5913,1.0,0,0,3,8,1120,590,1941,0.0,98199,47.6481,-122.406,2920,5922,4203,0.710806697108067,2924100,34963569,32039469
387000.0,3,1.5,1340,6500,1.0,0,0,2,7,1340,0,1972,0.0,98034,47.7168,-122.19200000000001,1620,7107,5160,0.7938461538461539,1795600,42250000,40454400
347500.0,4,2.75,2290,7000,2.0,0,0,2,8,2290,0,1977,0.0,98058,47.4442,-122.12899999999999,2000,7200,4710,0.6728571428571428,5244100,49000000,43755900
385000.0,3,2.0,1860,7400,1.0,0,0,2,8,930,0,1922,2004.0,98166,47.4598,-122.352,1640,8461,5540,0.7486486486486487,3459600,54760000,51300400
265000.0,3,1.0,1080,4930,1.0,0,0,2,6,1080,0,1950,0.0,98126,47.5209,-122.374,1100,5950,3850,0.7809330628803245,1166400,24304900,23138500
406000.0,3,1.0,960,5264,1.0,0,0,2,7,960,0,1953,0.0,98115,47.6805,-122.301,1140,5150,4304,0.817629179331307,921600,27709696,26788096
134000.0,2,1.5,980,5000,2.0,0,0,2,7,980,0,1922,2003.0,98014,47.7076,-121.359,1040,5000,4020,0.804,960400,25000000,24039600
415000.0,3,1.0,1500,3399,2.0,0,0,4,7,1300,200,1926,0.0,98103,47.6838,-122.352,1360,3588,1899,0.558693733451015,2250000,11553201,9303201
375000.0,3,1.75,1440,8775,1.0,0,0,2,7,1440,0,1973,0.0,98034,47.7231,-122.17,1790,7865,7335,0.8358974358974359,2073600,77000625,74927025
620000.0,4,2.5,2580,7465,2.0,0,0,2,8,2580,0,1993,0.0,98074,47.6319,-122.022,2350,7596,4885,0.6543871399866041,6656400,55726225,49069825
337500.0,5,2.5,2070,4698,2.0,0,0,2,7,2070,0,1999,0.0,98038,47.3539,-122.024,2010,4698,2628,0.5593869731800766,4284900,22071204,17786304
565000.0,3,2.5,1880,12368,1.0,0,0,3,7,1260,620,1967,0.0,98005,47.5901,-122.167,1950,11551,10488,0.8479948253557568,3534400,152967424,149433024
399500.0,3,1.75,2420,12676,2.0,0,0,2,7,2420,0,1911,1986.0,98045,47.4943,-121.789,1210,6769,10256,0.8090880403912907,5856400,160680976,154824576
1070000.0,2,1.75,1890,9466,2.0,0,0,2,8,1890,0,1987,0.0,98004,47.6144,-122.211,2180,12825,7576,0.8003380519754912,3572100,89605156,86033056
352500.0,3,2.0,1920,33630,1.0,0,0,2,8,1920,0,1992,0.0,98056,47.4983,-122.167,2080,7505,31710,0.9429081177520071,3686400,1130976900,1127290500
259000.0,3,2.0,1870,5909,1.0,0,0,2,7,1270,600,1986,0.0,98030,47.3665,-122.18299999999999,1870,7887,4039,0.683533592824505,3496900,34916281,31419381
320000.0,2,1.0,900,7620,1.0,0,0,2,7,900,0,1971,0.0,98106,47.5268,-122.34299999999999,1520,7620,6720,0.8818897637795275,810000,58064400,57254400
733000.0,3,2.5,2160,9888,2.0,0,0,3,9,2160,0,1989,0.0,98052,47.6712,-122.14200000000001,3060,7829,7728,0.7815533980582524,4665600,97772544,93106944
381500.0,2,1.0,900,2910,1.0,0,0,4,7,900,0,1924,0.0,98115,47.6859,-122.322,1320,2910,2010,0.6907216494845361,810000,8468100,7658100
343000.0,2,1.0,1180,9261,1.0,0,0,3,7,940,240,1957,0.0,98118,47.5492,-122.274,1700,6325,8081,0.8725839542166073,1392400,85766121,84373721
205500.0,2,1.0,900,6400,1.0,0,0,4,6,900,0,1938,0.0,98022,47.2113,-121.992,1320,6400,5500,0.859375,810000,40960000,40150000
525000.0,3,2.0,1600,16530,1.0,0,0,4,7,1600,0,1967,0.0,98075,47.5821,-122.016,1850,41006,14930,0.9032062915910466,2560000,273240900,270680900
300000.0,3,1.75,1500,8352,1.0,0,2,4,6,750,750,1943,0.0,98056,47.4883,-122.191,1500,8447,6852,0.8204022988505747,2250000,69755904,67505904
299000.0,2,1.0,1070,189486,1.0,0,0,2,6,1070,0,1942,0.0,98077,47.7199,-122.085,1970,60548,188416,0.9943531448233642,1144900,35904944196,35903799296
561000.0,4,2.5,2570,5250,2.0,0,0,2,8,2570,0,1990,0.0,98029,47.5763,-122.0,2260,5392,2680,0.5104761904761905,6604900,27562500,20957600
450000.0,3,1.0,1210,4000,1.5,0,0,2,7,1090,120,1928,0.0,98144,47.5934,-122.30799999999999,1210,4000,2790,0.6975,1464100,16000000,14535900
540000.0,4,2.5,1850,7850,2.0,0,0,2,8,1850,0,1985,0.0,98052,47.6914,-122.103,1830,8140,6000,0.7643312101910829,3422500,61622500,58200000
379000.0,3,2.5,1740,30886,2.0,0,0,2,8,1740,0,1992,0.0,98045,47.46,-121.70700000000001,1740,39133,29146,0.94366379589458,3027600,953944996,950917396
230000.0,3,1.0,1300,14000,1.0,0,0,3,7,1300,0,1958,0.0,98198,47.4213,-122.322,1390,8750,12700,0.9071428571428571,1690000,196000000,194310000
399950.0,3,2.5,2000,30605,2.0,0,0,3,8,2000,0,1989,0.0,98042,47.3442,-122.06200000000001,1930,35350,28605,0.9346512007841856,4000000,936666025,932666025
355000.0,5,2.5,3220,5806,2.0,0,0,2,8,3220,0,2002,0.0,98042,47.3714,-122.103,2760,5813,2586,0.4454013089906993,10368400,33709636,23341236
580000.0,4,2.25,2160,9593,1.0,0,0,2,8,2160,0,1969,0.0,98008,47.5883,-122.11200000000001,2820,9628,7433,0.7748358177838007,4665600,92025649,87360049
700000.0,3,2.0,2130,4299,1.5,0,0,3,7,1680,450,1922,0.0,98144,47.5779,-122.294,2040,4548,2169,0.5045359385903698,4536900,18481401,13944501
279900.0,3,1.75,1580,8151,1.0,0,1,3,7,1100,480,1962,0.0,98198,47.3672,-122.31200000000001,1650,8151,6571,0.8061587535271746,2496400,66438801,63942401
210000.0,3,1.0,1200,7500,1.0,0,0,2,6,1200,0,1905,1989.0,98178,47.4921,-122.275,1010,7000,6300,0.84,1440000,56250000,54810000
1170000.0,3,3.0,3790,5001,2.0,0,0,2,10,2810,980,1989,0.0,98122,47.6035,-122.285,2500,6286,1211,0.2421515696860628,14364100,25010001,10645901
290300.0,2,1.0,860,3874,1.0,0,0,3,6,860,0,1931,0.0,98055,47.4836,-122.204,1400,5106,3014,0.7780072276716572,739600,15007876,14268276
1600000.0,5,4.5,5130,43123,2.0,0,0,2,11,5130,0,1996,0.0,98006,47.544,-122.126,4670,43560,37993,0.8810379611808083,26316900,1859593129,1833276229
490000.0,3,1.0,1600,6380,1.5,0,0,2,7,1400,200,1939,0.0,98125,47.7015,-122.31700000000001,1760,6380,4780,0.7492163009404389,2560000,40704400,38144400
606000.0,4,2.5,2110,13850,2.0,0,0,2,9,2110,0,1987,0.0,98027,47.5497,-122.07700000000001,2520,10194,11740,0.8476534296028881,4452100,191822500,187370400
359950.0,3,1.0,1400,4980,1.0,0,0,2,6,950,450,1943,0.0,98133,47.7041,-122.34,990,4980,3580,0.7188755020080321,1960000,24800400,22840400
677100.0,3,2.0,2110,9199,1.0,0,0,2,10,2110,0,1993,0.0,98074,47.6496,-122.083,3130,8841,7089,0.7706272420915317,4452100,84621601,80169501
465000.0,3,2.0,1430,7125,1.0,0,0,3,7,1430,0,1984,0.0,98074,47.6256,-122.059,1570,8075,5695,0.7992982456140351,2044900,50765625,48720725
4500000.0,5,5.5,6640,40014,2.0,1,4,2,12,6350,290,2004,0.0,98155,47.7493,-122.28,3030,23408,33374,0.8340580796721148,44089600,1601120196,1557030596
500000.0,3,2.0,3040,41072,1.0,0,0,3,8,1520,1520,1978,0.0,98038,47.3944,-121.97200000000001,2230,54014,38032,0.925983638488508,9241600,1686909184,1677667584
455000.0,2,1.0,980,5000,1.0,0,0,3,7,980,0,1950,0.0,98155,47.7518,-122.279,1600,5965,4020,0.804,960400,25000000,24039600
705000.0,6,2.0,2570,4240,1.5,0,0,3,7,1970,600,1911,0.0,98115,47.6754,-122.307,2030,4240,1670,0.3938679245283019,6604900,17977600,11372700
420000.0,3,2.5,2060,7020,1.0,0,0,3,8,1460,600,1967,0.0,98177,47.7575,-122.36399999999999,2150,8400,4960,0.7065527065527065,4243600,49280400,45036800
169575.0,3,1.0,1300,8284,1.0,0,0,2,7,1300,0,1968,0.0,98003,47.3327,-122.306,1360,7848,6984,0.8430709802028006,1690000,68624656,66934656
250000.0,3,1.0,1300,8284,1.0,0,0,2,7,1300,0,1968,0.0,98003,47.3327,-122.306,1360,7848,6984,0.8430709802028006,1690000,68624656,66934656
530000.0,3,2.25,1680,7262,1.0,0,0,4,7,1180,500,1973,0.0,98034,47.713,-122.225,1910,7405,5582,0.7686587716882401,2822400,52736644,49914244
590000.0,5,3.25,4020,40341,1.0,0,0,4,8,2170,1850,1970,0.0,98027,47.4952,-122.068,2650,53437,36321,0.9003495203391091,16160400,1627396281,1611235881
257500.0,3,1.75,1530,14087,1.0,0,0,2,7,1070,460,1979,0.0,98042,47.3146,-122.04299999999999,1770,13660,12557,0.891389224107333,2340900,198443569,196102669
415000.0,3,1.0,1170,6700,1.0,0,0,2,8,1170,0,1957,0.0,98125,47.7122,-122.29,2410,7620,5530,0.8253731343283582,1368900,44890000,43521100
536000.0,3,1.75,1580,3764,1.5,0,0,2,7,1280,300,1945,0.0,98107,47.672,-122.397,1560,3764,2184,0.5802337938363443,2496400,14167696,11671296
246500.0,3,1.5,1270,11600,1.0,0,0,3,7,1270,0,1964,0.0,98031,47.4075,-122.196,1380,9945,10330,0.8905172413793103,1612900,134560000,132947100
395000.0,3,1.75,1480,7700,1.0,0,0,2,8,1480,0,1975,0.0,98034,47.7225,-122.20200000000001,1930,8560,6220,0.8077922077922078,2190400,59290000,57099600
739000.0,3,2.25,2220,10530,1.0,0,0,3,8,1700,520,1974,0.0,98052,47.6383,-122.098,2500,10014,8310,0.7891737891737892,4928400,110880900,105952500
1270000.0,4,2.75,3200,13729,2.0,0,0,2,11,3200,0,1984,0.0,98005,47.6402,-122.171,4050,16921,10529,0.7669167455750601,10240000,188485441,178245441
190000.0,3,1.0,910,10575,1.0,0,0,3,7,910,0,1968,0.0,98003,47.2741,-122.301,1470,10425,9665,0.9139479905437352,828100,111830625,111002525
305000.0,3,1.5,1480,9086,1.0,0,0,2,7,1480,0,1962,0.0,98168,47.4717,-122.323,1540,9750,7606,0.837112040501871,2190400,82555396,80364996
925000.0,4,4.25,3770,13058,2.0,0,0,3,8,3770,0,1983,0.0,98028,47.7517,-122.225,2200,12255,9288,0.7112880992495022,14212900,170511364,156298464
895000.0,4,3.0,3500,13444,2.0,0,0,2,10,2360,1140,1977,0.0,98040,47.5468,-122.23100000000001,3140,12935,9944,0.7396608152335614,12250000,180741136,168491136
656000.0,3,1.75,1480,7475,1.5,0,0,2,8,1480,0,1943,0.0,98115,47.6732,-122.272,2120,7216,5995,0.8020066889632107,2190400,55875625,53685225
560000.0,4,1.0,1660,4690,1.5,0,0,2,7,1260,400,1945,0.0,98117,47.6829,-122.37799999999999,1400,3876,3030,0.6460554371002132,2755600,21996100,19240500
610000.0,5,2.25,2520,11700,2.0,0,0,2,9,2520,0,1977,0.0,98074,47.6322,-122.053,2530,12000,9180,0.7846153846153846,6350400,136890000,130539600
645000.0,4,2.5,2850,37522,2.0,0,0,2,9,2850,0,1987,0.0,98075,47.5852,-121.992,2980,35280,34672,0.9240445605244924,8122500,1407900484,1399777984
259000.0,3,2.5,2153,4400,2.0,0,0,2,8,2153,0,2007,0.0,98001,47.2872,-122.28299999999999,2434,4400,2247,0.5106818181818182,4635409,19360000,14724591
980000.0,4,2.5,3780,10962,2.0,0,0,2,10,3780,0,1990,0.0,98033,47.6533,-122.18299999999999,3310,11651,7182,0.6551724137931034,14288400,120165444,105877044
872000.0,4,4.0,3770,9750,1.0,0,0,3,9,1940,1830,1967,0.0,98177,47.7159,-122.367,2260,9878,5980,0.6133333333333333,14212900,95062500,80849600
1000000.0,6,2.75,3600,9675,1.0,0,2,3,9,1940,1660,1977,0.0,98040,47.5726,-122.213,2990,9675,6075,0.627906976744186,12960000,93605625,80645625
900000.0,3,2.75,2980,12600,1.5,0,0,2,8,1590,1390,1941,2012.0,98033,47.674,-122.196,1520,9660,9620,0.7634920634920634,8880400,158760000,149879600
475000.0,4,1.5,2320,5534,1.5,0,0,3,7,1540,780,1915,0.0,98103,47.6944,-122.355,1670,5913,3214,0.5807734007950849,5382400,30625156,25242756
350000.0,5,2.75,2980,13482,1.0,0,0,3,8,1730,1250,1975,0.0,98042,47.3774,-122.16,2900,14800,10502,0.7789645453196855,8880400,181764324,172883924
840000.0,4,1.75,2930,11562,1.0,0,3,2,9,1670,1260,1947,0.0,98117,47.6765,-122.404,2530,6517,8632,0.7465836360491265,8584900,133679844,125094944
500000.0,4,2.5,2040,8400,1.0,0,0,2,8,1420,620,1963,0.0,98006,47.5512,-122.17,2540,8925,6360,0.7571428571428571,4161600,70560000,66398400
202500.0,3,1.5,1510,9898,1.0,0,0,2,7,1110,400,1954,0.0,98148,47.4303,-122.334,1420,9250,8388,0.847443928066276,2280100,97970404,95690304
523000.0,4,2.5,2660,65340,2.0,0,0,2,8,2660,0,1988,0.0,98027,47.4969,-122.06,2850,74052,62680,0.9592898683807775,7075600,4269315600,4262240000
225000.0,3,2.5,1740,10050,2.0,0,0,2,7,1740,0,1989,0.0,98001,47.2671,-122.236,1300,10125,8310,0.826865671641791,3027600,101002500,97974900
418200.0,3,2.25,2240,9542,1.0,0,1,2,7,1190,1050,1980,0.0,98198,47.3995,-122.318,2080,9542,7302,0.7652483756025991,5017600,91049764,86032164
356500.0,4,1.75,1570,9670,1.0,0,0,2,7,1170,400,1959,0.0,98028,47.7432,-122.24799999999999,2080,9100,8100,0.8376421923474664,2464900,93508900,91044000
670000.0,4,3.0,2500,5000,1.5,0,0,3,7,1460,0,1926,0.0,98103,47.6895,-122.331,1720,4500,2500,0.5,6250000,25000000,18750000
456150.0,3,2.25,1750,12408,1.0,0,0,4,7,1150,600,1962,0.0,98155,47.7509,-122.3,1820,12977,10658,0.8589619600257898,3062500,153958464,150895964
471000.0,4,2.5,3030,9687,2.0,0,0,2,8,2020,1010,1998,0.0,98045,47.485,-121.79899999999999,2050,10193,6657,0.6872096624341901,9180900,93837969,84657069
558000.0,3,2.5,1680,934,3.0,0,0,2,8,1680,0,2008,0.0,98116,47.5891,-122.387,1740,1280,-746,-0.7987152034261242,2822400,872356,-1950044
1380000.0,6,4.5,5740,10312,2.0,0,2,2,11,3610,2130,2000,0.0,98006,47.5533,-122.11,4350,11917,4572,0.44336695112490304,32947600,106337344,73389744
161500.0,3,1.0,1220,6000,1.0,0,0,4,7,1220,0,1961,0.0,98002,47.2811,-122.214,1420,13137,4780,0.7966666666666666,1488400,36000000,34511600
311000.0,3,1.0,1310,8370,1.5,0,0,2,7,1310,0,1962,0.0,98034,47.7284,-122.241,1310,8370,7060,0.8434886499402628,1716100,70056900,68340800
470000.0,6,1.75,2490,8732,1.5,0,0,3,8,2490,0,1966,0.0,98034,47.7252,-122.18700000000001,1840,8024,6242,0.7148419606046724,6200100,76247824,70047724
569000.0,3,3.25,2220,8227,1.5,0,0,4,8,1770,450,1929,0.0,98108,47.5665,-122.316,1750,4800,6007,0.7301568007779263,4928400,67683529,62755129
689000.0,4,2.5,2240,7350,2.0,0,0,2,9,2240,0,1989,0.0,98029,47.5652,-122.01299999999999,2200,8017,5110,0.6952380952380952,5017600,54022500,49004900
271900.0,3,1.75,1890,11875,1.0,0,0,2,7,1230,660,1979,0.0,98045,47.4472,-121.774,1580,10920,9985,0.840842105263158,3572100,141015625,137443525
278000.0,4,2.5,1850,6037,2.0,0,0,2,7,1850,0,1991,0.0,98030,47.358999999999995,-122.191,1860,6037,4187,0.6935564021865165,3422500,36445369,33022869
820000.0,2,2.5,2210,4440,2.0,0,0,3,8,1440,770,1931,0.0,98112,47.6305,-122.3,1560,4920,2230,0.5022522522522522,4884100,19713600,14829500
399500.0,3,1.75,1410,7700,1.0,0,0,3,7,1410,0,1967,0.0,98056,47.5375,-122.176,1560,7700,6290,0.8168831168831169,1988100,59290000,57301900
462000.0,3,2.75,1890,2614,2.0,0,0,3,9,1890,0,1979,0.0,98008,47.6102,-122.11399999999999,1800,2769,724,0.2769701606732976,3572100,6832996,3260896
347500.0,3,1.0,1830,12036,1.0,0,0,2,7,1550,280,1977,0.0,98042,47.3126,-122.04299999999999,1810,12036,10206,0.8479561316051845,3348900,144865296,141516396
562100.0,2,0.75,1440,3700,1.0,0,0,2,7,1200,240,1914,0.0,98107,47.6707,-122.36399999999999,1440,4300,2260,0.6108108108108108,2073600,13690000,11616400
230000.0,2,1.0,950,7560,1.0,0,0,2,6,950,0,1958,0.0,98058,47.4499,-122.176,1160,7560,6610,0.8743386243386243,902500,57153600,56251100
687000.0,4,2.5,2370,10083,2.0,0,0,4,8,2370,0,1966,0.0,98033,47.6715,-122.166,2370,10133,7713,0.7649509074680154,5616900,101666889,96049989
725786.0,4,2.5,3070,5762,2.0,0,0,2,10,3070,0,2000,0.0,98075,47.5847,-122.08,3630,6500,2692,0.46719888927455744,9424900,33200644,23775744
315500.0,3,1.0,1300,12600,1.0,0,0,3,7,1300,0,1969,0.0,98072,47.7422,-122.1,1480,13530,11300,0.8968253968253969,1690000,158760000,157070000
312000.0,4,2.0,1300,7054,1.0,0,0,2,7,1300,0,1950,2013.0,98146,47.5071,-122.369,1560,7100,5754,0.8157074000567054,1690000,49758916,48068916
343000.0,3,3.25,1210,1173,2.0,0,0,2,8,1000,210,2002,0.0,98133,47.7114,-122.35600000000001,1650,1493,-37,-0.03154305200341006,1464100,1375929,-88171
385195.0,1,1.0,710,6000,1.5,0,0,2,6,710,0,2015,0.0,98144,47.5756,-122.316,1440,4800,5290,0.8816666666666667,504100,36000000,35495900
415000.0,4,2.25,2240,12650,1.0,0,0,3,8,1730,510,1981,0.0,98059,47.4777,-122.14200000000001,2150,12650,10410,0.8229249011857708,5017600,160022500,155004900
461000.0,3,1.75,3600,8666,2.0,0,0,3,6,2400,1200,1948,0.0,98033,47.6893,-122.167,2290,8200,5066,0.5845834294945765,12960000,75099556,62139556
369990.0,4,2.5,1960,7133,2.0,0,0,2,7,1960,0,2002,0.0,98056,47.4941,-122.19,1960,6705,5173,0.7252208047105005,3841600,50879689,47038089
349950.0,4,2.5,1820,3134,2.0,0,0,2,7,1820,0,1999,0.0,98019,47.7351,-121.985,1820,3751,1314,0.4192724952137843,3312400,9821956,6509556
285750.0,3,2.25,1960,17126,1.0,0,0,2,8,1400,560,1966,0.0,98055,47.4436,-122.21,2060,11466,15166,0.885554128226089,3841600,293299876,289458276
542500.0,4,2.25,1750,10160,1.0,0,0,2,8,1320,430,1972,0.0,98005,47.5909,-122.15799999999999,2170,11165,8410,0.827755905511811,3062500,103225600,100163100
830000.0,5,3.5,3700,5400,2.0,0,0,2,9,2890,810,2011,0.0,98053,47.7085,-122.117,3620,5460,1700,0.3148148148148148,13690000,29160000,15470000
705000.0,4,2.5,2910,20946,2.0,0,0,3,8,2350,560,1976,0.0,98034,47.7085,-122.24,2020,11342,18036,0.8610713262675451,8468100,438734916,430266816
615000.0,2,1.0,1270,5000,1.0,0,0,2,8,1090,180,1949,0.0,98117,47.6828,-122.39299999999999,1640,5000,3730,0.746,1612900,25000000,23387100
184500.0,2,1.0,720,5880,1.0,0,0,2,6,720,0,1940,0.0,98178,47.5056,-122.27,1440,7200,5160,0.8775510204081632,518400,34574400,34056000
412000.0,2,1.0,1040,5120,1.0,0,0,2,7,1040,0,1901,0.0,98122,47.6048,-122.31200000000001,1250,4000,4080,0.796875,1081600,26214400,25132800
250000.0,3,1.5,2210,11111,1.5,0,0,2,7,2210,0,1934,0.0,98168,47.492,-122.309,1250,8422,8901,0.8010980109801098,4884100,123454321,118570221
580000.0,5,2.0,2060,6000,2.0,0,0,2,7,2060,0,1903,0.0,98105,47.6685,-122.305,1770,5000,3940,0.6566666666666666,4243600,36000000,31756400
220000.0,2,1.0,780,6000,1.0,0,0,4,6,780,0,1923,0.0,98055,47.4759,-122.208,1080,6000,5220,0.87,608400,36000000,35391600
675000.0,4,2.75,2240,8937,1.0,0,0,3,8,1460,780,1976,0.0,98033,47.6495,-122.194,2360,9038,6697,0.7493566073626496,5017600,79869969,74852369
373500.0,2,1.0,800,3330,1.0,0,0,2,7,800,0,1918,0.0,98107,47.6566,-122.35799999999999,1300,4320,2530,0.7597597597597597,640000,11088900,10448900
662700.0,2,1.5,2440,6900,2.0,0,0,2,7,1590,850,1910,0.0,98118,47.5568,-122.271,1770,6900,4460,0.6463768115942029,5953600,47610000,41656400
239950.0,5,1.0,1460,6032,2.0,0,0,3,6,1460,0,1941,0.0,98168,47.486999999999995,-122.28200000000001,1060,10300,4572,0.7579575596816976,2131600,36385024,34253424
383000.0,3,1.0,1150,10196,1.0,0,0,3,7,1150,0,1957,0.0,98052,47.6788,-122.162,1410,8925,9046,0.8872106708513142,1322500,103958416,102635916
485000.0,3,2.75,2650,12350,1.0,0,0,3,7,1470,1180,1975,0.0,98028,47.7669,-122.26799999999999,1950,14075,9700,0.7854251012145749,7022500,152522500,145500000
610000.0,4,2.75,2600,36583,1.0,0,0,4,8,1580,1020,1976,0.0,98075,47.593,-122.054,2300,27820,33983,0.9289287373916847,6760000,1338315889,1331555889
545000.0,6,1.75,1820,6250,1.0,0,0,2,7,1130,690,1954,0.0,98116,47.57899999999999,-122.39,1820,5750,4430,0.7088,3312400,39062500,35750100
780000.0,2,2.5,2560,2500,2.0,0,0,4,8,1690,870,1901,0.0,98112,47.6233,-122.3,1890,5000,-60,-0.024,6553600,6250000,-303600
305000.0,3,2.5,1714,3240,2.0,0,0,2,8,1714,0,2005,0.0,98055,47.4288,-122.19,1714,3240,1526,0.47098765432098766,2937796,10497600,7559804
405000.0,3,1.0,1330,15678,1.0,0,0,2,7,900,430,1984,0.0,98074,47.6355,-122.037,1330,12696,14348,0.9151677509886466,1768900,245799684,244030784
1110000.0,5,3.5,7350,12231,2.0,0,4,2,11,4750,2600,2001,0.0,98065,47.5373,-121.865,5380,12587,4881,0.39906794211429975,54022500,149597361,95574861
273000.0,3,1.75,2050,9045,2.0,0,0,3,6,2050,0,1959,0.0,98058,47.4572,-122.18,1200,9045,6995,0.7733554449972361,4202500,81812025,77609525
326500.0,3,1.0,1810,12375,2.0,0,0,2,7,1810,0,1970,0.0,98072,47.7427,-122.17200000000001,1420,9357,10565,0.8537373737373737,3276100,153140625,149864525
365000.0,3,1.75,1380,9134,1.0,0,0,4,7,880,500,1981,0.0,98056,47.5087,-122.193,1400,8190,7754,0.848916137508211,1904400,83429956,81525556
1000000.0,3,2.75,3070,10739,2.0,0,0,2,10,2440,630,1987,0.0,98004,47.6444,-122.191,3490,11913,7669,0.7141260825030263,9424900,115326121,105901221
422500.0,2,1.0,800,4046,1.0,0,0,2,7,800,0,1940,0.0,98117,47.6895,-122.382,1400,4046,3246,0.8022738507167573,640000,16370116,15730116
354450.0,4,2.75,2140,9920,2.0,0,0,2,8,2140,0,1993,0.0,98001,47.3529,-122.274,2130,9920,7780,0.7842741935483871,4579600,98406400,93826800
320000.0,3,1.0,1330,9540,1.0,0,0,3,7,1330,0,1971,0.0,98077,47.758,-122.075,1250,10350,8210,0.860587002096436,1768900,91011600,89242700
223000.0,3,1.0,1030,9120,1.0,0,0,2,7,1030,0,1961,0.0,98032,47.3607,-122.291,1470,10220,8090,0.8870614035087719,1060900,83174400,82113500
410000.0,3,2.5,1740,4948,2.0,0,0,2,7,1740,0,2008,0.0,98053,47.6966,-122.025,1290,3383,3208,0.6483427647534358,3027600,24482704,21455104
438000.0,3,1.0,1200,4000,1.5,0,0,3,6,1200,0,1923,0.0,98144,47.5881,-122.29899999999999,1390,4000,2800,0.7,1440000,16000000,14560000
390000.0,3,3.0,1490,2944,2.0,0,0,2,7,960,530,1993,0.0,98199,47.6506,-122.384,1590,1600,1454,0.4938858695652174,2220100,8667136,6447036
298500.0,4,2.5,1890,5954,2.0,0,0,2,7,1890,0,2004,0.0,98092,47.3293,-122.194,2030,5880,4064,0.6825663419549882,3572100,35450116,31878016
749999.0,5,2.25,3060,13630,2.0,0,0,2,10,3060,0,1989,0.0,98006,47.5585,-122.117,3430,10700,10570,0.7754952311078503,9363600,185776900,176413300
779000.0,6,2.5,3250,12000,1.0,0,1,2,8,1800,1450,1966,0.0,98115,47.6935,-122.28,3490,10320,8750,0.7291666666666666,10562500,144000000,133437500
570000.0,3,2.75,2730,11936,2.0,0,2,2,8,1530,1200,1978,0.0,98034,47.6987,-122.23100000000001,2810,12333,9206,0.7712801608579088,7452900,142468096,135015196
385000.0,3,1.0,810,4600,1.0,0,0,2,6,810,0,1918,0.0,98144,47.5712,-122.316,1520,4800,3790,0.8239130434782609,656100,21160000,20503900
649000.0,4,2.0,2240,11040,1.0,0,0,4,8,1120,1120,1961,0.0,98033,47.69300000000001,-122.16799999999999,1790,11040,8800,0.7971014492753623,5017600,121881600,116864000
283000.0,3,1.0,1740,5247,1.0,0,0,2,7,1270,470,1947,0.0,98168,47.5049,-122.329,1070,5636,3507,0.6683819325328759,3027600,27531009,24503409
699900.0,4,2.25,2380,16236,1.0,0,0,2,7,1540,840,1961,0.0,98008,47.6126,-122.12,2230,8925,13856,0.8534121704853412,5664400,263607696,257943296
278500.0,4,1.0,1540,8400,1.0,0,0,2,7,770,770,1971,0.0,98058,47.4278,-122.152,1520,9891,6860,0.8166666666666667,2371600,70560000,68188400
700000.0,4,1.75,2340,9100,1.0,0,0,2,8,1610,730,1975,0.0,98052,47.6401,-122.10799999999999,2470,11000,6760,0.7428571428571429,5475600,82810000,77334400
535000.0,4,2.75,2710,45963,2.0,0,0,2,9,2710,0,1995,0.0,98045,47.4745,-121.72399999999999,2710,33955,43253,0.9410395317973153,7344100,2112597369,2105253269
234500.0,3,1.75,1310,18400,1.0,0,0,2,7,870,440,1954,0.0,98168,47.5035,-122.302,1840,10790,17090,0.928804347826087,1716100,338560000,336843900
374150.0,3,1.75,1390,9585,1.0,0,0,3,7,1390,0,1973,0.0,98133,47.751999999999995,-122.35,1240,8188,8195,0.854981742305686,1932100,91872225,89940125
397000.0,4,2.5,2201,9542,2.0,0,0,2,8,2201,0,2006,0.0,98198,47.4002,-122.31700000000001,1990,9542,7341,0.7693355690630895,4844401,91049764,86205363
613000.0,3,2.25,1960,10385,1.0,0,0,2,8,1960,0,1988,0.0,98008,47.5736,-122.109,2800,12632,8425,0.8112662493981705,3841600,107848225,104006625
1150000.0,3,2.5,2850,10474,1.0,0,0,3,8,1730,1120,1954,0.0,98004,47.6218,-122.209,2820,10474,7624,0.7278976513270957,8122500,109704676,101582176
595000.0,4,1.75,1880,4080,1.0,0,0,2,7,940,940,1924,0.0,98115,47.6754,-122.32700000000001,1410,4080,2200,0.5392156862745098,3534400,16646400,13112000
340000.0,5,2.75,2440,6858,2.0,0,0,2,8,2440,0,2003,0.0,98030,47.3655,-122.17399999999999,2300,6858,4418,0.6442111402741324,5953600,47032164,41078564
388000.0,4,2.5,2560,5800,2.0,0,0,2,9,2560,0,2005,0.0,98038,47.3474,-122.025,3040,5800,3240,0.5586206896551724,6553600,33640000,27086400
404000.0,3,1.75,1410,15210,1.0,0,0,2,7,1410,0,1950,2014.0,98166,47.4181,-122.339,1970,16290,13800,0.9072978303747534,1988100,231344100,229356000
810000.0,3,2.0,2870,6360,1.5,0,1,3,8,1790,1080,1946,0.0,98115,47.6813,-122.275,2310,6466,3490,0.5487421383647799,8236900,40449600,32212700
405000.0,4,2.5,2620,9359,2.0,0,0,2,9,2620,0,1987,0.0,98058,47.438,-122.152,2580,7433,6739,0.7200555614916123,6864400,87590881,80726481
726000.0,5,3.0,2970,10335,2.0,0,0,2,9,2970,0,2000,0.0,98075,47.598,-122.01899999999999,2970,10335,7365,0.7126269956458636,8820900,106812225,97991325
266000.0,3,2.5,1780,7214,1.0,0,0,3,7,1400,380,1986,0.0,98030,47.3667,-122.182,1520,7228,5434,0.7532575547546437,3168400,52041796,48873396
722500.0,5,2.25,3700,7207,1.0,0,1,4,8,1850,1850,1970,0.0,98177,47.7736,-122.37100000000001,2340,7900,3507,0.4866102400444013,13690000,51940849,38250849
352000.0,4,2.5,1252,25002,1.0,0,0,2,8,992,260,1996,0.0,98001,47.3216,-122.291,1860,25002,23750,0.9499240060795137,1567504,625100004,623532500
265000.0,4,1.5,1240,8158,1.0,0,0,3,7,1110,130,1961,0.0,98198,47.3716,-122.31,1520,8147,6918,0.8480019612650159,1537600,66552964,65015364
856000.0,3,2.5,2160,3920,2.0,0,0,2,9,2160,0,2014,0.0,98116,47.5762,-122.415,1500,4920,1760,0.4489795918367347,4665600,15366400,10700800
346950.0,3,2.5,2040,4348,2.0,0,0,3,8,2040,0,2006,0.0,98038,47.3517,-121.999,2380,4348,2308,0.53081876724931,4161600,18905104,14743504
866059.0,5,3.5,3130,4797,2.0,0,0,2,9,2570,560,2014,0.0,98006,47.5664,-122.12899999999999,3440,5439,1667,0.34750885970398165,9796900,23011209,13214309
410000.0,3,2.5,2350,4456,2.0,0,0,2,7,2350,0,2004,0.0,98065,47.5314,-121.854,2350,4456,2106,0.47262118491921007,5522500,19855936,14333436
370000.0,3,1.75,1570,16817,2.0,0,0,2,7,1570,0,1982,0.0,98045,47.4716,-121.756,1600,16817,15247,0.906642088362966,2464900,282811489,280346589
230000.0,3,1.0,1530,389126,1.5,0,0,3,7,1530,0,1919,0.0,98022,47.1776,-122.01100000000001,1768,42148,387596,0.9960681116142329,2340900,151419043876,151416702976
400000.0,2,2.0,1520,5010,1.0,0,0,2,7,1520,0,1999,0.0,98117,47.6948,-122.36399999999999,1110,5040,3490,0.6966067864271457,2310400,25100100,22789700
172000.0,3,1.0,1350,9680,1.0,0,0,3,7,820,530,1959,0.0,98023,47.3274,-122.346,1320,9225,8330,0.8605371900826446,1822500,93702400,91879900
615000.0,3,1.75,1950,8480,1.0,0,0,3,8,1250,700,1962,0.0,98007,47.5893,-122.15,1740,8480,6530,0.7700471698113207,3802500,71910400,68107900
860000.0,4,3.5,3950,9600,2.0,0,0,2,10,3950,0,1998,0.0,98075,47.5945,-121.98100000000001,3110,10213,5650,0.5885416666666666,15602500,92160000,76557500
555000.0,3,1.75,2040,6000,1.0,0,0,4,7,1120,920,1958,0.0,98116,47.5688,-122.397,1530,6250,3960,0.66,4161600,36000000,31838400
579000.0,3,2.5,1990,4040,1.5,0,0,4,8,1390,600,1926,0.0,98103,47.6867,-122.354,1180,3030,2050,0.5074257425742574,3960100,16321600,12361500
385000.0,3,1.75,1300,7030,1.0,0,0,2,7,1300,0,1968,0.0,98034,47.721000000000004,-122.179,1450,7650,5730,0.8150782361308677,1690000,49420900,47730900
420000.0,4,2.25,2030,12000,2.0,0,0,2,7,2030,0,1977,0.0,98011,47.7699,-122.16799999999999,2190,9900,9970,0.8308333333333333,4120900,144000000,139879100
645000.0,3,1.75,2340,6750,1.5,0,0,4,7,1620,720,1914,0.0,98103,47.6956,-122.335,1410,3388,4410,0.6533333333333333,5475600,45562500,40086900
549950.0,3,2.5,2160,6288,2.0,0,0,2,8,2160,0,1996,0.0,98133,47.7655,-122.35,1830,7600,4128,0.6564885496183206,4665600,39538944,34873344
678000.0,3,2.75,2770,10000,1.0,0,1,4,8,1640,1130,1962,0.0,98033,47.7011,-122.206,2450,10000,7230,0.723,7672900,100000000,92327100
199000.0,4,2.0,2030,8120,2.0,0,0,2,7,2030,0,1950,0.0,98178,47.4994,-122.26100000000001,1520,9440,6090,0.75,4120900,65934400,61813500
604000.0,3,1.0,1440,13824,1.0,0,0,3,7,1440,0,1957,0.0,98040,47.5872,-122.241,2540,12092,12384,0.8958333333333334,2073600,191102976,189029376
268000.0,5,1.75,1730,10368,1.0,0,0,4,7,1010,720,1963,0.0,98059,47.5008,-122.162,1730,7728,8638,0.8331404320987654,2992900,107495424,104502524
960000.0,5,3.5,4510,16305,2.0,0,0,2,10,2820,1690,2003,0.0,98074,47.6346,-122.01100000000001,4330,18741,11795,0.7233977307574364,20340100,265853025,245512925
509250.0,3,2.5,2100,7600,1.0,0,0,3,7,1450,650,1980,0.0,98052,47.6968,-122.12700000000001,2010,7600,5500,0.7236842105263158,4410000,57760000,53350000
416000.0,3,2.5,1800,5372,2.0,0,0,2,8,1800,0,1987,0.0,98034,47.7188,-122.177,1650,6014,3572,0.6649292628443783,3240000,28858384,25618384
190000.0,3,1.0,1090,8520,1.0,0,0,2,7,1090,0,1967,0.0,98003,47.3364,-122.307,1190,8520,7430,0.8720657276995305,1188100,72590400,71402300
212000.0,3,1.5,1010,10000,1.0,0,0,3,7,1010,0,1973,0.0,98003,47.2881,-122.294,2420,34637,8990,0.899,1020100,100000000,98979900
325900.0,3,2.5,2040,9765,2.0,0,0,2,8,2040,0,1985,0.0,98023,47.309,-122.34899999999999,2350,10150,7725,0.7910906298003072,4161600,95355225,91193625
560000.0,3,3.5,2270,4088,2.0,0,0,2,8,1880,390,1996,0.0,98136,47.5356,-122.384,1760,5425,1818,0.44471624266144816,5152900,16711744,11558844
275000.0,3,2.5,1730,5799,2.0,0,0,3,7,1730,0,1987,0.0,98030,47.3499,-122.177,1710,6490,4069,0.7016727021900327,2992900,33628401,30635501
665000.0,4,2.5,2480,15411,2.0,0,2,2,8,2480,0,1994,0.0,98059,47.5379,-122.16,2940,14679,12931,0.8390759846862631,6150400,237498921,231348521
1510000.0,4,3.5,3480,7232,2.0,0,0,2,9,2580,0,1926,2010.0,98144,47.5859,-122.291,2380,5642,3752,0.5188053097345132,12110400,52301824,40191424
375000.0,4,2.0,1720,2410,1.0,0,0,2,7,970,750,1930,2006.0,98106,47.5252,-122.361,1160,1404,690,0.2863070539419087,2958400,5808100,2849700
359950.0,3,1.75,1570,6975,1.0,0,0,2,7,1040,530,1979,0.0,98126,47.5137,-122.37,1280,7813,5405,0.774910394265233,2464900,48650625,46185725
340000.0,4,2.75,3527,7200,2.0,0,0,2,7,3527,0,2005,0.0,98198,47.3823,-122.3,2490,7200,3673,0.5101388888888889,12439729,51840000,39400271
401000.0,2,1.0,840,8100,1.0,0,0,3,7,840,0,1948,0.0,98177,47.7019,-122.366,1100,8220,7260,0.8962962962962963,705600,65610000,64904400
669000.0,2,1.75,1950,10766,1.0,0,3,3,6,1160,790,1952,0.0,98166,47.4504,-122.37700000000001,1780,11721,8816,0.8188742336986811,3802500,115906756,112104256
638500.0,4,2.5,1980,6568,2.0,0,0,2,8,1980,0,2004,0.0,98052,47.70399999999999,-122.101,2310,6496,4588,0.6985383678440926,3920400,43138624,39218224
545000.0,2,1.5,1620,3760,2.0,0,0,4,7,1170,450,1924,0.0,98144,47.6012,-122.291,2130,4000,2140,0.5691489361702128,2624400,14137600,11513200
524000.0,4,1.0,1980,7015,1.0,0,0,2,7,1260,720,1973,0.0,98034,47.7204,-122.18,1570,7626,5035,0.7177476835352815,3920400,49210225,45289825
1610000.0,5,3.75,3530,13260,2.0,0,0,2,10,3530,0,2013,0.0,98040,47.5761,-122.205,3340,13260,9730,0.7337858220211161,12460900,175827600,163366700
280000.0,2,1.0,1260,4800,1.0,0,0,2,6,1100,160,1947,0.0,98126,47.5196,-122.376,1260,2435,3540,0.7375,1587600,23040000,21452400
828000.0,4,2.5,2120,10841,1.0,0,0,3,8,1500,620,1979,0.0,98006,47.556000000000004,-122.156,3130,10950,8721,0.8044460843095655,4494400,117527281,113032881
223000.0,3,1.75,1360,10573,1.0,0,0,3,7,1360,0,1984,0.0,98023,47.2983,-122.374,1580,8280,9213,0.8713704719568712,1849600,111788329,109938729
1290000.0,4,3.5,3100,2261,2.0,0,2,2,9,2250,850,1981,0.0,98033,47.6512,-122.20200000000001,2660,2000,-839,-0.3710747456877488,9610000,5112121,-4497879
750000.0,2,2.0,2370,155130,1.0,0,0,2,7,2370,0,1970,0.0,98019,47.7388,-121.97200000000001,1860,14475,152760,0.9847224908141559,5616900,24065316900,24059700000
430000.0,2,1.0,1460,9207,1.0,0,0,2,7,1210,250,1947,0.0,98125,47.7195,-122.287,1500,6898,7747,0.8414250027153253,2131600,84768849,82637249
711000.0,4,1.75,1980,10800,1.0,0,0,4,6,990,990,1948,0.0,98040,47.5768,-122.22200000000001,2180,10800,8820,0.8166666666666667,3920400,116640000,112719600
310000.0,4,2.5,1930,7014,2.0,0,0,2,8,1930,0,1994,0.0,98042,47.3921,-122.163,1990,7920,5084,0.7248360422013117,3724900,49196196,45471296
415000.0,5,1.75,3700,9140,1.0,0,0,2,8,1850,1850,1957,0.0,98178,47.5086,-122.258,2190,6720,5440,0.5951859956236324,13690000,83539600,69849600
274900.0,4,2.5,1970,6600,2.0,0,0,2,7,1970,0,1987,0.0,98030,47.3491,-122.16799999999999,1970,7682,4630,0.7015151515151515,3880900,43560000,39679100
525000.0,3,3.0,2470,36445,2.0,0,0,3,8,2470,0,1980,0.0,98027,47.4661,-121.99700000000001,2310,35350,33975,0.9322266428865413,6100900,1328238025,1322137125
179500.0,3,1.0,1180,32214,1.0,0,0,2,7,1180,0,1952,0.0,98092,47.3313,-122.198,2300,13714,31034,0.9633699633699634,1392400,1037741796,1036349396
478000.0,3,1.0,1280,2580,1.5,0,0,2,8,1280,0,1910,2014.0,98115,47.6727,-122.32,1410,3150,1300,0.5038759689922481,1638400,6656400,5018000
195000.0,3,1.75,1380,7350,1.0,0,0,2,7,990,390,1981,0.0,98042,47.369,-122.09299999999999,1660,8400,5970,0.8122448979591836,1904400,54022500,52118100
385000.0,4,3.0,2740,10925,1.0,0,0,2,8,1670,1070,1980,0.0,98058,47.4538,-122.125,2330,9940,8185,0.7491990846681922,7507600,119355625,111848025
401000.0,3,2.75,2020,9505,1.0,0,0,2,7,1260,760,1969,0.0,98011,47.7399,-122.197,2080,11901,7485,0.787480273540242,4080400,90345025,86264625
522000.0,4,2.5,2835,6598,2.0,0,0,2,8,2835,0,2002,0.0,98038,47.3878,-122.03399999999999,2770,6969,3763,0.5703243407093058,8037225,43533604,35496379
330000.0,4,1.75,1520,14417,1.0,0,0,3,7,1520,0,1968,0.0,98065,47.526,-121.809,1600,10716,12897,0.8945689117014636,2310400,207849889,205539489
503000.0,3,2.5,2190,4882,2.0,0,0,2,9,2190,0,1999,0.0,98155,47.7641,-122.306,2190,7055,2692,0.5514133551823024,4796100,23833924,19037824
175000.0,5,1.75,1680,8400,1.0,0,0,3,7,1680,0,1979,0.0,98003,47.3035,-122.307,1800,8550,6720,0.8,2822400,70560000,67737600
963990.0,4,3.5,3915,6364,2.0,0,0,2,9,3915,0,2014,0.0,98053,47.6844,-122.016,3830,6507,2449,0.3848208673790069,15327225,40500496,25173271
845000.0,5,2.0,1720,9972,1.0,0,0,3,8,1720,0,1951,0.0,98004,47.6368,-122.21799999999999,2700,9023,8252,0.8275170477336542,2958400,99440784,96482384
157500.0,2,1.0,670,4500,1.0,0,0,2,5,670,0,1905,0.0,98108,47.5271,-122.32600000000001,1210,4500,3830,0.8511111111111112,448900,20250000,19801100
450000.0,2,3.0,1790,1709,2.0,0,0,2,7,1400,390,2001,0.0,98144,47.5926,-122.296,1460,1462,-81,-0.047396138092451724,3204100,2920681,-283419
925000.0,4,1.75,2440,11793,1.0,0,4,2,8,1420,1020,1950,0.0,98115,47.6807,-122.26700000000001,2500,8028,9353,0.7930976002713475,5953600,139074849,133121249
600000.0,2,1.0,920,5029,1.0,0,0,3,7,920,0,1938,0.0,98115,47.6726,-122.265,1230,5029,4109,0.8170610459335852,846400,25290841,24444441
709000.0,4,1.0,1680,4087,1.5,0,0,2,7,1680,0,1911,0.0,98103,47.6667,-122.337,1740,3745,2407,0.5889405431857108,2822400,16703569,13881169
1390000.0,5,3.75,3290,6480,2.0,0,0,4,10,2190,1100,1938,0.0,98199,47.653,-122.415,2010,7639,3190,0.49228395061728397,10824100,41990400,31166300
248000.0,3,2.5,2120,6840,1.0,0,0,2,7,1220,900,1984,0.0,98092,47.278,-122.145,1820,8200,4720,0.6900584795321637,4494400,46785600,42291200
245000.0,3,1.0,910,6630,1.0,0,0,3,6,910,0,1912,0.0,98103,47.6947,-122.346,950,5100,5720,0.8627450980392157,828100,43956900,43128800
332000.0,2,1.0,1000,4776,1.0,0,0,3,6,1000,0,1942,0.0,98108,47.5619,-122.315,1500,4800,3776,0.7906197654941374,1000000,22810176,21810176
459950.0,3,2.5,2340,4273,2.0,0,0,2,7,2340,0,2002,0.0,98065,47.5362,-121.87799999999999,2400,4624,1933,0.4523753802948748,5475600,18258529,12782929
425000.0,3,2.0,1180,1800,2.0,0,2,2,8,1180,0,1994,0.0,98122,47.6168,-122.301,1500,1948,620,0.34444444444444444,1392400,3240000,1847600
460000.0,3,2.25,2080,50965,1.0,0,0,2,8,1590,490,1979,0.0,98077,47.7506,-122.06299999999999,2270,51836,48885,0.9591876778181104,4326400,2597431225,2593104825
838300.0,6,2.5,3760,12978,1.0,0,0,2,9,2360,1400,1967,0.0,98117,47.6976,-122.381,2300,7362,9218,0.7102789335799045,14137600,168428484,154290884
256000.0,3,2.5,1480,7200,2.0,0,0,4,7,1480,0,1995,0.0,98010,47.3126,-122.023,1350,7200,5720,0.7944444444444444,2190400,51840000,49649600
864000.0,3,2.75,3060,13554,2.0,0,0,2,10,3060,0,1984,0.0,98006,47.5609,-122.10600000000001,3060,11455,10494,0.7742363877822045,9363600,183710916,174347316
900000.0,4,3.5,3070,4440,2.0,0,0,2,9,2030,1040,1922,2007.0,98116,47.5732,-122.411,1780,4800,1370,0.30855855855855857,9424900,19713600,10288700
145600.0,3,1.0,1170,7560,1.0,0,0,2,6,1170,0,1958,0.0,98058,47.4514,-122.178,1170,7560,6390,0.8452380952380952,1368900,57153600,55784700
865000.0,5,3.0,2900,6730,1.0,0,0,4,8,1830,1070,1977,0.0,98115,47.6784,-122.285,2370,6283,3830,0.5690936106983655,8410000,45292900,36882900
250250.0,3,2.25,2210,8000,2.0,0,0,3,8,2210,0,1969,0.0,98023,47.3085,-122.381,1990,8000,5790,0.72375,4884100,64000000,59115900
162000.0,4,2.0,1440,7641,1.0,0,0,3,5,1440,0,1943,0.0,98056,47.508,-122.18299999999999,1440,7750,6201,0.8115429917550059,2073600,58384881,56311281
450000.0,4,1.75,1980,7350,1.0,0,0,2,7,1430,550,1973,0.0,98034,47.7088,-122.20200000000001,1870,7920,5370,0.7306122448979592,3920400,54022500,50102100
675500.0,4,2.75,2060,21344,1.0,0,0,1,8,1460,600,1978,0.0,98005,47.5934,-122.154,2060,16088,19284,0.9034857571214393,4243600,455566336,451322736
697000.0,3,2.25,2420,5304,1.5,0,0,4,7,1640,780,1947,0.0,98115,47.6765,-122.285,1560,5304,2884,0.5437405731523378,5856400,28132416,22276016
1320000.0,3,3.25,3440,4080,2.0,0,0,2,9,2560,880,2005,0.0,98105,47.6644,-122.28,3110,4080,640,0.1568627450980392,11833600,16646400,4812800
490000.0,3,1.75,1600,16510,1.0,0,0,2,8,1600,0,1984,0.0,98052,47.6601,-122.135,1510,10407,14910,0.9030890369473047,2560000,272580100,270020100
590000.0,3,2.25,2210,5742,1.0,0,0,2,8,1460,750,1951,0.0,98115,47.6891,-122.318,1900,4590,3532,0.6151166840822013,4884100,32970564,28086464
280000.0,4,1.75,2250,16000,1.0,0,0,2,8,1450,800,1957,0.0,98023,47.3303,-122.351,1930,16000,13750,0.859375,5062500,256000000,250937500
515000.0,2,1.0,1680,6500,1.0,0,0,3,7,1140,540,1941,0.0,98136,47.55,-122.38799999999999,1610,6500,4820,0.7415384615384616,2822400,42250000,39427600
576000.0,3,1.0,1140,5395,1.0,0,0,3,7,1010,130,1909,0.0,98115,47.6782,-122.306,1700,5376,4255,0.788693234476367,1299600,29106025,27806425
375000.0,3,1.75,1430,10574,2.0,0,0,2,7,1430,0,1981,0.0,98011,47.7668,-122.21799999999999,1900,10450,9144,0.8647626253073577,2044900,111809476,109764576
478000.0,3,1.0,1440,7107,1.0,0,0,3,7,1000,440,1980,0.0,98052,47.6968,-122.124,1540,7140,5667,0.7973828619670748,2073600,50509449,48435849
282000.0,3,1.0,1670,5200,1.0,0,0,4,7,1030,640,1977,0.0,98042,47.3659,-122.09200000000001,1620,6696,3530,0.6788461538461539,2788900,27040000,24251100
1400000.0,4,4.5,3080,10550,2.0,0,3,2,8,1940,1140,1976,2007.0,98040,47.5806,-122.244,2780,10550,7470,0.7080568720379147,9486400,111302500,101816100
593500.0,5,3.25,4300,50405,2.0,0,0,2,8,3220,1080,1972,0.0,98027,47.4615,-122.0,2680,41684,46105,0.9146910028766987,18490000,2540664025,2522174025
724950.0,4,3.5,3010,174240,2.0,0,0,2,9,3010,0,2004,0.0,98045,47.4775,-121.691,2720,247856,171230,0.9827249770431589,9060100,30359577600,30350517500
306000.0,3,1.75,1560,7500,1.0,0,0,3,8,1560,0,1966,0.0,98056,47.489,-122.18,1600,7904,5940,0.792,2433600,56250000,53816400
341000.0,4,1.75,1920,7665,1.0,0,0,3,8,1500,420,1975,0.0,98058,47.4476,-122.12799999999999,2100,7344,5745,0.7495107632093934,3686400,58752225,55065825
399950.0,3,2.5,1400,4400,1.0,0,0,2,7,1400,0,1930,2014.0,98106,47.553000000000004,-122.365,1060,4400,3000,0.6818181818181818,1960000,19360000,17400000
534000.0,5,2.0,2280,3600,2.0,0,0,2,7,2280,0,1992,0.0,98122,47.6056,-122.305,1740,1800,1320,0.36666666666666664,5198400,12960000,7761600
635000.0,6,2.5,3880,5700,2.0,0,0,2,7,3880,0,2003,0.0,98053,47.6816,-122.038,2620,5070,1820,0.3192982456140351,15054400,32490000,17435600
350000.0,2,1.0,1350,3880,1.0,0,0,2,6,950,400,1927,0.0,98103,47.6842,-122.344,1670,3920,2530,0.6520618556701031,1822500,15054400,13231900
856000.0,3,1.5,1480,2700,1.5,0,0,2,7,1480,0,1928,0.0,98112,47.62300000000001,-122.304,1970,4200,1220,0.45185185185185184,2190400,7290000,5099600
582000.0,4,3.0,1670,1189,3.0,0,0,2,8,1427,243,2000,0.0,98122,47.6182,-122.302,1700,1401,-481,-0.40454163162321277,2788900,1413721,-1375179
799000.0,4,2.5,3400,6742,2.0,0,0,2,9,3400,0,2004,0.0,98052,47.7067,-122.12899999999999,2970,6909,3342,0.4956986057549689,11560000,45454564,33894564
423700.0,3,2.5,2070,3986,2.0,0,0,2,8,2070,0,1999,0.0,98065,47.5348,-121.87700000000001,2090,3986,1916,0.4806823883592574,4284900,15888196,11603296
1840000.0,4,3.5,4870,39190,2.0,0,0,2,12,4870,0,1995,0.0,98006,47.5447,-122.124,5000,33880,34320,0.8757336055116101,23716900,1535856100,1512139200
322000.0,3,2.0,1760,43575,1.0,0,0,2,7,1160,600,1988,0.0,98010,47.3565,-121.94,1760,46038,41815,0.9596098680436029,3097600,1898780625,1895683025
929000.0,4,3.25,4030,57499,2.0,0,0,2,9,4030,0,2002,0.0,98053,47.6617,-122.02600000000001,3470,57499,53469,0.9299118245534705,16240900,3306135001,3289894101
443000.0,2,1.0,1130,5413,1.0,0,0,2,7,880,250,1939,0.0,98115,47.6971,-122.315,1250,5413,4283,0.7912433031590616,1276900,29300569,28023669
441500.0,3,1.75,1510,7700,1.0,0,0,2,7,1510,0,1968,0.0,98034,47.7283,-122.194,1440,7416,6190,0.8038961038961039,2280100,59290000,57009900
875000.0,4,3.5,3110,108464,2.0,0,2,3,8,3110,0,1979,0.0,98075,47.592,-122.01799999999999,2340,4938,105354,0.9713268918719575,9672100,11764439296,11754767196
3600000.0,3,3.25,5020,12431,2.0,1,4,2,10,3420,1600,1941,2002.0,98144,47.5925,-122.287,3680,12620,7411,0.5961708631646689,25200400,154529761,129329361
450000.0,2,1.0,740,5100,1.0,0,0,3,7,740,0,1947,0.0,98115,47.6787,-122.301,920,5100,4360,0.8549019607843137,547600,26010000,25462400
425000.0,3,2.25,1630,10500,1.0,0,0,2,7,1100,530,1974,0.0,98034,47.7176,-122.236,1640,9794,8870,0.8447619047619047,2656900,110250000,107593100
660000.0,4,1.75,2780,9900,2.0,0,0,3,10,2780,0,1978,0.0,98074,47.6348,-122.06,2600,12000,7120,0.7191919191919192,7728400,98010000,90281600
763101.0,3,1.75,1990,5560,1.0,0,0,3,7,1100,890,1939,0.0,98105,47.663999999999994,-122.287,1460,3706,3570,0.6420863309352518,3960100,30913600,26953500
499000.0,4,2.75,2250,14149,2.0,0,0,2,9,2250,0,1992,0.0,98019,47.7353,-121.962,2450,14027,11899,0.8409781610007775,5062500,200194201,195131701
521000.0,3,1.75,1720,37363,1.0,0,0,3,8,1350,370,1974,0.0,98053,47.6608,-122.035,2740,40635,35643,0.9539651526911651,2958400,1395993769,1393035369
302000.0,2,1.0,900,423838,1.0,0,2,4,6,900,0,1925,0.0,98022,47.228,-122.088,1810,94960,422938,0.9978765471713249,810000,179638650244,179637840244
293000.0,4,2.25,2360,6260,2.0,0,0,2,7,2360,0,1998,0.0,98038,47.3882,-122.053,2144,6773,3900,0.6230031948881789,5569600,39187600,33618000
335000.0,3,2.25,1530,4580,2.0,0,0,2,7,1530,0,2011,0.0,98019,47.7342,-121.96799999999999,2110,4094,3050,0.665938864628821,2340900,20976400,18635500
499000.0,2,1.0,1450,3090,2.0,0,0,2,7,1450,0,1919,1987.0,98103,47.6853,-122.35600000000001,1450,4635,1640,0.5307443365695793,2102500,9548100,7445600
600000.0,3,1.75,2040,5000,1.5,0,0,2,7,1780,260,1924,0.0,98115,47.6756,-122.29899999999999,1690,5000,2960,0.592,4161600,25000000,20838400
720000.0,4,1.75,2620,11041,1.5,0,0,3,9,2620,0,1962,0.0,98005,47.5975,-122.17399999999999,2230,11041,8421,0.7627026537451318,6864400,121903681,115039281
195000.0,2,2.0,1180,2553,2.0,0,0,2,6,1180,0,2005,0.0,98038,47.3501,-122.02,1310,2687,1373,0.5377986682334508,1392400,6517809,5125409
249000.0,3,1.0,1110,8423,1.0,0,0,2,7,1110,0,1952,0.0,98166,47.4718,-122.34200000000001,1140,9083,7313,0.8682179745933752,1232100,70946929,69714829
334000.0,3,2.25,1840,9781,2.0,0,0,2,7,1840,0,1989,0.0,98019,47.7347,-121.976,1490,10101,7941,0.8118801758511399,3385600,95667961,92282361
599950.0,4,1.75,2720,7810,1.0,0,0,2,8,1510,1210,1952,0.0,98115,47.6788,-122.28299999999999,2120,7315,5090,0.6517285531370038,7398400,60996100,53597700
149900.0,2,1.75,1090,1950,1.0,0,0,3,8,1090,0,1982,0.0,98198,47.3782,-122.319,1360,3426,860,0.441025641025641,1188100,3802500,2614400
700000.0,4,1.75,1730,6500,1.0,0,0,2,7,1250,480,1945,0.0,98115,47.6982,-122.28200000000001,1910,8100,4770,0.7338461538461538,2992900,42250000,39257100
525000.0,4,1.5,1170,6240,1.0,0,0,3,6,1170,0,1960,0.0,98040,47.5495,-122.23200000000001,2380,8846,5070,0.8125,1368900,38937600,37568700
1050000.0,4,3.75,4740,126759,2.0,0,0,3,10,4740,0,1991,0.0,98027,47.4449,-121.979,3060,118047,122019,0.9626062054765342,22467600,16067844081,16045376481
402000.0,3,2.5,1960,8000,1.0,0,0,3,7,1290,670,1977,0.0,98034,47.7249,-122.178,1960,8000,6040,0.755,3841600,64000000,60158400
450000.0,3,2.0,1430,3480,1.0,0,0,2,7,980,450,1947,0.0,98103,47.6874,-122.336,1450,4650,2050,0.5890804597701149,2044900,12110400,10065500
520000.0,3,2.25,2510,43995,2.0,0,0,2,8,2510,0,1981,0.0,98027,47.4545,-121.988,2470,48351,41485,0.9429480622798045,6300100,1935560025,1929259925
205000.0,3,1.75,1420,6980,1.0,0,0,4,7,820,600,1980,0.0,98023,47.2873,-122.367,1470,7319,5560,0.7965616045845272,2016400,48720400,46704000
635000.0,3,2.25,2680,175982,1.0,0,0,2,9,2680,0,2004,0.0,98038,47.4487,-122.03299999999999,3170,215186,173302,0.9847711697787274,7182400,30969664324,30962481924
210500.0,3,1.0,1220,9600,1.0,0,0,4,7,1220,0,1958,0.0,98001,47.2622,-122.28200000000001,1310,9600,8380,0.8729166666666667,1488400,92160000,90671600
406650.0,2,1.0,1070,6100,1.0,0,0,2,6,1070,0,1940,0.0,98126,47.5698,-122.37700000000001,1770,5695,5030,0.8245901639344262,1144900,37210000,36065100
350000.0,3,1.75,1580,19998,1.0,0,0,3,7,1580,0,1968,0.0,98010,47.3299,-122.046,1860,19998,18418,0.920992099209921,2496400,399920004,397423604
425000.0,4,1.75,1820,6000,1.0,0,0,2,7,930,890,1942,0.0,98115,47.6872,-122.296,1590,6000,4180,0.6966666666666667,3312400,36000000,32687600
798000.0,3,3.5,3590,6402,2.0,0,0,2,10,3590,0,1999,0.0,98074,47.6336,-122.06299999999999,3230,7305,2812,0.4392377382068104,12888100,40985604,28097504
180000.0,3,1.0,1960,9583,2.0,0,0,1,5,1960,0,1908,0.0,98056,47.505,-122.171,1850,8324,7623,0.7954711468224982,3841600,91833889,87992289
1250000.0,5,3.25,3160,13238,2.0,0,0,4,8,3160,0,1972,0.0,98040,47.5373,-122.22399999999999,2360,12042,10078,0.7612932467140051,9985600,175244644,165259044
435000.0,4,2.0,2030,4033,2.0,0,0,3,7,1630,400,1925,0.0,98133,47.7056,-122.34200000000001,1350,1340,2003,0.496652615918671,4120900,16265089,12144189
355000.0,3,1.5,1240,15867,1.0,0,0,2,7,1240,0,1962,0.0,98034,47.7167,-122.20200000000001,1570,9600,14627,0.9218503812945106,1537600,251761689,250224089
3000000.0,5,3.25,5370,14091,2.0,0,0,2,10,3850,1520,1918,2008.0,98004,47.6499,-122.21600000000001,2410,12047,8721,0.6189056844794549,28836900,198556281,169719381
685000.0,5,2.5,2670,14455,2.0,0,0,4,9,2670,0,1958,0.0,98155,47.7565,-122.28399999999999,1810,14455,11785,0.8152888273953649,7128900,208947025,201818125
311000.0,3,1.0,1640,12060,1.0,0,0,3,7,1640,0,1960,0.0,98059,47.4941,-122.15100000000001,1680,9147,10420,0.8640132669983416,2689600,145443600,142754000
305000.0,4,2.25,2130,9600,1.0,0,0,3,7,2130,0,1966,0.0,98031,47.4119,-122.211,1710,9600,7470,0.778125,4536900,92160000,87623100
675000.0,3,2.5,2550,4954,1.5,0,0,3,7,1850,700,1924,0.0,98144,47.5758,-122.287,1700,4954,2404,0.48526443278159065,6502500,24542116,18039616
769000.0,4,2.75,3630,15405,1.0,0,2,3,8,1850,1780,1968,0.0,98040,47.566,-122.225,3380,11184,11775,0.7643622200584226,13176900,237314025,224137125
430000.0,3,1.5,1690,9708,1.5,0,0,4,7,1690,0,1954,0.0,98006,47.5732,-122.13600000000001,1570,9858,8018,0.8259167696744952,2856100,94245264,91389164
516250.0,6,2.0,2390,8660,1.5,0,0,3,7,2390,0,1925,0.0,98011,47.7589,-122.21600000000001,2250,12942,6270,0.7240184757505773,5712100,74995600,69283500
760000.0,3,3.5,2350,10739,1.0,0,2,4,7,1340,1010,1940,0.0,98125,47.7288,-122.28399999999999,2580,11026,8389,0.7811714312319583,5522500,115326121,109803621
579950.0,3,3.5,1420,1217,2.0,0,0,2,8,1180,240,2003,0.0,98115,47.6827,-122.324,1494,1264,-203,-0.16680361544782252,2016400,1481089,-535311
476000.0,3,2.25,1570,7187,1.0,0,0,3,8,1170,400,1980,0.0,98133,47.7604,-122.35600000000001,1660,8775,5617,0.7815500208710171,2464900,51652969,49188069
510000.0,3,1.75,1600,19200,1.0,0,0,3,7,1600,0,1967,0.0,98034,47.7202,-122.249,2010,14850,17600,0.9166666666666666,2560000,368640000,366080000
205000.0,2,1.0,720,5040,1.0,0,0,2,6,720,0,1955,0.0,98106,47.5267,-122.36,1357,5120,4320,0.8571428571428571,518400,25401600,24883200
240000.0,3,1.0,1470,7350,1.0,0,0,2,7,1470,0,1969,0.0,98032,47.3616,-122.286,1720,8050,5880,0.8,2160900,54022500,51861600
738000.0,5,3.5,2790,16952,2.0,0,2,2,10,1970,820,1991,0.0,98166,47.4384,-122.34700000000001,2980,17281,14162,0.8354176498348278,7784100,287370304,279586204
420000.0,3,1.75,1720,8102,1.0,0,0,4,6,860,860,1940,0.0,98125,47.7336,-122.29,1440,8106,6382,0.7877067390767711,2958400,65642404,62684004
455000.0,3,1.75,1300,9600,1.0,0,0,3,7,1300,0,1969,0.0,98052,47.6388,-122.103,2070,9775,8300,0.8645833333333334,1690000,92160000,90470000
765000.0,4,1.0,2520,5500,1.5,0,0,4,8,1820,700,1912,0.0,98144,47.5785,-122.292,2350,5000,2980,0.5418181818181819,6350400,30250000,23899600
372000.0,4,1.5,1780,7914,1.5,0,0,3,7,1780,0,1962,0.0,98059,47.5142,-122.163,1350,8069,6134,0.7750821329289866,3168400,62631396,59462996
160000.0,3,1.0,1200,8360,1.0,0,0,1,6,1200,0,1948,0.0,98118,47.5414,-122.281,1570,6823,7160,0.8564593301435407,1440000,69889600,68449600
772000.0,4,2.5,2990,9643,2.0,0,0,2,9,2990,0,2003,0.0,98074,47.6292,-122.024,2990,8666,6653,0.6899305195478586,8940100,92987449,84047349
1130000.0,5,1.75,1910,5640,2.0,0,0,3,9,1910,0,1906,0.0,98112,47.6249,-122.311,2050,5400,3730,0.6613475177304965,3648100,31809600,28161500
479000.0,3,1.0,1370,3000,1.5,0,0,2,7,1370,0,1924,0.0,98103,47.6619,-122.351,1510,2151,1630,0.5433333333333333,1876900,9000000,7123100
570000.0,3,2.5,1910,4941,2.0,0,0,2,8,1910,0,1999,0.0,98075,47.5989,-122.016,1910,4941,3031,0.613438575187209,3648100,24413481,20765381
350000.0,4,1.0,1170,8147,1.5,0,0,2,6,1170,0,1959,0.0,98125,47.7281,-122.289,1260,8147,6977,0.8563888547931754,1368900,66373609,65004709
353000.0,3,2.5,1250,864,3.0,0,0,2,8,1250,0,2004,0.0,98115,47.6978,-122.318,1330,2298,-386,-0.44675925925925924,1562500,746496,-816004
699000.0,5,2.5,3340,24755,2.0,0,0,2,10,3340,0,2002,0.0,98038,47.4565,-122.066,3420,23274,21415,0.865077762068269,11155600,612810025,601654425
265000.0,3,2.0,1380,8536,2.0,0,0,3,7,1380,0,1955,0.0,98148,47.4374,-122.335,1260,8750,7156,0.8383317713214621,1904400,72863296,70958896
167000.0,1,1.0,780,10235,1.5,0,0,2,6,780,0,1989,0.0,98014,47.713,-121.315,930,10165,9455,0.923790913531998,608400,104755225,104146825
500000.0,4,2.25,2080,8000,1.0,0,0,2,8,1390,690,1964,0.0,98008,47.6264,-122.113,1800,7700,5920,0.74,4326400,64000000,59673600
700000.0,3,1.0,1410,7200,2.0,0,0,3,6,1410,0,1901,0.0,98144,47.5924,-122.302,1640,7200,5790,0.8041666666666667,1988100,51840000,49851900
295000.0,1,1.0,520,5600,1.0,0,0,2,6,520,0,1918,0.0,98116,47.5579,-122.395,1030,5265,5080,0.9071428571428571,270400,31360000,31089600
1010000.0,4,3.5,3500,4080,2.0,0,2,2,9,2590,910,2004,0.0,98115,47.6834,-122.292,2430,5100,580,0.14215686274509803,12250000,16646400,4396400
209000.0,2,1.0,840,5265,1.0,0,0,4,6,840,0,1969,0.0,98042,47.3644,-122.08200000000001,920,5100,4425,0.8404558404558404,705600,27720225,27014625
276000.0,3,1.75,2240,9200,1.0,0,0,3,7,1440,800,1968,0.0,98001,47.2635,-122.28399999999999,1740,9600,6960,0.7565217391304347,5017600,84640000,79622400
380000.0,4,2.5,2100,5857,2.0,0,0,2,8,2100,0,2002,0.0,98059,47.4956,-122.163,2090,7779,3757,0.6414546696260884,4410000,34304449,29894449
315000.0,3,1.5,1750,12500,1.0,0,0,2,7,1150,600,1954,0.0,98024,47.5666,-121.902,1680,13000,10750,0.86,3062500,156250000,153187500
685530.0,4,2.5,3130,60467,2.0,0,0,2,9,3130,0,1996,0.0,98014,47.6618,-121.962,2780,44224,57337,0.9482362280252038,9796900,3656258089,3646461189
254600.0,3,2.0,1470,20000,1.0,0,0,3,7,1470,0,1968,0.0,98002,47.2973,-122.08,1390,30056,18530,0.9265,2160900,400000000,397839100
230000.0,3,2.0,1440,5600,1.0,0,0,3,6,720,720,1942,0.0,98056,47.4947,-122.185,1120,5700,4160,0.7428571428571429,2073600,31360000,29286400
335000.0,3,3.0,1430,1249,3.0,0,0,2,8,1430,0,2003,0.0,98103,47.6971,-122.34,1020,1112,-181,-0.14491593274619696,2044900,1560001,-484899
550000.0,4,2.5,2170,9600,1.0,0,0,2,7,1460,710,1980,0.0,98052,47.6789,-122.116,1940,8400,7430,0.7739583333333333,4708900,92160000,87451100
123300.0,3,1.0,1150,8050,1.5,0,0,3,7,1150,0,1956,0.0,98032,47.373999999999995,-122.296,1360,8050,6900,0.8571428571428571,1322500,64802500,63480000
275436.0,4,2.75,2170,9658,1.5,0,0,2,7,2170,0,1966,0.0,98030,47.3741,-122.189,1490,9731,7488,0.7753158003727479,4708900,93276964,88568064
325000.0,4,3.5,2630,3435,1.5,0,3,2,7,1640,990,1984,0.0,98188,47.4355,-122.272,1920,2435,805,0.23435225618631733,6916900,11799225,4882325
635000.0,4,2.5,2490,40608,2.0,0,0,2,9,2490,0,1997,0.0,98053,47.6507,-122.00399999999999,3170,45441,38118,0.9386820330969267,6200100,1649009664,1642809564
513000.0,3,1.75,1710,5000,1.0,0,0,3,7,1110,600,1944,0.0,98107,47.6689,-122.37,920,5000,3290,0.658,2924100,25000000,22075900
580000.0,4,2.5,2130,35752,1.0,0,0,2,8,1490,640,1980,0.0,98075,47.5748,-122.031,3030,34000,33622,0.940422913403446,4536900,1278205504,1273668604
225000.0,3,1.0,940,9272,1.0,0,0,2,7,940,0,1954,0.0,98148,47.4353,-122.335,1270,9375,8332,0.8986194995685937,883600,85969984,85086384
265000.0,3,1.0,1400,9460,1.0,0,0,2,7,1060,340,1961,0.0,98168,47.5119,-122.321,1570,7700,8060,0.8520084566596194,1960000,89491600,87531600
313000.0,4,1.75,1630,3000,1.0,0,0,2,7,930,700,1978,0.0,98144,47.5961,-122.305,1630,3000,1370,0.45666666666666667,2656900,9000000,6343100
296000.0,2,1.0,1370,8400,1.0,0,0,2,7,1370,0,1948,0.0,98133,47.7344,-122.336,1330,8396,7030,0.8369047619047619,1876900,70560000,68683100
655500.0,4,2.75,2380,15800,1.0,0,0,2,8,1680,700,1957,0.0,98007,47.5929,-122.133,1950,11751,13420,0.8493670886075949,5664400,249640000,243975600
250750.0,5,1.75,2140,12058,1.0,0,0,3,8,2140,0,1951,0.0,98002,47.3167,-122.214,1640,10125,9918,0.8225244650854204,4579600,145395364,140815764
438000.0,4,2.5,1970,8545,2.0,0,0,2,8,1970,0,2004,0.0,98059,47.4893,-122.13799999999999,2590,7200,6575,0.7694558221181977,3880900,73017025,69136125
590000.0,3,2.75,2550,54014,2.0,0,0,3,8,1980,570,1967,0.0,98072,47.7596,-122.117,2180,21600,51464,0.9527900174028956,6502500,2917512196,2911009696
329500.0,3,1.0,1080,5250,1.0,0,0,3,7,1080,0,1947,0.0,98133,47.7309,-122.336,1100,5250,4170,0.7942857142857143,1166400,27562500,26396100
1200000.0,3,2.25,3070,9645,2.0,0,0,2,10,2110,960,1987,0.0,98006,47.5522,-122.14399999999999,3130,9450,6575,0.6817003628823225,9424900,93026025,83601125
415000.0,2,1.0,1470,6000,1.0,0,0,2,6,900,570,1944,0.0,98199,47.6527,-122.38600000000001,1670,6000,4530,0.755,2160900,36000000,33839100
900000.0,4,2.5,3620,42580,2.0,0,0,2,10,3620,0,1984,0.0,98052,47.7204,-122.115,2950,33167,38960,0.9149835603569751,13104400,1813056400,1799952000
378000.0,3,1.5,1050,57499,1.0,0,0,2,7,1050,0,1975,0.0,98024,47.5602,-121.86,1460,42688,56449,0.9817388128489191,1102500,3306135001,3305032501
474000.0,2,1.0,1050,403365,1.0,0,3,4,6,1050,0,1905,0.0,98022,47.2221,-122.059,1760,108900,402315,0.9973968985906065,1102500,162703323225,162702220725
464000.0,3,1.0,1320,3625,2.0,0,0,2,7,1320,0,1900,0.0,98122,47.6049,-122.288,1660,5438,2305,0.6358620689655172,1742400,13140625,11398225
310000.0,3,1.0,1210,7649,1.0,0,0,3,7,1210,0,1956,0.0,98155,47.7693,-122.32,1210,6760,6439,0.841809386847954,1464100,58507201,57043101
580000.0,3,1.5,1860,7190,2.0,0,1,4,7,1860,0,1952,0.0,98177,47.7716,-122.39200000000001,1670,5525,5330,0.741307371349096,3459600,51696100,48236500
999000.0,3,2.75,2830,505166,1.0,1,3,3,8,1830,1000,1962,0.0,98070,47.3782,-122.514,2120,21988,502336,0.9943978810925518,8008900,255192687556,255184678656
510000.0,2,1.0,810,6480,1.0,0,0,4,6,810,0,1942,0.0,98199,47.6493,-122.398,1920,6000,5670,0.875,656100,41990400,41334300
650000.0,3,1.5,1630,7475,1.0,0,1,2,7,1160,470,1940,0.0,98115,47.6725,-122.272,2320,7475,5845,0.7819397993311037,2656900,55875625,53218725
196000.0,3,1.0,880,19600,1.0,0,0,3,7,880,0,1978,0.0,98023,47.2707,-122.34,880,10500,18720,0.9551020408163265,774400,384160000,383385600
220000.0,4,1.75,1660,11664,1.0,0,0,2,6,1010,650,1952,0.0,98168,47.4943,-122.331,1670,9975,10004,0.857681755829904,2755600,136048896,133293296
855000.0,3,2.25,3440,10628,2.0,0,2,2,10,3440,0,1985,0.0,98006,47.5647,-122.10799999999999,3170,11434,7188,0.6763266842303349,11833600,112954384,101120784
483000.0,3,1.75,2110,10454,1.0,0,0,3,8,1440,670,1978,0.0,98028,47.7344,-122.24600000000001,1990,10890,8344,0.7981633824373445,4452100,109286116,104834016
400000.0,3,1.0,1060,12000,1.0,0,0,2,7,1060,0,1952,0.0,98133,47.7703,-122.35,1550,10500,10940,0.9116666666666666,1123600,144000000,142876400
435000.0,3,2.5,1900,7984,2.0,0,0,2,8,1900,0,1993,0.0,98011,47.7433,-122.194,2650,9352,6084,0.7620240480961924,3610000,63744256,60134256
219500.0,1,1.0,820,1060,1.0,0,0,2,8,760,60,2007,0.0,98126,47.5473,-122.37100000000001,1770,1924,240,0.22641509433962265,672400,1123600,451200
2950000.0,4,3.5,4860,23885,2.0,0,0,2,12,4860,0,1996,0.0,98039,47.6172,-122.23,3580,16054,19025,0.7965250157002303,23619600,570493225,546873625
427000.0,3,2.5,2050,3218,3.0,0,0,2,7,2050,0,2008,0.0,98133,47.7612,-122.344,2050,7200,1168,0.362958359229335,4202500,10355524,6153024
430000.0,2,1.5,1090,4013,1.5,0,0,2,7,1090,0,1900,0.0,98103,47.6652,-122.338,1390,4013,2923,0.7283827560428607,1188100,16104169,14916069
685000.0,2,1.5,1090,4013,1.5,0,0,2,7,1090,0,1900,0.0,98103,47.6652,-122.338,1390,4013,2923,0.7283827560428607,1188100,16104169,14916069
495000.0,2,1.5,1920,6250,1.0,0,0,2,7,1060,860,1937,0.0,98199,47.6497,-122.39299999999999,2070,6250,4330,0.6928,3686400,39062500,35376100
299950.0,3,2.5,1870,7942,2.0,0,0,2,7,1870,0,1990,0.0,98001,47.342,-122.279,1870,7392,6072,0.7645429362880887,3496900,63075364,59578464
390000.0,4,1.75,2690,46609,1.5,0,0,2,7,2690,0,1940,0.0,98146,47.4951,-122.352,1920,7302,43919,0.9422858246261452,7236100,2172398881,2165162781
385000.0,3,1.75,2160,5863,1.5,0,0,3,7,1260,900,1928,0.0,98144,47.5729,-122.315,1590,3000,3703,0.6315879242708511,4665600,34374769,29709169
740000.0,4,2.5,3000,10392,2.0,0,0,2,9,3000,0,1995,0.0,98027,47.535,-122.04899999999999,3140,9213,7392,0.7113163972286374,9000000,107993664,98993664
991700.0,4,3.0,2290,2350,2.0,0,1,2,9,1610,680,1924,0.0,98116,47.574,-122.415,1610,3820,60,0.02553191489361702,5244100,5522500,278400
765000.0,3,2.75,2250,9600,2.5,0,0,3,9,1830,420,1909,1991.0,98122,47.6033,-122.287,2060,4980,7350,0.765625,5062500,92160000,87097500
802000.0,4,2.25,2130,8734,2.0,0,2,3,8,2130,0,1961,0.0,98006,47.5672,-122.161,2550,8800,6604,0.756125486604076,4536900,76282756,71745856
950000.0,4,2.75,2500,20000,1.0,0,0,3,8,1700,800,1969,0.0,98004,47.5901,-122.198,2650,20000,17500,0.875,6250000,400000000,393750000
392000.0,4,2.5,2300,41167,2.0,0,0,2,7,2300,0,1988,0.0,98042,47.3412,-122.10799999999999,2300,21765,38867,0.9441300070444774,5290000,1694721889,1689431889
590000.0,3,2.5,3360,218235,1.0,0,0,2,8,3360,0,1989,0.0,98014,47.6601,-121.946,2650,220849,214875,0.9846037528352464,11289600,47626515225,47615225625
425000.0,4,2.5,1920,9000,2.0,0,0,1,7,1920,0,1989,0.0,98126,47.5153,-122.37,1530,10474,7080,0.7866666666666666,3686400,81000000,77313600
765000.0,5,1.75,2440,15143,1.5,0,4,3,8,1740,700,1944,0.0,98146,47.4948,-122.37,2390,10907,12703,0.8388694446278808,5953600,229310449,223356849
313500.0,3,2.25,1440,3488,2.0,0,0,3,7,1440,0,1983,0.0,98034,47.7257,-122.162,1390,3488,2048,0.5871559633027523,2073600,12166144,10092544
320000.0,3,1.0,1780,6840,2.0,0,0,3,6,1780,0,1947,0.0,98125,47.727,-122.3,1410,7200,5060,0.7397660818713451,3168400,46785600,43617200
604000.0,4,1.75,1490,4485,1.0,0,0,2,8,1350,140,1960,0.0,98199,47.6388,-122.399,1380,4846,2995,0.6677814938684504,2220100,20115225,17895125
570000.0,3,2.0,1400,1657,2.0,0,0,2,8,1060,340,2004,0.0,98112,47.6196,-122.29799999999999,1540,2275,257,0.1550995775497888,1960000,2745649,785649
639000.0,4,2.5,2150,12028,2.0,0,0,3,8,2150,0,1982,0.0,98052,47.7224,-122.101,1800,11777,9878,0.8212504156967076,4622500,144672784,140050284
335000.0,4,2.0,1910,10200,1.0,0,0,3,7,1910,0,1963,0.0,98059,47.4804,-122.133,1820,15600,8290,0.8127450980392157,3648100,104040000,100391900
896000.0,4,1.75,2660,3520,2.0,0,0,3,8,2080,580,1917,0.0,98115,47.6743,-122.30799999999999,2100,4080,860,0.24431818181818182,7075600,12390400,5314800
259500.0,3,1.75,1650,12349,1.0,0,0,2,7,1650,0,1957,0.0,98188,47.442,-122.28200000000001,1470,10763,10699,0.8663859421815532,2722500,152497801,149775301
637000.0,3,2.0,1980,6000,1.0,0,0,3,7,1380,600,1958,0.0,98115,47.6921,-122.28299999999999,1260,6000,4020,0.67,3920400,36000000,32079600
307450.0,4,2.75,2690,8874,1.0,0,0,2,8,1370,1320,1980,0.0,98023,47.3078,-122.383,1990,7875,6184,0.6968672526481857,7236100,78747876,71511776
535000.0,3,1.75,1380,3561,1.0,0,0,3,7,860,520,1925,0.0,98117,47.6822,-122.399,1820,4593,2181,0.6124684077506318,1904400,12680721,10776321
669500.0,4,2.25,2500,4046,1.5,0,0,3,7,1520,980,1940,0.0,98117,47.6882,-122.382,1410,4046,1546,0.3821057834898665,6250000,16370116,10120116
259000.0,3,1.75,1590,7148,1.0,0,0,2,7,1590,0,1952,0.0,98166,47.4713,-122.344,1150,7280,5558,0.7775601566871853,2528100,51093904,48565804
441000.0,4,1.5,1100,3300,1.0,0,0,0,7,1100,0,1919,0.0,98122,47.6033,-122.295,2020,4000,2200,0.6666666666666666,1210000,10890000,9680000
228800.0,4,2.5,1470,1612,2.0,0,0,2,7,980,490,2003,0.0,98118,47.5275,-122.271,1460,5027,142,0.0880893300248139,2160900,2598544,437644
530000.0,2,2.0,1680,4950,1.0,0,0,2,8,1680,0,2006,0.0,98053,47.7194,-122.022,1570,4800,3270,0.6606060606060606,2822400,24502500,21680100
524000.0,2,2.0,1450,2272,1.0,0,0,3,6,750,700,1924,0.0,98112,47.633,-122.28200000000001,2170,4370,822,0.3617957746478873,2102500,5161984,3059484
430000.0,4,2.25,2020,4840,1.5,0,0,4,8,1200,820,1925,0.0,98126,47.5576,-122.376,1410,4840,2820,0.5826446280991735,4080400,23425600,19345200
1330000.0,4,3.25,2470,4760,1.5,0,0,4,9,1890,580,1906,0.0,98112,47.6331,-122.31,2470,4760,2290,0.4810924369747899,6100900,22657600,16556700
210000.0,3,1.0,1230,12201,1.0,0,0,2,7,1230,0,1969,0.0,98042,47.3285,-122.134,1230,10780,10971,0.8991885910990902,1512900,148864401,147351501
449000.0,4,2.5,1850,5040,1.0,0,0,2,7,1230,620,1930,0.0,98126,47.5386,-122.37299999999999,1010,5040,3190,0.6329365079365079,3422500,25401600,21979100
945000.0,2,2.5,2540,7089,2.0,0,0,2,9,2540,0,2004,0.0,98116,47.5747,-122.414,1330,7089,4549,0.6416984059810975,6451600,50253921,43802321
200450.0,3,1.0,970,9130,1.0,0,0,2,6,970,0,1957,0.0,98188,47.4369,-122.272,1000,8886,8160,0.8937568455640745,940900,83356900,82416000
219950.0,3,1.5,1070,6601,1.0,0,0,2,6,1070,0,1985,0.0,98002,47.3115,-122.209,1030,6614,5531,0.8379033479775791,1144900,43573201,42428301
659500.0,4,3.0,2620,18362,1.0,0,0,3,8,1870,750,1956,0.0,98006,47.5646,-122.184,2630,16792,15742,0.8573140180808191,6864400,337163044,330298644
746000.0,4,2.75,2110,8190,1.5,0,0,4,8,2110,0,1966,0.0,98008,47.6269,-122.1,2420,8400,6080,0.7423687423687424,4452100,67076100,62624000
540000.0,3,1.75,2110,7129,1.0,0,0,2,8,1280,830,1982,0.0,98052,47.7219,-122.102,1810,8674,5019,0.7040258100715387,4452100,50822641,46370541
485000.0,5,2.0,1910,5508,1.0,0,0,2,7,1020,890,1968,0.0,98133,47.7074,-122.34899999999999,1030,7440,3598,0.6532316630355846,3648100,30338064,26689964
202000.0,2,1.0,670,7844,1.0,0,0,2,6,670,0,1942,0.0,98126,47.5165,-122.37200000000001,740,7218,7174,0.9145843957164712,448900,61528336,61079436
2530000.0,4,5.5,6930,45100,1.0,0,0,3,11,4310,0,1950,1991.0,98006,47.5547,-122.14399999999999,2560,37766,38170,0.8463414634146341,48024900,2034010000,1985985100
502000.0,3,2.75,2010,11200,1.0,0,0,2,8,1360,650,1979,0.0,98028,47.7728,-122.25299999999999,2200,10640,9190,0.8205357142857143,4040100,125440000,121399900
279000.0,2,2.75,1770,10534,1.0,0,0,2,8,1210,560,2003,0.0,98001,47.2773,-122.27600000000001,1600,17400,8764,0.8319726599582304,3132900,110965156,107832256
409500.0,3,1.0,1340,4120,1.0,0,0,3,7,1040,300,1921,0.0,98103,47.6916,-122.352,1270,4635,2780,0.6747572815533981,1795600,16974400,15178800
453000.0,3,2.0,1660,15050,1.0,0,0,2,7,1260,400,1983,0.0,98034,47.7203,-122.194,1660,7320,13390,0.8897009966777408,2755600,226502500,223746900
367000.0,4,1.0,1820,5500,1.5,0,0,2,6,1820,0,1947,0.0,98106,47.5185,-122.363,1140,5500,3680,0.6690909090909091,3312400,30250000,26937600
550000.0,3,2.5,2510,5400,2.0,0,0,2,9,2510,0,1992,0.0,98056,47.5204,-122.206,1840,5400,2890,0.5351851851851852,6300100,29160000,22859900
273500.0,3,1.5,1560,8314,1.0,0,0,2,7,1560,0,1962,0.0,98031,47.4117,-122.209,1820,8925,6754,0.8123646860716863,2433600,69122596,66688996
505000.0,4,3.0,2280,7400,1.0,0,0,2,7,1340,0,1978,0.0,98125,47.71100000000001,-122.306,1540,7500,5120,0.6918918918918919,5198400,54760000,49561600
770000.0,3,2.5,2650,40705,2.0,0,0,2,9,2650,0,1994,0.0,98053,47.668,-122.06299999999999,2550,42625,38055,0.9348974327478197,7022500,1656897025,1649874525
565000.0,4,2.25,2470,7447,2.0,0,0,2,8,2470,0,1984,0.0,98155,47.7514,-122.286,2270,7400,4977,0.6683228145561971,6100900,55457809,49356909
316000.0,3,0.75,1270,10092,1.0,0,0,4,7,1270,0,1971,0.0,98077,47.7567,-122.073,1300,10375,8822,0.8741577487118509,1612900,101848464,100235564
160000.0,4,1.0,1520,7298,1.5,0,0,2,7,1520,0,1960,0.0,98198,47.3706,-122.31,1520,7298,5778,0.7917237599342286,2310400,53260804,50950404
170000.0,3,1.0,1310,9529,1.0,0,0,2,7,1310,0,1956,0.0,98198,47.4105,-122.295,1330,9529,8219,0.8625249239164655,1716100,90801841,89085741
235000.0,3,1.0,1310,9529,1.0,0,0,2,7,1310,0,1956,0.0,98198,47.4105,-122.295,1330,9529,8219,0.8625249239164655,1716100,90801841,89085741
1800000.0,4,3.5,3930,39098,2.0,0,0,2,12,3930,0,1999,0.0,98005,47.6399,-122.15799999999999,4250,38682,35168,0.8994833495319454,15444900,1528653604,1513208704
310000.0,3,1.0,990,7050,1.0,0,0,2,7,990,0,1967,0.0,98034,47.7274,-122.20200000000001,1200,8125,6060,0.8595744680851064,980100,49702500,48722400
285000.0,4,1.75,2080,13629,1.0,0,0,3,7,1040,1040,1955,0.0,98178,47.4866,-122.23200000000001,1780,14659,11549,0.8473842541639152,4326400,185749641,181423241
280000.0,2,1.0,960,4920,1.0,0,0,2,6,960,0,1942,0.0,98117,47.6946,-122.36200000000001,1010,5040,3960,0.8048780487804879,921600,24206400,23284800
2300000.0,4,4.25,4070,13860,2.0,0,3,2,10,4070,0,2004,0.0,98040,47.59,-122.229,3430,9240,9790,0.7063492063492064,16564900,192099600,175534700
763776.0,4,2.5,2750,16139,2.0,0,0,2,9,2750,0,1989,0.0,98075,47.5843,-122.06,2810,13093,13389,0.8296053039221761,7562500,260467321,252904821
530000.0,5,2.75,3230,13572,1.0,0,2,2,8,1880,1350,1965,0.0,98166,47.4393,-122.34700000000001,2910,15292,10342,0.7620100206307103,10432900,184199184,173766284
362000.0,1,1.0,890,211576,1.5,0,0,2,7,890,0,1996,0.0,98019,47.7216,-121.883,1670,217364,210686,0.9957934737399327,792100,44764403776,44763611676
430000.0,2,1.0,990,4920,1.0,0,0,2,6,990,0,1931,0.0,98117,47.6939,-122.368,990,4960,3930,0.7987804878048781,980100,24206400,23226300
456500.0,3,1.0,1290,3880,1.5,0,0,3,7,1290,0,1919,0.0,98117,47.6879,-122.39200000000001,1290,4850,2590,0.6675257731958762,1664100,15054400,13390300
445000.0,4,2.5,2170,5257,2.0,0,0,2,7,2170,0,1989,0.0,98115,47.6999,-122.305,1430,7528,3087,0.5872170439414115,4708900,27636049,22927149
386900.0,3,1.0,1330,10500,1.0,0,0,2,7,960,370,1963,0.0,98034,47.7204,-122.196,1460,11550,9170,0.8733333333333333,1768900,110250000,108481100
479000.0,3,1.0,1340,13750,1.0,0,0,3,7,1340,0,1955,0.0,98006,47.5771,-122.15100000000001,1430,11400,12410,0.9025454545454545,1795600,189062500,187266900
525000.0,3,2.5,2200,4544,2.0,0,0,2,8,2200,0,2000,0.0,98065,47.5319,-121.867,2400,5431,2344,0.5158450704225352,4840000,20647936,15807936
272000.0,4,1.75,2520,10890,1.0,0,0,2,7,1260,1260,1979,0.0,98023,47.3224,-122.34299999999999,2090,12375,8370,0.768595041322314,6350400,118592100,112241700
517000.0,4,1.0,1180,13500,1.5,0,0,2,7,1180,0,1950,0.0,98125,47.7165,-122.30799999999999,1580,8976,12320,0.9125925925925926,1392400,182250000,180857600
615000.0,3,1.75,2660,7800,1.0,0,0,3,8,1330,1330,1951,0.0,98117,47.6993,-122.37799999999999,1950,6240,5140,0.658974358974359,7075600,60840000,53764400
439000.0,3,1.75,1250,7030,1.0,0,0,2,7,1250,0,1965,0.0,98008,47.6285,-122.118,1460,7210,5780,0.8221906116642959,1562500,49420900,47858400
716000.0,3,2.5,2270,7866,1.0,0,0,3,10,2270,0,1988,0.0,98029,47.5622,-122.022,2580,8132,5596,0.7114162217137046,5152900,61873956,56721056
308000.0,2,1.0,1080,6250,1.0,0,2,3,7,1080,0,1942,1968.0,98118,47.5128,-122.251,2100,6875,5170,0.8272,1166400,39062500,37896100
800000.0,3,2.25,1620,4500,2.0,0,0,3,8,1620,0,1926,0.0,98119,47.643,-122.361,1210,4320,2880,0.64,2624400,20250000,17625600
575000.0,3,2.0,940,5000,1.0,0,0,2,7,880,60,1941,0.0,98117,47.6771,-122.398,1420,5000,4060,0.812,883600,25000000,24116400
219950.0,3,1.5,1620,9310,1.0,0,0,3,7,1620,0,1967,0.0,98042,47.3665,-122.10700000000001,1610,10640,7690,0.8259935553168636,2624400,86676100,84051700
770000.0,4,2.5,2350,8001,2.0,0,0,3,8,2350,0,1987,0.0,98006,47.5478,-122.15299999999999,2460,8001,5651,0.7062867141607299,5522500,64016001,58493501
424950.0,3,1.75,2090,7505,1.0,0,0,2,7,2090,0,1967,0.0,98034,47.7326,-122.194,1510,7416,5415,0.7215189873417721,4368100,56325025,51956925
387000.0,3,2.25,1760,45133,2.0,0,0,2,7,1760,0,1984,0.0,98065,47.5124,-121.866,1910,51773,43373,0.9610041433097734,3097600,2036987689,2033890089
790000.0,4,1.75,2050,10920,1.0,0,3,2,8,1450,600,1974,0.0,98155,47.7431,-122.286,2440,10920,8870,0.8122710622710623,4202500,119246400,115043900
156000.0,2,1.0,600,4000,1.0,0,0,2,5,600,0,1933,0.0,98146,47.5065,-122.339,1290,6973,3400,0.85,360000,16000000,15640000
580000.0,2,1.0,2540,7000,1.0,0,0,4,8,1320,1220,1942,0.0,98118,47.5259,-122.26100000000001,2160,6000,4460,0.6371428571428571,6451600,49000000,42548400
490000.0,4,2.25,2090,10869,2.0,0,0,2,8,2090,0,1970,0.0,98033,47.6715,-122.164,1800,17788,8779,0.8077100009200479,4368100,118135161,113767061
950000.0,5,3.25,2700,3650,2.0,0,2,2,9,2070,630,1926,2014.0,98144,47.5959,-122.291,1940,4000,950,0.2602739726027397,7290000,13322500,6032500
400000.0,2,2.5,1410,1281,2.0,0,0,2,8,1090,320,2008,0.0,98126,47.5659,-122.37,1410,2550,-129,-0.10070257611241218,1988100,1640961,-347139
325000.0,2,2.5,1170,1638,2.0,0,0,2,8,1170,0,2008,0.0,98133,47.7041,-122.351,1350,1407,468,0.2857142857142857,1368900,2683044,1314144
365000.0,4,2.5,2540,6688,2.0,0,0,2,9,2540,0,2002,0.0,98092,47.3314,-122.18,2810,6776,4148,0.6202153110047847,6451600,44729344,38277744
255000.0,3,1.75,2190,6000,1.5,0,0,3,7,2190,0,1920,0.0,98002,47.3063,-122.223,1610,6000,3810,0.635,4796100,36000000,31203900
985000.0,5,3.5,3890,13261,2.0,0,1,2,9,2870,1020,1984,0.0,98125,47.7246,-122.28399999999999,3080,13261,9371,0.7066586230299374,15132100,175854121,160722021
595000.0,4,2.5,2030,10722,1.0,0,0,2,7,1100,930,1967,0.0,98115,47.6955,-122.301,1610,9134,8692,0.8106696511844805,4120900,114961284,110840384
427500.0,3,1.0,1350,7085,1.0,0,0,4,7,1350,0,1944,0.0,98125,47.7318,-122.305,1350,7085,5735,0.8094565984474241,1822500,50197225,48374725
728000.0,3,1.5,1940,4000,1.5,0,0,2,8,1310,630,1915,0.0,98112,47.6205,-122.291,1940,4000,2060,0.515,3763600,16000000,12236400
549950.0,2,1.0,1260,4000,1.0,0,0,2,7,1000,260,1940,0.0,98117,47.6898,-122.384,1780,4000,2740,0.685,1587600,16000000,14412400
650000.0,3,2.0,2800,10501,1.0,0,0,2,7,1400,1400,1954,0.0,98125,47.7055,-122.315,2260,6534,7701,0.7333587277402153,7840000,110271001,102431001
1130000.0,5,3.25,3080,13394,1.0,0,2,3,9,2230,0,1968,0.0,98033,47.6651,-122.19,2810,10720,10314,0.770046289383306,9486400,179399236,169912836
203000.0,3,1.0,840,6500,1.0,0,0,4,6,840,0,1969,0.0,98042,47.3637,-122.083,920,4680,5660,0.8707692307692307,705600,42250000,41544400
311000.0,2,1.0,860,3300,1.0,0,0,4,6,860,0,1903,0.0,98118,47.5496,-122.279,1380,4400,2440,0.7393939393939394,739600,10890000,10150400
387500.0,6,2.0,2400,7684,1.0,0,0,2,6,1200,1200,1932,2005.0,98028,47.7705,-122.26899999999999,1290,9800,5284,0.6876626756897449,5760000,59043856,53283856
370000.0,4,2.0,1640,7200,1.0,0,0,2,7,1640,0,1963,0.0,98155,47.7471,-122.324,1500,9000,5560,0.7722222222222223,2689600,51840000,49150400
228000.0,2,1.0,1060,6100,1.0,0,0,2,6,1060,0,1951,0.0,98125,47.7317,-122.296,1550,9150,5040,0.8262295081967214,1123600,37210000,36086400
740000.0,2,1.75,2080,4800,1.0,0,0,4,7,1080,1000,1923,0.0,98117,47.6896,-122.36200000000001,1310,4800,2720,0.5666666666666667,4326400,23040000,18713600
200000.0,4,2.0,2090,6630,1.0,0,0,2,7,1070,1020,1974,0.0,98178,47.5077,-122.26799999999999,1550,7980,4540,0.6847662141779789,4368100,43956900,39588800
660000.0,3,1.0,1240,3500,1.0,0,0,3,7,1240,0,1927,0.0,98103,47.6835,-122.34700000000001,1650,3360,2260,0.6457142857142857,1537600,12250000,10712400
275000.0,4,2.0,2030,8426,2.0,0,0,2,7,2030,0,1944,0.0,98168,47.4806,-122.287,1190,7007,6396,0.7590790410633753,4120900,70997476,66876576
708000.0,2,1.0,1120,5250,1.0,0,0,2,7,950,170,1938,0.0,98199,47.6496,-122.39200000000001,1510,5250,4130,0.7866666666666666,1254400,27562500,26308100
280000.0,3,2.5,1270,9675,2.0,0,0,2,8,1270,0,1993,0.0,98045,47.4639,-121.744,1270,11700,8405,0.868733850129199,1612900,93605625,91992725
325000.0,4,2.5,2260,5702,2.0,0,0,2,8,2260,0,2002,0.0,98042,47.3488,-122.15100000000001,2450,6381,3442,0.6036478428621537,5107600,32512804,27405204
495000.0,3,2.5,1780,47480,2.0,0,0,2,7,1780,0,1995,0.0,98045,47.4723,-121.70700000000001,1890,51836,45700,0.9625105307497894,3168400,2254350400,2251182000
691000.0,2,2.0,1780,3810,1.5,0,0,2,7,980,800,1922,0.0,98119,47.6474,-122.36200000000001,1690,3810,2030,0.5328083989501312,3168400,14516100,11347700
2290000.0,4,2.5,4080,18362,2.0,0,2,3,11,4080,0,1983,0.0,98004,47.6344,-122.214,4080,19991,14282,0.7778019823548633,16646400,337163044,320516644
329500.0,3,2.5,2120,22482,1.0,0,0,4,7,1360,760,1979,0.0,98001,47.341,-122.265,2330,16016,20362,0.9057023396494974,4494400,505440324,500945924
348000.0,3,2.5,2060,7458,2.0,0,0,2,9,2060,0,1989,0.0,98023,47.3045,-122.351,2480,7743,5398,0.72378653794583,4243600,55621764,51378164
425000.0,2,1.0,1670,6212,1.0,0,0,3,7,1670,0,1947,0.0,98125,47.7152,-122.28200000000001,1670,7272,4542,0.7311654861558274,2788900,38588944,35800044
210000.0,3,1.0,1080,21043,1.0,0,0,2,6,1080,0,1942,0.0,98106,47.5515,-122.35700000000001,1380,7620,19963,0.9486765195076747,1166400,442807849,441641449
285000.0,2,1.0,1210,4895,1.0,0,0,2,6,710,500,1951,0.0,98126,47.5202,-122.37299999999999,1100,6000,3685,0.7528089887640449,1464100,23961025,22496925
222000.0,3,1.0,990,8840,1.0,0,0,2,6,990,0,1966,0.0,98023,47.3074,-122.37100000000001,1120,8625,7850,0.8880090497737556,980100,78145600,77165500
200000.0,4,2.5,1720,9600,1.0,0,0,2,7,1120,600,1961,0.0,98092,47.2917,-122.18799999999999,1520,9400,7880,0.8208333333333333,2958400,92160000,89201600
247500.0,3,2.0,1530,8749,1.0,0,0,2,7,1530,0,1995,0.0,98023,47.2974,-122.37200000000001,1750,8749,7219,0.8251228711852783,2340900,76545001,74204101
1500000.0,4,5.5,6550,217374,1.0,0,0,2,11,5400,1150,2006,0.0,98058,47.4302,-122.095,4110,50378,210824,0.9698676014610763,42902500,47251455876,47208553376
190000.0,3,1.75,1100,9452,1.0,0,0,2,6,1100,0,1942,0.0,98146,47.4864,-122.337,1350,9452,8352,0.8836225137537029,1210000,89340304,88130304
975000.0,4,2.5,3020,4950,1.5,0,0,3,9,2020,1000,1921,0.0,98112,47.6467,-122.304,2300,5450,1930,0.3898989898989899,9120400,24502500,15382100
1130000.0,4,3.0,3180,4649,2.0,0,0,3,9,2070,1110,1925,0.0,98105,47.6583,-122.273,2720,5980,1469,0.31598193159819316,10112400,21613201,11500801
283200.0,4,1.75,1830,12540,1.0,0,0,3,8,1130,700,1958,0.0,98003,47.3348,-122.324,2020,12540,10710,0.854066985645933,3348900,157251600,153902700
650000.0,3,2.5,2540,8073,1.0,0,0,3,8,1880,660,1937,0.0,98177,47.7176,-122.36,2110,7702,5533,0.6853709897188158,6451600,65173329,58721729
449500.0,3,2.0,1770,6610,1.0,0,0,3,7,960,810,1954,0.0,98133,47.7703,-122.34299999999999,2010,4361,4840,0.7322239031770046,3132900,43692100,40559200
400000.0,3,1.75,1470,6682,1.0,0,0,2,7,1470,0,1987,0.0,98034,47.7315,-122.226,1790,7379,5212,0.7800059862316672,2160900,44649124,42488224
89950.0,1,1.0,570,4080,1.0,0,0,2,5,570,0,1942,0.0,98146,47.5098,-122.334,890,5100,3510,0.8602941176470589,324900,16646400,16321500
158800.0,3,1.0,960,8291,1.0,0,0,2,6,960,0,1950,0.0,98146,47.5006,-122.334,1110,8231,7331,0.8842117959232904,921600,68740681,67819081
870000.0,4,3.0,2940,7108,2.0,0,1,2,9,2220,720,2011,0.0,98136,47.5437,-122.395,2240,7950,4168,0.586381541924592,8643600,50523664,41880064
196000.0,3,1.5,1000,18568,1.0,0,0,2,6,1000,0,1989,0.0,98001,47.2976,-122.271,1610,17420,17568,0.9461439034898751,1000000,344770624,343770624
850000.0,3,1.75,2450,8603,1.0,0,0,4,8,1340,1110,1940,0.0,98199,47.6536,-122.414,2280,5779,6153,0.7152156224572823,6002500,74011609,68009109
775000.0,4,2.5,3310,5101,2.0,0,0,2,9,3310,0,2005,0.0,98052,47.6649,-122.08,3010,5176,1791,0.35110762595569495,10956100,26020201,15064101
483500.0,3,2.5,1670,4308,2.0,0,0,2,8,1670,0,2001,0.0,98027,47.5307,-122.04700000000001,1670,2897,2638,0.6123491179201486,2788900,18558864,15769964
387000.0,3,1.5,1620,21929,2.0,0,0,2,7,1620,0,1990,0.0,98019,47.766999999999996,-121.90299999999999,1600,21679,20309,0.9261252223083588,2624400,480881041,478256641
900000.0,3,3.0,2990,30869,2.0,0,0,2,10,2990,0,1951,2003.0,98155,47.7602,-122.27799999999999,1750,15802,27879,0.9031390715604652,8940100,952895161,943955061
336000.0,3,1.5,1240,5000,1.0,0,2,2,7,1240,0,1964,0.0,98106,47.5659,-122.36,1050,5000,3760,0.752,1537600,25000000,23462400
415000.0,2,1.0,670,6000,1.0,0,0,4,6,670,0,1949,0.0,98118,47.56100000000001,-122.275,1240,5040,5330,0.8883333333333333,448900,36000000,35551100
350000.0,3,1.5,1320,4400,1.0,0,0,2,6,1320,0,1909,0.0,98112,47.6231,-122.292,1350,4400,3080,0.7,1742400,19360000,17617600
1320000.0,4,5.25,6110,10369,2.0,0,0,2,11,6110,0,2005,0.0,98059,47.5285,-122.135,4190,10762,4259,0.4107435625421931,37332100,107516161,70184061
765000.0,3,1.75,2440,5800,1.0,0,3,3,8,1320,1120,1945,0.0,98199,47.6474,-122.412,2530,5800,3360,0.5793103448275863,5953600,33640000,27686400
527000.0,4,2.5,2900,6736,2.0,0,0,2,8,2900,0,2013,0.0,98059,47.4954,-122.152,2900,6736,3836,0.5694774346793349,8410000,45373696,36963696
524000.0,4,2.75,2310,5000,1.5,0,0,4,8,1480,830,1908,0.0,98118,47.5502,-122.26799999999999,1100,5000,2690,0.538,5336100,25000000,19663900
448000.0,2,1.0,1110,5413,1.0,0,0,2,6,890,220,1937,0.0,98115,47.6925,-122.32,1300,5413,4303,0.7949381119527065,1232100,29300569,28068469
775000.0,4,3.25,4100,241322,2.0,0,0,2,9,2500,1600,1981,0.0,98072,47.7302,-122.096,3770,87821,237222,0.9830102518626566,16810000,58236307684,58219497684
176500.0,3,1.0,930,9900,1.5,0,0,3,5,930,0,1910,0.0,98032,47.3745,-122.23100000000001,930,7200,8970,0.906060606060606,864900,98010000,97145100
750000.0,4,2.25,2420,11120,1.0,0,2,3,8,1620,800,1952,0.0,98146,47.4954,-122.366,2210,8497,8700,0.7823741007194245,5856400,123654400,117798000
1270000.0,4,2.25,2870,6000,1.0,0,0,4,8,1730,1140,1951,0.0,98112,47.6362,-122.28200000000001,2370,5500,3130,0.5216666666666666,8236900,36000000,27763100
250000.0,3,1.0,1480,6750,1.0,0,0,2,7,1480,0,1958,0.0,98146,47.505,-122.366,1480,7594,5270,0.7807407407407407,2190400,45562500,43372100
759000.0,3,2.75,1960,6390,1.5,0,2,4,8,1960,0,1900,0.0,98122,47.6032,-122.285,2440,5870,4430,0.6932707355242567,3841600,40832100,36990500
640000.0,3,2.0,1470,4640,1.5,0,0,3,7,1470,0,1926,0.0,98199,47.6398,-122.39299999999999,1700,5000,3170,0.6831896551724138,2160900,21529600,19368700
990000.0,3,3.25,2460,4182,2.0,0,0,4,8,2100,360,1910,0.0,98115,47.6782,-122.311,2370,4284,1722,0.4117647058823529,6051600,17489124,11437524
395000.0,4,1.75,1960,7945,1.0,0,0,3,7,980,980,1946,0.0,98125,47.7326,-122.291,1290,7945,5985,0.7533039647577092,3841600,63123025,59281425
275000.0,2,1.5,1160,1103,2.0,0,0,2,7,890,270,2006,0.0,98133,47.7677,-122.315,1160,1086,-57,-0.051677243880326386,1345600,1216609,-128991
390000.0,3,2.5,1910,4755,2.0,0,0,2,8,1910,0,1997,0.0,98059,47.4956,-122.162,2460,6099,2845,0.5983175604626709,3648100,22610025,18961925
752500.0,5,2.75,2720,4680,1.5,0,0,3,8,1710,0,1913,0.0,98107,47.6612,-122.363,1670,4800,1960,0.4188034188034188,7398400,21902400,14504000
450000.0,2,1.0,1020,5000,1.5,0,0,3,6,1020,0,1906,0.0,98107,47.6725,-122.396,1490,5000,3980,0.796,1040400,25000000,23959600
473000.0,2,1.0,900,5100,1.0,0,0,3,7,900,0,1909,0.0,98117,47.6804,-122.37799999999999,1400,5100,4200,0.8235294117647058,810000,26010000,25200000
178500.0,3,1.75,1120,10450,1.0,0,0,2,7,1120,0,1973,0.0,98045,47.4418,-121.772,1250,10414,9330,0.8928229665071771,1254400,109202500,107948100
485000.0,3,2.5,2340,59058,1.0,0,0,2,8,2340,0,1985,0.0,98038,47.4052,-122.02799999999999,2700,37263,56718,0.9603779335568424,5475600,3487847364,3482371764
215000.0,3,1.5,1410,8415,1.0,0,0,3,7,780,630,1982,0.0,98023,47.2914,-122.368,1440,7361,7005,0.8324420677361853,1988100,70812225,68824125
589000.0,4,1.75,1920,4862,1.0,0,0,4,7,1060,860,1919,0.0,98116,47.5747,-122.384,1840,4862,2942,0.6051007815713698,3686400,23639044,19952644
325000.0,4,1.75,1370,9993,1.0,0,0,2,6,1370,0,1918,0.0,98028,47.7572,-122.228,1650,11592,8623,0.8629040328229761,1876900,99860049,97983149
580000.0,3,2.5,1590,1937,2.5,0,0,2,8,1590,0,2004,0.0,98116,47.5903,-122.38799999999999,1620,2022,347,0.17914300464636035,2528100,3751969,1223869
181100.0,4,1.75,1850,7500,1.0,0,0,2,7,1850,0,1954,0.0,98198,47.4217,-122.333,1460,7500,5650,0.7533333333333333,3422500,56250000,52827500
345000.0,3,2.0,1430,4200,1.0,0,0,3,7,830,600,1908,0.0,98199,47.6462,-122.384,1540,5000,2770,0.6595238095238095,2044900,17640000,15595100
781000.0,3,1.75,1940,8729,1.0,0,0,2,8,1460,480,1960,0.0,98125,47.7027,-122.28200000000001,2250,9165,6789,0.7777523198533624,3763600,76195441,72431841
402500.0,4,1.0,1270,3630,1.5,0,0,2,7,1270,0,1903,0.0,98122,47.6135,-122.307,1420,4848,2360,0.650137741046832,1612900,13176900,11564000
426000.0,3,1.5,1380,7200,1.0,0,0,2,7,1080,300,1948,0.0,98106,47.5292,-122.348,1220,7200,5820,0.8083333333333333,1904400,51840000,49935600
389000.0,3,2.5,1720,4515,2.0,0,0,2,7,1720,0,2005,0.0,98065,47.5426,-121.87899999999999,2220,4618,2795,0.6190476190476191,2958400,20385225,17426825
670000.0,6,3.0,4050,36171,2.0,0,0,3,8,2620,1430,1970,0.0,98027,47.4708,-122.015,3660,42874,32121,0.8880318487185868,16402500,1308341241,1291938741
1510000.0,4,3.25,3660,5800,2.5,0,0,2,10,3360,300,1909,1995.0,98112,47.6283,-122.31200000000001,3240,5800,2140,0.3689655172413793,13395600,33640000,20244400
288400.0,3,2.25,1870,3230,2.0,0,0,2,7,1870,0,1997,0.0,98056,47.4915,-122.167,1620,3363,1360,0.42105263157894735,3496900,10432900,6936000
700000.0,4,2.0,2230,4635,1.5,0,0,4,7,1510,720,1908,0.0,98103,47.681999999999995,-122.34899999999999,1520,4635,2405,0.5188781014023732,4972900,21483225,16510325
830000.0,4,3.0,2020,6000,1.0,0,0,2,8,1220,800,1968,2015.0,98199,47.6563,-122.40100000000001,1400,6000,3980,0.6633333333333333,4080400,36000000,31919600
1900000.0,2,2.75,3690,32044,2.0,1,4,2,12,3690,0,1989,0.0,98166,47.4485,-122.369,2310,26988,28354,0.8848458369741605,13616100,1026817936,1013201836
350500.0,2,1.0,1450,6380,1.0,0,0,2,7,1450,0,1967,0.0,98115,47.6924,-122.321,1240,6380,4930,0.7727272727272727,2102500,40704400,38601900
431000.0,3,1.75,1630,9000,1.0,0,0,3,7,1630,0,1956,0.0,98166,47.4521,-122.36,1600,11120,7370,0.8188888888888889,2656900,81000000,78343100
485000.0,3,2.5,1840,8250,1.0,0,1,2,8,1340,500,1958,0.0,98177,47.7767,-122.37799999999999,1970,7920,6410,0.776969696969697,3385600,68062500,64676900
780000.0,3,1.5,1620,7500,1.0,0,2,3,8,1620,0,1949,0.0,98117,47.7014,-122.381,2440,7800,5880,0.784,2624400,56250000,53625600
720000.0,2,1.5,1840,9000,1.0,0,2,2,8,1340,500,1957,0.0,98136,47.5281,-122.38799999999999,1880,7560,7160,0.7955555555555556,3385600,81000000,77614400
415000.0,3,1.0,1360,73616,1.0,0,0,2,7,1360,0,1971,0.0,98072,47.7528,-122.119,2040,50965,72256,0.9815257552705934,1849600,5419315456,5417465856
480000.0,4,1.0,2080,5500,1.0,0,0,2,7,1040,1040,1941,0.0,98117,47.6838,-122.38600000000001,1280,4000,3420,0.6218181818181818,4326400,30250000,25923600
452250.0,4,2.25,2550,10000,1.0,0,0,3,7,1560,990,1979,0.0,98028,47.77,-122.259,2440,10000,7450,0.745,6502500,100000000,93497500
316000.0,3,2.5,2550,8170,2.0,0,0,2,8,2550,0,1985,0.0,98023,47.31100000000001,-122.345,1840,8823,5620,0.6878824969400245,6502500,66748900,60246400
700000.0,2,1.0,1160,17635,1.0,1,4,2,6,1160,0,1945,0.0,98178,47.5117,-122.24799999999999,1510,13122,16475,0.9342217181740856,1345600,310993225,309647625
285000.0,4,2.0,1760,5500,1.0,0,1,2,7,780,980,1925,2004.0,98118,47.5183,-122.265,1510,5500,3740,0.68,3097600,30250000,27152400
575000.0,3,1.75,1720,4050,1.0,0,0,4,7,860,860,1906,0.0,98115,47.6782,-122.314,1720,4410,2330,0.5753086419753086,2958400,16402500,13444100
590000.0,3,2.25,2300,12430,1.0,0,2,3,8,1580,720,1960,0.0,98166,47.435,-122.34700000000001,2500,12430,10130,0.8149637972646823,5290000,154504900,149214900
587500.0,4,1.75,2500,20868,1.0,0,2,2,8,1600,900,1956,0.0,98166,47.431000000000004,-122.338,2170,15026,18368,0.8801993482844547,6250000,435473424,429223424
364000.0,4,2.25,1750,10270,1.5,0,0,3,8,1750,0,1968,0.0,98155,47.7612,-122.31,1750,10127,8520,0.8296007789678675,3062500,105472900,102410400
490000.0,3,2.5,1890,10190,2.0,0,0,2,8,1890,0,1986,0.0,98074,47.6478,-122.061,2080,9794,8300,0.8145240431795878,3572100,103836100,100264000
410000.0,3,2.25,1800,36704,1.0,0,0,3,8,1360,440,1978,0.0,98027,47.4688,-122.01299999999999,2730,36404,34904,0.9509590235396687,3240000,1347183616,1343943616
520000.0,3,2.5,2160,4297,2.0,0,0,2,9,2160,0,1999,0.0,98029,47.5476,-122.012,2160,3968,2137,0.4973237142192227,4665600,18464209,13798609
389000.0,3,1.0,1380,6591,1.0,0,0,3,7,1380,0,1947,0.0,98133,47.7164,-122.351,1610,6594,5211,0.7906235776058261,1904400,43441281,41536881
450000.0,2,1.0,1180,6000,1.0,0,0,2,7,1180,0,1910,0.0,98119,47.6531,-122.37299999999999,1600,6000,4820,0.8033333333333333,1392400,36000000,34607600
325000.0,3,2.5,2550,4240,2.0,0,0,2,7,2550,0,2006,0.0,98031,47.3986,-122.169,2550,4240,1690,0.39858490566037735,6502500,17977600,11475100
660000.0,2,1.0,1070,5000,1.0,0,0,2,7,1070,0,1924,0.0,98103,47.6631,-122.337,1400,4000,3930,0.786,1144900,25000000,23855100
850000.0,3,2.25,2870,8170,2.0,0,0,2,10,2250,620,1995,0.0,98136,47.5363,-122.385,1310,8170,5300,0.6487148102815178,8236900,66748900,58512000
285000.0,3,2.5,1940,9874,2.0,0,0,2,7,1940,0,1990,0.0,98042,47.3794,-122.113,1860,8875,7934,0.8035244075349403,3763600,97495876,93732276
395000.0,2,1.0,870,3121,1.0,0,0,3,7,870,0,1923,0.0,98107,47.6659,-122.369,1570,1777,2251,0.7212431912848446,756900,9740641,8983741
440000.0,3,2.0,1550,2401,2.0,0,0,2,7,1550,0,1996,0.0,98103,47.6545,-122.348,1550,3446,851,0.35443565181174513,2402500,5764801,3362301
249000.0,3,1.75,1400,5648,1.5,0,0,4,6,1400,0,1917,0.0,98056,47.5133,-122.196,2320,9420,4248,0.7521246458923513,1960000,31899904,29939904
635000.0,3,1.75,1210,4400,1.5,0,0,3,8,1210,0,1930,0.0,98105,47.6621,-122.288,2020,3750,3190,0.725,1464100,19360000,17895900
515000.0,3,2.5,3430,48993,2.0,0,0,2,9,3430,0,2001,0.0,98001,47.2609,-122.27,2460,36256,45563,0.9299899985712244,11764900,2400314049,2388549149
1400000.0,3,3.25,3020,6073,2.0,0,0,3,9,3020,0,1954,0.0,98112,47.6332,-122.29,3020,7700,3053,0.5027169438498271,9120400,36881329,27760929
200000.0,2,1.0,950,8100,1.0,0,0,2,6,950,0,1955,0.0,98166,47.4572,-122.351,1620,7630,7150,0.8827160493827161,902500,65610000,64707500
1140000.0,4,2.75,3370,8103,1.0,0,3,2,9,1970,1400,1970,2014.0,98136,47.5232,-122.383,2120,6360,4733,0.5841046525978033,11356900,65658609,54301709
445000.0,4,1.0,1460,4600,1.0,0,2,2,6,780,680,1946,0.0,98126,47.566,-122.38,1560,4600,3140,0.6826086956521739,2131600,21160000,19028400
555000.0,3,1.5,1740,4200,1.5,0,0,3,7,1640,100,1920,0.0,98117,47.6782,-122.361,1660,3750,2460,0.5857142857142857,3027600,17640000,14612400
537000.0,4,2.0,1720,6413,1.0,0,0,3,7,860,860,1950,0.0,98116,47.5734,-122.395,1280,6413,4693,0.7317947918290971,2958400,41126569,38168169
315000.0,3,1.75,1480,7500,1.0,0,0,3,7,1480,0,1968,0.0,98055,47.4629,-122.18700000000001,1480,7500,6020,0.8026666666666666,2190400,56250000,54059600
805000.0,5,2.5,3320,7266,2.0,0,0,2,9,3320,0,2000,0.0,98075,47.5862,-122.054,3060,10269,3946,0.5430773465455546,11022400,52794756,41772356
414000.0,4,2.5,3490,9030,1.5,0,0,3,8,3490,0,1969,0.0,98023,47.3198,-122.38600000000001,2540,8400,5540,0.6135105204872646,12180100,81540900,69360800
375000.0,2,1.5,1160,1648,2.0,0,0,2,7,1160,0,2002,0.0,98144,47.5916,-122.29299999999999,1458,2351,488,0.2961165048543689,1345600,2715904,1370304
401000.0,4,1.75,3010,12523,1.0,0,0,2,8,1780,1230,1952,0.0,98125,47.707,-122.316,2040,7560,9513,0.7596422582448296,9060100,156825529,147765429
210000.0,3,1.0,1030,4583,1.0,0,0,2,7,1030,0,1967,0.0,98198,47.4231,-122.329,1730,8023,3553,0.7752563822823478,1060900,21003889,19942989
365000.0,2,1.0,980,5110,1.0,0,0,3,7,780,200,1939,0.0,98115,47.7002,-122.314,1430,5110,4130,0.8082191780821918,960400,26112100,25151700
178000.0,5,1.5,1990,18200,1.0,0,0,2,7,1990,0,1960,0.0,98178,47.4938,-122.262,1860,8658,16210,0.8906593406593407,3960100,331240000,327279900
710000.0,2,1.0,1790,4000,1.0,0,0,3,7,1040,750,1923,0.0,98112,47.6405,-122.301,1310,4000,2210,0.5525,3204100,16000000,12795900
255000.0,2,1.0,810,7980,1.0,0,0,0,6,810,0,1928,0.0,98146,47.489,-122.337,1440,7980,7170,0.8984962406015038,656100,63680400,63024300
528000.0,5,2.25,2940,38009,1.0,0,0,2,8,1700,1240,1977,0.0,98077,47.7653,-122.07700000000001,2620,38300,35069,0.9226498987082007,8643600,1444684081,1436040481
537000.0,4,4.25,4883,26040,2.0,0,3,2,10,3859,1024,2006,0.0,98092,47.26300000000001,-122.21600000000001,3736,9870,21157,0.8124807987711213,23843689,678081600,654237911
442000.0,4,1.5,1360,6110,1.0,0,0,2,7,1010,350,1955,0.0,98116,47.5755,-122.396,1520,6110,4750,0.7774140752864157,1849600,37332100,35482500
375000.0,3,1.75,1370,19550,1.0,0,0,2,7,1370,0,1978,0.0,98014,47.7002,-121.912,1430,17550,18180,0.929923273657289,1876900,382202500,380325600
637250.0,4,2.5,2120,3220,2.0,0,0,2,9,2120,0,2005,0.0,98052,47.6662,-122.083,2120,3547,1100,0.3416149068322981,4494400,10368400,5874000
427500.0,3,1.75,1240,7200,1.0,0,0,4,7,1240,0,1942,0.0,98136,47.5142,-122.389,1640,7200,5960,0.8277777777777777,1537600,51840000,50302400
700000.0,4,2.5,2770,89298,2.0,0,0,2,8,2770,0,2004,0.0,98053,47.6624,-122.01,2650,89298,86528,0.9689802683150799,7672900,7974132804,7966459904
680000.0,3,1.75,1660,5750,1.0,0,0,3,7,1080,580,1909,0.0,98116,47.5843,-122.385,2060,5560,4090,0.711304347826087,2755600,33062500,30306900
393820.0,2,2.0,1170,8251,1.0,0,0,2,7,1170,0,1941,0.0,98115,47.6873,-122.291,1360,6798,7081,0.8581990061810689,1368900,68079001,66710101
525000.0,4,2.75,2470,7200,1.0,0,0,4,7,1350,1120,1940,0.0,98108,47.5631,-122.31700000000001,1500,6000,4730,0.6569444444444444,6100900,51840000,45739100
505000.0,2,1.75,1310,3816,1.0,0,0,1,7,1110,200,1929,0.0,98117,47.678999999999995,-122.368,1510,3816,2506,0.6567085953878407,1716100,14561856,12845756
555565.0,3,2.0,1670,11337,1.0,0,1,3,7,1670,0,1959,0.0,98033,47.6602,-122.18799999999999,2210,11337,9667,0.8526947164152774,2788900,128527569,125738669
650000.0,3,1.75,1660,10819,1.0,0,0,3,7,1240,420,1942,0.0,98177,47.7045,-122.37899999999999,3110,11853,9159,0.8465662260837415,2755600,117050761,114295161
632500.0,5,3.25,3500,7254,2.0,0,0,2,8,2760,740,2005,0.0,98065,47.5444,-121.881,2820,6317,3754,0.517507582023711,12250000,52620516,40370516
269000.0,3,2.5,1440,3800,2.0,0,0,2,7,1440,0,2005,0.0,98038,47.3606,-122.039,1890,3819,2360,0.6210526315789474,2073600,14440000,12366400
405000.0,4,2.75,2360,7716,1.0,0,0,2,7,1390,970,1978,0.0,98034,47.7301,-122.223,2160,8794,5356,0.6941420425090721,5569600,59536656,53967056
845000.0,3,3.5,3460,15745,2.0,0,0,2,10,3460,0,1986,0.0,98077,47.7262,-122.06,3350,14825,12285,0.7802476976818038,11971600,247905025,235933425
234000.0,3,1.0,1750,8820,1.0,0,0,3,7,1750,0,1961,0.0,98032,47.3608,-122.29,1400,9600,7070,0.8015873015873016,3062500,77792400,74729900
638000.0,4,1.75,1470,4236,1.5,0,0,3,7,1470,0,1946,0.0,98107,47.6692,-122.399,1480,5400,2766,0.6529745042492918,2160900,17943696,15782796
290000.0,3,1.75,1710,10950,1.0,0,0,2,7,1060,650,1967,0.0,98045,47.4678,-121.745,1180,10950,9240,0.8438356164383561,2924100,119902500,116978400
262000.0,1,0.75,520,12981,1.0,0,0,4,3,520,0,1920,0.0,98022,47.2082,-121.995,1340,12233,12461,0.9599414528926893,270400,168506361,168235961
270000.0,4,2.5,2350,5835,2.0,0,0,2,8,2350,0,2003,0.0,98042,47.3494,-122.15299999999999,3010,5772,3485,0.5972579263067695,5522500,34047225,28524725
875000.0,4,2.25,2380,4876,2.0,0,0,3,9,2240,140,1948,0.0,98117,47.6822,-122.4,1780,4559,2496,0.5118949958982772,5664400,23775376,18110976
299000.0,3,2.25,1920,7840,2.0,0,0,3,8,1920,0,1982,0.0,98032,47.3631,-122.27600000000001,2170,7210,5920,0.7551020408163265,3686400,61465600,57779200
551000.0,3,1.0,1580,6000,1.0,0,0,4,7,1580,0,1947,0.0,98027,47.5286,-122.03200000000001,1580,6000,4420,0.7366666666666667,2496400,36000000,33503600
350000.0,3,2.75,3070,5280,2.0,0,1,2,7,2360,710,1950,1986.0,98166,47.4486,-122.353,2570,18983,2210,0.4185606060606061,9424900,27878400,18453500
1900000.0,3,2.5,2660,13367,2.0,0,2,2,10,2660,0,1992,0.0,98004,47.6501,-122.21700000000001,2660,13367,10707,0.8010024687663649,7075600,178676689,171601089
511718.0,2,1.75,1700,5000,1.0,0,0,2,6,850,850,1915,0.0,98117,47.6787,-122.363,1690,5000,3300,0.66,2890000,25000000,22110000
965000.0,4,3.25,5010,49222,2.0,0,0,4,9,3710,1300,1978,0.0,98027,47.5489,-122.09200000000001,3140,54014,44212,0.8982162447685994,25100100,2422805284,2397705184
475000.0,4,2.25,2680,4673,2.0,0,0,2,7,2680,0,1999,0.0,98011,47.7539,-122.219,2460,4645,1993,0.4264926171624224,7182400,21836929,14654529
1060000.0,4,2.75,2720,4000,1.5,0,2,4,8,1840,880,1928,0.0,98117,47.6797,-122.359,1600,4000,1280,0.32,7398400,16000000,8601600
252000.0,2,1.0,940,15450,1.0,0,0,3,6,940,0,1926,0.0,98070,47.4408,-122.461,1370,34820,14510,0.9391585760517799,883600,238702500,237818900
580000.0,6,2.5,3596,13700,1.0,0,0,4,8,1798,1798,1964,0.0,98166,47.4388,-122.339,1894,10500,10104,0.7375182481751825,12931216,187690000,174758784
374950.0,2,2.25,1240,1172,2.0,0,0,2,8,1000,240,2008,0.0,98144,47.5877,-122.316,1260,1111,-68,-0.05802047781569966,1537600,1373584,-164016
739000.0,5,4.0,4660,9900,2.0,0,2,3,9,2600,2060,1979,0.0,98056,47.5135,-122.2,3380,9900,5240,0.5292929292929293,21715600,98010000,76294400
271000.0,4,1.75,1710,7200,1.0,0,0,4,7,910,800,1975,0.0,98031,47.3967,-122.17399999999999,1730,7200,5490,0.7625,2924100,51840000,48915900
230000.0,2,1.0,930,7550,1.0,0,0,2,6,930,0,1986,0.0,98168,47.4866,-122.303,1370,10176,6620,0.8768211920529801,864900,57002500,56137600
210000.0,3,2.25,1430,9150,1.0,0,0,2,7,1070,360,1984,0.0,98023,47.3239,-122.35,1430,6364,7720,0.8437158469945355,2044900,83722500,81677600
350000.0,3,2.75,1650,5700,2.0,0,0,3,7,1650,0,1988,0.0,98166,47.4563,-122.348,1320,7620,4050,0.7105263157894737,2722500,32490000,29767500
491500.0,3,2.25,1560,12000,1.0,0,0,3,7,1110,450,1968,0.0,98034,47.7256,-122.166,2190,4612,10440,0.87,2433600,144000000,141566400
325000.0,3,2.5,1870,9825,1.0,0,0,3,7,1250,620,1994,0.0,98045,47.4639,-121.744,1380,11475,7955,0.8096692111959287,3496900,96530625,93033725
190000.0,3,2.0,1320,7625,1.0,0,0,2,7,1320,0,1987,0.0,98038,47.3635,-122.045,1420,7500,6305,0.8268852459016394,1742400,58140625,56398225
658600.0,4,2.0,1400,4690,1.5,0,0,3,7,1400,0,1945,0.0,98117,47.6826,-122.37799999999999,1400,4690,3290,0.7014925373134329,1960000,21996100,20036100
299950.0,3,1.5,1940,8951,1.0,0,0,2,7,1300,640,1958,0.0,98168,47.473,-122.32799999999999,2000,8319,7011,0.7832644397274048,3763600,80120401,76356801
464000.0,5,2.0,2000,3000,1.5,0,0,2,6,1200,800,1931,0.0,98122,47.6028,-122.29799999999999,1330,4000,1000,0.3333333333333333,4000000,9000000,5000000
308000.0,3,1.0,1640,18144,1.5,0,0,2,6,1640,0,1942,0.0,98168,47.5027,-122.33,1500,9065,16504,0.9096119929453262,2689600,329204736,326515136
625000.0,3,1.0,1020,7650,1.0,0,0,2,6,1020,0,1919,0.0,98033,47.6795,-122.20200000000001,1870,5500,6630,0.8666666666666667,1040400,58522500,57482100
240000.0,3,1.75,1630,9450,1.0,0,0,3,7,1080,550,1977,0.0,98032,47.3729,-122.295,1280,9100,7820,0.8275132275132275,2656900,89302500,86645600
530000.0,4,2.5,2940,35996,2.0,0,0,2,9,2940,0,1995,0.0,98042,47.3401,-122.06700000000001,2890,35089,33056,0.9183242582509168,8643600,1295712016,1287068416
1000000.0,5,4.5,2120,8944,2.0,1,4,4,8,2120,0,1939,1963.0,98006,47.5488,-122.197,2870,8944,6824,0.7629695885509838,4494400,79995136,75500736
439000.0,1,1.0,790,2400,1.0,0,0,2,7,790,0,1918,0.0,98122,47.6178,-122.29899999999999,1580,2566,1610,0.6708333333333333,624100,5760000,5135900
575000.0,4,1.75,2020,6200,1.0,0,0,3,6,1010,1010,1948,0.0,98133,47.7013,-122.35,1440,4158,4180,0.6741935483870968,4080400,38440000,34359600
418000.0,3,1.75,1530,7238,1.0,0,0,2,7,1530,0,1959,0.0,98155,47.7629,-122.315,1580,7238,5708,0.7886156396794695,2340900,52388644,50047744
1210000.0,4,3.75,3250,10949,2.0,0,0,3,9,2940,310,1930,0.0,98004,47.638999999999996,-122.219,2340,15234,7699,0.7031692391999269,10562500,119880601,109318101
1100000.0,4,3.75,2930,3200,1.5,0,0,4,9,2130,800,1925,0.0,98119,47.643,-122.359,1900,4320,270,0.084375,8584900,10240000,1655100
1900000.0,3,3.75,3150,8550,2.0,0,0,2,10,3150,0,2007,0.0,98112,47.6387,-122.28399999999999,2510,8550,5400,0.631578947368421,9922500,73102500,63180000
580000.0,3,2.5,2180,40278,2.0,0,0,2,9,2180,0,1985,0.0,98072,47.733000000000004,-122.09,2630,40000,38098,0.9458761606832514,4752400,1622317284,1617564884
380000.0,2,1.0,1040,7372,1.0,0,0,4,7,840,200,1939,0.0,98126,47.5285,-122.37799999999999,1930,5150,6332,0.8589256646771568,1081600,54346384,53264784
256000.0,3,1.0,880,5375,1.0,0,0,3,5,880,0,1924,0.0,98055,47.4858,-122.20200000000001,980,4838,4495,0.8362790697674418,774400,28890625,28116225
349950.0,3,1.0,1400,7066,1.0,0,0,2,8,1400,0,1957,0.0,98125,47.7127,-122.325,1400,7320,5666,0.801868100764223,1960000,49928356,47968356
691500.0,4,2.5,2600,7200,2.0,0,0,2,7,2600,0,1962,2002.0,98115,47.6944,-122.274,1790,6175,4600,0.6388888888888888,6760000,51840000,45080000
556000.0,3,1.75,1590,2500,1.5,0,0,3,7,1190,400,1908,0.0,98105,47.6668,-122.29899999999999,1420,3800,910,0.364,2528100,6250000,3721900
218000.0,3,2.25,1610,7084,1.0,0,0,3,8,1280,330,1968,0.0,98023,47.3146,-122.384,2170,8505,5474,0.7727272727272727,2592100,50183056,47590956
425000.0,4,2.0,1390,4500,1.5,0,0,4,7,1390,0,1908,0.0,98108,47.5552,-122.311,1900,5460,3110,0.6911111111111111,1932100,20250000,18317900
935000.0,3,3.25,3710,38509,2.0,0,0,2,10,3710,0,1998,0.0,98014,47.69300000000001,-121.868,1680,25865,34799,0.903658884935989,13764100,1482943081,1469178981
732000.0,4,1.75,2360,11300,1.0,0,0,3,9,2360,0,1974,0.0,98006,47.5728,-122.163,2290,11951,8940,0.7911504424778761,5569600,127690000,122120400
805500.0,3,1.0,1440,10330,1.0,0,0,3,7,1440,0,1952,0.0,98004,47.6245,-122.193,2080,10327,8890,0.8606001936108422,2073600,106708900,104635300
507250.0,3,1.75,1400,5750,1.0,0,2,2,6,1100,300,1915,0.0,98126,47.5659,-122.38,1500,5175,4350,0.7565217391304347,1960000,33062500,31102500
800000.0,4,2.5,4600,67369,2.0,0,0,2,10,4600,0,1990,0.0,98053,47.6417,-121.992,4600,67369,62769,0.9317193367869495,21160000,4538582161,4517422161
600000.0,3,2.25,2100,8276,2.0,0,1,3,8,2100,0,1979,0.0,98008,47.6068,-122.11200000000001,2420,18135,6176,0.7462542290961818,4410000,68492176,64082176
627800.0,4,1.75,2010,12044,1.0,0,0,2,9,2010,0,1982,0.0,98074,47.6446,-122.068,2200,11144,10034,0.8331119229491863,4040100,145057936,141017836
660000.0,2,2.25,2550,6000,2.0,0,0,4,7,1860,690,1902,0.0,98115,47.6739,-122.323,2010,4000,3450,0.575,6502500,36000000,29497500
153503.0,2,2.5,1240,3649,2.0,0,0,2,7,1240,0,1986,0.0,98003,47.3241,-122.322,1400,3721,2409,0.6601808714716361,1537600,13315201,11777601
456500.0,3,2.25,2090,9163,1.0,0,0,2,7,1460,630,1975,0.0,98034,47.7334,-122.167,1960,7713,7073,0.7719087635054022,4368100,83960569,79592469
1310000.0,5,2.5,2770,8100,2.0,0,0,2,9,2770,0,2002,0.0,98004,47.6341,-122.208,2070,8100,5330,0.6580246913580247,7672900,65610000,57937100
843500.0,3,2.5,3560,11448,2.0,0,0,2,11,3560,0,1997,0.0,98052,47.7126,-122.104,3290,11506,7888,0.6890286512928022,12673600,131056704,118383104
625000.0,3,1.0,1240,4080,1.0,0,0,2,7,1240,0,1925,0.0,98103,47.667,-122.333,2060,4080,2840,0.696078431372549,1537600,16646400,15108800
527000.0,2,1.75,1640,4080,1.0,0,0,2,7,840,800,1921,0.0,98105,47.6645,-122.32600000000001,1980,4080,2440,0.5980392156862745,2689600,16646400,13956800
1970000.0,5,3.75,3940,13738,1.5,0,3,3,9,3940,0,1951,0.0,98004,47.6203,-122.212,2370,13320,9798,0.7132042509826758,15523600,188732644,173209044
1000000.0,5,2.5,3150,50094,2.0,0,0,3,9,3150,0,1969,0.0,98005,47.6387,-122.177,3600,48787,46944,0.9371182177506289,9922500,2509408836,2499486336
855000.0,4,3.0,2550,5300,2.0,0,0,2,8,1720,830,1908,2013.0,98117,47.6786,-122.367,1590,4505,2750,0.5188679245283019,6502500,28090000,21587500
725000.0,4,3.25,3940,27591,2.0,0,3,2,9,3440,500,2000,0.0,98059,47.5157,-122.116,3420,29170,23651,0.8571998115327462,15523600,761263281,745739681
315000.0,1,1.0,580,7200,1.0,0,0,2,6,580,0,2000,0.0,98126,47.5249,-122.37299999999999,1360,7560,6620,0.9194444444444444,336400,51840000,51503600
180000.0,3,1.75,1330,16000,1.0,0,0,2,7,1330,0,1978,0.0,98001,47.28,-122.257,1330,14374,14670,0.916875,1768900,256000000,254231100
700000.0,2,1.0,930,5000,1.0,0,3,2,7,930,0,1926,2013.0,98136,47.5333,-122.38799999999999,1760,5228,4070,0.814,864900,25000000,24135100
476500.0,3,1.0,1060,8625,2.0,0,0,3,7,1060,0,1962,1997.0,98033,47.6615,-122.179,2010,8901,7565,0.8771014492753623,1123600,74390625,73267025
193000.0,3,1.5,1180,9048,1.0,0,0,2,7,1180,0,1960,0.0,98148,47.4327,-122.32799999999999,1460,8942,7868,0.8695844385499558,1392400,81866304,80473904
295000.0,4,2.5,1850,6663,2.0,0,0,2,7,1850,0,1990,0.0,98030,47.3618,-122.195,1850,6417,4813,0.7223472910100556,3422500,44395569,40973069
363000.0,2,1.0,820,4880,1.0,0,0,3,6,820,0,1925,0.0,98136,47.5483,-122.39399999999999,1320,4880,4060,0.8319672131147541,672400,23814400,23142000
875000.0,4,2.5,3600,21794,2.0,0,0,3,11,3600,0,1990,0.0,98077,47.7121,-122.072,3410,19864,18194,0.8348169220886482,12960000,474978436,462018436
257200.0,3,2.0,1850,8250,1.0,0,0,3,7,1150,700,1952,0.0,98002,47.3066,-122.209,1580,7153,6400,0.7757575757575758,3422500,68062500,64640000
555000.0,3,2.0,2240,11250,1.0,0,0,2,8,2240,0,1968,0.0,98008,47.6371,-122.119,2200,12500,9010,0.8008888888888889,5017600,126562500,121544900
380000.0,3,2.25,1860,15559,2.0,0,0,3,7,1860,0,1963,0.0,98022,47.1559,-121.646,1110,11586,13699,0.8804550420978212,3459600,242082481,238622881
282000.0,4,2.75,2390,7330,2.0,0,0,2,7,2390,0,1989,0.0,98023,47.3061,-122.359,1980,6735,4940,0.6739427012278308,5712100,53728900,48016800
545000.0,4,2.5,2040,6034,2.0,0,0,2,7,2040,0,1990,0.0,98115,47.6952,-122.323,1380,5986,3994,0.6619158104076898,4161600,36409156,32247556
550000.0,3,1.5,1900,5000,1.5,0,0,2,7,1640,260,1926,0.0,98115,47.6779,-122.294,2090,5000,3100,0.62,3610000,25000000,21390000
921500.0,3,1.5,1900,5000,1.5,0,0,2,7,1640,260,1926,0.0,98115,47.6779,-122.294,2090,5000,3100,0.62,3610000,25000000,21390000
885000.0,3,1.5,2200,2880,2.0,0,0,4,7,1440,760,1904,0.0,98112,47.6308,-122.31200000000001,2440,4640,680,0.2361111111111111,4840000,8294400,3454400
820000.0,4,2.25,2280,6660,1.5,0,2,2,8,1960,320,1940,0.0,98119,47.6503,-122.368,1720,5336,4380,0.6576576576576577,5198400,44355600,39157200
289000.0,3,1.0,1090,7315,1.0,0,0,4,6,1090,0,1981,0.0,98056,47.494,-122.165,1090,5800,6225,0.8509911141490089,1188100,53509225,52321125
334000.0,1,1.0,670,5750,1.0,0,0,2,7,670,0,1942,2011.0,98116,47.5624,-122.39399999999999,1170,5750,5080,0.8834782608695653,448900,33062500,32613600
206000.0,3,1.0,1050,5233,1.0,0,0,4,5,1050,0,1906,0.0,98010,47.3106,-121.999,970,7500,4183,0.7993502770877126,1102500,27384289,26281789
491950.0,3,2.25,2090,10733,1.0,0,0,2,7,1440,650,1958,0.0,98115,47.6971,-122.281,1740,8100,8643,0.805273455697382,4368100,115197289,110829189
430000.0,3,2.5,2030,7770,2.0,0,0,2,8,2030,0,2003,0.0,98024,47.5253,-121.93,1360,10782,5740,0.7387387387387387,4120900,60372900,56252000
208000.0,3,2.0,1250,7995,1.0,0,0,3,7,1250,0,1980,0.0,98042,47.3684,-122.09200000000001,1540,7650,6745,0.8436522826766729,1562500,63920025,62357525
245000.0,4,2.25,2600,6390,1.0,0,0,2,8,1390,1210,1978,0.0,98023,47.3174,-122.366,2110,6700,3790,0.593114241001565,6760000,40832100,34072100
426000.0,2,1.0,640,2500,1.0,0,0,3,6,640,0,1918,0.0,98117,47.6776,-122.361,1460,4200,1860,0.744,409600,6250000,5840400
400000.0,3,2.5,2120,3742,2.0,0,0,2,7,2120,0,2006,0.0,98059,47.4787,-122.12899999999999,2250,4696,1622,0.43345804382683056,4494400,14002564,9508164
553000.0,3,1.0,1330,5100,1.0,0,0,2,7,900,430,1942,0.0,98115,47.6837,-122.291,1500,5100,3770,0.7392156862745098,1768900,26010000,24241100
296000.0,2,1.0,750,4680,1.0,0,0,2,5,750,0,1948,0.0,98117,47.6919,-122.37100000000001,1450,4400,3930,0.8397435897435898,562500,21902400,21339900
428000.0,3,2.5,2230,32660,1.0,0,0,3,8,2230,0,1977,0.0,98042,47.3321,-122.105,2400,33120,30430,0.9317207593386405,4972900,1066675600,1061702700
325000.0,4,2.5,1890,6156,1.0,0,0,2,7,980,910,1980,0.0,98106,47.551,-122.35600000000001,1590,6954,4266,0.6929824561403509,3572100,37896336,34324236
294000.0,2,1.0,820,6366,1.0,0,0,4,6,820,0,1952,0.0,98133,47.7512,-122.34,1580,10169,5546,0.8711907005969212,672400,40525956,39853556
410000.0,3,1.75,1880,8424,1.0,0,0,3,7,1380,500,1977,0.0,98059,47.5116,-122.161,1970,8523,6544,0.7768281101614435,3534400,70963776,67429376
590000.0,4,4.25,2360,57514,2.0,0,0,3,8,2360,0,1939,0.0,98003,47.2843,-122.294,2037,35733,55154,0.958966512501304,5569600,3307860196,3302290596
445000.0,3,2.25,1850,4050,2.0,0,0,3,7,1850,0,1985,0.0,98029,47.5669,-122.01700000000001,1650,4468,2200,0.5432098765432098,3422500,16402500,12980000
921000.0,4,2.5,2310,5362,2.0,0,4,3,8,2010,300,1928,0.0,98122,47.6044,-122.28399999999999,2530,5960,3052,0.5691906005221932,5336100,28751044,23414944
496000.0,3,1.5,2520,37616,1.0,0,0,2,8,2520,0,1955,0.0,98045,47.4777,-121.76299999999999,1470,33750,35096,0.9330072309655466,6350400,1414963456,1408613056
95000.0,2,1.0,800,8550,1.0,0,0,2,7,800,0,1947,0.0,98198,47.4075,-122.294,1490,8550,7750,0.9064327485380117,640000,73102500,72462500
359000.0,4,1.75,1580,6396,1.0,0,0,3,6,790,790,1945,0.0,98126,47.5378,-122.369,1180,6396,4816,0.7529706066291432,2496400,40908816,38412416
452500.0,3,2.5,2430,88426,1.0,0,0,3,7,1570,860,1985,0.0,98045,47.4828,-121.71799999999999,1560,56827,85996,0.972519394748151,5904900,7819157476,7813252576
555000.0,4,1.75,2350,6200,1.5,0,0,3,7,1410,940,1946,0.0,98116,47.559,-122.397,1800,6150,3850,0.6209677419354839,5522500,38440000,32917500
549900.0,5,3.0,3800,42316,1.5,0,0,3,9,3800,0,1984,0.0,98042,47.3488,-122.095,2580,35775,38516,0.9101994517440212,14440000,1790643856,1776203856
569000.0,5,3.0,3670,10583,1.0,0,0,4,8,2060,1610,1952,0.0,98155,47.7589,-122.277,2720,13865,6913,0.65321742417084,13468900,111999889,98530989
318500.0,4,2.0,1780,7350,1.0,0,0,4,7,900,880,1974,0.0,98058,47.4562,-122.15799999999999,1480,7350,5570,0.7578231292517007,3168400,54022500,50854100
487028.0,2,1.5,1295,1093,2.0,0,0,2,9,1105,190,2007,0.0,98112,47.6192,-122.29899999999999,1295,1413,-202,-0.1848124428179323,1677025,1194649,-482376
240000.0,3,1.0,1350,7560,1.0,0,0,3,7,950,400,1959,0.0,98032,47.3784,-122.303,1470,7560,6210,0.8214285714285714,1822500,57153600,55331100
253000.0,3,2.25,1440,9806,1.0,0,0,2,7,1440,0,1965,0.0,98030,47.3857,-122.212,1590,9782,8366,0.8531511319600245,2073600,96157636,94084036
380000.0,5,1.75,1320,38125,1.0,0,0,3,7,1120,200,1947,0.0,98198,47.3937,-122.323,2360,15070,36805,0.9653770491803279,1742400,1453515625,1451773225
250000.0,2,0.75,700,16828,1.0,0,0,3,6,700,0,1958,0.0,98092,47.3009,-122.125,2010,29316,16128,0.9584026622296173,490000,283181584,282691584
368500.0,2,1.75,2510,19141,2.0,0,0,2,9,2510,0,1977,0.0,98092,47.3103,-122.199,2400,13030,16631,0.8688678752416279,6300100,366377881,360077781
340000.0,3,1.0,3180,27586,1.0,0,0,2,8,1400,1780,1969,0.0,98022,47.1986,-121.96700000000001,2180,27586,24406,0.8847241354310157,10112400,760987396,750874996
400000.0,2,1.0,910,4000,1.0,0,0,2,7,910,0,1918,0.0,98136,47.5427,-122.38799999999999,1060,1346,3090,0.7725,828100,16000000,15171900
835000.0,3,2.0,1570,4625,1.5,0,0,4,8,1570,0,1927,0.0,98117,47.68,-122.399,1760,4625,3055,0.6605405405405406,2464900,21390625,18925725
299000.0,3,2.5,2450,7062,2.0,0,0,2,8,2450,0,1993,0.0,98023,47.3061,-122.36,1960,7200,4612,0.6530727839139054,6002500,49871844,43869344
1680000.0,6,2.25,4910,6600,2.5,0,0,4,10,3580,1330,1910,0.0,98102,47.6458,-122.32,3280,5500,1690,0.25606060606060604,24108100,43560000,19451900
265000.0,3,2.0,1570,5706,1.0,0,0,2,7,1570,0,1998,0.0,98092,47.3156,-122.18799999999999,1570,5706,4136,0.724851033999299,2464900,32558436,30093536
437500.0,4,2.5,2680,7513,2.0,0,0,2,8,2680,0,1998,0.0,98059,47.4956,-122.161,2640,7243,4833,0.6432849727139625,7182400,56445169,49262769
865000.0,3,1.75,2090,4725,2.0,0,0,2,7,1610,480,1947,2013.0,98199,47.657,-122.39399999999999,1280,4725,2635,0.5576719576719577,4368100,22325625,17957525
626000.0,3,2.0,2150,7200,1.0,0,0,2,8,2150,0,1988,0.0,98029,47.5709,-122.01799999999999,2510,7222,5050,0.7013888888888888,4622500,51840000,47217500
247300.0,2,2.0,1140,1118,2.0,0,0,2,7,1040,100,2009,0.0,98144,47.596000000000004,-122.311,1140,1118,-22,-0.01967799642218247,1299600,1249924,-49676
2080000.0,4,3.5,4230,20377,2.0,0,0,2,11,4230,0,1997,0.0,98004,47.5954,-122.206,3980,20489,16147,0.7924130146734063,17892900,415222129,397329229
425000.0,3,1.0,1790,6000,1.5,0,0,1,8,1790,0,1937,0.0,98108,47.5448,-122.32,1060,4000,4210,0.7016666666666667,3204100,36000000,32795900
905000.0,5,3.5,3100,10200,1.0,0,4,2,9,1660,1440,1970,0.0,98008,47.6134,-122.11200000000001,2700,10455,7100,0.696078431372549,9610000,104040000,94430000
641250.0,3,2.5,2220,2550,3.0,0,2,2,10,2220,0,1990,0.0,98117,47.6963,-122.39299999999999,2200,5610,330,0.12941176470588237,4928400,6502500,1574100
675000.0,4,2.5,2370,9679,2.0,0,0,2,8,2370,0,1984,0.0,98027,47.5631,-122.085,2290,7944,7309,0.7551399938010125,5616900,93683041,88066141
845000.0,4,2.75,4070,115434,2.0,0,0,2,9,4070,0,2002,0.0,98045,47.4843,-121.75200000000001,2970,95832,111364,0.9647417571945874,16564900,13325008356,13308443456
401500.0,4,1.0,1790,8400,1.0,0,0,3,7,1260,530,1954,0.0,98133,47.7627,-122.353,1470,8400,6610,0.7869047619047619,3204100,70560000,67355900
395000.0,3,2.5,1610,3755,2.0,0,0,2,7,1610,0,1987,0.0,98052,47.6825,-122.09700000000001,1300,3823,2145,0.5712383488681758,2592100,14100025,11507925
1100000.0,5,2.75,2830,18050,1.0,0,0,4,7,1630,1200,1958,0.0,98040,47.5773,-122.226,2370,14250,15220,0.843213296398892,8008900,325802500,317793600
145000.0,3,1.0,1010,5490,1.0,0,0,2,6,1010,0,1954,0.0,98168,47.4762,-122.29299999999999,1740,10658,4480,0.8160291438979964,1020100,30140100,29120000
900000.0,3,1.0,1560,3825,1.5,0,0,2,8,1390,170,1930,0.0,98117,47.6803,-122.387,1700,5100,2265,0.592156862745098,2433600,14630625,12197025
374500.0,3,1.5,1330,8636,1.0,0,0,3,7,1330,0,1968,0.0,98034,47.7289,-122.20299999999999,1370,7475,7306,0.8459935155164428,1768900,74580496,72811596
850000.0,4,2.25,2330,10451,2.0,0,0,3,8,2330,0,1965,0.0,98005,47.6044,-122.16799999999999,1880,8400,8121,0.7770548272892546,5428900,109223401,103794501
490000.0,3,1.0,960,5750,1.0,0,0,2,7,960,0,1951,0.0,98116,47.5689,-122.39299999999999,1520,5750,4790,0.8330434782608696,921600,33062500,32140900
304000.0,3,2.5,1710,6773,2.0,0,0,2,8,1710,0,1993,0.0,98003,47.2635,-122.31200000000001,2220,7551,5063,0.7475269452236822,2924100,45873529,42949429
400000.0,4,2.25,2230,7200,1.0,0,0,3,7,1300,930,1963,0.0,98133,47.7648,-122.33,2010,7752,4970,0.6902777777777778,4972900,51840000,46867100
454000.0,3,2.0,1700,10000,2.0,0,0,2,8,1700,0,1992,0.0,98011,47.7661,-122.205,1460,9621,8300,0.83,2890000,100000000,97110000
160000.0,2,2.0,1040,4750,1.0,0,0,1,6,850,190,1950,0.0,98118,47.5293,-122.272,1350,5000,3710,0.7810526315789473,1081600,22562500,21480900
542000.0,3,1.75,1070,8030,1.0,0,0,2,7,1070,0,1966,2014.0,98052,47.67,-122.155,1540,7875,6960,0.8667496886674969,1144900,64480900,63336000
403500.0,5,2.5,3600,17300,1.0,0,0,3,8,2410,1190,1968,0.0,98166,47.4468,-122.34100000000001,2620,30200,13700,0.791907514450867,12960000,299290000,286330000
418000.0,4,2.5,2750,8471,2.0,0,0,2,7,2750,0,2003,0.0,98038,47.3671,-122.029,2610,7482,5721,0.6753630031873451,7562500,71757841,64195341
406000.0,4,1.5,1920,6000,2.0,0,1,2,7,1920,0,1951,0.0,98198,47.4029,-122.321,1920,6000,4080,0.68,3686400,36000000,32313600
242500.0,3,2.25,1770,10000,1.0,0,0,2,7,1340,430,1978,0.0,98198,47.3814,-122.322,1270,5055,8230,0.823,3132900,100000000,96867100
425000.0,4,2.5,2460,5440,2.0,0,0,2,9,2460,0,2003,0.0,98058,47.448,-122.12100000000001,2460,5124,2980,0.5477941176470589,6051600,29593600,23542000
613000.0,4,2.0,1550,4815,1.5,0,0,2,7,1550,0,1909,0.0,98103,47.667,-122.336,1680,4013,3265,0.6780893042575286,2402500,23184225,20781725
189000.0,3,2.0,1460,11481,1.0,0,0,1,7,1170,290,1995,0.0,98045,47.4493,-121.777,1540,9680,10021,0.8728333768835467,2131600,131813361,129681761
700000.0,4,2.25,2440,9450,1.5,0,0,2,7,2440,0,1947,0.0,98125,47.7061,-122.307,1720,7503,7010,0.7417989417989418,5953600,89302500,83348900
750000.0,3,1.0,1640,6516,1.5,0,0,3,7,1440,200,1935,0.0,98103,47.6693,-122.339,1770,4000,4876,0.7483118477593615,2689600,42458256,39768656
494000.0,2,1.0,1290,4650,1.0,0,0,3,7,1290,0,1906,0.0,98115,47.6877,-122.325,1640,3900,3360,0.7225806451612903,1664100,21622500,19958400
700000.0,4,3.0,3150,7778,2.0,0,0,2,9,3150,0,2000,0.0,98075,47.5972,-122.01799999999999,2970,6500,4628,0.5950115710979687,9922500,60497284,50574784
705000.0,2,2.5,2305,5580,1.0,0,0,2,8,2305,0,2007,0.0,98077,47.7203,-122.024,1440,5748,3275,0.5869175627240143,5313025,31136400,25823375
356000.0,2,1.75,1060,16470,1.0,0,0,2,7,1060,0,1977,0.0,98072,47.7409,-122.089,1790,16748,15410,0.9356405585913783,1123600,271260900,270137300
625000.0,3,1.75,2060,12558,1.0,0,0,3,7,1350,710,1984,0.0,98052,47.6659,-122.14399999999999,1850,8722,10498,0.8359611403089664,4243600,157703364,153459764
144975.0,2,1.0,900,7500,1.0,0,0,2,5,900,0,1940,0.0,98198,47.4177,-122.319,1350,7500,6600,0.88,810000,56250000,55440000
970000.0,4,4.5,3890,5906,2.0,0,3,2,11,3060,0,2004,0.0,98029,47.5426,-121.995,4170,6052,2016,0.3413477819166949,15132100,34880836,19748736
415000.0,3,1.75,1910,12596,1.0,0,0,2,7,1340,570,1977,0.0,98072,47.7399,-122.09899999999999,1550,13310,10686,0.8483645601778342,3648100,158659216,155011116
485000.0,4,3.0,2340,7048,1.0,0,0,3,8,1340,1000,1979,0.0,98034,47.7306,-122.227,1440,8088,4708,0.6679909194097616,5475600,49674304,44198704
799950.0,3,3.0,2900,11769,2.0,0,0,2,10,2900,0,1997,0.0,98052,47.6993,-122.118,2900,9611,8869,0.7535899396720197,8410000,138509361,130099361
783350.0,4,2.5,3290,35001,2.0,0,0,2,10,3290,0,1991,0.0,98077,47.7231,-122.038,4090,40371,31711,0.9060026856375533,10824100,1225070001,1214245901
430000.0,1,1.0,630,1362,1.0,0,0,2,7,630,0,1943,0.0,98109,47.6342,-122.34200000000001,1090,1376,732,0.5374449339207048,396900,1855044,1458144
2540000.0,5,4.75,5410,13431,2.0,0,0,3,10,5050,360,1941,0.0,98112,47.6306,-122.288,3750,11596,8021,0.5972005062914154,29268100,180391761,151123661
975000.0,4,2.5,4270,43386,1.0,0,0,2,10,2680,1590,1991,0.0,98053,47.6915,-122.053,3630,36180,39116,0.9015811552113585,18232900,1882344996,1864112096
950000.0,3,1.5,1700,8050,1.0,0,0,2,7,1130,570,1950,0.0,98004,47.6304,-122.21799999999999,2920,12239,6350,0.7888198757763976,2890000,64802500,61912500
350000.0,2,1.0,1430,8157,1.5,0,0,2,7,1150,280,1944,0.0,98177,47.7256,-122.361,1820,8157,6727,0.8246904499203138,2044900,66536649,64491749
637000.0,4,2.75,2850,7510,2.0,0,0,2,8,2850,0,2008,0.0,98125,47.7097,-122.305,1510,8833,4660,0.6205059920106525,8122500,56400100,48277600
895000.0,3,2.0,2160,105415,1.0,0,0,2,10,2160,0,1991,0.0,98059,47.4806,-122.152,2760,9620,103255,0.9795095574633591,4665600,11112322225,11107656625
579000.0,2,2.0,1760,7200,1.0,0,0,4,7,880,880,1946,0.0,98118,47.5658,-122.27600000000001,1760,7200,5440,0.7555555555555555,3097600,51840000,48742400
314900.0,4,1.75,2700,27072,1.0,0,0,2,7,1380,1320,1958,0.0,98003,47.2877,-122.29299999999999,2460,34850,24372,0.9002659574468085,7290000,732893184,725603184
122000.0,2,1.0,860,6000,1.0,0,0,2,6,860,0,1945,0.0,98022,47.2109,-121.985,1300,6000,5140,0.8566666666666667,739600,36000000,35260400
405000.0,2,1.0,880,3000,1.0,0,0,4,7,880,0,1927,0.0,98103,47.6868,-122.34899999999999,1300,3000,2120,0.7066666666666667,774400,9000000,8225600
553650.0,2,2.5,1360,1349,2.0,0,0,2,8,1050,310,1997,0.0,98112,47.6254,-122.292,1430,4400,-11,-0.00815418828762046,1849600,1819801,-29799
369900.0,2,2.5,1770,1853,3.0,0,0,2,8,1770,0,2007,0.0,98126,47.5472,-122.37100000000001,1770,1924,83,0.04479222881813276,3132900,3433609,300709
225000.0,3,2.0,2030,24829,1.0,0,0,3,7,1220,810,1979,0.0,98001,47.2718,-122.291,1980,15204,22799,0.9182407668452213,4120900,616479241,612358341
160000.0,2,1.0,1180,9350,1.0,0,0,2,6,1180,0,1918,0.0,98178,47.4889,-122.259,1780,9306,8170,0.8737967914438503,1392400,87422500,86030100
449500.0,4,2.0,2430,199940,1.0,0,0,2,8,1310,1120,1961,0.0,98038,47.4116,-122.029,2220,150282,197510,0.9878463539061718,5904900,39976003600,39970098700
650000.0,3,1.0,1300,8266,1.0,0,0,3,7,1300,0,1953,0.0,98004,47.6337,-122.199,1300,8707,6966,0.8427292523590613,1690000,68326756,66636756
542126.0,4,2.5,2360,43088,2.0,0,0,2,8,2360,0,1977,0.0,98077,47.7661,-122.071,2850,39216,40728,0.9452283698477534,5569600,1856575744,1851006144
309950.0,3,1.5,1200,15606,1.0,0,0,2,7,1200,0,1985,0.0,98045,47.4752,-121.755,1210,15606,14406,0.9231064975009612,1440000,243547236,242107236
115000.0,2,1.0,1000,16524,1.0,0,0,2,5,1000,0,1913,0.0,98001,47.2841,-122.255,1350,10208,15524,0.9394819656257565,1000000,273042576,272042576
221700.0,2,1.5,1556,20000,1.0,0,0,3,7,1556,0,1957,0.0,98032,47.3891,-122.28200000000001,2250,17286,18444,0.9222,2421136,400000000,397578864
726000.0,3,2.5,1890,3880,1.5,0,0,3,8,1460,430,1915,0.0,98107,47.6642,-122.36200000000001,1010,3880,1990,0.5128865979381443,3572100,15054400,11482300
515000.0,3,1.75,1810,5733,1.0,0,0,3,7,1010,800,1926,0.0,98116,47.5709,-122.38799999999999,1260,4680,3923,0.6842839699982557,3276100,32867289,29591189
756000.0,4,2.5,2730,10753,2.0,0,0,2,9,2730,0,1991,0.0,98006,47.5414,-122.133,3090,10740,8023,0.7461173625964848,7452900,115627009,108174109
1570000.0,4,3.75,3070,5850,2.0,0,0,4,9,2400,670,1927,0.0,98112,47.633,-122.28299999999999,2940,5573,2780,0.4752136752136752,9424900,34222500,24797600
442000.0,4,2.25,2080,12007,1.0,0,0,3,8,1220,860,1979,0.0,98074,47.6259,-122.051,2110,12459,9927,0.8267677188306821,4326400,144168049,139841649
260000.0,4,2.0,1620,7992,2.0,0,0,3,7,1620,0,1975,0.0,98031,47.395,-122.176,1710,7500,6372,0.7972972972972973,2624400,63872064,61247664
390000.0,2,1.75,1150,2723,1.0,0,0,3,7,770,380,1923,0.0,98102,47.6357,-122.322,1440,4000,1573,0.5776716856408373,1322500,7414729,6092229
459500.0,2,1.0,1250,3825,1.0,0,0,2,7,850,400,1929,0.0,98117,47.6805,-122.38,1370,4998,2575,0.673202614379085,1562500,14630625,13068125
330000.0,3,1.5,1430,8000,1.0,0,0,4,7,1430,0,1948,0.0,98155,47.772,-122.322,1410,9820,6570,0.82125,2044900,64000000,61955100
189000.0,2,1.0,790,7128,1.0,0,0,2,6,790,0,1944,0.0,98168,47.4873,-122.324,1110,7150,6338,0.8891694725028059,624100,50808384,50184284
280000.0,3,1.0,1200,9322,1.5,0,0,3,7,1200,0,1954,0.0,98030,47.3749,-122.225,1540,9677,8122,0.8712722591718516,1440000,86899684,85459684
400000.0,2,1.75,2110,9519,1.0,0,0,1,7,2110,0,1948,0.0,98155,47.7504,-122.306,1480,9519,7409,0.7783380607206639,4452100,90611361,86159261
368000.0,4,2.0,3160,11193,1.0,0,0,4,6,2410,750,1942,0.0,98056,47.4937,-122.184,1020,5940,8033,0.7176806932904494,9985600,125283249,115297649
390000.0,4,1.75,2700,7875,1.5,0,0,3,8,2700,0,1968,0.0,98058,47.45399999999999,-122.14399999999999,2220,7875,5175,0.6571428571428571,7290000,62015625,54725625
245000.0,2,1.0,820,7475,1.0,0,0,2,6,820,0,1945,0.0,98133,47.7321,-122.34100000000001,1030,5720,6655,0.8903010033444816,672400,55875625,55203225
375000.0,4,2.5,1800,8432,1.0,0,0,3,7,1200,600,1960,0.0,98133,47.7463,-122.336,1780,8432,6632,0.786527514231499,3240000,71098624,67858624
465000.0,5,1.5,1750,12491,1.0,0,0,2,6,1390,360,1961,0.0,98033,47.6995,-122.17399999999999,1560,12473,10741,0.8598991273717076,3062500,156025081,152962581
445000.0,3,2.0,1540,67953,1.0,0,0,2,7,1540,0,1997,0.0,98059,47.5018,-122.126,1250,9100,66413,0.9773372772357365,2371600,4617610209,4615238609
250000.0,3,1.0,1130,7800,1.0,0,0,2,7,1130,0,1952,0.0,98118,47.5239,-122.288,1170,7800,6670,0.8551282051282051,1276900,60840000,59563100
475500.0,3,1.0,1500,9416,1.0,0,0,3,8,1500,0,1952,0.0,98133,47.7135,-122.33200000000001,1440,7200,7916,0.840696686491079,2250000,88661056,86411056
672324.0,2,1.75,1600,5795,1.5,0,0,2,8,1600,0,1940,0.0,98105,47.6709,-122.27600000000001,2310,6301,4195,0.7238999137187231,2560000,33582025,31022025
420000.0,3,2.0,1200,5029,1.0,0,0,2,6,880,320,1937,0.0,98115,47.6936,-122.294,1510,5854,3829,0.7613839729568502,1440000,25290841,23850841
515000.0,3,2.0,1690,5100,1.5,0,0,4,7,1690,0,1907,0.0,98117,47.6801,-122.38,1690,5100,3410,0.6686274509803921,2856100,26010000,23153900
732350.0,4,2.5,2270,7665,2.0,0,0,2,9,2270,0,1986,0.0,98052,47.6612,-122.148,2450,8706,5395,0.7038486627527724,5152900,58752225,53599325
297500.0,4,2.5,1910,5000,2.0,0,0,2,7,1910,0,2005,0.0,98038,47.3608,-122.036,2020,5000,3090,0.618,3648100,25000000,21351900
475000.0,3,1.5,1640,2720,1.5,0,0,2,8,1640,0,1929,0.0,98115,47.6869,-122.31700000000001,1490,4375,1080,0.39705882352941174,2689600,7398400,4708800
414000.0,4,2.5,2120,6497,2.0,0,0,2,7,2120,0,2003,0.0,98019,47.7241,-121.95700000000001,2230,6300,4377,0.6736955517931353,4494400,42211009,37716609
357250.0,3,1.5,1400,8840,1.0,0,0,3,6,1400,0,1952,0.0,98125,47.7273,-122.309,1260,8840,7440,0.8416289592760181,1960000,78145600,76185600
289950.0,2,1.0,760,6000,1.0,0,0,3,6,760,0,1950,0.0,98133,47.7168,-122.34,950,6000,5240,0.8733333333333333,577600,36000000,35422400
550000.0,3,1.0,1070,3713,1.0,0,0,3,6,1070,0,1917,0.0,98118,47.5683,-122.285,1290,3960,2643,0.7118233234581202,1144900,13786369,12641469
446000.0,3,1.75,1460,9998,1.0,0,0,2,7,960,500,1958,0.0,98028,47.7434,-122.242,1460,9998,8538,0.8539707941588318,2131600,99960004,97828404
279000.0,3,1.5,1280,16738,1.5,0,0,3,5,1280,0,1932,0.0,98038,47.3895,-122.023,1590,16317,15458,0.9235273031425499,1638400,280160644,278522244
370000.0,3,2.25,1650,4859,2.0,0,0,2,7,1650,0,1988,0.0,98011,47.7729,-122.17200000000001,1890,5018,3209,0.6604239555464088,2722500,23609881,20887381
216000.0,3,2.0,1260,4125,1.0,0,0,2,6,1260,0,1998,0.0,98188,47.4401,-122.279,1300,9091,2865,0.6945454545454546,1587600,17015625,15428025
1100000.0,3,2.5,2200,20000,1.0,0,1,2,7,1400,800,1952,0.0,98004,47.5809,-122.191,3050,11775,17800,0.89,4840000,400000000,395160000
1280000.0,4,2.5,3560,15450,1.0,0,1,4,8,2060,1500,1977,0.0,98040,47.5657,-122.23,3680,17314,11890,0.7695792880258899,12673600,238702500,226028900
355000.0,2,1.5,1140,2500,1.0,0,1,2,7,630,510,1988,0.0,98106,47.5707,-122.359,1500,5000,1360,0.544,1299600,6250000,4950400
699000.0,4,2.5,2550,7312,2.0,0,0,2,9,2550,0,1988,0.0,98008,47.6441,-122.113,2330,7480,4762,0.651258205689278,6502500,53465344,46962844
412000.0,3,2.5,1553,1991,3.0,0,0,2,8,1553,0,2014,0.0,98133,47.7049,-122.34,1509,2431,438,0.21998995479658462,2411809,3964081,1552272
276000.0,2,1.0,1140,7200,1.0,0,0,2,6,1140,0,1923,1951.0,98065,47.5265,-121.823,1110,7200,6060,0.8416666666666667,1299600,51840000,50540400
100000.0,2,1.0,790,6426,1.0,0,0,2,6,790,0,1944,0.0,98178,47.4933,-122.245,1380,6946,5636,0.8770619358854653,624100,41293476,40669376
955500.0,4,1.75,2130,5080,1.5,0,0,2,8,2130,0,1914,0.0,98119,47.6427,-122.363,1900,5080,2950,0.5807086614173228,4536900,25806400,21269500
199000.0,3,1.0,1390,21262,1.0,0,0,2,7,1390,0,1958,0.0,98058,47.4454,-122.185,1560,10800,19872,0.9346251528548585,1932100,452072644,450140544
762000.0,4,3.5,4000,15253,2.0,0,0,2,9,4000,0,2007,0.0,98065,47.5433,-121.887,3550,8747,11253,0.7377565069166722,16000000,232654009,216654009
425000.0,4,2.0,1520,7983,1.0,0,0,4,7,1520,0,1967,0.0,98034,47.7357,-122.193,1520,7783,6463,0.8095953902041839,2310400,63728289,61417889
546000.0,2,1.0,1657,5031,2.0,0,0,2,7,1657,0,1910,0.0,98116,47.5699,-122.389,2050,6201,3374,0.6706420194792287,2745649,25310961,22565312
419600.0,3,1.75,1680,8460,1.0,0,0,2,7,1180,500,1976,0.0,98133,47.7554,-122.353,1890,9529,6780,0.8014184397163121,2822400,71571600,68749200
735000.0,4,2.25,2270,5102,1.0,0,0,4,8,1340,930,1954,0.0,98199,47.6528,-122.40799999999999,1800,5102,2832,0.555076440611525,5152900,26030404,20877504
1230000.0,2,2.5,2470,609,3.0,0,0,2,11,1910,560,2011,0.0,98112,47.6182,-122.31200000000001,2440,1229,-1861,-3.0558292282430215,6100900,370881,-5730019
445000.0,2,2.0,1240,2500,2.0,0,0,2,7,1240,0,1985,0.0,98117,47.6793,-122.395,1660,5000,1260,0.504,1537600,6250000,4712400
665000.0,3,2.0,1740,41275,1.0,0,0,2,8,1740,0,1974,1989.0,98045,47.4914,-121.76299999999999,2630,41275,39535,0.9578437310720775,3027600,1703625625,1700598025
1290000.0,5,3.5,4090,290980,1.0,0,0,2,11,2920,1170,2002,0.0,98034,47.7161,-122.219,1880,9255,286890,0.9859440511375352,16728100,84669360400,84652632300
508500.0,4,2.75,2520,12500,2.0,0,0,2,8,1720,800,1979,0.0,98074,47.6225,-122.064,2520,13000,9980,0.7984,6350400,156250000,149899600
345950.0,5,1.0,1340,11198,1.5,0,0,2,8,1340,0,1934,0.0,98155,47.736000000000004,-122.295,1390,8020,9858,0.880335774245401,1795600,125395204,123599604
207500.0,3,1.0,1640,9750,1.0,0,0,2,7,1640,0,1968,0.0,98042,47.3256,-122.141,1200,9750,8110,0.8317948717948718,2689600,95062500,92372900
1080000.0,4,2.5,3000,10920,1.0,0,0,3,8,1550,1450,1969,0.0,98040,47.5347,-122.227,2380,10920,7920,0.7252747252747253,9000000,119246400,110246400
640000.0,3,1.0,1210,3720,2.0,0,0,3,8,1210,0,1930,0.0,98112,47.6317,-122.301,1560,6000,2510,0.6747311827956989,1464100,13838400,12374300
329500.0,3,1.0,1810,13068,1.0,0,0,3,7,1360,450,1941,0.0,98070,47.4482,-122.462,1400,13068,11258,0.8614937251300888,3276100,170772624,167496524
460000.0,4,2.75,2200,9676,1.0,0,0,2,8,1500,700,1979,0.0,98028,47.7713,-122.259,2120,9585,7476,0.7726333195535345,4840000,93624976,88784976
1230000.0,3,1.75,2200,14630,1.5,0,1,2,8,2200,0,1948,2003.0,98004,47.6074,-122.213,2850,15803,12430,0.849624060150376,4840000,214036900,209196900
805000.0,5,3.0,2350,6480,2.0,0,3,3,7,1650,700,1924,1962.0,98118,47.558,-122.266,1840,7200,4130,0.6373456790123457,5522500,41990400,36467900
200000.0,3,1.5,1090,10454,1.0,0,0,2,6,1090,0,1963,0.0,98042,47.3425,-122.08200000000001,1230,12196,9364,0.895733690453415,1188100,109286116,108098016
749700.0,3,1.75,2280,77972,1.0,0,0,2,8,1460,820,1977,0.0,98059,47.4804,-122.15100000000001,2460,14430,75692,0.9707587339044785,5198400,6079632784,6074434384
535000.0,2,1.0,1520,3360,1.0,0,0,3,7,830,690,1927,0.0,98117,47.6815,-122.382,1470,3774,1840,0.5476190476190477,2310400,11289600,8979200
330000.0,3,2.25,1620,7150,1.0,0,2,3,7,1280,340,1950,0.0,98178,47.5048,-122.241,1620,6930,5530,0.7734265734265734,2624400,51122500,48498100
479200.0,3,2.0,1510,3750,1.5,0,0,3,7,1510,0,1928,0.0,98116,47.5737,-122.383,1500,5000,2240,0.5973333333333334,2280100,14062500,11782400
373000.0,5,2.5,3001,5710,2.0,0,0,2,8,3001,0,2006,0.0,98042,47.3727,-122.177,2340,5980,2709,0.47443082311733803,9006001,32604100,23598099
355000.0,4,1.5,2020,6000,1.0,0,0,3,7,1010,1010,1953,0.0,98178,47.5019,-122.235,1710,6000,3980,0.6633333333333333,4080400,36000000,31919600
275000.0,3,2.0,1380,4500,1.0,0,0,2,7,1380,0,2008,0.0,98038,47.3661,-122.021,1620,4000,3120,0.6933333333333334,1904400,20250000,18345600
380000.0,3,1.5,1520,4288,1.0,0,0,2,7,1020,500,1949,0.0,98136,47.5284,-122.387,1660,4288,2768,0.6455223880597015,2310400,18386944,16076544
417000.0,2,1.75,1090,4590,1.0,0,0,3,7,790,300,1915,0.0,98105,47.6677,-122.324,1390,4080,3500,0.7625272331154684,1188100,21068100,19880000
1170000.0,5,3.75,4220,15959,2.0,0,0,2,11,4220,0,2004,0.0,98075,47.5869,-121.96700000000001,4630,16531,11739,0.7355724042859828,17808400,254689681,236881281
598500.0,3,2.25,2520,12000,1.0,0,0,2,10,2520,0,1978,0.0,98074,47.6381,-122.06200000000001,2510,12000,9480,0.79,6350400,144000000,137649600
629000.0,3,2.0,1760,5000,1.0,0,0,4,7,960,800,1920,0.0,98199,47.6408,-122.40299999999999,1380,5000,3240,0.648,3097600,25000000,21902400
226950.0,2,1.0,930,6600,1.0,0,0,2,6,930,0,1957,0.0,98168,47.4868,-122.33,1250,6600,5670,0.8590909090909091,864900,43560000,42695100
1230000.0,4,2.5,2600,11542,1.5,0,0,3,9,2200,400,1939,0.0,98177,47.7076,-122.37700000000001,2840,10960,8942,0.7747357477040374,6760000,133217764,126457764
415000.0,3,2.25,2180,11100,1.0,0,0,4,8,1700,480,1979,0.0,98056,47.5162,-122.176,2350,11397,8920,0.8036036036036036,4752400,123210000,118457600
595000.0,3,2.5,1910,3075,2.0,0,0,2,8,1910,0,2001,0.0,98029,47.5491,-122.005,1940,3485,1165,0.37886178861788616,3648100,9455625,5807525
209950.0,3,1.75,1100,5525,1.0,0,0,4,6,1100,0,1968,0.0,98042,47.3625,-122.084,1050,5200,4425,0.8009049773755657,1210000,30525625,29315625
568000.0,3,1.75,1760,235224,1.0,0,0,2,7,1760,0,1973,0.0,98053,47.6735,-122.041,2320,87120,233464,0.9925177702955481,3097600,55330330176,55327232576
119900.0,2,1.0,700,3180,1.0,0,0,2,6,480,220,1951,0.0,98178,47.4976,-122.262,1760,6360,2480,0.779874213836478,490000,10112400,9622400
207000.0,3,1.0,1080,10200,1.0,0,0,3,7,1080,0,1962,0.0,98023,47.3215,-122.351,1230,10400,9120,0.8941176470588236,1166400,104040000,102873600
195000.0,3,1.0,1070,22489,1.0,0,0,2,7,1070,0,1967,0.0,98001,47.3278,-122.262,1880,20250,21419,0.9524211836898039,1144900,505755121,504610221
324950.0,3,1.5,1460,8710,1.0,0,0,2,7,1460,0,1955,0.0,98166,47.4561,-122.35700000000001,1400,8645,7250,0.8323765786452354,2131600,75864100,73732500
210000.0,1,1.0,1050,7583,1.0,0,0,3,6,1050,0,1947,0.0,98133,47.7294,-122.34100000000001,1420,7560,6533,0.8615323750494527,1102500,57501889,56399389
1080000.0,4,2.75,3160,42733,2.0,0,0,2,9,3160,0,1995,0.0,98053,47.6367,-121.958,1890,24000,39573,0.9260524653078417,9985600,1826109289,1816123689
325088.0,4,1.0,1400,6739,1.0,0,0,2,7,1000,400,1954,0.0,98108,47.5402,-122.29799999999999,1500,6380,5339,0.7922540436266509,1960000,45414121,43454121
790000.0,4,3.0,3120,157875,2.0,0,0,3,8,3120,0,1977,0.0,98058,47.443999999999996,-122.18700000000001,1580,7050,154755,0.9802375296912114,9734400,24924515625,24914781225
150000.0,2,1.0,720,212137,1.0,0,0,2,5,720,0,1982,0.0,98058,47.422,-122.066,2010,109642,211417,0.9966059668987494,518400,45002106769,45001588369
790000.0,3,3.0,2840,206910,2.0,0,0,2,10,2840,0,1999,0.0,98059,47.468999999999994,-122.06299999999999,2070,25067,204070,0.9862742255086753,8065600,42811748100,42803682500
255000.0,2,1.0,1220,2500,1.0,0,0,2,6,770,450,1910,0.0,98126,47.5727,-122.37200000000001,1540,3000,1280,0.512,1488400,6250000,4761600
697000.0,4,3.0,2820,2850,1.5,0,0,4,7,1860,960,1928,0.0,98117,47.6813,-122.367,1570,4500,30,0.010526315789473684,7952400,8122500,170100
457500.0,2,1.0,840,5000,1.0,0,0,3,7,840,0,1908,0.0,98117,47.6803,-122.37100000000001,1240,5000,4160,0.832,705600,25000000,24294400
690000.0,3,2.0,1610,5100,1.5,0,0,4,8,1610,0,1940,0.0,98115,47.6825,-122.307,1740,5100,3490,0.6843137254901961,2592100,26010000,23417900
967000.0,4,3.25,1860,4356,2.0,0,0,2,9,1860,0,1917,2005.0,98103,47.6785,-122.351,1860,4356,2496,0.5730027548209367,3459600,18974736,15515136
980000.0,4,1.75,2260,17711,1.0,0,1,3,9,2260,0,1968,0.0,98040,47.5498,-122.214,2880,16594,15451,0.8723956862966518,5107600,313679521,308571921
619420.0,4,2.75,2450,14803,2.0,0,0,3,9,2450,0,1988,0.0,98059,47.5261,-122.162,2330,14803,12353,0.8344930081740188,6002500,219128809,213126309
389000.0,2,1.0,850,3276,1.0,0,0,2,6,850,0,1910,0.0,98103,47.6742,-122.35,1460,4100,2426,0.7405372405372406,722500,10732176,10009676
500000.0,3,1.0,1800,7200,1.0,0,0,2,7,1020,780,1964,0.0,98118,47.5616,-122.275,1740,5475,5400,0.75,3240000,51840000,48600000
569000.0,4,1.75,1230,7890,1.0,0,1,3,7,1090,140,1950,0.0,98004,47.5808,-122.189,2380,13176,6660,0.844106463878327,1512900,62252100,60739200
425000.0,4,2.25,2060,8540,1.0,0,0,3,7,1540,520,1967,0.0,98034,47.733999999999995,-122.19,1560,7700,6480,0.7587822014051522,4243600,72931600,68688000
635000.0,4,2.25,2750,6180,1.0,0,0,3,8,1500,1250,1948,0.0,98118,47.5691,-122.28399999999999,1740,6180,3430,0.5550161812297735,7562500,38192400,30629900
256500.0,2,1.0,1120,9912,1.0,0,0,3,6,1120,0,1980,0.0,98070,47.3735,-122.43,1540,9750,8792,0.8870056497175142,1254400,98247744,96993344
695000.0,4,2.5,3010,11393,2.0,0,0,2,8,3010,0,2005,0.0,98028,47.7389,-122.221,2810,11282,8383,0.7358026858597384,9060100,129800449,120740349
535000.0,4,1.5,1580,5000,1.5,0,0,2,7,1390,190,1945,0.0,98107,47.6735,-122.39299999999999,1580,5000,3420,0.684,2496400,25000000,22503600
454200.0,4,2.5,2630,5379,2.0,0,0,2,8,2630,0,2004,0.0,98059,47.4977,-122.163,2630,5379,2749,0.5110615356014129,6916900,28933641,22016741
418500.0,2,1.0,790,5800,1.0,0,0,2,6,790,0,1943,0.0,98117,47.6973,-122.36,1460,5800,5010,0.8637931034482759,624100,33640000,33015900
749950.0,4,2.75,3110,35235,2.0,0,0,3,9,3110,0,1983,0.0,98072,47.7355,-122.095,2790,35445,32125,0.9117354902795516,9672100,1241505225,1231833125
338500.0,3,1.75,2130,5489,1.0,0,0,2,8,1370,760,1999,0.0,98070,47.4489,-122.456,1750,7200,3359,0.6119511750774276,4536900,30129121,25592221
1250000.0,4,3.75,4520,9240,1.5,0,2,2,10,3270,1250,1992,0.0,98040,47.5897,-122.229,3380,9240,4720,0.5108225108225108,20430400,85377600,64947200
299950.0,3,2.5,1600,9830,2.0,0,0,3,8,1600,0,1993,0.0,98001,47.339,-122.266,1890,8910,8230,0.8372329603255341,2560000,96628900,94068900
325000.0,4,1.75,1950,12500,1.0,0,0,2,7,1330,620,1963,0.0,98168,47.4999,-122.32700000000001,1760,11520,10550,0.844,3802500,156250000,152447500
434000.0,4,3.0,2010,8171,2.0,0,0,2,8,2010,0,1973,0.0,98011,47.7688,-122.21799999999999,2090,8203,6161,0.7540080773467139,4040100,66765241,62725141
328950.0,4,1.75,2550,8976,1.0,0,0,4,7,1300,1250,1978,0.0,98058,47.4286,-122.179,2220,9477,6426,0.7159090909090909,6502500,80568576,74066076
2100000.0,5,3.75,5340,10655,2.5,0,3,3,10,3740,1600,1912,0.0,98144,47.5795,-122.285,3910,9418,5315,0.4988268418582825,28515600,113529025,85013425
570000.0,4,2.0,2000,46902,2.0,0,0,2,8,2000,0,1978,0.0,98075,47.5851,-122.072,2420,38130,44902,0.9573578951857064,4000000,2199797604,2195797604
802000.0,3,2.25,2170,5001,2.0,0,0,2,8,2170,0,2014,0.0,98103,47.6937,-122.338,1700,6991,2831,0.5660867826434713,4708900,25010001,20301101
525000.0,3,1.0,1550,6840,1.5,0,0,2,7,1550,0,1918,0.0,98103,47.6572,-122.335,2370,4560,5290,0.7733918128654971,2402500,46785600,44383100
700000.0,6,3.0,2790,4550,2.5,0,0,3,8,2790,0,1907,0.0,98119,47.626999999999995,-122.361,2590,4550,1760,0.3868131868131868,7784100,20702500,12918400
350000.0,3,1.75,1980,273556,1.0,0,0,2,6,1040,940,1956,1999.0,98042,47.4012,-122.11,2180,217799,271576,0.992761993887906,3920400,74832885136,74828964736
277500.0,2,1.5,1190,1236,3.0,0,0,2,7,1190,0,2005,0.0,98133,47.7274,-122.35700000000001,1390,1756,46,0.0372168284789644,1416100,1527696,111596
1580000.0,5,2.75,3650,20150,1.0,0,0,3,10,2360,1290,1975,0.0,98004,47.6215,-122.22399999999999,3220,19800,16500,0.8188585607940446,13322500,406022500,392700000
195000.0,3,1.0,1510,4350,1.5,0,0,4,6,1510,0,1913,0.0,98022,47.2052,-121.98700000000001,1210,5500,2840,0.6528735632183909,2280100,18922500,16642400
222000.0,3,2.0,1200,6074,1.0,0,0,2,7,1200,0,1968,0.0,98002,47.325,-122.205,1430,6338,4874,0.8024366150806718,1440000,36893476,35453476
865000.0,5,3.0,2830,8854,1.0,0,0,3,8,1500,1330,1979,0.0,98040,47.5743,-122.209,2260,8604,6024,0.6803704540320759,8008900,78393316,70384416
445000.0,4,2.0,1650,6000,1.0,0,0,4,7,1000,650,1959,0.0,98144,47.5834,-122.307,1540,6000,4350,0.725,2722500,36000000,33277500
495800.0,4,1.5,1710,4600,1.5,0,0,2,7,1710,0,1924,0.0,98115,47.6847,-122.318,1740,4455,2890,0.6282608695652174,2924100,21160000,18235900
548500.0,3,1.0,1740,4400,1.5,0,0,2,7,1740,0,1924,0.0,98122,47.6059,-122.3,1720,4400,2660,0.6045454545454545,3027600,19360000,16332400
310000.0,3,1.75,1840,10723,1.0,0,0,3,7,1220,620,1974,0.0,98058,47.428999999999995,-122.154,1590,9820,8883,0.8284062295999254,3385600,114982729,111597129
205000.0,3,1.5,1820,8585,1.0,0,0,3,7,1820,0,1962,0.0,98055,47.4479,-122.213,1740,10088,6765,0.7880023296447292,3312400,73702225,70389825
470000.0,5,3.75,3860,6901,2.0,0,0,2,7,3860,0,2003,0.0,98038,47.3694,-122.03200000000001,3000,8584,3041,0.4406607738008984,14899600,47623801,32724201
430000.0,3,1.5,1810,349351,1.5,0,0,2,7,1810,0,2002,0.0,98010,47.3392,-121.897,2480,339332,347541,0.9948189643081028,3276100,122046121201,122042845101
310000.0,2,2.0,1030,2271,3.0,0,0,2,7,1030,0,1999,0.0,98125,47.7263,-122.314,1439,1387,1241,0.5464553060325847,1060900,5157441,4096541
355000.0,4,1.0,1410,7693,1.5,0,0,3,7,1410,0,1953,0.0,98133,47.7604,-122.331,1330,8395,6283,0.8167164955154036,1988100,59182249,57194149
621500.0,5,2.5,2140,15950,1.0,0,2,3,8,1370,770,1968,0.0,98166,47.4797,-122.35799999999999,2600,14273,13810,0.8658307210031349,4579600,254402500,249822900
175000.0,6,1.5,1930,8400,1.0,0,0,2,7,1030,900,1971,0.0,98146,47.4869,-122.34,1780,9520,6470,0.7702380952380953,3724900,70560000,66835100
326000.0,6,1.5,1930,8400,1.0,0,0,2,7,1030,900,1971,0.0,98146,47.4869,-122.34,1780,9520,6470,0.7702380952380953,3724900,70560000,66835100
690000.0,4,3.5,1930,5400,1.5,0,2,2,7,1930,0,1920,0.0,98116,47.5679,-122.40899999999999,1500,3340,3470,0.6425925925925926,3724900,29160000,25435100
335000.0,4,2.5,2210,7214,2.0,0,0,2,8,2210,0,2003,0.0,98003,47.3554,-122.29799999999999,2270,7246,5004,0.6936512337122263,4884100,52041796,47157696
197000.0,4,1.0,1360,11175,1.0,0,0,2,7,1360,0,1961,0.0,98188,47.4551,-122.272,1340,9702,9815,0.8782997762863535,1849600,124880625,123031025
312500.0,3,1.75,1830,7969,1.0,0,0,2,7,930,900,1950,2008.0,98055,47.4667,-122.214,1790,7425,6139,0.7703601455640607,3348900,63504961,60156061
436000.0,3,2.25,2120,6710,1.0,0,0,4,7,1420,700,1959,0.0,98155,47.7461,-122.324,1880,6960,4590,0.684053651266766,4494400,45024100,40529700
1020000.0,4,2.5,2700,4590,2.0,0,0,2,8,2700,0,2002,0.0,98103,47.6734,-122.329,2080,3570,1890,0.4117647058823529,7290000,21068100,13778100
805000.0,4,2.5,3160,35225,2.0,0,1,2,9,2250,910,1992,0.0,98006,47.5672,-122.111,3460,17223,32065,0.9102909865152591,9985600,1240800625,1230815025
652427.0,4,2.25,2770,13129,2.0,0,0,3,8,2770,0,1979,0.0,98074,47.6268,-122.05,2400,13129,10359,0.789016680630665,7672900,172370641,164697741
1010000.0,3,2.5,2240,41339,1.0,0,0,3,9,2240,0,1945,1992.0,98005,47.6483,-122.163,2900,45738,39099,0.9458138803551126,5017600,1708912921,1703895321
355000.0,4,2.5,2570,6466,2.0,0,0,2,9,2570,0,1999,0.0,98092,47.3324,-122.17,2520,6667,3896,0.6025363439529848,6604900,41809156,35204256
334550.0,2,1.0,880,12000,1.0,0,0,2,7,880,0,1939,0.0,98133,47.7436,-122.35600000000001,1960,9395,11120,0.9266666666666666,774400,144000000,143225600
557500.0,3,2.25,1820,9670,2.0,0,0,2,8,1820,0,1984,0.0,98052,47.6382,-122.11,2160,11424,7850,0.811789038262668,3312400,93508900,90196500
277500.0,4,2.25,1660,7184,1.0,0,0,2,7,1110,550,1963,0.0,98188,47.4678,-122.294,1640,7200,5524,0.7689309576837416,2755600,51609856,48854256
300000.0,4,3.0,2200,10800,1.0,0,0,2,6,2200,0,1960,0.0,98058,47.4476,-122.169,1430,10800,8600,0.7962962962962963,4840000,116640000,111800000
325000.0,4,1.0,1640,3844,1.5,0,0,3,7,1460,180,1928,0.0,98133,47.7017,-122.354,1230,3844,2204,0.5733610822060354,2689600,14776336,12086736
402500.0,4,2.0,1650,3504,1.0,0,0,2,7,760,890,1951,2013.0,98144,47.5803,-122.294,1480,3504,1854,0.5291095890410958,2722500,12278016,9555516
461000.0,3,1.75,1420,5170,1.0,0,0,3,7,1420,0,1963,0.0,98007,47.6151,-122.145,2250,7700,3750,0.7253384912959381,2016400,26728900,24712500
540000.0,3,1.0,1270,3840,1.5,0,0,2,7,1270,0,1926,0.0,98103,47.6896,-122.35700000000001,1270,4175,2570,0.6692708333333334,1612900,14745600,13132700
385000.0,3,1.0,1070,4000,1.0,0,0,3,7,1070,0,1971,0.0,98108,47.5529,-122.305,1090,4000,2930,0.7325,1144900,16000000,14855100
480000.0,2,1.0,1060,3040,1.0,0,0,2,7,860,200,1924,0.0,98103,47.6725,-122.329,1470,3814,1980,0.6513157894736842,1123600,9241600,8118000
539950.0,3,2.25,2190,7149,1.0,0,1,3,8,1240,950,1963,0.0,98056,47.5243,-122.204,3500,7149,4959,0.6936634494334872,4796100,51108201,46312101
529000.0,3,2.25,1940,217800,2.0,0,0,2,9,1940,0,1990,0.0,98024,47.5636,-121.932,2580,83558,215860,0.9910927456382002,3763600,47436840000,47433076400
417000.0,3,2.5,1300,877,2.0,0,0,2,7,1060,240,2008,0.0,98199,47.6591,-122.39200000000001,1320,1414,-423,-0.4823261117445838,1690000,769129,-920871
405000.0,3,1.5,1330,12500,1.0,0,0,2,7,1330,0,1966,0.0,98027,47.5263,-122.051,2310,12500,11170,0.8936,1768900,156250000,154481100
299000.0,3,2.25,1940,9100,1.0,0,0,3,8,1630,310,1966,0.0,98023,47.3133,-122.36399999999999,2080,9100,7160,0.7868131868131868,3763600,82810000,79046400
299000.0,3,1.75,2100,15480,1.0,0,0,2,7,2100,0,1983,0.0,98001,47.2924,-122.271,1330,15657,13380,0.8643410852713178,4410000,239630400,235220400
372220.0,3,1.0,1290,5500,1.0,0,0,2,7,980,310,1951,0.0,98136,47.5266,-122.39200000000001,1680,5000,4210,0.7654545454545455,1664100,30250000,28585900
494400.0,2,1.75,1560,1750,1.0,0,0,3,6,780,780,1904,0.0,98109,47.6347,-122.355,1850,3600,190,0.10857142857142857,2433600,3062500,628900
280000.0,3,1.75,2630,6500,1.0,0,0,2,7,1330,1300,1958,0.0,98055,47.4878,-122.221,2520,6500,3870,0.5953846153846154,6916900,42250000,35333100
277950.0,3,2.5,2100,6021,2.0,0,0,2,7,2100,0,1992,0.0,98023,47.2917,-122.375,2091,7547,3921,0.6512207274539114,4410000,36252441,31842441
770000.0,3,2.75,2070,54557,2.0,0,0,2,8,2070,0,1996,0.0,98058,47.4659,-122.116,2190,49658,52487,0.9620580310500944,4284900,2976466249,2972181349
760000.0,4,2.5,2960,28005,2.0,0,0,2,10,2960,0,1989,0.0,98072,47.7477,-122.117,3510,35248,25045,0.8943045884663453,8761600,784280025,775518425
230000.0,2,2.0,1300,3608,1.0,0,0,2,7,1300,0,2004,0.0,98198,47.3623,-122.309,1510,3608,2308,0.6396895787139689,1690000,13017664,11327664
525000.0,4,2.5,2520,7731,2.0,0,0,2,9,2520,0,1994,0.0,98155,47.7709,-122.29700000000001,2000,7704,5211,0.6740395809080326,6350400,59768361,53417961
307000.0,3,1.0,1150,6000,1.5,0,0,2,7,1150,0,1927,0.0,98045,47.4963,-121.787,1210,7700,4850,0.8083333333333333,1322500,36000000,34677500
253779.0,4,2.0,2030,9600,1.5,0,0,2,6,1430,600,1947,0.0,98188,47.4459,-122.272,1820,14600,7570,0.7885416666666667,4120900,92160000,88039100
405000.0,3,1.5,1880,7400,1.0,0,0,2,8,1480,400,1968,0.0,98155,47.7743,-122.27,1820,8660,5520,0.745945945945946,3534400,54760000,51225600
360000.0,2,1.0,2320,11250,2.0,0,0,3,6,2320,0,1942,0.0,98146,47.504,-122.36200000000001,1620,11250,8930,0.7937777777777778,5382400,126562500,121180100
521000.0,2,1.0,1050,7500,1.5,0,3,3,6,1050,0,1910,0.0,98116,47.5577,-122.399,2540,13680,6450,0.86,1102500,56250000,55147500
680000.0,4,2.5,3030,13068,2.0,0,0,2,9,3030,0,1978,0.0,98005,47.6313,-122.17200000000001,2940,11999,10038,0.7681359044995408,9180900,170772624,161591724
355000.0,1,0.75,530,33278,1.0,0,2,3,4,530,0,1950,0.0,98074,47.6412,-122.079,2830,14311,32748,0.9840735621131078,280900,1107425284,1107144384
200000.0,3,1.5,1090,9600,1.0,0,0,3,7,1090,0,1968,0.0,98042,47.3639,-122.109,1240,9620,8510,0.8864583333333333,1188100,92160000,90971900
330000.0,3,2.25,2220,4060,1.0,0,0,2,7,1330,890,1993,0.0,98118,47.5188,-122.265,1930,5625,1840,0.45320197044334976,4928400,16483600,11555200
221000.0,3,2.25,1430,5999,2.0,0,0,2,7,1430,0,1987,0.0,98023,47.3116,-122.35799999999999,1600,5999,4569,0.7616269378229705,2044900,35988001,33943101
1600000.0,4,4.5,3780,6000,2.0,0,4,3,11,2770,1010,1910,1977.0,98116,47.5922,-122.38799999999999,2660,6000,2220,0.37,14288400,36000000,21711600
310000.0,2,1.0,1560,4920,1.0,0,0,3,6,780,780,1947,0.0,98125,47.7248,-122.325,1760,7510,3360,0.6829268292682927,2433600,24206400,21772800
862000.0,4,2.25,2220,4200,1.5,0,0,4,8,1310,910,1932,0.0,98199,47.6418,-122.39399999999999,2020,4940,1980,0.4714285714285714,4928400,17640000,12711600
200000.0,3,1.5,1140,8340,1.0,0,0,2,7,1140,0,1960,0.0,98168,47.4773,-122.28,1140,8340,7200,0.8633093525179856,1299600,69555600,68256000
630000.0,4,2.5,2540,11100,1.0,0,0,4,7,2540,0,1957,0.0,98008,47.6317,-122.124,1560,11100,8560,0.7711711711711712,6451600,123210000,116758400
432250.0,3,2.25,1440,6232,2.0,0,0,2,7,1440,0,1985,0.0,98029,47.5658,-122.01799999999999,1740,5999,4792,0.7689345314505777,2073600,38837824,36764224
478000.0,3,2.25,1570,9500,1.0,0,0,3,7,1070,500,1977,0.0,98033,47.6843,-122.185,2250,9583,7930,0.8347368421052631,2464900,90250000,87785100
249000.0,4,2.25,1860,9576,1.0,0,0,2,7,1400,460,1962,0.0,98032,47.3612,-122.28399999999999,1860,9576,7716,0.8057644110275689,3459600,91699776,88240176
495000.0,5,3.0,2440,4750,1.0,0,0,2,9,1450,990,2006,0.0,98108,47.5485,-122.302,1420,5940,2310,0.4863157894736842,5953600,22562500,16608900
630000.0,4,2.5,2100,8800,1.0,0,2,3,7,1240,860,1960,0.0,98008,47.6146,-122.11399999999999,2000,8800,6700,0.7613636363636364,4410000,77440000,73030000
550000.0,4,2.5,2150,27540,2.0,0,0,2,8,2150,0,1997,0.0,98053,47.637,-121.969,2150,27540,25390,0.9219317356572259,4622500,758451600,753829100
350000.0,3,2.5,2440,18674,2.0,0,0,3,8,2440,0,1994,0.0,98042,47.3672,-122.126,2530,10603,16234,0.8693370461604369,5953600,348718276,342764676
270000.0,5,1.5,1930,7480,2.0,0,0,2,7,1930,0,1966,0.0,98058,47.4503,-122.15700000000001,1480,7705,5550,0.7419786096256684,3724900,55950400,52225500
488250.0,4,2.0,1830,9610,1.0,0,0,2,7,1830,0,1963,0.0,98033,47.695,-122.176,1970,10754,7780,0.809573361082206,3348900,92352100,89003200
248000.0,4,3.5,1850,6519,2.0,0,0,2,7,1130,720,1986,0.0,98023,47.3087,-122.354,1280,6664,4669,0.7162141432735082,3422500,42497361,39074861
889000.0,4,3.5,3210,5000,3.0,0,0,2,9,3210,0,2014,0.0,98136,47.5203,-122.39299999999999,1360,5000,1790,0.358,10304100,25000000,14695900
375000.0,1,1.0,1090,5250,1.0,0,0,2,6,980,110,1927,0.0,98117,47.6999,-122.391,2160,5250,4160,0.7923809523809524,1188100,27562500,26374400
933000.0,3,1.5,1870,3300,2.0,0,2,2,7,1870,0,1906,0.0,98102,47.6221,-122.325,1820,2460,1430,0.43333333333333335,3496900,10890000,7393100
625000.0,3,2.25,1920,8412,1.0,0,2,2,8,1460,460,1977,0.0,98006,47.5578,-122.132,2490,8700,6492,0.7717546362339515,3686400,70761744,67075344
328000.0,2,1.0,700,4350,1.0,0,0,2,6,700,0,1943,0.0,98116,47.5577,-122.391,1620,5100,3650,0.8390804597701149,490000,18922500,18432500
470000.0,4,2.25,3380,9900,1.0,0,2,3,8,1690,1690,1969,0.0,98166,47.4438,-122.34,2390,9900,6520,0.6585858585858586,11424400,98010000,86585600
502500.0,5,2.5,2430,6168,2.0,0,0,2,8,2430,0,2007,0.0,98056,47.5237,-122.199,2150,8400,3738,0.6060311284046692,5904900,38044224,32139324
484000.0,3,1.75,1950,17400,1.0,0,0,2,7,1210,740,1976,0.0,98072,47.7424,-122.09100000000001,1900,17250,15450,0.8879310344827587,3802500,302760000,298957500
252500.0,2,1.0,900,7500,1.0,0,0,3,6,900,0,1961,0.0,98014,47.6481,-121.916,1190,10000,6600,0.88,810000,56250000,55440000
610000.0,3,2.5,2060,8893,2.0,0,0,2,8,2060,0,1987,0.0,98006,47.5615,-122.165,2650,8500,6833,0.7683571348251433,4243600,79085449,74841849
419000.0,4,2.0,2180,10447,1.0,0,0,3,8,1280,900,1969,0.0,98155,47.7675,-122.279,2190,10987,8267,0.7913276538719249,4752400,109139809,104387409
322500.0,4,2.25,2140,9377,2.0,0,0,3,8,2140,0,1986,0.0,98092,47.2649,-122.21799999999999,2030,7846,7237,0.7717820198357683,4579600,87928129,83348529
563000.0,6,1.0,1730,2760,1.5,0,0,2,7,1250,480,1918,0.0,98109,47.6342,-122.353,1630,3200,1030,0.37318840579710144,2992900,7617600,4624700
464000.0,4,2.5,3140,12591,2.0,0,0,2,9,3140,0,1993,0.0,98042,47.3826,-122.146,2650,11720,9451,0.7506155190215233,9859600,158533281,148673681
870000.0,4,4.25,3010,4887,2.0,0,3,3,10,1940,1070,1951,0.0,98115,47.6933,-122.272,2540,9375,1877,0.38408021280949456,9060100,23882769,14822669
280000.0,2,1.5,800,1196,2.0,0,0,2,8,800,0,2003,0.0,98103,47.6972,-122.34100000000001,1020,1087,396,0.3311036789297659,640000,1430416,790416
850000.0,3,2.5,3300,11570,2.0,0,0,2,9,3300,0,1994,0.0,98006,47.5599,-122.12100000000001,3280,11446,8270,0.7147796024200519,10890000,133864900,122974900
458950.0,2,1.0,1530,4370,1.0,0,0,2,7,1130,400,1946,0.0,98115,47.6888,-122.30799999999999,1580,4275,2840,0.6498855835240275,2340900,19096900,16756000
122000.0,2,1.0,760,5280,1.0,0,0,2,6,760,0,1946,0.0,98168,47.483000000000004,-122.33,1710,6594,4520,0.8560606060606061,577600,27878400,27300800
525000.0,5,3.0,2450,4591,2.0,0,0,2,7,2450,0,1994,0.0,98117,47.6828,-122.38799999999999,1060,5500,2141,0.46634720104552385,6002500,21077281,15074781
286300.0,2,1.0,1000,31838,1.0,0,0,2,7,1000,0,1962,0.0,98045,47.4789,-121.779,1490,39747,30838,0.9685909918964759,1000000,1013658244,1012658244
218450.0,2,1.0,840,7425,1.0,0,0,3,6,840,0,1952,0.0,98166,47.4749,-122.339,1300,11674,6585,0.8868686868686869,705600,55130625,54425025
525000.0,3,1.5,1380,4290,1.0,0,0,2,7,1080,300,1955,0.0,98107,47.674,-122.37899999999999,1510,3900,2910,0.6783216783216783,1904400,18404100,16499700
650000.0,3,1.5,1380,4290,1.0,0,0,2,7,1080,300,1955,0.0,98107,47.674,-122.37899999999999,1510,3900,2910,0.6783216783216783,1904400,18404100,16499700
356000.0,4,2.0,2020,48693,1.5,0,0,2,7,2020,0,1949,0.0,98045,47.4646,-121.759,1610,34900,46673,0.9585155977245189,4080400,2371008249,2366927849
436500.0,2,1.0,1260,5000,1.0,0,0,2,7,1040,220,1951,0.0,98117,47.6782,-122.397,1510,5000,3740,0.748,1587600,25000000,23412400
410000.0,3,1.75,1440,7112,1.0,0,0,2,7,1180,260,1979,0.0,98034,47.7304,-122.227,1570,9152,5672,0.7975253093363329,2073600,50580544,48506944
512500.0,4,1.75,1540,8311,1.0,0,0,3,7,1540,0,1950,0.0,98125,47.7046,-122.29299999999999,1890,7996,6771,0.814703405125737,2371600,69072721,66701121
510000.0,4,1.0,1060,7200,1.0,0,1,2,6,880,180,1925,0.0,98118,47.5591,-122.26799999999999,1910,7200,6140,0.8527777777777777,1123600,51840000,50716400
566000.0,4,1.75,1900,10297,1.0,0,0,3,8,1900,0,1966,0.0,98005,47.5944,-122.155,2220,9612,8397,0.815480236962222,3610000,106028209,102418209
525000.0,3,1.75,2870,26500,1.5,0,1,2,8,2870,0,1948,1981.0,98166,47.4485,-122.355,2420,20500,23630,0.8916981132075472,8236900,702250000,694013100
435000.0,3,1.0,1050,5500,1.0,0,0,2,6,930,120,1920,0.0,98126,47.5402,-122.38,1410,5834,4450,0.8090909090909091,1102500,30250000,29147500
406500.0,3,2.75,1840,68479,1.0,0,2,2,8,1340,500,1989,0.0,98014,47.6802,-121.90799999999999,2060,61903,66639,0.9731304487507119,3385600,4689373441,4685987841
550000.0,5,2.75,3000,9473,1.0,0,0,2,8,1500,1500,1966,0.0,98052,47.6567,-122.13,2050,8820,6473,0.6833104613110947,9000000,89737729,80737729
251000.0,3,2.0,1200,10212,1.5,0,0,4,6,1200,0,1949,0.0,98022,47.206,-121.99799999999999,1280,10212,9012,0.882491186839013,1440000,104284944,102844944
830000.0,3,1.5,1840,10125,1.0,0,0,3,8,1220,620,1959,0.0,98040,47.5607,-122.21700000000001,2320,10160,8285,0.8182716049382716,3385600,102515625,99130025
803000.0,4,2.5,2790,7673,2.0,0,0,2,9,2790,0,1989,0.0,98052,47.6692,-122.13600000000001,2740,7837,4883,0.6363873322038316,7784100,58874929,51090829
206000.0,3,1.0,970,9360,1.0,0,0,3,5,970,0,1942,0.0,98002,47.2808,-122.225,1050,11348,8390,0.8963675213675214,940900,87609600,86668700
200000.0,4,1.0,1070,7467,1.5,0,0,2,7,1070,0,1944,0.0,98178,47.4942,-122.235,1160,7467,6397,0.8567028257667069,1144900,55756089,54611189
219000.0,2,1.0,900,5160,1.0,0,0,2,6,900,0,1952,0.0,98106,47.525,-122.35600000000001,900,5160,4260,0.8255813953488372,810000,26625600,25815600
777000.0,4,4.0,2680,6000,1.0,0,0,2,7,1380,1300,1962,2014.0,98199,47.6557,-122.38799999999999,1930,6000,3320,0.5533333333333333,7182400,36000000,28817600
593700.0,3,2.5,2000,22000,2.0,0,0,2,8,2000,0,1979,0.0,98075,47.59,-122.081,2180,19800,20000,0.9090909090909091,4000000,484000000,480000000
712500.0,3,1.5,1660,8797,1.0,0,0,3,7,1660,0,1956,0.0,98004,47.5892,-122.20200000000001,2350,10053,7137,0.8112993065817893,2755600,77387209,74631609
600000.0,4,1.5,1770,6014,1.5,0,0,3,7,1240,530,1946,0.0,98116,47.5773,-122.39299999999999,1740,6014,4244,0.7056867309610908,3132900,36168196,33035296
554663.0,3,2.0,1230,6802,1.5,0,0,2,7,1230,0,1940,0.0,98105,47.6712,-122.279,1850,6398,5572,0.8191708321082035,1512900,46267204,44754304
267000.0,3,1.0,1740,10875,1.0,0,0,3,7,1020,720,1962,0.0,98188,47.4682,-122.28299999999999,1470,8532,9135,0.84,3027600,118265625,115238025
390000.0,3,2.0,1710,8910,1.0,0,0,4,7,1710,0,1953,0.0,98133,47.7719,-122.338,1430,8493,7200,0.8080808080808081,2924100,79388100,76464000
335000.0,6,2.0,2020,7071,1.0,0,0,2,7,1010,1010,1979,0.0,98108,47.5329,-122.294,2020,5000,5051,0.7143261207749965,4080400,49999041,45918641
938000.0,4,2.5,2410,9886,1.0,0,0,4,8,1990,420,1975,0.0,98040,47.5351,-122.223,2530,10658,7476,0.7562209184705644,5808100,97732996,91924896
370000.0,4,2.75,2310,14745,1.0,0,0,2,7,1410,900,1993,0.0,98198,47.376999999999995,-122.31,2060,9678,12435,0.8433367243133265,5336100,217415025,212078925
335000.0,5,2.5,2400,4548,2.0,0,0,2,7,2400,0,2003,0.0,98042,47.371,-122.12700000000001,2200,4465,2148,0.47229551451187335,5760000,20684304,14924304
695000.0,5,2.0,3160,3990,1.5,0,0,2,7,1870,1290,1923,0.0,98103,47.653999999999996,-122.337,1780,4240,830,0.20802005012531327,9985600,15920100,5934500
387500.0,3,1.0,1560,14333,1.0,0,0,3,7,1560,0,1953,0.0,98166,47.431999999999995,-122.348,1640,14333,12773,0.8911602595409196,2433600,205434889,203001289
245000.0,3,2.5,1770,6187,2.0,0,0,2,7,1770,0,1992,0.0,98031,47.4034,-122.189,1650,7200,4417,0.7139162760627121,3132900,38278969,35146069
308550.0,3,2.0,1600,13200,1.0,0,0,2,7,1600,0,1990,0.0,98045,47.4656,-121.756,1360,11520,11600,0.8787878787878788,2560000,174240000,171680000
225000.0,3,1.75,1330,13102,1.0,0,0,2,7,1330,0,1968,0.0,98003,47.3172,-122.322,1270,11475,11772,0.8984887803388796,1768900,171662404,169893504
715000.0,4,2.5,2970,29163,2.0,0,0,2,9,2970,0,1993,0.0,98053,47.6717,-122.025,3100,31105,26193,0.8981586256557967,8820900,850480569,841659669
335000.0,3,1.0,1020,10200,1.0,0,0,3,7,1020,0,1954,0.0,98133,47.7503,-122.348,1170,8188,9180,0.9,1040400,104040000,102999600
634000.0,3,2.5,2490,4904,2.0,0,0,2,9,2490,0,2003,0.0,98029,47.5451,-122.014,2370,4050,2414,0.49225122349102773,6200100,24049216,17849116
337500.0,5,2.0,1700,7314,1.0,0,0,2,7,1000,700,1956,0.0,98108,47.549,-122.305,2000,7176,5614,0.7675690456658463,2890000,53494596,50604596
440000.0,1,1.0,850,6567,1.0,0,0,3,6,850,0,1940,0.0,98010,47.327,-122.039,2160,9794,5717,0.8705649459418303,722500,43125489,42402989
350000.0,3,1.75,1250,13775,1.0,0,2,2,7,1250,0,1990,0.0,98045,47.4981,-121.772,1260,13707,12525,0.9092558983666061,1562500,189750625,188188125
400000.0,2,1.0,610,4560,1.0,0,0,2,5,610,0,1918,0.0,98136,47.5498,-122.383,930,1392,3950,0.8662280701754386,372100,20793600,20421500
1290000.0,4,3.5,3700,13175,2.0,0,0,3,11,3700,0,1989,0.0,98006,47.5471,-122.133,3880,15508,9475,0.7191650853889943,13690000,173580625,159890625
435000.0,3,1.0,950,10080,1.0,0,0,3,7,950,0,1954,0.0,98006,47.571999999999996,-122.139,1060,10000,9130,0.9057539682539683,902500,101606400,100703900
681000.0,4,2.5,3860,5130,2.0,0,0,2,8,2930,930,2004,0.0,98065,47.5387,-121.87899999999999,3130,6163,1270,0.2475633528265107,14899600,26316900,11417300
397000.0,3,3.5,1360,1275,2.0,0,0,2,8,1240,120,2007,0.0,98144,47.5904,-122.315,1360,1275,-85,-0.06666666666666667,1849600,1625625,-223975
775000.0,4,2.5,3890,34513,2.0,0,0,2,10,3890,0,1996,0.0,98077,47.7749,-122.04799999999999,3600,28435,30623,0.8872888476805841,15132100,1191147169,1176015069
480000.0,3,2.25,1680,9090,1.0,0,0,3,7,1130,550,1959,0.0,98008,47.6068,-122.13,1960,9090,7410,0.8151815181518152,2822400,82628100,79805700
158000.0,3,2.5,1520,7200,2.0,0,0,3,7,1520,0,1985,0.0,98030,47.3679,-122.182,1780,7210,5680,0.7888888888888889,2310400,51840000,49529600
590000.0,3,2.0,2420,208652,1.5,0,0,2,8,2420,0,2005,0.0,98010,47.3666,-121.978,3180,212137,206232,0.9884017406974293,5856400,43535657104,43529800704
772500.0,5,2.75,3890,9130,2.0,0,0,2,9,3890,0,2004,0.0,98065,47.5407,-121.86,3450,8361,5240,0.5739320920043811,15132100,83356900,68224800
464500.0,5,1.5,2940,13425,1.0,0,0,2,8,1470,1470,1955,0.0,98155,47.7632,-122.29,1580,8200,10485,0.7810055865921788,8643600,180230625,171587025
281000.0,3,1.75,1350,8737,1.0,0,0,2,7,1350,0,1966,0.0,98188,47.4378,-122.279,1600,8928,7387,0.8454847201556598,1822500,76335169,74512669
620000.0,3,2.25,2190,45738,1.0,0,0,2,8,2190,0,1990,0.0,98052,47.7108,-122.12,2970,4496,43548,0.9521185884822249,4796100,2091964644,2087168544
475000.0,3,2.25,2280,5750,1.0,0,1,3,7,1150,1130,1985,0.0,98116,47.5641,-122.39299999999999,1500,5060,3470,0.6034782608695652,5198400,33062500,27864100
245000.0,2,2.0,1070,4500,1.0,0,0,3,6,910,160,1932,0.0,98055,47.4896,-122.204,1280,4500,3430,0.7622222222222222,1144900,20250000,19105100
660000.0,5,2.25,2540,3750,1.5,0,0,3,7,1510,1030,1925,0.0,98115,47.6729,-122.29899999999999,1780,3750,1210,0.32266666666666666,6451600,14062500,7610900
527500.0,4,2.25,2270,8480,1.0,0,0,4,8,1310,960,1973,0.0,98006,47.5448,-122.17399999999999,1910,9050,6210,0.7323113207547169,5152900,71910400,66757500
135000.0,2,1.0,1220,7250,1.0,0,0,3,6,1220,0,1914,0.0,98010,47.3585,-121.975,1350,20250,6030,0.8317241379310345,1488400,52562500,51074100
275000.0,3,1.75,1890,5000,1.0,0,0,2,7,1890,0,2003,0.0,98092,47.3357,-122.175,2960,5421,3110,0.622,3572100,25000000,21427900
430000.0,4,2.0,1990,4740,1.0,0,0,2,7,1080,910,1926,0.0,98122,47.6112,-122.303,1560,2370,2750,0.580168776371308,3960100,22467600,18507500
213500.0,3,1.0,1220,6000,1.0,0,0,3,7,1220,0,1968,0.0,98002,47.3245,-122.209,1420,6000,4780,0.7966666666666666,1488400,36000000,34511600
535000.0,3,3.0,2640,5978,2.0,0,0,2,9,2640,0,2012,0.0,98045,47.4759,-121.735,2680,6060,3338,0.5583807293409166,6969600,35736484,28766884
641000.0,3,1.75,1480,9603,1.0,0,0,2,7,1480,0,1952,0.0,98004,47.5915,-122.20200000000001,2660,10766,8123,0.8458814953660314,2190400,92217609,90027209
436300.0,3,2.0,2320,9420,1.0,0,0,4,7,2320,0,1952,0.0,98056,47.5133,-122.196,2030,9420,7100,0.7537154989384289,5382400,88736400,83354000
1440000.0,4,1.75,2410,6000,1.5,0,0,2,8,2410,0,1911,0.0,98109,47.6369,-122.355,1280,4000,3590,0.5983333333333334,5808100,36000000,30191900
830000.0,4,2.75,2090,13500,1.0,0,0,3,8,2090,0,1949,0.0,98040,47.573,-122.225,2130,13500,11410,0.8451851851851852,4368100,182250000,177881900
380000.0,3,1.0,920,3532,1.0,0,0,2,6,920,0,1910,0.0,98118,47.5539,-122.26799999999999,1250,4000,2612,0.739524348810872,846400,12475024,11628624
132500.0,3,0.75,850,8573,1.0,0,0,2,6,600,250,1945,0.0,98146,47.503,-122.35600000000001,850,8382,7723,0.900851510556398,722500,73496329,72773829
179950.0,3,1.0,1130,9907,1.0,0,0,2,7,1130,0,1954,0.0,98188,47.4362,-122.286,1320,9907,8777,0.8859392348844252,1276900,98148649,96871749
188200.0,3,1.0,1260,7265,1.0,0,0,3,7,1260,0,1954,0.0,98002,47.2979,-122.22399999999999,940,7200,6005,0.8265657260839642,1587600,52780225,51192625
659000.0,4,2.0,2090,10800,1.0,0,0,3,7,2090,0,1951,0.0,98040,47.5759,-122.223,2090,10800,8710,0.8064814814814815,4368100,116640000,112271900
317000.0,3,2.0,2020,7260,1.5,0,0,2,7,1180,840,1926,0.0,98108,47.5496,-122.311,1400,5950,5240,0.721763085399449,4080400,52707600,48627200
625000.0,3,2.25,1970,4564,1.0,0,0,2,8,1470,500,1959,0.0,98199,47.6703,-122.41,1980,5000,2594,0.5683610867659947,3880900,20830096,16949196
350000.0,3,1.75,1820,9545,1.0,0,0,2,7,1230,590,1976,0.0,98155,47.7772,-122.296,1790,9530,7725,0.8093242535358827,3312400,91107025,87794625
750000.0,3,1.5,1840,5000,1.5,0,0,4,7,1340,500,1915,0.0,98107,47.6652,-122.36200000000001,1840,5000,3160,0.632,3385600,25000000,21614400
457000.0,4,1.75,2100,10358,1.0,0,0,4,8,1280,820,1959,0.0,98133,47.7478,-122.338,2080,9000,8258,0.7972581579455493,4410000,107288164,102878164
632500.0,4,2.0,1770,5000,2.0,0,0,3,7,1770,0,1906,0.0,98107,47.6748,-122.38600000000001,1550,5000,3230,0.646,3132900,25000000,21867100
223000.0,3,2.0,1110,7231,1.0,0,0,3,7,1110,0,1991,0.0,98031,47.4036,-122.191,1550,7245,6121,0.8464942608214632,1232100,52287361,51055261
610000.0,4,2.75,2090,8400,1.0,0,0,3,8,1240,850,1976,0.0,98052,47.6872,-122.12299999999999,2340,9000,6310,0.7511904761904762,4368100,70560000,66191900
385000.0,4,1.75,2080,8215,2.0,0,0,3,7,2080,0,1948,0.0,98155,47.736999999999995,-122.305,1550,8215,6135,0.7468046256847231,4326400,67486225,63159825
367500.0,3,3.25,1400,1343,2.0,0,0,2,7,1160,240,2005,0.0,98118,47.5483,-122.277,1400,1326,-57,-0.04244229337304542,1960000,1803649,-156351
385100.0,3,1.0,1060,8040,1.0,0,0,3,6,1060,0,1949,0.0,98125,47.7121,-122.287,1300,7620,6980,0.8681592039800995,1123600,64641600,63518000
230000.0,2,1.0,720,5913,1.0,0,0,2,6,720,0,1920,0.0,98118,47.5447,-122.27,1560,6600,5193,0.878234398782344,518400,34963569,34445169
286000.0,3,2.75,1100,750,2.0,0,0,2,7,780,320,2008,0.0,98106,47.5601,-122.363,1170,4800,-350,-0.4666666666666667,1210000,562500,-647500
201700.0,3,1.0,1010,9576,1.0,0,0,3,7,1010,0,1967,0.0,98001,47.2956,-122.272,1540,9576,8566,0.8945279866332498,1020100,91699776,90679676
1350000.0,4,4.75,5230,89298,2.5,0,0,2,11,5230,0,2002,0.0,98038,47.4097,-122.06299999999999,4110,107153,84068,0.9414320589486886,27352900,7974132804,7946779904
525000.0,4,1.75,2420,7672,1.0,0,0,2,8,1480,940,1979,0.0,98027,47.5637,-122.085,2370,7699,5252,0.6845672575599583,5856400,58859584,53003184
361000.0,3,1.5,1200,7236,1.0,0,0,2,7,1200,0,1975,0.0,98011,47.739,-122.194,1680,7800,6036,0.8341625207296849,1440000,52359696,50919696
530000.0,3,1.5,1950,1963,3.0,0,0,2,8,1950,0,2002,0.0,98117,47.6904,-122.397,1590,2028,13,0.006622516556291391,3802500,3853369,50869
455000.0,3,2.25,1870,7403,1.0,0,0,2,7,1870,0,1950,0.0,98125,47.7171,-122.32,1630,7440,5533,0.7473997028231798,3496900,54804409,51307509
421000.0,4,2.25,1310,8400,1.0,0,0,3,7,1310,0,1966,0.0,98034,47.7317,-122.181,1600,8400,7090,0.844047619047619,1716100,70560000,68843900
640000.0,4,2.0,1520,6200,1.5,0,0,2,7,1520,0,1945,0.0,98115,47.678000000000004,-122.26899999999999,1910,6200,4680,0.7548387096774194,2310400,38440000,36129600
240000.0,3,1.0,1270,12733,1.0,0,0,2,7,1270,0,1955,0.0,98188,47.445,-122.27600000000001,1660,11536,11463,0.900259169088196,1612900,162129289,160516389
360000.0,2,1.0,840,7414,1.0,0,0,3,6,840,0,1928,0.0,98033,47.6771,-122.17200000000001,1740,9784,6574,0.8867008362557324,705600,54967396,54261796
157340.0,2,1.0,900,23000,1.0,0,0,1,7,900,0,1953,0.0,98042,47.3576,-122.156,1460,8265,22100,0.9608695652173913,810000,529000000,528190000
1240000.0,4,3.0,3010,6139,2.0,0,4,4,8,2560,450,1950,0.0,98115,47.6799,-122.26799999999999,2100,6798,3129,0.5096921322690992,9060100,37687321,28627221
250000.0,3,1.0,1050,6874,1.0,0,0,2,6,1050,0,1954,0.0,98133,47.762,-122.355,1500,8954,5824,0.8472505091649695,1102500,47251876,46149376
735000.0,6,2.75,3360,84506,1.0,0,0,4,7,2040,1320,1962,0.0,98052,47.715,-122.12100000000001,2190,43124,81146,0.9602395096206187,11289600,7141264036,7129974436
884900.0,7,4.75,5370,10800,1.5,0,0,2,8,5370,0,1967,0.0,98040,47.538000000000004,-122.223,2310,10910,5430,0.5027777777777778,28836900,116640000,87803100
775000.0,3,3.5,2690,104544,2.0,0,0,2,8,2690,0,1948,1990.0,98072,47.7717,-122.11200000000001,2300,81698,101854,0.9742692072237527,7236100,10929447936,10922211836
463000.0,3,1.75,1710,7320,1.0,0,0,2,7,1710,0,1948,0.0,98155,47.7512,-122.281,2260,8839,5610,0.7663934426229508,2924100,53582400,50658300
579000.0,3,2.5,1640,1269,3.0,0,0,2,8,1640,0,2009,0.0,98112,47.6197,-122.3,1590,1231,-371,-0.2923561859732072,2689600,1610361,-1079239
570000.0,6,3.75,4000,6015,2.0,0,2,2,10,3080,920,2004,0.0,98058,47.453,-122.118,3180,5700,2015,0.3349958437240233,16000000,36180225,20180225
1060000.0,5,4.5,4140,7924,2.0,0,0,2,10,4140,0,2005,0.0,98074,47.6102,-121.993,3960,8410,3784,0.47753659767794043,17139600,62789776,45650176
375000.0,4,2.75,3140,24800,1.0,0,0,3,8,2080,1060,1971,0.0,98042,47.3782,-122.161,2850,12900,21660,0.8733870967741936,9859600,615040000,605180400
422000.0,2,1.75,1320,2609,1.0,0,0,3,7,920,400,1938,0.0,98117,47.6878,-122.366,1200,4220,1289,0.4940590264469145,1742400,6806881,5064481
866500.0,4,3.5,3080,4945,2.0,0,0,2,9,2010,1070,2014,0.0,98126,47.5662,-122.37899999999999,1220,4945,1865,0.37714863498483314,9486400,24453025,14966625
705000.0,3,2.5,2500,10359,2.0,0,0,2,10,2500,0,1986,0.0,98074,47.6286,-122.051,2580,10142,7859,0.7586639637030601,6250000,107308881,101058881
470000.0,4,2.5,2520,9684,2.0,0,0,2,8,2520,0,1994,0.0,98045,47.4848,-121.801,2090,10133,7164,0.7397769516728625,6350400,93779856,87429456
360000.0,3,1.25,2350,6200,1.0,0,0,3,7,1320,1030,1966,0.0,98007,47.5979,-122.135,2140,9543,3850,0.6209677419354839,5522500,38440000,32917500
795000.0,4,2.5,2570,13450,1.0,0,4,2,8,1510,1060,1948,0.0,98155,47.7429,-122.285,3470,12615,10880,0.8089219330855019,6604900,180902500,174297600
800000.0,4,2.5,3100,7807,2.0,0,0,2,9,3100,0,2003,0.0,98034,47.7151,-122.227,3100,7807,4707,0.6029204560010247,9610000,60949249,51339249
2450000.0,4,3.5,4730,13586,1.5,0,0,4,10,4270,460,1935,0.0,98112,47.6319,-122.288,3710,8828,8856,0.6518474900633004,22372900,184579396,162206496
277284.0,3,1.75,1030,4800,1.0,0,0,2,6,930,100,1927,0.0,98126,47.566,-122.37299999999999,1540,4800,3770,0.7854166666666667,1060900,23040000,21979100
460000.0,2,1.0,1020,4002,1.0,0,0,4,7,1020,0,1953,0.0,98116,47.5828,-122.395,1780,5000,2982,0.7451274362818591,1040400,16016004,14975604
898888.0,3,2.5,2080,3729,2.0,0,0,2,9,2080,0,1996,0.0,98033,47.6731,-122.199,2080,4000,1649,0.44220970769643336,4326400,13905441,9579041
211000.0,3,1.0,1410,47916,1.0,0,0,2,7,1410,0,1981,0.0,98019,47.7149,-121.96,1810,215622,46506,0.9705735036313549,1988100,2295943056,2293954956
222000.0,2,2.0,1360,3300,2.0,0,0,2,6,1360,0,2004,0.0,98038,47.3489,-122.022,1310,3300,1940,0.5878787878787879,1849600,10890000,9040400
672000.0,3,2.5,2620,21587,2.0,0,0,2,7,2620,0,1992,0.0,98053,47.6384,-121.959,2570,23650,18967,0.8786306573400657,6864400,465998569,459134169
778000.0,3,2.25,2260,33080,1.0,0,0,4,9,1690,570,1974,0.0,98005,47.6386,-122.18299999999999,3020,35291,30820,0.9316807738814994,5107600,1094286400,1089178800
312500.0,3,1.75,1490,9493,1.0,0,0,3,8,1490,0,1976,0.0,98058,47.4514,-122.134,2440,9600,8003,0.8430422416517434,2220100,90117049,87896949
650000.0,4,2.5,2530,6500,1.5,0,0,2,8,1720,810,1975,0.0,98115,47.6737,-122.28399999999999,2150,5280,3970,0.6107692307692307,6400900,42250000,35849100
740000.0,6,2.25,3140,10250,1.0,0,0,3,8,1570,1570,1959,0.0,98005,47.6116,-122.169,2320,10250,7110,0.6936585365853658,9859600,105062500,95202900
320000.0,3,2.0,1820,17600,1.0,0,0,4,7,1820,0,1972,0.0,98059,47.4703,-122.11200000000001,2190,17440,15780,0.8965909090909091,3312400,309760000,306447600
455000.0,4,2.5,1770,13168,2.0,0,0,2,7,1770,0,1990,0.0,98019,47.7306,-121.96600000000001,2050,14859,11398,0.8655832320777643,3132900,173396224,170263324
2450000.0,5,4.0,4430,9000,2.0,0,0,2,10,4430,0,2013,0.0,98004,47.6168,-122.21600000000001,2470,9490,4570,0.5077777777777778,19624900,81000000,61375100
500000.0,3,3.25,1490,902,3.0,0,0,2,8,1220,270,2001,0.0,98102,47.6357,-122.324,1550,1092,-588,-0.6518847006651884,2220100,813604,-1406496
325000.0,3,1.75,1790,27427,1.0,0,0,2,7,1130,660,1978,0.0,98065,47.532,-121.76100000000001,1610,16684,25637,0.9347358442410764,3204100,752240329,749036229
416000.0,3,2.5,1710,1296,3.0,0,0,2,8,1510,200,2004,0.0,98103,47.6963,-122.34200000000001,1610,1282,-414,-0.3194444444444444,2924100,1679616,-1244484
495000.0,4,2.25,2070,20280,2.0,0,0,3,7,2070,0,1968,0.0,98072,47.773999999999994,-122.134,2190,21560,18210,0.8979289940828402,4284900,411278400,406993500
549000.0,2,1.0,1140,5400,1.0,0,0,4,7,1140,0,1908,0.0,98112,47.6205,-122.294,1520,4800,4260,0.7888888888888889,1299600,29160000,27860400
589000.0,5,2.0,3930,10150,1.5,0,0,3,8,3070,860,1968,0.0,98008,47.6317,-122.11399999999999,2200,8190,6220,0.6128078817733991,15444900,103022500,87577600
194820.0,3,1.5,1100,32700,1.0,0,0,2,7,1100,0,1967,0.0,98001,47.3186,-122.289,1616,32700,31600,0.9663608562691132,1210000,1069290000,1068080000
405000.0,3,2.5,2260,5500,1.5,0,0,2,7,1280,980,1910,0.0,98117,47.681000000000004,-122.38799999999999,1790,5355,3240,0.5890909090909091,5107600,30250000,25142400
625000.0,3,2.5,2260,5500,1.5,0,0,2,7,1280,980,1910,0.0,98117,47.681000000000004,-122.38799999999999,1790,5355,3240,0.5890909090909091,5107600,30250000,25142400
205000.0,3,1.0,1130,7014,1.0,0,0,2,7,1130,0,1954,0.0,98168,47.4743,-122.274,1440,9350,5884,0.8388936412888509,1276900,49196196,47919296
345100.0,3,3.75,1950,8625,1.0,0,0,2,8,1360,590,1959,0.0,98178,47.505,-122.258,1950,6670,6675,0.7739130434782608,3802500,74390625,70588125
200000.0,3,1.0,960,7500,1.0,0,0,2,6,960,0,1953,0.0,98178,47.4966,-122.255,1250,6000,6540,0.872,921600,56250000,55328400
1910000.0,4,3.5,4210,18564,2.0,0,0,2,11,4210,0,2001,0.0,98039,47.6206,-122.225,3520,18564,14354,0.7732169790993321,17724100,344622096,326897996
524500.0,3,1.5,3430,264844,1.0,0,2,2,7,2230,1200,1988,0.0,98045,47.4476,-121.723,1660,145926,261414,0.9870489797767743,11764900,70142344336,70130579436
598600.0,4,2.75,3470,212639,2.0,0,0,2,7,2070,1400,1993,0.0,98019,47.7066,-121.96799999999999,2370,233917,209169,0.983681262609399,12040900,45215344321,45203303421
367777.0,5,3.0,2140,5937,1.0,0,0,2,7,1280,860,1978,0.0,98118,47.5459,-122.27,1820,6710,3797,0.639548593565774,4579600,35247969,30668369
750000.0,3,2.75,2520,5401,1.0,0,0,3,7,1360,1160,1946,0.0,98119,47.6452,-122.37299999999999,1800,5036,2881,0.5334197370857249,6350400,29170801,22820401
575000.0,5,2.25,3550,7992,2.0,0,0,2,8,3550,0,1968,0.0,98034,47.7285,-122.179,2110,7992,4442,0.5558058058058059,12602500,63872064,51269564
84000.0,2,1.0,700,20130,1.0,0,0,2,6,700,0,1949,0.0,98168,47.4752,-122.271,1490,18630,19430,0.9652260307998013,490000,405216900,404726900
255000.0,2,1.0,740,5000,1.0,0,0,3,6,740,0,1926,0.0,98118,47.5298,-122.273,1170,4968,4260,0.852,547600,25000000,24452400
1740000.0,4,3.75,3300,4545,1.5,0,4,2,10,2600,700,1926,1999.0,98105,47.6561,-122.274,3300,5000,1245,0.2739273927392739,10890000,20657025,9767025
415000.0,3,2.25,1640,5880,1.0,0,0,2,7,1240,400,1977,0.0,98106,47.5323,-122.351,1200,4760,4240,0.7210884353741497,2689600,34574400,31884800
449900.0,3,2.5,2780,8225,2.0,0,1,2,9,2780,0,1990,0.0,98198,47.3509,-122.323,720,9736,5445,0.6620060790273556,7728400,67650625,59922225
220000.0,5,1.5,1830,94960,1.5,0,0,2,7,1830,0,1929,0.0,98031,47.4218,-122.21799999999999,1440,16365,93130,0.9807287278854254,3348900,9017401600,9014052700
899000.0,4,2.5,3540,9349,2.0,0,0,2,10,3540,0,2003,0.0,98052,47.7046,-122.10700000000001,3280,7546,5809,0.6213498769921917,12531600,87403801,74872201
430000.0,3,2.5,1440,7320,1.0,0,0,4,7,1440,0,1954,0.0,98125,47.7179,-122.316,1160,6941,5880,0.8032786885245902,2073600,53582400,51508800
472500.0,4,2.5,2960,223462,2.0,0,0,2,10,2960,0,2001,0.0,98030,47.3646,-122.211,2770,16482,220502,0.986753899991945,8761600,49935265444,49926503844
680000.0,6,2.5,3180,9375,1.0,0,0,3,8,1590,1590,1967,0.0,98006,47.5707,-122.12899999999999,2670,9625,6195,0.6608,10112400,87890625,77778225
1650000.0,5,4.0,3310,8400,2.0,0,0,2,10,3310,0,2000,0.0,98033,47.6914,-122.214,3430,8400,5090,0.6059523809523809,10956100,70560000,59603900
810000.0,3,2.0,2390,8025,2.0,0,0,4,7,2390,0,1921,0.0,98105,47.6707,-122.288,1920,5350,5635,0.7021806853582554,5712100,64400625,58688525
605000.0,3,2.5,2460,138085,2.0,0,0,3,9,2460,0,1977,0.0,98027,47.4572,-122.007,2090,219542,135625,0.9821848861208676,6051600,19067467225,19061415625
522000.0,3,1.75,1630,15600,1.0,0,0,2,7,1630,0,1958,0.0,98033,47.68,-122.165,1830,10850,13970,0.8955128205128206,2656900,243360000,240703100
759000.0,5,2.75,3490,8230,2.0,0,0,2,10,3490,0,2005,0.0,98075,47.5825,-121.97,3480,7331,4740,0.5759416767922235,12180100,67732900,55552800
411000.0,4,2.75,2500,5257,2.0,0,0,2,8,2500,0,1966,0.0,98118,47.5293,-122.287,1660,5970,2757,0.5244435990108427,6250000,27636049,21386049
286950.0,4,2.5,2080,9846,1.0,0,0,2,7,1240,840,1984,0.0,98001,47.3338,-122.26799999999999,1890,7977,7766,0.7887466991671744,4326400,96943716,92617316
440000.0,3,1.5,1290,1286,3.0,0,0,2,7,1290,0,2000,0.0,98103,47.6617,-122.34899999999999,1720,1286,-4,-0.003110419906687403,1664100,1653796,-10304
149000.0,3,1.0,1700,8645,1.0,0,0,2,6,1700,0,1955,0.0,98146,47.4899,-122.337,1500,7980,6945,0.8033545401966454,2890000,74736025,71846025
284700.0,3,1.0,1700,8645,1.0,0,0,2,6,1700,0,1955,0.0,98146,47.4899,-122.337,1500,7980,6945,0.8033545401966454,2890000,74736025,71846025
374950.0,3,2.5,2540,11562,1.0,0,1,2,8,1290,1250,1964,0.0,98028,47.7614,-122.229,2230,10310,9022,0.78031482442484,6451600,133679844,127228244
816000.0,3,1.5,1180,8545,1.0,0,0,2,8,1180,0,1952,0.0,98004,47.623999999999995,-122.2,1660,9000,7365,0.8619075482738443,1392400,73017025,71624625
533250.0,4,1.75,1520,15398,1.0,0,0,3,7,1370,150,1960,0.0,98027,47.5265,-122.05,1840,12500,13878,0.9012858812832836,2310400,237098404,234788004
689800.0,3,2.75,2390,9313,1.0,0,0,4,8,1390,1000,1942,0.0,98133,47.7209,-122.331,2390,12712,6923,0.7433694835176635,5712100,86731969,81019869
775000.0,4,2.75,2740,6200,1.5,0,3,3,8,1820,920,1947,0.0,98125,47.7084,-122.277,2430,6000,3460,0.5580645161290323,7507600,38440000,30932400
702000.0,3,2.5,2190,8528,1.0,0,0,2,8,1760,430,1991,0.0,98033,47.6943,-122.209,2060,9811,6338,0.7431988742964353,4796100,72726784,67930684
160000.0,3,1.0,1350,8700,1.5,0,0,2,6,1350,0,1942,0.0,98188,47.4497,-122.289,1300,8700,7350,0.8448275862068966,1822500,75690000,73867500
255500.0,3,1.0,1350,8700,1.5,0,0,2,6,1350,0,1942,0.0,98188,47.4497,-122.289,1300,8700,7350,0.8448275862068966,1822500,75690000,73867500
949000.0,4,2.75,2980,42253,1.0,0,0,3,9,1860,1120,1973,0.0,98005,47.6392,-122.163,2980,42253,39273,0.9294724634937164,8880400,1785316009,1776435609
169500.0,2,1.0,790,7450,1.0,0,0,3,6,790,0,1944,0.0,98058,47.4743,-122.17,800,7450,6660,0.8939597315436242,624100,55502500,54878400
586000.0,4,2.25,2130,9000,2.0,0,0,3,8,2130,0,1965,0.0,98006,47.5716,-122.15899999999999,2110,10431,6870,0.7633333333333333,4536900,81000000,76463100
680000.0,4,2.5,2700,37431,1.0,0,0,3,8,1600,1100,1978,0.0,98072,47.7258,-122.117,2290,37431,34731,0.9278672757874489,7290000,1401079761,1393789761
851500.0,3,2.0,3200,18184,1.0,0,0,4,8,2000,1200,1977,0.0,98005,47.6034,-122.17200000000001,1670,7416,14984,0.8240211174659041,10240000,330657856,320417856
582500.0,2,1.5,1159,4800,1.0,0,0,2,7,1159,0,1948,0.0,98199,47.6592,-122.399,1640,4800,3641,0.7585416666666667,1343281,23040000,21696719
637000.0,4,3.5,3080,118918,2.0,0,0,2,9,3080,0,2008,0.0,98019,47.7721,-121.92399999999999,1830,434728,115838,0.9740997998620898,9486400,14141490724,14132004324
225000.0,3,1.0,1000,9295,1.0,0,0,2,7,1000,0,1955,0.0,98146,47.483999999999995,-122.346,1320,13500,8295,0.8924152770306616,1000000,86397025,85397025
795000.0,3,3.25,2260,3727,2.0,0,0,2,8,1880,380,2003,0.0,98119,47.6422,-122.361,1600,4800,1467,0.39361416689026024,5107600,13890529,8782929
304999.0,4,2.25,2270,9600,1.0,0,0,2,7,1290,980,1976,0.0,98023,47.3261,-122.355,1930,15000,7330,0.7635416666666667,5152900,92160000,87007100
95000.0,1,0.75,760,5746,1.0,0,0,3,5,760,0,1915,0.0,98002,47.3046,-122.215,970,6696,4986,0.8677340758788723,577600,33016516,32438916
240000.0,4,1.75,1420,5382,1.0,0,0,4,5,1040,380,1942,0.0,98056,47.4946,-122.18700000000001,1150,5382,3962,0.7361575622445188,2016400,28965924,26949524
772000.0,4,2.5,2500,8680,1.0,0,0,3,7,1250,1250,1958,0.0,98004,47.6073,-122.19200000000001,2140,8680,6180,0.7119815668202765,6250000,75342400,69092400
245000.0,2,1.5,1450,6258,1.0,0,0,3,8,1450,0,1983,0.0,98198,47.3785,-122.322,1460,5375,4808,0.7682965803771173,2102500,39162564,37060064
430000.0,5,3.0,2500,5750,1.0,0,0,2,8,1430,1070,1999,0.0,98126,47.551,-122.369,1980,7130,3250,0.5652173913043478,6250000,33062500,26812500
799000.0,3,1.5,2210,6300,1.5,0,0,4,8,2210,0,1916,0.0,98144,47.5892,-122.29,2700,6300,4090,0.6492063492063492,4884100,39690000,34805900
880000.0,5,2.75,3020,9187,2.0,0,0,2,9,3020,0,2007,0.0,98033,47.6806,-122.167,2250,9675,6167,0.6712746271905954,9120400,84400969,75280569
750000.0,4,2.5,3290,7538,2.0,0,0,2,9,3290,0,2004,0.0,98075,47.598,-121.97200000000001,3450,7538,4248,0.5635447068187848,10824100,56821444,45997344
2890000.0,4,4.0,5780,7173,2.0,0,0,2,11,4130,1650,2008,0.0,98112,47.6374,-122.288,3930,7994,1393,0.19420047399972118,33408400,51451929,18043529
532000.0,3,2.5,1820,4910,2.0,0,0,2,8,1820,0,1993,0.0,98029,47.5703,-121.99600000000001,2090,6668,3090,0.6293279022403259,3312400,24108100,20795700
525000.0,4,2.75,2500,10330,1.0,0,0,3,8,1380,1120,1978,0.0,98155,47.7743,-122.286,2270,10430,7830,0.7579864472410455,6250000,106708900,100458900
239000.0,2,1.0,1210,9375,1.0,0,1,3,7,1210,0,1952,0.0,98198,47.3865,-122.322,1680,8400,8165,0.8709333333333333,1464100,87890625,86426525
460000.0,2,1.5,1090,4000,1.0,0,0,2,8,970,120,1951,0.0,98116,47.5798,-122.39299999999999,1700,4000,2910,0.7275,1188100,16000000,14811900
540000.0,4,2.25,1330,8400,1.5,0,0,2,8,1330,0,1962,0.0,98005,47.6078,-122.169,2270,10146,7070,0.8416666666666667,1768900,70560000,68791100
475000.0,2,1.0,890,4590,1.0,0,0,2,7,890,0,1923,0.0,98117,47.6901,-122.36200000000001,1310,4590,3700,0.8061002178649237,792100,21068100,20276000
445000.0,3,1.75,1360,4998,1.0,0,0,2,8,1360,0,1968,0.0,98108,47.547,-122.302,1350,4998,3638,0.7278911564625851,1849600,24980004,23130404
1580000.0,5,3.75,4220,9240,2.0,0,2,4,11,3420,800,1991,0.0,98040,47.5895,-122.229,3380,9240,5020,0.5432900432900433,17808400,85377600,67569200
549950.0,4,2.5,3780,6800,2.0,0,0,2,8,3780,0,2004,0.0,98038,47.3526,-122.012,3640,7326,3020,0.4441176470588235,14288400,46240000,31951600
294950.0,4,2.0,2610,14321,1.5,0,0,3,6,1690,920,1940,0.0,98188,47.4672,-122.296,1630,8599,11711,0.8177501571119336,6812100,205091041,198278941
736000.0,3,2.5,1980,2975,3.0,0,2,2,8,1980,0,1993,0.0,98109,47.6294,-122.344,1980,3144,995,0.334453781512605,3920400,8850625,4930225
214946.0,3,1.75,1290,8688,1.0,0,0,3,7,1290,0,1980,0.0,98042,47.3655,-122.08,1750,9090,7398,0.8515193370165746,1664100,75481344,73817244
856000.0,5,3.25,3620,5500,2.0,0,2,2,9,3620,0,2003,0.0,98029,47.5442,-121.99600000000001,3260,5500,1880,0.3418181818181818,13104400,30250000,17145600
775000.0,2,2.5,2680,7392,1.0,0,0,2,9,2680,0,2004,0.0,98053,47.717,-122.02600000000001,2315,7045,4712,0.6374458874458875,7182400,54641664,47459264
205000.0,3,1.75,1200,8631,1.0,0,0,2,7,1200,0,1959,0.0,98198,47.3864,-122.30799999999999,1564,8115,7431,0.8609662843239485,1440000,74494161,73054161
429592.0,2,2.75,1992,10946,1.5,0,4,4,6,1288,704,1903,0.0,98070,47.3551,-122.475,1110,8328,8954,0.8180157135026493,3968064,119814916,115846852
414250.0,4,1.75,1640,13566,1.0,0,0,3,7,1120,520,1977,0.0,98072,47.7423,-122.09899999999999,1470,13530,11926,0.879109538552263,2689600,184036356,181346756
399950.0,4,2.75,1920,4400,1.0,0,0,3,6,960,960,1906,0.0,98106,47.5532,-122.365,1040,4400,2480,0.5636363636363636,3686400,19360000,15673600
319990.0,3,2.25,1840,7326,1.0,0,0,4,7,1370,470,1979,0.0,98031,47.3958,-122.16799999999999,2050,7475,5486,0.7488397488397488,3385600,53670276,50284676
524000.0,3,1.5,1310,9471,1.0,0,0,3,8,1310,0,1970,0.0,98052,47.6644,-122.148,2100,9449,8161,0.8616830324147398,1716100,89699841,87983741
349950.0,2,1.0,1050,6317,1.5,0,0,3,7,1050,0,1913,0.0,98019,47.7364,-121.98100000000001,1600,9616,5267,0.8337818584771253,1102500,39904489,38801989
889000.0,4,2.5,2570,4480,1.5,0,0,3,8,1580,990,1927,0.0,98105,47.6701,-122.291,2070,4480,1910,0.4263392857142857,6604900,20070400,13465500
300000.0,3,1.0,930,5160,1.5,0,0,4,6,930,0,1919,0.0,98106,47.5256,-122.35700000000001,1060,5160,4230,0.8197674418604651,864900,26625600,25760700
395000.0,1,1.0,730,3000,1.0,0,0,2,7,730,0,1911,0.0,98107,47.6741,-122.396,1520,5000,2270,0.7566666666666667,532900,9000000,8467100
348000.0,2,2.5,1270,1242,3.0,0,0,2,7,1270,0,2008,0.0,98117,47.701,-122.36200000000001,1280,1199,-28,-0.02254428341384863,1612900,1542564,-70336
830000.0,2,1.0,1150,6000,1.0,0,1,3,7,710,440,1921,0.0,98033,47.6841,-122.213,2450,7200,4850,0.8083333333333333,1322500,36000000,34677500
173000.0,2,1.0,820,10450,1.0,0,0,3,7,820,0,1965,0.0,98055,47.4261,-122.199,1240,11200,9630,0.9215311004784689,672400,109202500,108530100
585000.0,4,1.75,3000,42200,1.0,0,3,2,7,1500,1500,1950,0.0,98056,47.5265,-122.20200000000001,2500,9821,39200,0.9289099526066351,9000000,1780840000,1771840000
576750.0,3,2.0,2220,5000,1.0,0,0,3,7,1110,1110,1966,0.0,98116,47.5807,-122.39399999999999,1450,5000,2780,0.556,4928400,25000000,20071600
495000.0,5,3.25,2500,7620,1.0,0,3,2,7,1250,1250,1962,0.0,98106,47.5298,-122.344,2020,7620,5120,0.6719160104986877,6250000,58064400,51814400
216650.0,3,3.5,1540,1427,2.0,0,0,2,7,1360,180,2007,0.0,98109,47.542,-122.322,1220,4000,-113,-0.07918710581639804,2371600,2036329,-335271
615000.0,4,2.75,2750,15450,1.0,0,0,2,8,1800,950,1978,0.0,98155,47.7749,-122.28299999999999,2750,10620,12700,0.8220064724919094,7562500,238702500,231140000
675000.0,4,2.5,3130,12463,1.0,0,0,3,8,1620,1510,1978,0.0,98006,47.568999999999996,-122.12700000000001,2740,11779,9333,0.7488566155821231,9796900,155326369,145529469
510000.0,3,2.0,1430,9250,1.0,0,0,3,8,990,440,1983,0.0,98052,47.6952,-122.096,1830,8003,7820,0.8454054054054054,2044900,85562500,83517600
630000.0,3,2.5,2680,327135,2.0,0,0,2,8,2680,0,1995,0.0,98010,47.3783,-122.00299999999999,2020,60080,324455,0.9918076635028352,7182400,107017308225,107010125825
359950.0,4,2.5,3010,5701,2.0,0,0,2,8,3010,0,2003,0.0,98042,47.3492,-122.152,3010,5772,2691,0.4720224522013682,9060100,32501401,23441301
265000.0,3,1.5,1530,7500,1.5,0,0,2,7,1530,0,1986,0.0,98038,47.3639,-122.055,2080,11250,5970,0.796,2340900,56250000,53909100
210000.0,3,1.0,1240,4842,1.0,0,0,3,6,1240,0,1916,0.0,98118,47.5166,-122.26899999999999,1540,5110,3602,0.7439074762494837,1537600,23444964,21907364
367000.0,3,2.5,2260,93218,1.0,0,2,3,6,2260,0,1998,0.0,98022,47.2582,-121.935,2180,111078,90958,0.9757557553262245,5107600,8689595524,8684487924
1080000.0,4,2.25,2820,5000,1.5,0,2,3,9,1800,1020,1926,0.0,98122,47.6097,-122.287,2880,6000,2180,0.436,7952400,25000000,17047600
756000.0,3,2.5,3560,8297,1.0,0,2,3,8,1650,1910,1948,0.0,98199,47.6473,-122.40700000000001,2760,8297,4737,0.5709292515367,12673600,68840209,56166609
203000.0,3,2.25,1630,9145,1.0,0,0,2,7,1630,0,1960,0.0,98146,47.5,-122.34700000000001,1630,9206,7515,0.8217605248769819,2656900,83631025,80974125
535000.0,4,2.5,2880,23994,2.0,0,3,2,9,2880,0,2002,0.0,98022,47.2124,-122.005,2470,17009,21114,0.8799699924981246,8294400,575712036,567417636
525000.0,3,3.25,2200,7440,2.0,0,0,3,7,1710,490,1947,0.0,98118,47.5409,-122.26799999999999,1260,6765,5240,0.7043010752688172,4840000,55353600,50513600
347500.0,3,1.75,1620,7500,1.0,0,0,2,7,1220,400,1981,0.0,98059,47.4815,-122.162,1470,7938,5880,0.784,2624400,56250000,53625600
620000.0,3,1.75,1480,2185,2.5,0,0,2,9,1480,0,2005,0.0,98034,47.6945,-122.17,1480,2441,705,0.32265446224256294,2190400,4774225,2583825
645000.0,4,2.5,2250,10696,2.0,0,0,2,8,2250,0,1996,0.0,98006,47.5715,-122.12799999999999,2340,13286,8446,0.7896409872849663,5062500,114404416,109341916
2200000.0,4,3.0,3540,11098,2.0,0,0,2,10,3000,0,1940,0.0,98112,47.63399999999999,-122.288,3430,8214,7558,0.6810236078572716,12531600,123165604,110634004
280000.0,3,2.0,1790,42399,1.0,0,0,3,7,1790,0,1990,0.0,98092,47.3143,-122.134,1330,40015,40609,0.9577820231609236,3204100,1797675201,1794471101
432000.0,3,2.0,1400,6380,1.0,0,0,3,7,700,700,1924,0.0,98125,47.7015,-122.316,1690,5800,4980,0.780564263322884,1960000,40704400,38744400
790000.0,3,1.5,2390,4452,2.0,0,1,2,9,1790,600,1929,0.0,98126,47.5826,-122.37799999999999,2610,5000,2062,0.46316262353998205,5712100,19820304,14108204
635000.0,4,1.75,2400,10050,1.0,0,0,4,8,2400,0,1957,0.0,98008,47.6339,-122.124,1680,10050,7650,0.7611940298507462,5760000,101002500,95242500
442000.0,3,1.5,2050,6384,1.0,0,0,2,7,1350,700,1958,0.0,98126,47.5325,-122.37799999999999,1590,7214,4334,0.6788847117794486,4202500,40755456,36552956
490000.0,4,3.0,2640,5267,2.0,0,0,2,7,2640,0,2001,0.0,98065,47.5298,-121.88,2640,5670,2627,0.49876590089234857,6969600,27741289,20771689
250000.0,5,1.75,2320,7700,1.0,0,0,4,7,1290,1030,1962,0.0,98001,47.3426,-122.285,1740,7210,5380,0.6987012987012987,5382400,59290000,53907600
1330000.0,4,2.5,2440,3600,2.5,0,0,3,8,2440,0,1902,0.0,98119,47.6298,-122.36200000000001,2440,5440,1160,0.32222222222222224,5953600,12960000,7006400
120000.0,3,1.0,1260,7500,1.0,0,0,2,6,1260,0,1954,0.0,98198,47.4191,-122.33,1260,7500,6240,0.832,1587600,56250000,54662400
2950000.0,5,4.75,6240,47480,1.0,0,3,2,11,4610,1630,2003,0.0,98040,47.5317,-122.23299999999999,4170,17668,41240,0.8685762426284751,38937600,2254350400,2215412800
325000.0,4,2.5,1930,8458,2.0,0,0,2,7,1930,0,1993,0.0,98038,47.3645,-122.039,1670,9485,6528,0.771813667533696,3724900,71537764,67812864
210000.0,4,1.75,1200,7680,1.0,0,0,2,7,1200,0,1968,0.0,98092,47.3138,-122.19200000000001,1490,7800,6480,0.84375,1440000,58982400,57542400
215000.0,1,1.0,970,7639,1.0,0,0,3,5,570,400,1920,0.0,98166,47.4655,-122.346,1360,7380,6669,0.8730200287995811,940900,58354321,57413421
387000.0,3,1.75,1810,10800,1.0,0,0,4,8,1210,600,1968,0.0,98056,47.5236,-122.184,1800,10800,8990,0.8324074074074074,3276100,116640000,113363900
408000.0,3,1.0,1380,7015,1.5,0,0,3,7,1380,0,1925,0.0,98117,47.6987,-122.36,1160,6700,5635,0.8032786885245902,1904400,49210225,47305825
410000.0,3,1.0,1470,6500,1.0,0,0,3,7,1470,0,1953,0.0,98166,47.473,-122.36200000000001,1470,9300,5030,0.7738461538461539,2160900,42250000,40089100
216000.0,3,1.0,1010,7920,1.0,0,0,2,6,1010,0,1925,0.0,98126,47.5249,-122.37,1520,7560,6910,0.8724747474747475,1020100,62726400,61706300
390000.0,3,1.0,1010,7920,1.0,0,0,2,6,1010,0,1925,0.0,98126,47.5249,-122.37,1520,7560,6910,0.8724747474747475,1020100,62726400,61706300
357000.0,3,1.5,1340,11744,1.0,0,0,1,7,1340,0,1950,0.0,98146,47.4947,-122.36,2020,13673,10404,0.885899182561308,1795600,137921536,136125936
215000.0,3,1.0,970,7275,1.0,0,0,3,7,970,0,1970,0.0,98031,47.4006,-122.18799999999999,1750,7200,6305,0.8666666666666667,940900,52925625,51984725
265000.0,3,1.0,1122,6554,1.5,0,0,2,5,1122,0,1900,0.0,98118,47.5135,-122.257,1610,5650,5432,0.828806835520293,1258884,42954916,41696032
589950.0,3,2.75,1670,1350,3.0,0,0,2,9,1350,320,2014,0.0,98116,47.5763,-122.40799999999999,1520,4800,-320,-0.23703703703703705,2788900,1822500,-966400
440000.0,3,1.75,2840,16851,1.0,0,3,2,8,1600,1240,1950,0.0,98155,47.7458,-122.287,2650,11063,14011,0.8314640080707376,8065600,283956201,275890601
248000.0,2,1.0,770,8600,1.0,0,0,3,4,770,0,1914,0.0,98027,47.5325,-122.031,1420,6960,7830,0.9104651162790698,592900,73960000,73367100
730000.0,3,2.25,2040,130680,2.0,0,0,2,9,2040,0,1977,0.0,98072,47.7584,-122.13600000000001,3080,39630,128640,0.9843893480257117,4161600,17077262400,17073100800
425000.0,4,2.5,3052,12145,2.0,0,0,2,8,3052,0,2004,0.0,98003,47.2598,-122.304,2767,8604,9093,0.7487031700288185,9314704,147501025,138186321
680000.0,3,2.5,2620,14248,2.0,0,0,3,8,1830,790,1977,0.0,98004,47.6281,-122.194,2620,12343,11628,0.8161145423919146,6864400,203005504,196141104
341500.0,5,2.25,3120,10400,2.0,0,0,2,8,3120,0,1980,0.0,98023,47.3097,-122.34,2160,8267,7280,0.7,9734400,108160000,98425600
395000.0,2,1.0,1100,3975,1.0,0,0,2,7,900,200,1950,0.0,98105,47.6701,-122.286,1110,4280,2875,0.7232704402515723,1210000,15800625,14590625
1230000.0,4,2.75,3410,95396,1.5,0,0,3,10,3410,0,1962,0.0,98005,47.6547,-122.15799999999999,3721,35352,91986,0.9642542664262652,11628100,9100396816,9088768716
695500.0,5,2.75,2510,9180,1.0,0,1,3,8,1600,910,1975,0.0,98052,47.6389,-122.098,2650,9780,6670,0.7265795206971678,6300100,84272400,77972300
308000.0,3,1.75,1680,8629,1.0,0,0,2,8,1200,480,1977,0.0,98198,47.3662,-122.319,1990,8400,6949,0.8053076833932089,2822400,74459641,71637241
422500.0,3,2.0,1960,6450,1.0,0,0,3,7,1000,960,1977,0.0,98038,47.3972,-122.029,1660,20720,4490,0.6961240310077519,3841600,41602500,37760900
418000.0,2,1.0,1040,6900,1.0,0,0,3,7,1040,0,1915,0.0,98136,47.5411,-122.391,1620,6280,5860,0.8492753623188406,1081600,47610000,46528400
385000.0,5,1.5,1750,9780,1.5,0,0,3,7,1750,0,1961,0.0,98028,47.7755,-122.235,1750,10295,8030,0.8210633946830266,3062500,95648400,92585900
876650.0,3,3.25,2170,12508,1.5,0,0,4,9,1650,520,1928,1970.0,98040,47.5665,-122.229,2720,21070,10338,0.8265110329389191,4708900,156450064,151741164
450000.0,3,2.5,1639,2710,2.0,0,0,2,8,1479,160,2003,0.0,98144,47.5924,-122.294,1580,1733,1071,0.39520295202952027,2686321,7344100,4657779
418800.0,4,2.25,2100,9984,1.0,0,0,3,7,1290,810,1973,0.0,98028,47.7365,-122.242,1930,10511,7884,0.7896634615384616,4410000,99680256,95270256
330000.0,2,1.0,880,1753,2.0,0,0,3,7,880,0,1945,0.0,98199,47.6475,-122.397,1010,1748,873,0.4980034227039361,774400,3073009,2298609
550000.0,3,1.75,1940,8376,1.0,0,0,3,8,1290,650,1963,0.0,98006,47.5586,-122.17299999999999,2400,8674,6436,0.768385864374403,3763600,70157376,66393776
270000.0,4,2.5,2490,11650,1.0,0,0,2,7,1390,1100,1990,0.0,98148,47.4416,-122.33200000000001,2010,10495,9160,0.7862660944206008,6200100,135722500,129522400
978500.0,3,2.25,2060,7080,2.0,0,0,2,9,1800,260,1940,0.0,98199,47.6455,-122.40899999999999,3070,7500,5020,0.7090395480225988,4243600,50126400,45882800
975000.0,4,2.5,2720,10455,2.0,0,2,2,10,2500,220,1981,0.0,98006,47.5564,-122.15799999999999,3240,12348,7735,0.7398373983739838,7398400,109307025,101908625
455000.0,3,2.25,2180,6850,1.0,0,0,2,7,1750,430,1973,0.0,98034,47.7246,-122.21700000000001,1740,7016,4670,0.6817518248175183,4752400,46922500,42170100
1420000.0,4,3.25,3600,38016,2.0,0,2,2,11,3310,290,1991,0.0,98034,47.7124,-122.25299999999999,2440,22693,34416,0.9053030303030303,12960000,1445216256,1432256256
220000.0,2,1.0,840,9000,1.0,0,0,4,6,840,0,1951,0.0,98168,47.5033,-122.329,1350,10400,8160,0.9066666666666666,705600,81000000,80294400
490000.0,3,2.0,2370,12196,2.0,0,0,3,7,2370,0,1970,0.0,98033,47.6734,-122.176,1380,12196,9826,0.805673991472614,5616900,148742416,143125516
420000.0,4,2.25,2270,9100,2.0,0,0,2,7,2270,0,1978,0.0,98034,47.7242,-122.17,1710,7910,6830,0.7505494505494505,5152900,82810000,77657100
408500.0,4,2.5,2720,7043,2.0,0,0,2,9,2720,0,2003,0.0,98092,47.3315,-122.169,2640,6958,4323,0.6138009371006673,7398400,49603849,42205449
716000.0,3,1.5,1140,4800,1.5,0,0,2,7,1140,0,1915,0.0,98109,47.6368,-122.354,1260,4800,3660,0.7625,1299600,23040000,21740400
965000.0,4,2.5,2460,5000,2.0,0,0,4,8,1620,840,1938,0.0,98112,47.6282,-122.29299999999999,2320,5000,2540,0.508,6051600,25000000,18948400
357823.0,3,1.5,1240,9196,1.0,0,0,2,8,1240,0,1968,0.0,98072,47.7562,-122.094,1690,10800,7956,0.8651587646802957,1537600,84566416,83028816
7060000.0,5,4.5,10040,37325,2.0,1,2,2,11,7680,2360,1940,2001.0,98004,47.65,-122.214,3930,25449,27285,0.7310113864701943,100801600,1393155625,1292354025
425000.0,3,2.25,1670,9500,1.0,0,0,2,7,1170,500,1977,0.0,98125,47.7253,-122.309,1470,9500,7830,0.8242105263157895,2788900,90250000,87461100
711777.0,4,1.75,2220,6731,1.0,0,0,3,7,1110,1110,1953,0.0,98116,47.5691,-122.391,1600,6350,4511,0.6701827365918883,4928400,45306361,40377961
335000.0,3,1.0,980,9903,1.0,0,0,3,7,980,0,1966,0.0,98028,47.7746,-122.23899999999999,1830,9903,8923,0.9010400888619611,960400,98069409,97109009
825000.0,4,1.5,1890,6938,1.5,0,0,2,8,1890,0,1919,0.0,98116,47.5896,-122.389,1700,6250,5048,0.727587200922456,3572100,48135844,44563744
210000.0,2,1.0,1100,6000,1.5,0,0,3,6,1100,0,1900,0.0,98108,47.5275,-122.323,1280,6000,4900,0.8166666666666667,1210000,36000000,34790000
575000.0,2,1.75,2770,19700,2.0,0,0,2,8,1780,990,1983,0.0,98177,47.7581,-122.365,2360,9700,16930,0.8593908629441624,7672900,388090000,380417100
1210000.0,4,2.75,4250,10925,2.0,0,0,2,10,4250,0,2003,0.0,98059,47.5297,-122.14,4650,11544,6675,0.6109839816933639,18062500,119355625,101293125
431500.0,2,2.0,1370,4866,1.0,0,0,2,8,1370,0,2005,0.0,98053,47.70399999999999,-122.012,1365,4784,3496,0.7184545828195643,1876900,23677956,21801056
475000.0,3,1.5,1480,13457,1.0,0,0,2,7,1480,0,1959,0.0,98007,47.5914,-122.13600000000001,2100,10517,11977,0.8900200639072602,2190400,181090849,178900449
1500000.0,4,3.75,3770,4000,2.5,0,0,4,9,2890,880,1916,0.0,98122,47.6157,-122.287,2800,5000,230,0.0575,14212900,16000000,1787100
540000.0,6,3.0,2870,206474,2.0,0,0,2,7,2330,540,1960,1985.0,98042,47.401,-122.095,2380,59677,203604,0.9860999447872372,8236900,42631512676,42623275776
775000.0,3,2.5,3820,35016,2.0,0,0,3,9,3820,0,1987,0.0,98053,47.6496,-122.041,3010,35190,31196,0.8909070139364862,14592400,1226120256,1211527856
635000.0,3,2.5,1530,2978,1.0,0,0,2,7,1210,320,1997,0.0,98117,47.6796,-122.39,1640,5100,1448,0.4862323707186031,2340900,8868484,6527584
1300000.0,3,2.75,4120,16365,1.0,0,2,2,12,4120,0,1999,0.0,98059,47.5265,-122.148,4020,14110,12245,0.7482432019553926,16974400,267813225,250838825
405000.0,3,2.25,1590,7267,1.0,0,0,3,7,1100,490,1976,0.0,98133,47.7457,-122.33200000000001,2060,8336,5677,0.7812026971239852,2528100,52809289,50281189
210000.0,3,1.0,1520,8600,1.0,0,0,2,6,1040,480,1951,0.0,98168,47.5134,-122.335,1320,8600,7080,0.8232558139534883,2310400,73960000,71649600
880000.0,4,2.5,2350,4675,2.0,0,0,2,9,2150,200,1923,0.0,98112,47.6344,-122.305,2240,3848,2325,0.49732620320855614,5522500,21855625,16333125
239000.0,4,2.0,1370,8837,1.5,0,0,2,7,1370,0,1955,0.0,98188,47.4386,-122.285,1360,9000,7467,0.8449700124476632,1876900,78092569,76215669
515000.0,3,2.5,1540,6100,1.0,0,0,2,6,770,770,1944,2014.0,98126,47.5696,-122.37799999999999,1710,5950,4560,0.7475409836065574,2371600,37210000,34838400
1380000.0,3,3.25,3786,38038,1.0,1,4,2,9,1934,1852,1978,2006.0,98070,47.3907,-122.448,2850,33361,34252,0.9004679530995321,14333796,1446889444,1432555648
215000.0,4,2.25,1500,5393,2.0,0,0,2,7,1500,0,1999,0.0,98001,47.3378,-122.262,1500,5952,3893,0.7218616725384758,2250000,29084449,26834449
315000.0,6,2.0,1750,17685,1.0,0,0,3,5,1750,0,1943,0.0,98056,47.5096,-122.178,1750,9209,15935,0.9010460842521911,3062500,312759225,309696725
442500.0,3,1.5,1800,8303,1.0,0,0,2,7,1200,600,1957,0.0,98133,47.7693,-122.35700000000001,1800,8171,6503,0.7832108876309768,3240000,68939809,65699809
311000.0,2,1.75,1180,55321,1.0,0,0,2,8,1180,0,1941,2004.0,98042,47.3329,-122.09100000000001,1480,56192,54141,0.9786699445057031,1392400,3060413041,3059020641
425000.0,2,1.0,830,6030,1.0,0,0,3,6,830,0,1925,0.0,98103,47.6994,-122.34700000000001,1280,6030,5200,0.8623548922056384,688900,36360900,35672000
433500.0,3,1.75,1540,9450,1.0,0,0,3,6,1040,500,1919,0.0,98103,47.6985,-122.348,1200,5400,7910,0.837037037037037,2371600,89302500,86930900
450000.0,3,2.25,1610,8296,2.0,0,0,2,8,1610,0,1978,0.0,98115,47.7,-122.29700000000001,1610,8288,6686,0.805930568948891,2592100,68823616,66231516
675000.0,3,2.25,1990,10260,2.0,0,0,3,8,1990,0,1987,0.0,98052,47.6801,-122.115,1990,10260,8270,0.8060428849902534,3960100,105267600,101307500
535000.0,3,2.5,2070,4132,2.0,0,0,2,8,2070,0,1999,0.0,98074,47.6036,-122.015,1530,5606,2062,0.4990319457889642,4284900,17073424,12788524
577000.0,3,1.75,1760,12874,1.0,0,0,3,7,1230,530,1967,0.0,98005,47.5906,-122.167,1950,10240,11114,0.8632903526487494,3097600,165739876,162642276
480000.0,3,1.75,1740,8528,1.0,0,0,3,7,1290,450,1939,0.0,98125,47.7097,-122.303,1610,8528,6788,0.7959662288930581,3027600,72726784,69699184
400000.0,3,1.5,1950,4473,1.0,0,0,3,6,1530,420,1914,0.0,98034,47.7094,-122.228,2670,14256,2523,0.5640509725016767,3802500,20007729,16205229
304000.0,3,1.0,1280,8184,1.5,0,0,3,6,1280,0,1947,0.0,98155,47.7467,-122.319,1120,8184,6904,0.8435972629521017,1638400,66977856,65339456
355000.0,3,1.75,1460,7203,1.0,0,0,2,7,1460,0,1990,0.0,98056,47.5049,-122.189,1570,7203,5743,0.7973066777731501,2131600,51883209,49751609
998000.0,4,3.25,3770,982998,2.0,0,0,2,10,3770,0,1992,0.0,98058,47.413999999999994,-122.087,2290,37141,979228,0.996164793824606,14212900,966285068004,966270855104
550000.0,4,1.75,2410,8447,2.0,0,3,3,8,2060,350,1936,1980.0,98074,47.6499,-122.088,2520,14789,6037,0.7146916064875104,5808100,71351809,65543709
550000.0,4,1.75,2410,8447,2.0,0,3,3,8,2060,350,1936,1980.0,98074,47.6499,-122.088,2520,14789,6037,0.7146916064875104,5808100,71351809,65543709
210000.0,3,1.75,1400,7300,2.0,0,0,2,6,1400,0,1948,0.0,98178,47.4999,-122.26799999999999,1440,10825,5900,0.8082191780821918,1960000,53290000,51330000
317000.0,3,2.5,2100,7587,2.0,0,0,2,9,2100,0,1990,0.0,98023,47.3072,-122.391,2330,8119,5487,0.723210755239225,4410000,57562569,53152569
700000.0,4,3.5,5360,25800,1.0,0,0,2,9,3270,2090,1971,0.0,98074,47.6099,-122.054,2650,21781,20440,0.7922480620155039,28729600,665640000,636910400
265000.0,3,1.0,1000,9150,1.0,0,0,2,7,1000,0,1969,0.0,98059,47.4829,-122.124,1490,10647,8150,0.8907103825136612,1000000,83722500,82722500
700000.0,4,3.5,3150,6175,2.0,0,0,2,9,3150,0,2001,0.0,98075,47.5966,-122.01700000000001,3150,6986,3025,0.4898785425101215,9922500,38130625,28208125
1020000.0,5,3.5,4180,17841,2.0,0,2,2,10,3160,1020,1990,0.0,98075,47.5618,-122.037,3260,12608,13661,0.7657082002129926,17472400,318301281,300828881
1150000.0,4,2.25,2840,20242,1.0,0,0,2,8,2240,600,1972,0.0,98004,47.638999999999996,-122.21600000000001,2840,20372,17402,0.8596976583341567,8065600,409738564,401672964
460000.0,4,2.5,2110,35091,1.0,0,0,3,8,1290,820,1985,0.0,98027,47.467,-122.014,2740,36427,32981,0.9398706220968339,4452100,1231378281,1226926181
410000.0,2,1.5,1660,4000,1.0,0,0,2,7,1000,660,1950,0.0,98115,47.6832,-122.304,1570,5500,2340,0.585,2755600,16000000,13244400
665000.0,4,3.0,2160,4400,1.0,0,0,4,7,1320,840,1921,0.0,98122,47.6163,-122.29299999999999,1430,4400,2240,0.509090909090909,4665600,19360000,14694400
600000.0,4,2.5,2420,7744,2.0,0,0,2,9,2420,0,1994,0.0,98056,47.534,-122.18,2820,11129,5324,0.6875,5856400,59969536,54113136
502000.0,4,1.75,1920,3844,1.0,0,0,2,7,1170,750,1967,0.0,98133,47.7041,-122.353,1480,3844,1924,0.5005202913631633,3686400,14776336,11089936
364950.0,4,2.5,2310,8030,2.0,0,0,2,7,2310,0,1978,0.0,98019,47.7433,-121.98200000000001,1780,8041,5720,0.7123287671232876,5336100,64480900,59144800
680000.0,3,2.25,2330,4000,1.5,0,2,4,7,1520,810,1927,0.0,98115,47.6732,-122.29,1870,4000,1670,0.4175,5428900,16000000,10571100
235500.0,5,2.5,2340,13713,1.0,0,0,1,8,1670,670,1967,0.0,98003,47.3307,-122.324,2080,11000,11373,0.8293590024064756,5475600,188046369,182570769
576000.0,4,2.5,2590,5756,2.0,0,0,2,8,2590,0,2001,0.0,98065,47.5356,-121.875,2620,6109,3166,0.5500347463516331,6708100,33131536,26423436
405000.0,2,3.0,1410,1240,2.0,0,0,2,8,1140,270,2006,0.0,98136,47.5221,-122.39,1410,1273,-170,-0.13709677419354838,1988100,1537600,-450500
335000.0,3,2.75,2850,8039,1.0,0,0,3,8,1540,1310,1989,0.0,98031,47.4141,-122.204,2240,7727,5189,0.6454782933200647,8122500,64625521,56503021
122000.0,2,1.0,730,6728,1.0,0,0,2,6,730,0,1953,0.0,98148,47.4275,-122.324,1170,7034,5998,0.8914982164090368,532900,45265984,44733084
432000.0,3,1.75,1470,6250,1.0,0,3,3,7,1070,400,1939,0.0,98155,47.7394,-122.288,2630,7050,4780,0.7648,2160900,39062500,36901600
375000.0,4,2.25,2330,11400,1.0,0,0,3,8,2330,0,1974,0.0,98058,47.4495,-122.148,2640,10200,9070,0.7956140350877193,5428900,129960000,124531100
276000.0,4,2.25,2460,11250,1.0,0,0,3,8,2460,0,1959,0.0,98002,47.3182,-122.212,1630,10216,8790,0.7813333333333333,6051600,126562500,120510900
450000.0,3,2.25,2080,111513,1.5,0,0,2,8,1680,400,1977,0.0,98072,47.7403,-122.11200000000001,2440,107157,109433,0.9813474662147015,4326400,12435149169,12430822769
210000.0,2,1.0,990,8140,1.0,0,0,0,6,990,0,1910,0.0,98116,47.5828,-122.382,2150,5000,7150,0.8783783783783784,980100,66259600,65279500
279000.0,3,2.5,1450,4106,2.0,0,0,2,7,1450,0,2011,0.0,98038,47.3655,-122.01899999999999,2000,4000,2656,0.6468582562104238,2102500,16859236,14756736
635000.0,3,1.75,1340,3900,2.0,0,0,4,7,1340,0,1900,0.0,98107,47.6711,-122.37899999999999,1470,1611,2560,0.6564102564102564,1795600,15210000,13414400
350000.0,3,2.5,2730,7372,2.0,0,0,2,9,2730,0,1998,0.0,98023,47.2831,-122.346,2710,8343,4642,0.6296798697775366,7452900,54346384,46893484
218000.0,3,1.0,1140,7560,1.0,0,0,3,6,1140,0,1958,0.0,98058,47.4624,-122.185,1300,7560,6420,0.8492063492063492,1299600,57153600,55854000
750000.0,4,1.5,1950,6300,1.5,0,1,2,7,1650,300,1944,0.0,98115,47.6819,-122.271,1760,6300,4350,0.6904761904761905,3802500,39690000,35887500
310597.0,4,1.75,2000,25700,1.0,0,0,3,7,1150,850,1958,0.0,98023,47.32,-122.36200000000001,2420,27500,23700,0.9221789883268483,4000000,660490000,656490000
355000.0,3,1.0,900,37800,1.0,0,0,3,5,700,200,1923,0.0,98034,47.7146,-122.234,1750,11998,36900,0.9761904761904762,810000,1428840000,1428030000
735000.0,5,2.75,3390,5211,2.0,0,0,2,9,3390,0,2004,0.0,98075,47.5977,-121.98100000000001,3210,5211,1821,0.3494530800230282,11492100,27154521,15662421
155000.0,1,1.0,720,6000,1.0,0,0,2,6,720,0,1940,0.0,98108,47.5266,-122.316,1040,6000,5280,0.88,518400,36000000,35481600
354000.0,3,1.0,940,10368,1.0,0,0,2,7,940,0,1965,0.0,98052,47.6608,-122.133,2090,9620,9428,0.9093364197530864,883600,107495424,106611824
415000.0,3,1.75,1770,10513,1.0,0,0,3,7,1400,370,1982,0.0,98028,47.7726,-122.266,2070,9968,8743,0.8316370208313517,3132900,110523169,107390269
202000.0,1,1.0,590,833,1.0,0,0,3,7,590,0,1926,0.0,98122,47.6082,-122.29899999999999,780,1617,243,0.2917166866746699,348100,693889,345789
580000.0,3,2.5,1980,1873,2.0,0,0,2,7,1470,510,1996,0.0,98107,47.6659,-122.369,1500,1873,-107,-0.057127602776294716,3920400,3508129,-412271
1500000.0,4,3.25,3070,10375,2.0,0,0,2,10,2180,890,1962,2005.0,98004,47.5862,-122.198,2500,11194,7305,0.7040963855421687,9424900,107640625,98215725
790000.0,4,2.5,3500,7519,2.0,0,0,2,9,3500,0,2004,0.0,98053,47.6799,-122.024,3920,7982,4019,0.5345125681606596,12250000,56535361,44285361
499900.0,3,2.5,2100,5112,2.0,0,0,2,8,2100,0,1999,0.0,98065,47.5338,-121.867,2100,4370,3012,0.5892018779342723,4410000,26132544,21722544
525000.0,4,2.25,2620,98881,1.0,0,0,2,7,1820,800,1952,0.0,98070,47.4662,-122.45299999999999,1728,95832,96261,0.9735035042121338,6864400,9777452161,9770587761
810000.0,4,2.5,2810,10613,2.0,0,0,2,9,2810,0,1989,0.0,98006,47.5424,-122.141,2800,9933,7803,0.7352303778385,7896100,112635769,104739669
425000.0,4,1.5,2290,8773,1.0,0,0,3,7,1330,960,1947,0.0,98133,47.7173,-122.33,1740,7058,6483,0.7389718454348569,5244100,76965529,71721429
241250.0,3,1.75,1350,7588,1.0,0,0,2,7,1350,0,1993,0.0,98010,47.3123,-122.023,1470,7341,6238,0.8220875065893516,1822500,57577744,55755244
318700.0,4,2.5,2770,19116,1.0,0,0,3,8,1600,1170,1961,0.0,98003,47.3386,-122.319,2730,18429,16346,0.8550952082025528,7672900,365421456,357748556
720000.0,4,1.75,2530,5000,1.5,0,2,4,8,2070,460,1917,0.0,98103,47.6624,-122.348,1950,3600,2470,0.494,6400900,25000000,18599100
291000.0,3,1.0,1280,10500,1.5,0,0,3,5,1280,0,1941,0.0,98024,47.566,-121.89399999999999,1410,10500,9220,0.878095238095238,1638400,110250000,108611600
420000.0,3,1.75,1060,38644,1.0,0,0,2,7,1060,0,1983,0.0,98077,47.7442,-122.072,1310,11416,37584,0.9725701273160129,1123600,1493358736,1492235136
210000.0,2,1.75,1000,3554,1.0,0,0,3,8,1000,0,1975,0.0,98198,47.3811,-122.32,1150,4000,2554,0.7186268992684299,1000000,12630916,11630916
645000.0,3,3.25,3870,11000,2.0,0,2,2,9,2970,900,1991,0.0,98106,47.5545,-122.354,2970,11000,7130,0.6481818181818182,14976900,121000000,106023100
762000.0,5,2.0,3370,5000,1.5,0,0,3,7,2140,1230,1907,0.0,98109,47.6373,-122.35,1920,3200,1630,0.326,11356900,25000000,13643100
247500.0,4,1.75,2290,7765,1.0,0,0,2,6,2290,0,1936,1953.0,98146,47.4997,-122.353,1240,8215,5475,0.7050869285254346,5244100,60295225,55051125
282500.0,3,2.25,1670,7150,2.0,0,0,3,7,1670,0,1990,0.0,98042,47.3603,-122.088,1570,7040,5480,0.7664335664335664,2788900,51122500,48333600
395000.0,3,1.75,1460,22651,1.0,0,0,3,7,1460,0,1961,0.0,98027,47.4861,-122.03,2030,49222,21191,0.9355436846055362,2131600,513067801,510936201
295000.0,3,1.75,1770,8235,1.0,0,0,2,7,1030,740,1960,0.0,98148,47.4323,-122.32799999999999,1560,8918,6465,0.785063752276867,3132900,67815225,64682325
235000.0,2,1.0,820,5100,1.0,0,0,3,6,820,0,1954,0.0,98056,47.5175,-122.205,2270,5100,4280,0.8392156862745098,672400,26010000,25337600
770000.0,3,1.75,1900,6334,1.0,0,2,2,8,1450,450,1948,0.0,98105,47.6675,-122.27600000000001,1530,6334,4434,0.7000315756236186,3610000,40119556,36509556
559950.0,2,2.0,1870,4950,1.0,0,0,2,8,1870,0,2006,0.0,98053,47.7195,-122.022,1670,4800,3080,0.6222222222222222,3496900,24502500,21005600
639000.0,4,2.0,1840,5419,1.0,0,0,3,7,920,920,1942,0.0,98199,47.6483,-122.404,1800,5419,3579,0.6604539582948884,3385600,29365561,25979961
314950.0,3,1.0,1590,8470,1.0,0,0,3,7,1140,450,1967,0.0,98058,47.4473,-122.15899999999999,1570,9375,6880,0.8122786304604487,2528100,71740900,69212800
525000.0,3,1.0,1640,6180,1.0,0,0,3,7,1640,0,1946,0.0,98118,47.5682,-122.28399999999999,1540,6180,4540,0.7346278317152104,2689600,38192400,35502800
2400000.0,3,2.25,3000,11665,1.5,1,4,2,11,3000,0,2001,0.0,98075,47.5884,-122.086,3000,15959,8665,0.7428204029147021,9000000,136072225,127072225
820000.0,3,1.75,2160,6272,1.0,0,0,3,8,1390,770,1960,0.0,98115,47.6777,-122.306,1290,5376,4112,0.6556122448979592,4665600,39337984,34672384
1390000.0,3,3.0,2490,3600,2.0,0,3,3,8,1790,700,1911,0.0,98119,47.6313,-122.369,2490,3600,1110,0.30833333333333335,6200100,12960000,6759900
521450.0,3,2.0,1290,5700,1.0,0,0,4,7,1290,0,1950,0.0,98116,47.5713,-122.397,1160,5700,4410,0.7736842105263158,1664100,32490000,30825900
760750.0,3,2.5,3190,49137,2.0,0,0,2,9,3190,0,1988,0.0,98074,47.6027,-122.04299999999999,3240,53143,45947,0.9350794716812179,10176100,2414444769,2404268669
759600.0,4,1.0,1540,115434,1.5,0,0,3,7,1540,0,1923,0.0,98031,47.4163,-122.22,2027,23522,113894,0.9866590432628168,2371600,13325008356,13322636756
346150.0,3,2.0,2140,7200,1.0,0,0,3,8,1480,660,1966,0.0,98056,47.5084,-122.185,2070,7220,5060,0.7027777777777777,4579600,51840000,47260400
390000.0,2,1.0,980,3800,1.0,0,0,2,7,980,0,1926,0.0,98103,47.6903,-122.34,1520,5010,2820,0.7421052631578947,960400,14440000,13479600
359950.0,5,2.25,2450,9432,2.0,0,0,2,8,2450,0,1973,0.0,98058,47.4519,-122.13,2310,9100,6982,0.7402459711620017,6002500,88962624,82960124
430000.0,3,2.0,1360,5120,1.5,0,0,3,6,910,450,1924,0.0,98116,47.5587,-122.39299999999999,1440,5120,3760,0.734375,1849600,26214400,24364800
960000.0,4,3.5,4610,11676,2.0,0,0,2,10,4610,0,2000,0.0,98075,47.6011,-121.98299999999999,3900,11164,7066,0.60517300445358,21252100,136328976,115076876
800000.0,7,6.75,7480,41664,2.0,0,2,2,11,5080,2400,1953,0.0,98166,47.4643,-122.368,2810,33190,34184,0.820468509984639,55950400,1735888896,1679938496
1010000.0,3,2.5,2860,5805,2.0,0,0,2,9,2860,0,1999,0.0,98005,47.6218,-122.16,2360,5832,2945,0.5073212747631353,8179600,33698025,25518425
290000.0,3,2.0,1810,11456,1.0,0,0,2,7,1810,0,1970,0.0,98045,47.4648,-121.756,1360,12931,9646,0.8420041899441341,3276100,131239936,127963836
1350000.0,4,2.0,2240,10296,1.0,0,0,4,8,2240,0,1948,0.0,98004,47.6177,-122.21700000000001,2500,10918,8056,0.7824397824397824,5017600,106007616,100990016
777000.0,3,3.25,3610,59677,2.0,0,0,2,10,2440,1170,2003,0.0,98027,47.5464,-122.088,3130,65775,56067,0.9395076830269619,13032100,3561344329,3548312229
526000.0,2,1.0,1450,4500,1.5,0,0,3,7,1450,0,1921,0.0,98107,47.6739,-122.396,1470,5000,3050,0.6777777777777778,2102500,20250000,18147500
550000.0,3,3.5,1450,1091,2.0,0,0,2,8,1200,250,2007,0.0,98119,47.6475,-122.359,1490,3017,-359,-0.3290559120073327,2102500,1190281,-912219
276000.0,3,1.5,1820,8750,1.0,0,0,3,7,1200,620,1958,0.0,98198,47.4213,-122.322,1500,8000,6930,0.792,3312400,76562500,73250100
2500000.0,5,3.25,5620,12672,2.0,0,0,3,11,4140,1480,1916,0.0,98144,47.5786,-122.287,4470,8050,7052,0.5565025252525253,31584400,160579584,128995184
325000.0,3,1.75,2080,6554,1.0,0,0,2,7,1040,1040,1950,0.0,98118,47.5135,-122.257,1230,5650,4474,0.682636557827281,4326400,42954916,38628516
365000.0,3,2.5,1780,1754,3.0,0,0,2,8,1780,0,2007,0.0,98126,47.548,-122.37299999999999,1780,1607,-26,-0.014823261117445839,3168400,3076516,-91884
2150000.0,8,6.0,4340,9415,2.0,0,0,2,8,4340,0,1967,0.0,98004,47.6316,-122.20200000000001,2050,9100,5075,0.5390334572490706,18835600,88642225,69806625
825050.0,4,3.25,2860,3680,2.0,0,0,2,9,1980,880,1925,1993.0,98115,47.6752,-122.3,2010,3680,820,0.22282608695652173,8179600,13542400,5362800
690000.0,3,1.5,2540,9520,1.0,0,0,2,8,1500,1040,1959,0.0,98115,47.6834,-122.306,1870,6800,6980,0.7331932773109243,6451600,90630400,84178800
390000.0,4,1.0,1140,6250,1.5,0,0,2,6,1140,0,1958,0.0,98126,47.5433,-122.375,1140,1370,5110,0.8176,1299600,39062500,37762900
385000.0,3,2.0,1320,1297,3.0,0,0,2,7,1320,0,1995,0.0,98117,47.6959,-122.376,1380,1503,-23,-0.017733230531996914,1742400,1682209,-60191
619000.0,3,2.5,2040,7503,2.0,0,0,2,8,2040,0,1987,0.0,98029,47.5718,-122.021,2170,7503,5463,0.728108756497401,4161600,56295009,52133409
494000.0,4,2.25,1790,42000,1.0,0,0,2,7,1170,620,1983,0.0,98045,47.4819,-121.744,2060,50094,40210,0.9573809523809523,3204100,1764000000,1760795900
412450.0,3,2.0,1910,13505,1.0,0,0,2,8,1910,0,1955,0.0,98034,47.7114,-122.23,2010,8000,11595,0.8585708996667901,3648100,182385025,178736925
580000.0,3,1.75,1460,2800,2.0,0,0,2,7,1460,0,1928,0.0,98117,47.6779,-122.37100000000001,1220,4062,1340,0.4785714285714286,2131600,7840000,5708400
269900.0,3,1.5,1420,22100,1.0,0,0,4,7,1420,0,1957,0.0,98042,47.4193,-122.149,1540,21780,20680,0.9357466063348416,2016400,488410000,486393600
704300.0,4,1.5,1790,4080,1.5,0,0,4,7,1790,0,1928,0.0,98144,47.5749,-122.291,1710,4080,2290,0.5612745098039216,3204100,16646400,13442300
267000.0,3,2.0,1390,6005,2.0,0,0,2,8,1390,0,2005,0.0,98022,47.2117,-121.99,1264,5550,4615,0.768526228143214,1932100,36060025,34127925
310000.0,4,1.75,1880,12150,1.0,0,0,2,7,1280,600,1976,0.0,98023,47.3272,-122.363,1980,9680,10270,0.8452674897119341,3534400,147622500,144088100
227064.0,3,1.5,1570,10824,2.0,0,0,2,7,1570,0,1908,0.0,98118,47.54,-122.275,1530,8125,9254,0.8549519586104952,2464900,117158976,114694076
925000.0,3,2.5,2690,7000,2.0,0,0,4,7,1840,850,1943,0.0,98115,47.6784,-122.277,1800,6435,4310,0.6157142857142858,7236100,49000000,41763900
245000.0,3,1.75,1670,11452,1.0,0,2,2,8,1670,0,1992,0.0,98022,47.1913,-122.015,1820,11152,9782,0.8541739434159972,2788900,131148304,128359404
339888.0,3,1.0,1040,7490,1.0,0,0,2,7,1040,0,1969,0.0,98034,47.7137,-122.213,1520,7410,6450,0.8611481975967957,1081600,56100100,55018500
439000.0,4,2.0,1560,7500,1.0,0,0,3,7,1560,0,1968,0.0,98034,47.7281,-122.181,1730,7500,5940,0.792,2433600,56250000,53816400
400000.0,2,1.0,1470,6120,1.0,0,0,1,7,1470,0,1940,0.0,98115,47.6914,-122.287,1840,6120,4650,0.7598039215686274,2160900,37454400,35293500
560000.0,3,2.25,2070,15002,1.5,0,0,2,8,2070,0,1955,2013.0,98155,47.7635,-122.274,2070,15002,12932,0.8620183975469937,4284900,225060004,220775104
703011.0,2,1.0,1370,5922,1.0,0,2,2,8,1130,240,1941,0.0,98199,47.6473,-122.406,2460,6759,4552,0.7686592367443431,1876900,35070084,33193184
363000.0,2,1.0,1120,4800,1.0,0,0,2,7,770,0,1926,0.0,98126,47.5669,-122.37200000000001,1510,4800,3680,0.7666666666666667,1254400,23040000,21785600
650000.0,4,2.75,2640,6240,2.0,0,0,2,9,2640,0,2001,0.0,98075,47.5788,-122.059,2640,5898,3600,0.5769230769230769,6969600,38937600,31968000
299950.0,3,1.0,1030,9916,1.0,0,0,3,7,1030,0,1972,0.0,98034,47.7218,-122.176,1470,9044,8886,0.8961274707543364,1060900,98327056,97266156
228950.0,3,1.0,1120,6625,1.0,0,0,2,6,1120,0,1942,0.0,98168,47.4879,-122.33200000000001,1120,6794,5505,0.8309433962264151,1254400,43890625,42636225
465000.0,4,1.75,1730,11700,1.0,0,0,2,7,880,850,1956,0.0,98008,47.6031,-122.13,1570,7820,9970,0.8521367521367521,2992900,136890000,133897100
725000.0,3,2.5,2090,9847,2.0,0,2,2,9,2090,0,1983,0.0,98006,47.5651,-122.11399999999999,2860,11483,7757,0.7877526150096477,4368100,96963409,92595309
212500.0,3,1.0,920,14400,1.0,0,0,3,7,920,0,1977,0.0,98001,47.2816,-122.26899999999999,1170,9600,13480,0.9361111111111111,846400,207360000,206513600
526000.0,4,2.25,2970,54450,2.0,0,0,2,8,2970,0,1983,1998.0,98058,47.4338,-122.146,2260,6465,51480,0.9454545454545454,8820900,2964802500,2955981600
383000.0,3,2.5,1720,10031,2.0,0,0,2,8,1720,0,1993,0.0,98028,47.7688,-122.238,2280,5845,8311,0.8285315521882165,2958400,100620961,97662561
244000.0,3,1.75,1460,4692,1.0,0,0,2,7,1460,0,1988,0.0,98055,47.472,-122.19200000000001,1600,4557,3232,0.6888320545609549,2131600,22014864,19883264
565000.0,3,1.5,1540,3570,1.5,0,0,4,7,1490,50,1930,0.0,98105,47.6692,-122.325,1620,4080,2030,0.5686274509803921,2371600,12744900,10373300
373000.0,8,3.0,2850,12714,1.0,0,0,2,7,2850,0,1959,0.0,98055,47.4859,-122.205,1480,4942,9864,0.7758376592732421,8122500,161645796,153523296
300000.0,3,2.0,1310,9855,1.0,0,0,2,7,1310,0,1962,0.0,98034,47.7296,-122.241,1310,8370,8545,0.8670725520040589,1716100,97121025,95404925
405000.0,5,2.5,2430,4781,2.0,0,0,2,9,2430,0,2001,0.0,98058,47.4487,-122.117,2420,4770,2351,0.4917381300983058,5904900,22857961,16953061
979000.0,3,1.5,1700,14133,1.0,0,1,3,8,1700,0,1954,0.0,98004,47.6166,-122.22,2630,17376,12433,0.8797141442015142,2890000,199741689,196851689
324888.0,4,1.75,2160,28750,2.0,0,0,3,8,2160,0,1978,0.0,98092,47.3212,-122.118,1790,53578,26590,0.9248695652173913,4665600,826562500,821896900
445000.0,3,1.5,860,3200,1.0,0,0,2,6,860,0,1929,0.0,98117,47.6791,-122.36200000000001,1220,4300,2340,0.73125,739600,10240000,9500400
761000.0,3,3.5,2050,2020,2.0,0,0,2,8,1520,530,2006,0.0,98112,47.6235,-122.306,1230,3640,-30,-0.01485148514851485,4202500,4080400,-122100
435000.0,4,2.0,1650,4745,1.0,0,0,2,7,1130,520,1972,0.0,98034,47.7359,-122.18,1650,5184,3095,0.6522655426765016,2722500,22515025,19792525
252000.0,3,2.25,1570,8410,1.0,0,0,2,7,1180,390,1991,0.0,98022,47.1942,-121.99,1540,8410,6840,0.8133174791914387,2464900,70728100,68263200
350000.0,3,1.75,1660,10150,1.5,0,0,2,7,1660,0,1957,0.0,98133,47.7512,-122.34200000000001,1640,8906,8490,0.8364532019704434,2755600,103022500,100266900
875000.0,3,1.0,1220,8119,1.0,0,0,3,7,1220,0,1955,0.0,98039,47.6328,-122.236,1910,8119,6899,0.8497351890626924,1488400,65918161,64429761
940000.0,3,1.0,1220,8119,1.0,0,0,3,7,1220,0,1955,0.0,98039,47.6328,-122.236,1910,8119,6899,0.8497351890626924,1488400,65918161,64429761
280000.0,3,2.0,1780,11342,1.0,0,0,2,7,1780,0,1964,0.0,98148,47.4617,-122.32700000000001,2140,8449,9562,0.8430611885029096,3168400,128640964,125472564
450000.0,3,2.5,2180,4226,2.0,0,0,2,8,2180,0,2004,0.0,98011,47.7733,-122.226,2540,4607,2046,0.4841457643161382,4752400,17859076,13106676
905000.0,3,2.5,3520,237402,2.5,0,0,2,9,3520,0,2004,0.0,98092,47.2687,-122.056,2310,165963,233882,0.9851728292095264,12390400,56359709604,56347319204
382450.0,3,2.5,2220,20531,2.0,0,0,2,8,2220,0,1998,0.0,98001,47.2864,-122.264,2420,19249,18311,0.8918708294773757,4928400,421521961,416593561
246700.0,3,2.0,1610,13309,1.0,0,0,3,7,1610,0,1967,0.0,98042,47.3398,-122.133,1610,15725,11699,0.8790292283417237,2592100,177129481,174537381
220000.0,3,1.5,1070,9331,1.0,0,0,2,6,1070,0,1956,0.0,98155,47.7633,-122.31299999999999,1480,8400,8261,0.8853284749758868,1144900,87067561,85922661
555750.0,3,1.0,1060,4880,1.0,0,0,1,6,910,150,1913,0.0,98118,47.5545,-122.288,1200,4880,3820,0.7827868852459017,1123600,23814400,22690800
262500.0,3,1.5,1160,8906,1.0,0,0,2,7,1160,0,1962,0.0,98118,47.5362,-122.29,1160,8906,7746,0.8697507298450483,1345600,79316836,77971236
515000.0,2,1.0,910,4725,1.0,0,0,2,7,910,0,1949,0.0,98115,47.676,-122.281,1600,5200,3815,0.8074074074074075,828100,22325625,21497525
499500.0,3,2.5,2970,21907,2.0,0,0,2,9,2970,0,1998,0.0,98059,47.4741,-122.09899999999999,2040,27917,18937,0.8644268955128498,8820900,479916649,471095749
135000.0,1,1.0,790,13062,1.0,0,0,2,6,790,0,1942,0.0,98168,47.4919,-122.311,1240,7137,12272,0.9395192160465472,624100,170615844,169991744
462500.0,2,2.0,1540,7290,2.0,0,0,2,7,1540,0,1948,1983.0,98136,47.551,-122.395,1540,7072,5750,0.7887517146776406,2371600,53144100,50772500
937500.0,4,2.5,3130,21100,1.0,0,4,2,9,2530,600,1956,0.0,98177,47.7598,-122.37200000000001,3680,23000,17970,0.8516587677725118,9796900,445210000,435413100
458000.0,3,1.5,1470,9570,1.0,0,0,2,7,1280,190,1941,0.0,98125,47.7032,-122.306,1390,9570,8100,0.8463949843260188,2160900,91584900,89424000
845000.0,4,2.75,3160,7143,1.5,0,0,2,8,2100,1060,1933,0.0,98199,47.6513,-122.406,2200,6122,3983,0.5576088478230435,9985600,51022449,41036849
660000.0,3,2.25,2675,40910,2.0,0,0,2,8,2675,0,1984,0.0,98075,47.5916,-122.055,2300,39438,38235,0.9346125641652407,7155625,1673628100,1666472475
265000.0,3,2.0,1340,6783,1.0,0,0,3,7,1340,0,1987,0.0,98030,47.3504,-122.177,1630,6458,5443,0.8024472947073567,1795600,46009089,44213489
599999.0,9,4.5,3830,6988,2.5,0,0,2,7,2450,1380,1938,0.0,98103,47.6927,-122.338,1460,6291,3158,0.4519175729822553,14668900,48832144,34163244
280000.0,3,2.5,1800,8697,2.0,0,0,2,8,1800,0,1987,0.0,98023,47.3115,-122.4,1770,8390,6897,0.7930320800275957,3240000,75637809,72397809
1060000.0,3,3.25,2990,189852,2.0,0,0,3,10,2990,0,1974,0.0,98072,47.746,-122.13799999999999,3500,48760,186862,0.9842508901670776,8940100,36043781904,36034841804
875000.0,4,3.0,3720,14125,1.0,0,0,3,9,1930,1790,1960,0.0,98005,47.5911,-122.177,3160,15300,10405,0.736637168141593,13838400,199515625,185677225
125000.0,3,1.0,920,7276,1.0,0,0,3,6,920,0,1961,0.0,98002,47.285,-122.211,1120,7276,6356,0.8735568993952721,846400,52940176,52093776
634800.0,4,3.0,3280,4904,2.0,0,0,2,7,3280,0,2005,0.0,98053,47.6802,-122.03299999999999,2600,5004,1624,0.33115823817292006,10758400,24049216,13290816
269950.0,4,1.0,1440,9600,1.0,0,0,1,7,1440,0,1964,0.0,98001,47.3168,-122.264,1740,43560,8160,0.85,2073600,92160000,90086400
359950.0,3,2.25,1940,11612,1.0,0,0,3,8,1100,840,1981,0.0,98178,47.5018,-122.23,2180,8954,9672,0.8329314502239064,3763600,134838544,131074944
417000.0,3,1.75,1590,11454,1.0,0,0,3,8,1590,0,1979,0.0,98056,47.5049,-122.186,1970,9960,9864,0.8611838658983761,2528100,131194116,128666016
389000.0,2,2.0,1340,4122,1.0,0,0,2,8,1340,0,2007,0.0,98053,47.7182,-122.022,1350,4273,2782,0.6749150897622513,1795600,16990884,15195284
1040000.0,4,2.5,3770,10893,2.0,0,2,2,11,3770,0,1997,0.0,98006,47.5646,-122.12899999999999,3710,9685,7123,0.6539061782796292,14212900,118657449,104444549
698000.0,6,2.5,2680,11250,1.0,0,0,4,7,1340,1340,1967,0.0,98033,47.6553,-122.19,2200,9875,8570,0.7617777777777778,7182400,126562500,119380100
685000.0,4,2.5,2820,10125,2.0,0,0,2,8,2820,0,2008,0.0,98155,47.7494,-122.304,1560,10125,7305,0.7214814814814815,7952400,102515625,94563225
198500.0,3,1.75,1520,7137,1.0,0,0,2,5,1520,0,1932,0.0,98168,47.4924,-122.311,1240,8602,5617,0.7870253607958526,2310400,50936769,48626369
350000.0,4,2.5,2560,5428,2.0,0,0,2,8,2560,0,2012,0.0,98042,47.3835,-122.095,2620,5428,2868,0.5283714075165807,6553600,29463184,22909584
649950.0,3,2.5,3310,387684,1.0,0,0,2,8,2160,1150,1919,1996.0,98038,47.4167,-121.936,2340,189050,384374,0.9914621186327008,10956100,150298883856,150287927756
441000.0,3,1.5,1540,7200,1.0,0,0,2,7,1540,0,1968,0.0,98011,47.7357,-122.195,1560,7500,5660,0.7861111111111111,2371600,51840000,49468400
462600.0,3,1.75,1430,11761,1.0,0,0,3,8,1430,0,1964,0.0,98052,47.6686,-122.15700000000001,2040,10035,10331,0.8784116996854009,2044900,138321121,136276221
365070.0,4,2.5,2506,6232,2.0,0,0,2,7,2506,0,2006,0.0,98030,47.3734,-122.182,2070,8260,3726,0.5978818998716303,6280036,38837824,32557788
550000.0,4,2.0,2250,7500,1.0,0,0,4,7,1200,1050,1956,0.0,98005,47.5877,-122.15700000000001,1440,7500,5250,0.7,5062500,56250000,51187500
470000.0,5,1.75,2740,9600,1.0,0,0,3,7,1370,1370,1945,0.0,98144,47.5738,-122.315,1990,4800,6860,0.7145833333333333,7507600,92160000,84652400
340000.0,3,1.75,1540,10400,1.0,0,0,2,6,1540,0,1977,0.0,98024,47.5651,-121.89,1090,7500,8860,0.8519230769230769,2371600,108160000,105788400
910000.0,4,2.75,4190,38912,1.0,0,0,3,9,2040,2150,1965,0.0,98005,47.6472,-122.15700000000001,3050,36884,34722,0.892321134868421,17556100,1514143744,1496587644
405000.0,4,1.75,1690,8392,1.0,0,0,2,7,1190,500,1979,0.0,98028,47.773,-122.256,1880,9861,6702,0.7986177311725453,2856100,70425664,67569564
661000.0,4,2.25,1990,4600,1.5,0,2,3,8,1420,570,1932,0.0,98126,47.5638,-122.38,1810,5750,2610,0.5673913043478261,3960100,21160000,17199900
635000.0,4,2.5,2410,7069,2.0,0,0,2,9,2410,0,1993,0.0,98034,47.7094,-122.234,2240,7184,4659,0.6590748337812986,5808100,49970761,44162661
282000.0,2,1.0,1150,6098,1.0,0,0,2,7,950,200,1948,0.0,98125,47.7259,-122.32799999999999,1790,8455,4948,0.811413578222368,1322500,37185604,35863104
235000.0,4,1.75,1720,10137,2.0,0,0,2,7,1720,0,1956,0.0,98188,47.4424,-122.27600000000001,1350,10205,8417,0.8303245536154681,2958400,102758769,99800369
277500.0,3,2.0,1260,22100,2.0,0,0,3,7,1260,0,1981,0.0,98023,47.2772,-122.354,1430,13000,20840,0.9429864253393665,1587600,488410000,486822400
346500.0,5,2.5,2020,8250,1.0,0,0,3,8,1430,590,1978,0.0,98058,47.4432,-122.135,1680,8959,6230,0.7551515151515151,4080400,68062500,63982100
480000.0,5,2.25,2240,5500,1.0,0,0,2,7,1490,750,1959,0.0,98136,47.5305,-122.391,2010,6050,3260,0.5927272727272728,5017600,30250000,25232400
360000.0,4,2.25,1930,6508,2.0,0,0,2,8,1930,0,1996,0.0,98019,47.7458,-121.977,2170,6548,4578,0.7034419176398279,3724900,42354064,38629164
245000.0,3,2.5,1820,6785,1.0,0,0,2,7,1420,400,1994,0.0,98092,47.3201,-122.177,1710,6055,4965,0.7317612380250552,3312400,46036225,42723825
625000.0,3,3.5,1560,1490,2.0,0,0,2,8,1240,320,1995,0.0,98102,47.6248,-122.319,1560,1662,-70,-0.04697986577181208,2433600,2220100,-213500
750500.0,5,3.0,2170,2440,1.5,0,0,3,8,1450,720,1911,0.0,98115,47.6724,-122.31700000000001,2070,4000,270,0.11065573770491803,4708900,5953600,1244700
525000.0,3,1.75,1600,9579,1.0,0,0,2,8,1180,420,1977,0.0,98072,47.7662,-122.15899999999999,1750,9829,7979,0.8329679507255454,2560000,91757241,89197241
740000.0,4,3.5,3760,57063,2.0,0,0,2,9,2950,810,1998,0.0,98053,47.6328,-121.964,2870,28945,53303,0.9341079158123478,14137600,3256185969,3242048369
523000.0,3,1.5,1240,7735,1.0,0,0,3,7,1240,0,1957,0.0,98008,47.601000000000006,-122.12200000000001,1260,7500,6495,0.8396897220426632,1537600,59830225,58292625
292000.0,3,1.75,1090,4500,1.5,0,0,4,8,1090,0,1929,0.0,98118,47.5157,-122.256,1640,5225,3410,0.7577777777777778,1188100,20250000,19061900
625000.0,4,2.5,2740,9599,1.0,0,2,2,8,1820,920,1961,0.0,98177,47.7728,-122.385,2660,8280,6859,0.7145535993332639,7507600,92140801,84633201
700000.0,3,2.5,3110,11727,2.0,0,2,2,9,3110,0,2002,0.0,98065,47.5445,-121.87100000000001,4240,13353,8617,0.7348000341093204,9672100,137522529,127850429
399950.0,3,2.5,1610,1320,2.0,0,0,2,7,1280,330,2007,0.0,98144,47.6,-122.29799999999999,1480,1602,-290,-0.2196969696969697,2592100,1742400,-849700
545000.0,4,3.5,1880,1341,3.0,0,0,2,8,1650,230,2007,0.0,98122,47.6053,-122.306,1740,1883,-539,-0.40193885160328113,3534400,1798281,-1736119
339999.0,4,2.0,1740,6369,1.0,0,0,4,6,870,870,1954,0.0,98133,47.7461,-122.33200000000001,1560,7200,4629,0.7268016957136129,3027600,40564161,37536561
1210000.0,4,2.25,3270,6000,2.0,0,0,4,8,2180,1090,1909,0.0,98122,47.6101,-122.286,2880,6000,2730,0.455,10692900,36000000,25307100
545000.0,3,2.5,1990,5149,2.0,0,0,2,8,1990,0,2003,0.0,98075,47.5895,-122.01899999999999,2280,4506,3159,0.613517187803457,3960100,26512201,22552101
260000.0,4,1.75,1960,8400,1.0,0,0,3,8,1960,0,1967,0.0,98023,47.3111,-122.37899999999999,2080,8400,6440,0.7666666666666667,3841600,70560000,66718400
526000.0,3,1.75,1680,3420,1.0,0,0,2,7,960,720,1992,0.0,98115,47.6854,-122.291,1680,4080,1740,0.5087719298245614,2822400,11696400,8874000
701000.0,4,3.0,2910,8540,2.0,0,0,2,9,2910,0,2003,0.0,98059,47.5223,-122.156,3040,6091,5630,0.6592505854800936,8468100,72931600,64463500
290000.0,3,2.25,1500,7482,1.0,0,0,3,7,1210,290,1968,0.0,98055,47.4619,-122.18700000000001,1480,7308,5982,0.7995188452285485,2250000,55980324,53730324
330600.0,1,1.0,580,1799,1.0,0,0,2,7,580,0,1908,2005.0,98117,47.6829,-122.375,1260,4000,1219,0.6775986659255142,336400,3236401,2900001
550500.0,3,1.75,2540,8280,1.0,0,0,2,7,1270,1270,1949,0.0,98177,47.7219,-122.35799999999999,1950,8280,5740,0.6932367149758454,6451600,68558400,62106800
430000.0,2,1.0,950,6426,1.0,0,0,2,7,950,0,1949,0.0,98126,47.5653,-122.37,1360,2550,5476,0.8521630874572051,902500,41293476,40390976
4000000.0,4,5.5,7080,16573,2.0,0,0,2,12,5760,1320,2008,0.0,98039,47.6151,-122.22399999999999,3140,15996,9493,0.5727991311168769,50126400,274664329,224537929
260600.0,2,1.0,810,4560,1.0,0,0,2,7,810,0,1928,0.0,98126,47.5425,-122.376,1490,4560,3750,0.8223684210526315,656100,20793600,20137500
825000.0,5,3.0,4080,7500,2.0,0,2,3,8,2720,1360,1961,0.0,98103,47.6722,-122.34899999999999,2000,4545,3420,0.456,16646400,56250000,39603600
378950.0,4,2.0,1820,8400,1.0,0,0,4,7,1300,520,1956,0.0,98155,47.7615,-122.329,1700,9450,6580,0.7833333333333333,3312400,70560000,67247600
435000.0,4,2.5,2650,9065,2.0,0,0,2,7,2650,0,2000,0.0,98019,47.7258,-121.959,2590,13218,6415,0.7076668505239934,7022500,82174225,75151725
631000.0,3,2.25,1670,1396,2.0,0,0,2,9,1250,420,2015,0.0,98115,47.6814,-122.288,1610,5191,-274,-0.19627507163323782,2788900,1948816,-840084
415000.0,3,2.5,2480,8342,2.0,0,0,2,8,2480,0,1986,0.0,98058,47.4381,-122.134,2300,8303,5862,0.7027091824502517,6150400,69588964,63438564
222000.0,3,1.75,1240,7560,1.0,0,0,2,8,1070,170,1967,0.0,98003,47.333,-122.3,1650,7560,6320,0.8359788359788359,1537600,57153600,55616000
245000.0,3,2.0,1390,8250,1.0,0,0,2,7,1390,0,1987,0.0,98042,47.3707,-122.094,1390,7875,6860,0.8315151515151515,1932100,68062500,66130400
720000.0,3,2.5,2880,10126,2.0,0,0,3,10,2880,0,1985,0.0,98074,47.6319,-122.037,2960,10514,7246,0.7155836460596484,8294400,102535876,94241476
215000.0,3,1.0,1060,9954,1.0,0,0,3,7,1060,0,1960,0.0,98032,47.3801,-122.289,1620,8760,8894,0.8935101466747036,1123600,99082116,97958516
579100.0,2,1.0,1070,2754,1.0,0,0,2,7,830,240,1924,0.0,98103,47.6755,-122.331,1760,4080,1684,0.6114742193173566,1144900,7584516,6439616
522500.0,4,1.75,1640,9299,1.5,0,0,3,7,870,770,1943,0.0,98056,47.5334,-122.16799999999999,2460,14326,7659,0.8236369502097,2689600,86471401,83781801
489000.0,3,2.0,1510,3000,1.0,0,0,3,7,910,600,1972,0.0,98115,47.6804,-122.319,1620,4000,1490,0.49666666666666665,2280100,9000000,6719900
240000.0,3,1.0,1230,2353,1.5,0,0,3,6,1230,0,1925,0.0,98106,47.5177,-122.354,1280,1572,1123,0.4772630684232894,1512900,5536609,4023709
420250.0,3,2.0,1510,3657,1.0,0,0,2,8,1510,0,2007,0.0,98053,47.7225,-122.029,1510,3657,2147,0.5870932458299152,2280100,13373649,11093549
523000.0,4,2.5,3180,20870,2.0,0,0,2,8,2120,1060,1967,0.0,98034,47.7176,-122.241,2700,14190,17690,0.8476281744130331,10112400,435556900,425444500
628000.0,4,2.0,2260,6000,1.0,0,0,2,8,1430,830,1958,0.0,98115,47.6876,-122.29799999999999,2030,5874,3740,0.6233333333333333,5107600,36000000,30892400
320000.0,4,2.5,1920,7277,2.0,0,0,3,8,1920,0,1990,0.0,98031,47.4058,-122.19200000000001,2300,7645,5357,0.7361550089322523,3686400,52954729,49268329
359950.0,3,2.5,1980,7800,2.0,0,0,2,8,1980,0,1999,0.0,98055,47.4492,-122.199,1700,20580,5820,0.7461538461538462,3920400,60840000,56919600
232000.0,2,1.0,1200,8063,1.0,0,0,3,6,1200,0,1958,0.0,98198,47.4204,-122.324,1200,7500,6863,0.8511720203398239,1440000,65011969,63571969
810000.0,4,2.25,2020,5600,1.0,0,2,3,8,1210,810,1961,0.0,98115,47.6821,-122.26700000000001,2660,6050,3580,0.6392857142857142,4080400,31360000,27279600
245000.0,4,1.5,2010,7561,1.5,0,0,3,7,1890,120,1921,0.0,98002,47.31100000000001,-122.227,1420,6564,5551,0.7341621478640391,4040100,57168721,53128621
273000.0,3,2.25,1930,8192,1.0,0,0,2,7,1470,460,1984,0.0,98003,47.2624,-122.29899999999999,1510,8192,6262,0.764404296875,3724900,67108864,63383964
1190000.0,5,2.5,2710,14989,1.0,0,0,2,8,1720,990,1959,0.0,98004,47.6411,-122.20700000000001,3180,16624,12279,0.8192007472146241,7344100,224670121,217326021
438000.0,5,1.0,1950,6250,1.5,0,0,3,7,1450,0,1917,0.0,98136,47.5511,-122.38600000000001,1950,6250,4300,0.688,3802500,39062500,35260000
400000.0,3,1.75,2110,19600,1.0,0,0,3,8,2110,0,1959,0.0,98055,47.4742,-122.198,880,10077,17490,0.8923469387755102,4452100,384160000,379707900
340000.0,3,1.0,1250,4800,1.0,0,0,3,7,1250,0,1951,0.0,98126,47.5517,-122.381,1404,4800,3550,0.7395833333333334,1562500,23040000,21477500
552000.0,2,2.5,1380,951,3.0,0,0,2,9,1380,0,2006,0.0,98103,47.6654,-122.355,1430,3400,-429,-0.45110410094637227,1904400,904401,-999999
790000.0,3,1.75,2050,4080,2.0,0,0,2,8,2050,0,1991,0.0,98105,47.6698,-122.325,1890,4080,2030,0.49754901960784315,4202500,16646400,12443900
360000.0,3,1.5,1800,22000,2.0,0,0,2,8,1800,0,1931,0.0,98168,47.4889,-122.286,1440,16640,20200,0.9181818181818182,3240000,484000000,480760000
235000.0,3,1.0,1310,15022,1.0,0,0,2,7,1310,0,1934,1984.0,98168,47.5008,-122.33200000000001,1530,13154,13712,0.9127945679669818,1716100,225660484,223944384
775000.0,2,1.0,1010,3600,1.0,0,0,2,7,1010,0,1913,0.0,98107,47.6641,-122.35700000000001,1540,3600,2590,0.7194444444444444,1020100,12960000,11939900
489200.0,3,2.75,1850,9600,1.5,0,0,4,7,1850,0,1965,0.0,98034,47.7259,-122.226,1250,10500,7750,0.8072916666666666,3422500,92160000,88737500
341000.0,3,2.25,1750,8900,2.0,0,0,3,8,1750,0,1977,0.0,98058,47.4451,-122.13600000000001,1680,7910,7150,0.8033707865168539,3062500,79210000,76147500
335000.0,4,2.5,2154,6050,2.0,0,0,2,8,2154,0,2012,0.0,98030,47.3513,-122.17399999999999,2305,5769,3896,0.6439669421487604,4639716,36602500,31962784
393500.0,3,1.75,1230,1441,2.0,0,0,2,8,1010,220,2004,0.0,98116,47.5626,-122.382,1170,1942,211,0.14642609299097847,1512900,2076481,563581
360000.0,3,2.0,1960,8846,1.0,0,3,3,6,980,980,1940,0.0,98178,47.5101,-122.24600000000001,2190,6363,6886,0.7784309292335518,3841600,78251716,74410116
400800.0,4,1.0,1070,5750,1.0,0,0,2,6,870,200,1923,0.0,98126,47.56399999999999,-122.37899999999999,1270,5750,4680,0.8139130434782609,1144900,33062500,31917600
585000.0,3,1.0,1450,5378,1.0,0,0,2,7,1190,260,1939,0.0,98199,47.6436,-122.405,1810,5559,3928,0.7303830420230569,2102500,28922884,26820384
1600000.0,4,2.75,3680,5000,2.0,0,3,2,9,2480,1200,1936,0.0,98105,47.6599,-122.26899999999999,3200,5000,1320,0.264,13542400,25000000,11457600
2880000.0,4,2.5,5760,32033,2.0,0,4,3,12,4390,1370,1994,0.0,98177,47.7288,-122.37,3420,28475,26273,0.8201854337714232,33177600,1026113089,992935489
300000.0,3,1.0,1220,13000,1.0,0,0,3,7,1220,0,1955,0.0,98133,47.7608,-122.353,1510,12600,11780,0.9061538461538462,1488400,169000000,167511600
1050000.0,4,2.75,2950,4560,2.0,0,0,4,7,1810,1140,1912,0.0,98103,47.6525,-122.333,2000,4560,1610,0.3530701754385965,8702500,20793600,12091100
360000.0,3,1.5,1340,1110,2.0,0,0,2,7,1040,300,1999,0.0,98117,47.698,-122.366,1220,1110,-230,-0.2072072072072072,1795600,1232100,-563500
665900.0,4,2.25,2870,5453,2.0,0,1,3,8,2220,650,1926,0.0,98146,47.5129,-122.38799999999999,1660,4800,2583,0.47368421052631576,8236900,29735209,21498309
470000.0,4,1.0,2590,18224,1.5,0,0,3,7,2000,590,1911,0.0,98118,47.5318,-122.286,1800,7080,15634,0.8578797190517998,6708100,332114176,325406076
581000.0,4,1.75,2090,8164,1.0,0,0,3,8,1070,1020,1963,0.0,98052,47.6715,-122.155,1310,7975,6074,0.7439980401763842,4368100,66650896,62282796
527000.0,6,3.5,3000,8401,1.0,0,0,2,8,1500,1500,1979,0.0,98125,47.7226,-122.29899999999999,1400,8403,5401,0.6428996548029996,9000000,70576801,61576801
423000.0,4,1.75,1730,7245,1.0,0,0,3,7,880,0,1955,0.0,98007,47.5995,-122.14399999999999,1550,7245,5515,0.7612146307798482,2992900,52490025,49497125
875000.0,4,3.5,2850,4416,1.5,0,0,2,7,2040,810,1926,0.0,98103,47.6835,-122.34200000000001,1860,4416,1566,0.3546195652173913,8122500,19501056,11378556
410000.0,3,1.0,1020,6903,1.0,0,0,2,7,1020,0,1951,0.0,98116,47.57100000000001,-122.39200000000001,1440,6678,5883,0.8522381573229031,1040400,47651409,46611009
606000.0,3,2.5,2200,6005,2.0,0,0,2,9,2200,0,1997,0.0,98072,47.7408,-122.169,2320,6098,3805,0.6336386344712739,4840000,36060025,31220025
654000.0,3,2.5,3240,60840,2.0,0,0,2,7,3240,0,1997,0.0,98045,47.5192,-121.764,2570,204732,57600,0.9467455621301775,10497600,3701505600,3691008000
150000.0,3,0.75,490,38500,1.5,0,0,3,5,490,0,1959,0.0,98014,47.7112,-121.315,800,18297,38010,0.9872727272727273,240100,1482250000,1482009900
373000.0,3,2.5,2990,6771,1.0,0,0,2,7,1550,1440,2003,0.0,98106,47.5237,-122.353,1800,6771,3781,0.5584108698862797,8940100,45846441,36906341
550000.0,5,2.0,2450,9488,1.0,0,0,3,7,1240,1210,1900,1955.0,98133,47.7056,-122.34,1310,5693,7038,0.741779089376054,6002500,90022144,84019644
512500.0,3,2.5,1900,7604,2.0,0,0,2,8,1900,0,1990,0.0,98033,47.7002,-122.18799999999999,1980,9583,5704,0.7501315097317202,3610000,57820816,54210816
360000.0,4,2.5,2640,7388,2.0,0,0,2,7,2640,0,2003,0.0,98038,47.3505,-122.027,2640,6383,4748,0.6426637791012453,6969600,54582544,47612944
369000.0,3,2.0,1340,1480,3.0,0,0,2,8,1340,0,1997,0.0,98117,47.6904,-122.39299999999999,1340,1321,140,0.0945945945945946,1795600,2190400,394800
825000.0,4,2.5,3220,5262,2.0,0,0,2,9,3220,0,2003,0.0,98033,47.6878,-122.162,3220,4921,2042,0.3880653743823641,10368400,27688644,17320244
255000.0,3,2.0,930,11475,1.0,0,0,2,7,930,0,1978,0.0,98045,47.4644,-121.745,1280,11250,10545,0.918954248366013,864900,131675625,130810725
1290000.0,4,2.5,3240,10800,1.0,0,0,2,10,2260,980,1946,0.0,98105,47.6709,-122.262,3490,10800,7560,0.7,10497600,116640000,106142400
270000.0,5,2.5,2630,8470,1.5,0,0,3,8,2630,0,1968,0.0,98002,47.2863,-122.196,1780,8575,5840,0.6894923258559622,6916900,71740900,64824000
480680.0,3,2.5,1730,4924,2.0,0,0,2,8,1730,0,1996,0.0,98029,47.5672,-122.005,1610,4313,3194,0.648659626320065,2992900,24245776,21252876
525000.0,4,1.75,2120,7725,1.0,0,0,2,8,1220,900,1965,0.0,98007,47.6003,-122.14399999999999,2160,7725,5605,0.7255663430420712,4494400,59675625,55181225
291500.0,3,1.0,880,9238,1.5,0,0,4,6,880,0,1946,0.0,98155,47.7494,-122.319,1170,9238,8358,0.9047412859926391,774400,85340644,84566244
305000.0,4,2.0,1800,13551,1.0,0,0,3,7,1800,0,1974,0.0,98059,47.4721,-122.12799999999999,1730,13551,11751,0.8671684746513173,3240000,183629601,180389601
285000.0,3,1.75,1600,7500,1.0,0,0,2,7,1600,0,1998,0.0,98002,47.2831,-122.199,1620,7461,5900,0.7866666666666666,2560000,56250000,53690000
1880000.0,3,2.5,3280,29111,2.0,1,3,2,11,3280,0,1925,0.0,98199,47.6699,-122.416,3530,21074,25831,0.8873278142282985,10758400,847450321,836691921
329500.0,5,1.75,3290,8000,1.0,0,0,2,7,1790,1500,1968,0.0,98030,47.3733,-122.214,2380,7000,4710,0.58875,10824100,64000000,53175900
1570000.0,4,2.25,2890,18226,3.0,1,4,2,10,2890,0,1984,0.0,98056,47.5169,-122.209,2870,11151,15336,0.8414353121913749,8352100,332187076,323834976
379260.0,3,2.5,1730,7202,1.0,0,0,2,7,1330,400,1991,0.0,98198,47.4099,-122.329,2100,8125,5472,0.7597889475145793,2992900,51868804,48875904
356000.0,3,2.5,1590,3411,2.0,0,0,2,7,1590,0,2000,0.0,98065,47.5303,-121.87799999999999,1590,3411,1821,0.5338610378188214,2528100,11634921,9106821
571900.0,4,1.75,1710,8947,1.0,0,0,3,7,1710,0,1956,0.0,98007,47.5947,-122.135,1360,10133,7237,0.8088744830669499,2924100,80048809,77124709
271500.0,3,1.75,1995,18360,2.0,0,0,2,7,1995,0,1957,0.0,98198,47.4129,-122.322,1980,13640,16365,0.8913398692810458,3980025,337089600,333109575
390000.0,3,1.75,1300,10030,1.0,0,0,3,7,1300,0,1967,0.0,98034,47.7359,-122.19200000000001,1520,7713,8730,0.8703888334995015,1690000,100600900,98910900
550000.0,3,2.5,2720,62310,1.0,0,0,2,8,2040,680,1985,0.0,98038,47.4168,-122.074,2770,204296,59590,0.9563472957791687,7398400,3882536100,3875137700
755000.0,2,2.5,1360,2070,2.0,0,0,2,8,1360,0,1999,0.0,98102,47.6423,-122.329,1920,2092,710,0.34299516908212563,1849600,4284900,2435300
509500.0,2,2.5,1590,1485,2.0,0,0,2,8,1300,290,1994,0.0,98199,47.6375,-122.387,1880,3675,-105,-0.0707070707070707,2528100,2205225,-322875
486700.0,2,1.0,1200,6278,1.0,0,0,2,7,1080,120,1942,0.0,98103,47.7001,-122.351,1200,6211,5078,0.8088563236699586,1440000,39413284,37973284
527500.0,2,1.0,1170,3000,1.5,0,0,2,7,1170,0,1910,0.0,98103,47.6697,-122.338,1530,4000,1830,0.61,1368900,9000000,7631100
475000.0,5,2.5,2010,3600,1.5,0,0,2,6,1510,500,1912,0.0,98119,47.6522,-122.366,1780,3600,1590,0.44166666666666665,4040100,12960000,8919900
268000.0,3,2.75,1880,1793,2.0,0,0,2,7,1810,70,2001,0.0,98108,47.5405,-122.29299999999999,1800,2537,-87,-0.04852203011712214,3534400,3214849,-319551
562000.0,3,2.0,3250,50529,2.0,0,0,3,8,3250,0,1978,0.0,98075,47.5849,-122.016,2370,47480,47279,0.9356805003067545,10562500,2553179841,2542617341
780000.0,4,2.5,2270,13449,1.0,0,0,3,9,1310,960,1975,0.0,98040,47.5416,-122.23200000000001,2810,13475,11179,0.8312142166703844,5152900,180875601,175722701
700000.0,9,3.0,3680,4400,2.0,0,0,2,7,2830,850,1908,0.0,98102,47.6374,-122.324,1960,2450,720,0.16363636363636364,13542400,19360000,5817600
710000.0,3,2.0,1880,3000,1.0,0,0,3,8,1040,840,1931,0.0,98109,47.6418,-122.351,1790,3000,1120,0.37333333333333335,3534400,9000000,5465600
445000.0,3,1.0,1050,5664,1.0,0,0,3,7,910,140,1947,0.0,98115,47.6897,-122.285,1500,5664,4614,0.8146186440677966,1102500,32080896,30978396
729000.0,3,3.25,2250,60548,1.0,0,0,2,9,2250,0,2005,0.0,98038,47.4246,-122.014,2760,84070,58298,0.9628394001453392,5062500,3666060304,3660997804
384400.0,3,3.25,1689,1388,3.0,0,0,2,8,1689,0,2008,0.0,98125,47.7174,-122.31700000000001,1459,1384,-301,-0.21685878962536023,2852721,1926544,-926177
815000.0,6,3.0,2860,17853,1.0,0,0,2,8,1430,1430,1962,2015.0,98006,47.54600000000001,-122.175,1920,13452,14993,0.8398028342575478,8179600,318729609,310550009
865000.0,4,2.5,2710,4069,3.0,0,0,3,10,2710,0,1990,0.0,98122,47.604,-122.288,1810,3586,1359,0.3339886950110592,7344100,16556761,9212661
514000.0,3,2.0,1770,7200,1.0,0,0,3,7,1770,0,1967,0.0,98033,47.6642,-122.17299999999999,2250,11250,5430,0.7541666666666667,3132900,51840000,48707100
615000.0,4,2.75,2820,13193,1.0,0,0,2,8,1860,960,1965,0.0,98006,47.5579,-122.17399999999999,2580,13193,10373,0.7862502842416433,7952400,174055249,166102849
865000.0,4,3.25,3400,99170,1.0,0,0,3,8,2000,1400,1980,0.0,98072,47.7293,-122.09899999999999,3460,47920,95770,0.9657154381365333,11560000,9834688900,9823128900
755000.0,4,2.5,3110,6930,2.0,0,0,2,9,3110,0,2004,0.0,98052,47.7011,-122.11200000000001,3090,7000,3820,0.5512265512265512,9672100,48024900,38352800
425000.0,4,1.0,1480,8321,1.0,0,0,2,7,1080,400,1953,0.0,98155,47.7629,-122.318,1580,8502,6841,0.8221367624083644,2190400,69239041,67048641
375000.0,2,1.0,940,9839,1.0,0,0,2,6,940,0,1910,0.0,98136,47.5379,-122.38600000000001,1330,8740,8899,0.9044618355523936,883600,96805921,95922321
750000.0,4,2.5,2680,4548,2.0,0,0,2,8,2680,0,2009,0.0,98052,47.7073,-122.11399999999999,2750,4548,1868,0.41072999120492526,7182400,20684304,13501904
722000.0,4,2.75,3190,5408,2.0,0,0,2,9,3190,0,2005,0.0,98075,47.5903,-121.988,3160,5773,2218,0.41013313609467456,10176100,29246464,19070364
1010000.0,3,2.5,1920,4480,2.0,0,1,2,9,1920,0,1949,1997.0,98119,47.6472,-122.37299999999999,1790,4500,2560,0.5714285714285714,3686400,20070400,16384000
725000.0,3,2.5,2610,7510,2.0,0,0,2,9,2610,0,1996,0.0,98052,47.6648,-122.137,2610,8458,4900,0.6524633821571239,6812100,56400100,49588000
170000.0,3,0.75,1040,42180,1.0,0,0,1,6,1040,0,1947,0.0,98055,47.4518,-122.199,1270,24090,41140,0.975343764817449,1081600,1779152400,1778070800
845000.0,4,3.25,2880,35315,1.0,0,0,2,11,2270,610,1982,0.0,98005,47.6587,-122.163,1910,167378,32435,0.9184482514512247,8294400,1247149225,1238854825
271900.0,3,2.0,1450,8771,2.0,0,0,3,7,1450,0,1991,0.0,98022,47.1947,-121.98899999999999,1450,8653,7321,0.8346824763424923,2102500,76930441,74827941
1300000.0,6,4.5,3902,3880,3.0,0,4,3,9,2782,1120,1977,0.0,98116,47.5837,-122.399,1100,3870,-22,-0.005670103092783505,15225604,15054400,-171204
261500.0,4,2.5,2460,7800,1.0,0,0,2,8,1500,960,1977,0.0,98023,47.3081,-122.384,2210,7800,5340,0.6846153846153846,6051600,60840000,54788400
619500.0,3,2.5,2170,5000,2.0,0,0,2,9,2170,0,2003,0.0,98029,47.5458,-121.99600000000001,2170,5000,2830,0.566,4708900,25000000,20291100
435000.0,5,2.25,1970,15247,1.0,0,0,2,7,1450,520,1986,0.0,98024,47.5669,-121.905,1300,10800,13277,0.8707942546074637,3880900,232471009,228590109
210000.0,3,1.0,1000,5454,1.0,0,0,2,7,1000,0,1954,0.0,98133,47.7339,-122.337,1320,5250,4454,0.8166483314998166,1000000,29746116,28746116
489950.0,3,2.0,1580,4010,1.0,0,0,3,7,790,790,1909,0.0,98117,47.6769,-122.37100000000001,1350,5350,2430,0.6059850374064838,2496400,16080100,13583700
260000.0,4,1.5,2130,8800,1.0,0,0,2,7,1100,1030,1962,0.0,98032,47.383,-122.288,1480,8120,6670,0.7579545454545454,4536900,77440000,72903100
300000.0,4,1.0,1370,8499,1.0,0,0,2,7,1370,0,1949,0.0,98155,47.736000000000004,-122.301,1370,8187,7129,0.8388045652429698,1876900,72233001,70356101
530000.0,4,2.0,2150,14161,1.0,0,2,2,8,1330,820,1966,0.0,98003,47.3376,-122.323,2310,14034,12011,0.8481745639432243,4622500,200533921,195911421
235000.0,3,1.75,1370,14030,1.0,0,0,3,8,1370,0,1977,0.0,98092,47.2969,-122.163,2100,15260,12660,0.902352102637206,1876900,196840900,194964000
593500.0,3,1.0,1370,4000,2.0,0,0,3,8,1370,0,1918,0.0,98105,47.6711,-122.324,1370,4000,2630,0.6575,1876900,16000000,14123100
562000.0,3,3.0,3290,80471,2.0,0,2,3,8,2330,960,1975,0.0,98070,47.504,-122.464,1830,30494,77181,0.9591157062792808,10824100,6475581841,6464757741
585000.0,3,2.0,3190,207346,2.0,0,0,2,9,3190,0,1994,0.0,98022,47.2737,-122.015,2930,206474,204156,0.9846150878242165,10176100,42992363716,42982187616
2400000.0,4,3.25,4140,20734,1.0,0,1,2,10,3300,840,1977,2005.0,98004,47.6344,-122.215,4020,20008,16594,0.8003279637310697,17139600,429898756,412759156
199500.0,3,1.75,1690,8901,1.0,0,0,2,7,1690,0,1986,0.0,98030,47.3546,-122.176,1690,7532,7211,0.8101336928435008,2856100,79227801,76371701
544500.0,5,1.0,1690,3240,1.5,0,0,2,7,1690,0,1914,0.0,98115,47.6746,-122.325,1230,4500,1550,0.4783950617283951,2856100,10497600,7641500
394900.0,3,1.0,1430,13370,1.0,0,0,2,7,1430,0,1962,0.0,98034,47.7317,-122.241,1670,10075,11940,0.8930441286462228,2044900,178756900,176712000
912000.0,4,3.75,1980,4095,2.0,0,0,2,9,1980,0,2009,0.0,98103,47.6901,-122.35600000000001,1480,3840,2115,0.5164835164835165,3920400,16769025,12848625
260000.0,3,2.5,1490,8102,2.0,0,0,3,7,1490,0,1990,0.0,98042,47.3712,-122.09200000000001,1640,7943,6612,0.8160947914095286,2220100,65642404,63422304
858000.0,5,3.0,3620,12778,1.0,0,2,4,8,1900,1720,1964,0.0,98006,47.5512,-122.191,2930,10669,9158,0.7167005791203631,13104400,163277284,150172884
1280000.0,4,2.5,2720,16454,1.0,0,1,4,9,1870,850,1963,0.0,98040,47.5489,-122.21600000000001,3560,15993,13734,0.8346906527288197,7398400,270734116,263335716
242150.0,4,1.75,1490,8544,1.0,0,0,3,7,1490,0,1970,0.0,98031,47.3894,-122.166,1180,8372,7054,0.8256086142322098,2220100,72999936,70779836
220000.0,3,1.75,1230,7200,1.0,0,0,2,7,1230,0,1986,0.0,98023,47.2881,-122.363,1540,7210,5970,0.8291666666666667,1512900,51840000,50327100
235000.0,3,2.0,1900,7980,1.0,0,0,3,7,1340,560,1977,0.0,98023,47.305,-122.37299999999999,1690,7840,6080,0.7619047619047619,3610000,63680400,60070400
370000.0,3,1.75,1530,10300,1.0,0,0,3,7,1530,0,1978,0.0,98133,47.7767,-122.35600000000001,1940,9883,8770,0.8514563106796117,2340900,106090000,103749100
450000.0,3,1.75,2290,44866,1.0,0,0,2,8,1390,900,1981,0.0,98077,47.7398,-122.041,2410,44866,42576,0.9489591227209914,5244100,2012957956,2007713856
534950.0,5,1.5,2240,6337,1.0,0,0,2,8,1280,960,1956,0.0,98125,47.7046,-122.316,1870,6380,4097,0.6465204355373205,5017600,40157569,35139969
730000.0,4,2.5,3470,14271,2.0,0,0,2,9,3470,0,2005,0.0,98065,47.5423,-121.87700000000001,3450,9380,10801,0.7568495550416929,12040900,203661441,191620541
465000.0,4,2.5,3050,32450,1.0,0,0,3,8,1550,1500,1983,0.0,98030,47.3626,-122.209,2350,15390,29400,0.9060092449922958,9302500,1053002500,1043700000
178000.0,3,1.0,1100,5734,1.0,0,0,3,7,1100,0,1955,0.0,98030,47.3632,-122.17399999999999,1770,6050,4634,0.8081618416463202,1210000,32878756,31668756
215000.0,3,1.0,1610,7140,1.0,0,0,2,7,1080,530,1976,0.0,98031,47.3943,-122.189,1800,7600,5530,0.7745098039215687,2592100,50979600,48387500
300000.0,3,2.75,1910,15508,1.0,0,0,2,8,1210,700,1984,0.0,98023,47.3128,-122.345,2450,7989,13598,0.8768377611555326,3648100,240498064,236849964
430000.0,3,2.0,1510,7066,1.0,0,2,2,7,1230,280,1973,0.0,98125,47.7053,-122.303,1950,8089,5556,0.7863005943956977,2280100,49928356,47648256
183000.0,3,1.5,1280,4366,2.0,0,0,3,6,1280,0,1985,0.0,98002,47.335,-122.215,1280,4366,3086,0.7068254695373339,1638400,19061956,17423556
585000.0,3,2.5,1910,1501,2.5,0,0,2,8,1530,380,2007,0.0,98199,47.6441,-122.385,1760,1750,-409,-0.2724850099933378,3648100,2253001,-1395099
192950.0,3,1.0,1170,3330,2.0,0,0,3,6,1170,0,1969,0.0,98092,47.3155,-122.182,1090,3330,2160,0.6486486486486487,1368900,11088900,9720000
599000.0,2,1.0,1550,7713,1.0,0,0,2,7,1550,0,1930,1979.0,98117,47.7005,-122.35799999999999,1340,6350,6163,0.799040580837547,2402500,59490369,57087869
326500.0,3,1.0,1060,7920,1.0,0,0,3,7,1060,0,1968,0.0,98106,47.5649,-122.35799999999999,1060,7457,6860,0.8661616161616161,1123600,62726400,61602800
358803.0,2,1.0,1040,5765,1.0,0,0,2,7,1040,0,1944,0.0,98133,47.7024,-122.346,1040,3844,4725,0.8196010407632264,1081600,33235225,32153625
537000.0,3,2.5,1550,12920,2.0,0,0,4,7,1550,0,1999,0.0,98033,47.6973,-122.194,2610,10800,11370,0.8800309597523219,2402500,166926400,164523900
1160000.0,3,2.5,2490,24691,1.0,1,4,3,9,1580,910,1961,0.0,98146,47.488,-122.36399999999999,2800,24121,22201,0.899153537726297,6200100,609645481,603445381
156000.0,2,1.0,920,5889,1.0,0,0,3,6,920,0,1950,0.0,98002,47.3012,-122.21799999999999,1210,6180,4969,0.8437765325182544,846400,34680321,33833921
219000.0,3,1.0,1250,8276,1.5,0,0,4,6,1250,0,1939,0.0,98022,47.2092,-121.99700000000001,1250,8792,7026,0.8489608506524892,1562500,68492176,66929676
1190000.0,3,1.5,2540,2700,2.0,0,0,3,8,1630,910,1922,0.0,98119,47.637,-122.361,2520,5400,160,0.05925925925925926,6451600,7290000,838400
248000.0,5,1.75,2190,16788,1.0,0,2,2,8,1380,810,1978,0.0,98030,47.3764,-122.176,1920,8366,14598,0.8695496783416726,4796100,281836944,277040844
340000.0,3,1.75,1340,196020,1.0,0,0,3,7,1340,0,1987,0.0,98010,47.2931,-121.992,2250,232230,194680,0.9931639628609326,1795600,38423840400,38422044800
899100.0,5,2.5,2410,15300,1.0,0,0,3,8,1400,1010,1975,0.0,98040,47.5416,-122.23100000000001,2440,15300,12890,0.842483660130719,5808100,234090000,228281900
346950.0,3,1.75,1830,10954,1.0,0,0,2,7,1830,0,1963,0.0,98155,47.7554,-122.306,1850,8624,9124,0.8329377396384883,3348900,119990116,116641216
330000.0,3,1.0,1850,5775,2.0,0,0,2,6,1740,110,1928,0.0,98108,47.5446,-122.296,1520,3578,3925,0.6796536796536796,3422500,33350625,29928125
325000.0,3,1.0,1410,8250,1.0,0,0,2,7,1410,0,1954,0.0,98177,47.7621,-122.36,1580,8250,6840,0.8290909090909091,1988100,68062500,66074400
315000.0,3,1.75,1460,7884,1.0,0,0,2,8,1460,0,1975,0.0,98058,47.4457,-122.12799999999999,2050,7210,6424,0.8148148148148148,2131600,62157456,60025856
649950.0,3,2.5,1500,1375,2.0,0,0,2,9,1200,300,2014,0.0,98119,47.6451,-122.375,1680,1627,-125,-0.09090909090909091,2250000,1890625,-359375
316000.0,3,1.0,1130,7200,1.5,0,0,3,6,1130,0,1942,0.0,98133,47.7298,-122.355,1350,1358,6070,0.8430555555555556,1276900,51840000,50563100
386000.0,2,2.5,1620,3196,2.0,0,0,2,8,1620,0,2008,0.0,98065,47.5167,-121.87799999999999,1750,2828,1576,0.493116395494368,2624400,10214416,7590016
535000.0,2,1.75,2330,7280,1.0,0,0,2,7,1450,880,1982,0.0,98188,47.4282,-122.28,1830,12178,4950,0.679945054945055,5428900,52998400,47569500
600000.0,3,3.0,1520,1800,3.0,0,0,2,7,1520,0,2003,0.0,98115,47.6822,-122.32600000000001,1520,1500,280,0.15555555555555556,2310400,3240000,929600
339000.0,4,2.5,2840,8746,2.0,0,0,2,8,2840,0,2001,0.0,98022,47.19,-122.01299999999999,2630,9900,5906,0.6752801280585411,8065600,76492516,68426916
167000.0,3,2.0,1520,7456,1.0,0,0,2,7,1520,0,1949,0.0,98166,47.4745,-122.34299999999999,1740,8464,5936,0.796137339055794,2310400,55591936,53281536
430000.0,3,1.0,1740,4800,1.0,0,0,2,8,1740,0,1952,0.0,98118,47.5596,-122.27,1600,4800,3060,0.6375,3027600,23040000,20012400
688000.0,4,4.0,4000,9309,2.0,0,0,2,9,4000,0,2007,0.0,98065,47.5421,-121.88799999999999,3920,8048,5309,0.5703083037920292,16000000,86657481,70657481
834500.0,3,2.25,2780,6000,1.0,0,3,3,9,1670,1110,1948,0.0,98199,47.6442,-122.406,2780,6000,3220,0.5366666666666666,7728400,36000000,28271600
1080000.0,4,4.25,3500,8750,1.0,0,4,4,9,2140,1360,1951,0.0,98177,47.7222,-122.367,3110,8750,5250,0.6,12250000,76562500,64312500
250000.0,3,1.0,1060,52272,1.0,0,0,2,7,1060,0,1960,0.0,98030,47.36,-122.178,1900,5971,51212,0.9797214569941842,1123600,2732361984,2731238384
402500.0,3,1.0,1290,4000,1.5,0,0,2,7,1290,0,1926,0.0,98118,47.5462,-122.277,1160,5040,2710,0.6775,1664100,16000000,14335900
432500.0,3,2.5,2390,6435,1.0,0,0,2,8,1600,790,1978,0.0,98034,47.726000000000006,-122.194,2020,7300,4045,0.6285936285936286,5712100,41409225,35697125
485000.0,5,1.75,2460,14100,1.0,0,0,2,7,1380,1080,1972,0.0,98028,47.7452,-122.22399999999999,2028,11078,11640,0.825531914893617,6051600,198810000,192758400
560000.0,4,2.75,2930,22000,1.0,0,3,3,9,1580,0,1978,0.0,98023,47.3227,-122.384,2930,9758,19070,0.8668181818181818,8584900,484000000,475415100
410000.0,4,2.25,2200,8292,2.0,0,0,2,7,2200,0,1990,0.0,98155,47.7456,-122.315,1090,8290,6092,0.7346840328027014,4840000,68757264,63917264
455000.0,3,2.5,1870,7344,1.0,0,0,2,8,1470,400,1980,0.0,98034,47.7265,-122.206,1930,7344,5474,0.7453703703703703,3496900,53934336,50437436
459500.0,4,2.5,2060,8968,1.0,0,0,3,7,1190,870,1975,0.0,98155,47.7686,-122.31700000000001,1350,8972,6908,0.7702943800178412,4243600,80425024,76181424
371000.0,4,1.75,1610,11305,1.0,0,0,2,7,1610,0,1968,0.0,98034,47.727,-122.176,1870,11850,9695,0.8575851393188855,2592100,127803025,125210925
289500.0,3,2.25,2120,3400,2.0,0,0,2,7,2120,0,2002,0.0,98092,47.3364,-122.17,2420,3400,1280,0.3764705882352941,4494400,11560000,7065600
395000.0,3,3.5,1450,1263,2.0,0,0,2,8,1160,290,2007,0.0,98199,47.6508,-122.383,1390,1282,-187,-0.14806017418844022,2102500,1595169,-507331
496752.0,2,1.0,1980,5000,1.0,0,0,3,7,1090,890,1923,0.0,98144,47.58600000000001,-122.295,1720,5000,3020,0.604,3920400,25000000,21079600
227000.0,2,1.0,860,6800,1.0,0,0,2,6,860,0,1943,0.0,98133,47.7274,-122.337,1220,6800,5940,0.8735294117647059,739600,46240000,45500400
330000.0,3,1.75,1460,9261,1.0,0,0,2,7,1460,0,1985,0.0,98056,47.5155,-122.189,1550,8800,7801,0.8423496382680056,2131600,85766121,83634521
480000.0,5,2.0,2590,8610,1.0,0,0,3,7,1340,1250,1958,0.0,98008,47.6112,-122.126,1750,8610,6020,0.6991869918699187,6708100,74132100,67424000
290000.0,2,1.0,1120,217800,1.0,0,0,2,6,1120,0,1976,0.0,98019,47.7378,-121.912,1480,217800,216680,0.9948576675849403,1254400,47436840000,47435585600
281000.0,3,1.0,1340,21336,1.5,0,0,3,5,1340,0,1945,0.0,98032,47.4023,-122.273,1340,37703,19996,0.9371953505811773,1795600,455224896,453429296
705000.0,4,1.5,1780,3120,1.5,0,3,2,8,1780,0,1926,0.0,98118,47.5589,-122.264,1710,3600,1340,0.42948717948717946,3168400,9734400,6566000
1400000.0,4,2.5,2920,4000,1.5,0,0,4,8,1910,1010,1909,0.0,98105,47.6578,-122.28,2470,4000,1080,0.27,8526400,16000000,7473600
485000.0,4,3.25,2820,6611,1.0,0,0,2,7,1410,1410,1958,0.0,98155,47.7473,-122.285,2320,6611,3791,0.5734382090455302,7952400,43705321,35752921
622000.0,3,2.25,1550,1919,3.0,0,0,2,8,1550,0,2003,0.0,98107,47.6729,-122.37899999999999,1550,2918,369,0.19228764981761334,2402500,3682561,1280061
380000.0,3,2.25,1600,39848,1.0,0,3,3,8,1600,0,1958,0.0,98022,47.1991,-122.01299999999999,1600,39848,38248,0.9598474201967476,2560000,1587863104,1585303104
2130000.0,4,2.75,3190,19513,2.0,0,4,3,10,3190,0,1982,0.0,98034,47.6991,-122.235,2750,13496,16323,0.8365192435812022,10176100,380757169,370581069
561500.0,3,1.75,1960,6380,1.0,0,0,3,7,980,980,1939,0.0,98115,47.6975,-122.316,1480,6380,4420,0.6927899686520376,3841600,40704400,36862800
242000.0,3,1.0,970,9600,1.0,0,0,2,7,970,0,1972,0.0,98045,47.4451,-121.76799999999999,1110,9600,8630,0.8989583333333333,940900,92160000,91219100
348500.0,3,1.5,1360,10726,1.0,0,0,3,7,1360,0,1966,0.0,98059,47.4948,-122.134,1650,10726,9366,0.8732052955435391,1849600,115047076,113197476
370000.0,3,1.5,1360,10726,1.0,0,0,3,7,1360,0,1966,0.0,98059,47.4948,-122.134,1650,10726,9366,0.8732052955435391,1849600,115047076,113197476
752000.0,6,3.75,3810,6663,2.0,0,0,3,8,3810,0,1977,0.0,98103,47.6938,-122.34,1610,4561,2853,0.4281855020261144,14516100,44395569,29879469
230000.0,3,1.75,1340,8250,1.0,0,0,2,7,1100,240,1985,0.0,98042,47.3668,-122.09,1540,7860,6910,0.8375757575757575,1795600,68062500,66266900
715000.0,3,2.25,1990,4977,3.0,0,0,2,9,1990,0,2012,0.0,98118,47.5404,-122.26799999999999,1280,5000,2987,0.6001607394012457,3960100,24770529,20810429
240415.0,3,1.75,1120,10187,1.0,0,0,2,7,1120,0,1968,0.0,98198,47.3694,-122.311,1900,8736,9067,0.8900559536664376,1254400,103774969,102520569
562000.0,4,1.75,2060,4080,1.5,0,0,2,7,1460,600,1922,1996.0,98105,47.6698,-122.325,1620,4080,2020,0.4950980392156863,4243600,16646400,12402800
360000.0,3,1.5,1170,4080,1.0,0,0,4,6,1170,0,1917,0.0,98126,47.5338,-122.381,920,4242,2910,0.7132352941176471,1368900,16646400,15277500
659950.0,3,2.5,1610,1246,2.0,0,1,2,9,1080,530,2014,0.0,98119,47.6423,-122.375,1610,1249,-364,-0.29213483146067415,2592100,1552516,-1039584
458500.0,3,2.0,1890,1599,2.0,0,0,2,9,1430,460,2012,0.0,98136,47.5438,-122.385,1780,1562,-291,-0.18198874296435272,3572100,2556801,-1015299
259950.0,2,2.0,1070,649,2.0,0,0,2,9,720,350,2008,0.0,98106,47.5213,-122.35700000000001,1070,928,-421,-0.6486902927580893,1144900,421201,-723699
366000.0,3,1.75,1680,6108,1.0,0,0,2,8,1680,0,1989,0.0,98055,47.4501,-122.208,2220,5664,4428,0.724950884086444,2822400,37307664,34485264
978000.0,4,2.75,2890,7821,2.0,0,0,2,9,2890,0,2014,0.0,98006,47.553999999999995,-122.189,2890,10108,4931,0.6304820355453267,8352100,61168041,52815941
525000.0,2,1.0,1360,6120,1.0,0,0,2,7,1060,300,1947,0.0,98115,47.6841,-122.291,1800,5100,4760,0.7777777777777778,1849600,37454400,35604800
926300.0,3,1.5,1660,4800,2.0,0,0,2,8,1660,0,1907,0.0,98119,47.6352,-122.35799999999999,1690,4000,3140,0.6541666666666667,2755600,23040000,20284400
750000.0,2,1.0,1620,6120,1.0,0,0,2,7,1620,0,1951,0.0,98115,47.6731,-122.32600000000001,1650,4590,4500,0.7352941176470589,2624400,37454400,34830000
660000.0,2,1.0,960,6263,1.0,0,1,3,6,960,0,1942,0.0,98033,47.6646,-122.20200000000001,1460,6054,5303,0.8467188248443238,921600,39225169,38303569
305000.0,4,1.75,1000,7200,1.5,0,0,3,6,1000,0,1947,0.0,98155,47.742,-122.324,1280,7200,6200,0.8611111111111112,1000000,51840000,50840000
800000.0,2,2.5,2395,6143,1.0,0,0,2,8,2395,0,2003,0.0,98053,47.7114,-122.029,2170,6162,3748,0.6101253459221878,5736025,37736449,32000424
600000.0,4,1.75,3050,9440,1.0,0,0,2,8,1800,1250,1966,0.0,98034,47.7228,-122.18299999999999,2020,8660,6390,0.676906779661017,9302500,89113600,79811100
435000.0,2,1.0,1120,88327,1.5,0,0,3,6,1120,0,1972,0.0,98010,47.3205,-121.867,1640,136662,87207,0.9873198455738336,1254400,7801658929,7800404529
1140000.0,4,3.25,2960,4296,2.0,0,0,2,9,2190,770,2007,0.0,98119,47.6526,-122.37200000000001,2150,6000,1336,0.31098696461824954,8761600,18455616,9694016
318000.0,3,2.25,1250,1017,3.0,0,0,2,8,1250,0,2008,0.0,98133,47.7099,-122.333,1250,1017,-233,-0.22910521140609635,1562500,1034289,-528211
639000.0,4,2.0,1940,5000,1.0,0,0,3,7,980,960,1910,0.0,98107,47.6719,-122.369,1940,5000,3060,0.612,3763600,25000000,21236400
453000.0,3,2.5,1750,3900,2.0,0,0,2,8,1750,0,1977,0.0,98052,47.6638,-122.12899999999999,1750,5700,2150,0.5512820512820513,3062500,15210000,12147500
800000.0,4,1.75,2150,9148,1.0,0,0,3,7,2150,0,1955,0.0,98004,47.5828,-122.197,2370,9148,6998,0.764975951027547,4622500,83685904,79063404
437000.0,2,1.75,1500,6800,1.0,0,0,3,7,910,590,1942,0.0,98117,47.7004,-122.37100000000001,1450,6800,5300,0.7794117647058824,2250000,46240000,43990000
1150000.0,3,2.75,3230,75889,2.0,1,4,2,7,3230,0,1925,1993.0,98023,47.3344,-122.37,2560,72229,72659,0.9574378368406489,10432900,5759140321,5748707421
490000.0,4,2.5,3000,8645,2.0,0,0,2,8,3000,0,1985,0.0,98034,47.7315,-122.22399999999999,1930,8866,5645,0.6529786003470214,9000000,74736025,65736025
499950.0,4,1.75,1520,7700,1.0,0,0,3,7,1520,0,1967,0.0,98034,47.7356,-122.191,1520,7500,6180,0.8025974025974026,2310400,59290000,56979600
160134.0,3,1.5,1190,10116,1.0,0,0,2,7,1190,0,1968,0.0,98042,47.385,-122.085,1190,9905,8926,0.8823645709766706,1416100,102333456,100917356
191000.0,3,1.0,990,8255,1.0,0,0,2,7,990,0,1953,0.0,98148,47.425,-122.331,1180,9750,7265,0.8800726832222895,980100,68145025,67164925
221000.0,3,1.0,1250,7280,1.0,0,0,2,7,1250,0,1965,0.0,98001,47.3414,-122.286,1450,7350,6030,0.8282967032967034,1562500,52998400,51435900
352800.0,4,2.0,2080,6360,1.0,0,0,2,7,1330,750,1960,0.0,98118,47.5392,-122.27799999999999,2080,6741,4280,0.6729559748427673,4326400,40449600,36123200
350000.0,3,2.5,1640,10424,2.0,0,0,2,7,1640,0,1988,0.0,98019,47.7345,-121.977,1560,10101,8784,0.8426707597851113,2689600,108659776,105970176
458000.0,4,1.5,1550,3000,1.5,0,0,2,7,1350,200,1918,0.0,98105,47.6604,-122.324,1710,5535,1450,0.48333333333333334,2402500,9000000,6597500
359950.0,3,1.0,1290,189486,1.0,0,0,3,7,1290,0,1960,0.0,98092,47.3356,-122.15700000000001,2370,98881,188196,0.99319210917957,1664100,35904944196,35903280096
1050000.0,3,3.0,3250,5093,2.0,0,3,2,10,3250,0,2004,0.0,98146,47.5123,-122.39,2820,7752,1843,0.36186923227959944,10562500,25938649,15376149
353000.0,3,1.75,1260,11775,1.0,0,0,4,6,1260,0,1942,0.0,98108,47.5501,-122.296,1270,5480,10515,0.8929936305732484,1587600,138650625,137063025
717550.0,3,3.5,2840,4468,3.0,0,0,2,10,2840,0,2006,0.0,98052,47.7069,-122.117,3040,5400,1628,0.36436884512085943,8065600,19963024,11897424
450000.0,3,2.25,1960,6500,2.0,0,0,3,8,1960,0,1977,0.0,98052,47.6642,-122.12899999999999,1860,6160,4540,0.6984615384615385,3841600,42250000,38408400
167500.0,3,1.0,760,3090,1.0,0,0,1,5,760,0,1903,0.0,98118,47.5513,-122.275,1020,5356,2330,0.7540453074433657,577600,9548100,8970500
550000.0,3,1.75,2240,78225,2.0,0,0,4,8,2240,0,1976,0.0,98070,47.4638,-122.484,2030,202554,75985,0.9713646532438479,5017600,6119150625,6114133025
939000.0,4,2.25,2240,9684,2.0,0,0,3,9,2240,0,1970,0.0,98040,47.5489,-122.225,2440,9618,7444,0.768690623709211,5017600,93779856,88762256
700000.0,3,1.75,1820,15570,1.0,0,2,2,8,1820,0,1948,0.0,98146,47.5068,-122.38600000000001,2490,9480,13750,0.8831085420680796,3312400,242424900,239112500
480000.0,4,3.5,3370,435600,2.0,0,3,2,9,3370,0,2005,0.0,98045,47.4398,-121.738,2790,114868,432230,0.9922635445362719,11356900,189747360000,189736003100
501000.0,3,1.0,1160,4360,1.0,0,0,3,8,1160,0,1929,0.0,98105,47.6718,-122.291,1810,4360,3200,0.7339449541284404,1345600,19009600,17664000
580000.0,3,2.25,1640,8625,1.0,0,0,2,8,1320,320,1987,0.0,98052,47.6772,-122.15299999999999,1770,9476,6985,0.8098550724637681,2689600,74390625,71701025
527550.0,1,0.75,820,59677,1.0,0,0,2,5,820,0,1999,0.0,98065,47.5316,-121.764,1590,14163,58857,0.9862593629036313,672400,3561344329,3560671929
399000.0,4,2.5,2800,4687,2.0,0,0,2,9,2800,0,2005,0.0,98038,47.3594,-122.04,2750,4750,1887,0.4026029443140602,7840000,21967969,14127969
240000.0,3,1.75,1780,5000,1.5,0,0,2,6,1080,700,1957,0.0,98146,47.5105,-122.36,1500,5000,3220,0.644,3168400,25000000,21831600
353000.0,4,2.75,2200,268329,1.0,0,0,2,7,1410,790,1989,0.0,98092,47.3224,-122.12200000000001,2240,58806,266129,0.9918011098315873,4840000,72000452241,71995612241
335000.0,4,2.0,1480,3132,1.0,0,0,4,6,740,740,1910,0.0,98108,47.55,-122.31200000000001,1480,6420,1652,0.5274584929757343,2190400,9809424,7619024
475000.0,3,3.0,2010,2554,2.0,0,0,2,7,1860,150,2001,0.0,98118,47.5525,-122.26899999999999,1370,5100,544,0.21299921691464369,4040100,6522916,2482816
660000.0,3,2.0,2880,5100,1.5,0,0,3,7,2080,800,1926,0.0,98117,47.6805,-122.385,1820,5100,2220,0.43529411764705883,8294400,26010000,17715600
551000.0,3,1.0,940,1948,1.0,0,0,4,6,940,0,1900,0.0,98107,47.6733,-122.383,1700,5000,1008,0.5174537987679672,883600,3794704,2911104
249950.0,4,1.75,1620,10530,1.0,0,0,2,7,1620,0,1968,0.0,98030,47.3808,-122.211,1890,9975,8910,0.8461538461538461,2624400,110880900,108256500
1150000.0,4,3.25,4400,262666,2.0,0,0,2,11,4400,0,1988,0.0,98075,47.5927,-122.064,3240,9791,258266,0.9832486884484478,19360000,68993427556,68974067556
575000.0,3,1.75,1530,6743,1.0,0,0,2,7,1410,120,1955,0.0,98116,47.5745,-122.396,2040,6000,5213,0.7730980275841614,2340900,45468049,43127149
1090000.0,4,2.75,3460,11350,1.0,0,4,3,9,1780,1680,1974,0.0,98006,47.56800000000001,-122.15299999999999,3200,13874,7890,0.6951541850220264,11971600,128822500,116850900
515000.0,4,2.5,2890,7306,2.0,0,0,2,7,2890,0,2006,0.0,98065,47.5447,-121.883,2850,6687,4416,0.604434711196277,8352100,53377636,45025536
235000.0,3,1.5,1980,11214,1.0,0,0,2,7,1980,0,1959,0.0,98168,47.4696,-122.29799999999999,1510,9072,9234,0.8234349919743178,3920400,125753796,121833396
796000.0,3,1.0,1980,3243,1.5,0,0,2,8,1980,0,1912,0.0,98102,47.6429,-122.32700000000001,1380,1249,1263,0.3894542090656799,3920400,10517049,6596649
450000.0,2,1.5,1450,2550,1.0,0,0,2,7,820,630,1984,0.0,98103,47.6911,-122.348,1450,5100,1100,0.43137254901960786,2102500,6502500,4400000
2050000.0,4,3.0,4280,18834,1.0,0,4,4,11,2180,2100,1971,0.0,98116,47.5811,-122.4,2490,8858,14554,0.7727514070298397,18318400,354719556,336401156
270000.0,4,2.5,1810,6509,2.0,0,0,2,7,1810,0,1994,0.0,98042,47.3531,-122.14299999999999,1760,7417,4699,0.721923490551544,3276100,42367081,39090981
1710000.0,3,3.0,2490,27702,2.0,1,4,2,10,2490,0,2000,0.0,98116,47.5596,-122.40299999999999,2580,12119,25212,0.9101147931557289,6200100,767400804,761200704
565000.0,3,1.0,1610,4108,1.5,0,0,4,7,1610,0,1928,0.0,98126,47.5704,-122.376,1680,4467,2498,0.6080817916260954,2592100,16875664,14283564
680000.0,1,2.5,1820,3008,2.0,0,0,2,7,1090,730,1910,2004.0,98103,47.6529,-122.339,1860,3420,1188,0.3949468085106383,3312400,9048064,5735664
5570000.0,5,5.75,9200,35069,2.0,0,0,2,13,6200,3000,2001,0.0,98039,47.6289,-122.23299999999999,3560,24345,25869,0.7376600416322108,84640000,1229834761,1145194761
864500.0,4,2.5,3520,35991,2.0,0,0,3,10,3520,0,1992,0.0,98077,47.7437,-122.035,3210,35991,32471,0.9021977716651385,12390400,1295352081,1282961681
1150000.0,4,2.25,3740,18000,1.0,0,0,3,9,1870,1870,1951,0.0,98177,47.7027,-122.37799999999999,2610,10902,14260,0.7922222222222223,13987600,324000000,310012400
335000.0,3,2.25,2150,30476,2.0,0,0,2,7,2150,0,1991,0.0,98188,47.4605,-122.277,2010,10800,28326,0.9294526840792755,4622500,928786576,924164076
911000.0,4,3.25,3526,15958,2.0,0,0,2,10,3526,0,1997,0.0,98075,47.567,-122.03299999999999,3639,15090,12432,0.7790449931069057,12432676,254657764,242225088
425000.0,2,1.0,1070,6625,1.0,0,0,2,7,830,240,1950,0.0,98116,47.5736,-122.39299999999999,1310,6625,5555,0.8384905660377359,1144900,43890625,42745725
299950.0,3,1.0,1410,81021,1.0,0,0,2,7,1410,0,1949,1981.0,98058,47.4303,-122.06700000000001,2000,81021,79611,0.9825971044544007,1988100,6564402441,6562414341
864000.0,4,2.5,3190,49658,2.0,0,0,2,10,3190,0,1999,0.0,98074,47.6216,-122.015,3040,49658,46468,0.9357606025212453,10176100,2465916964,2455740864
425000.0,2,1.0,1270,6000,1.0,0,0,2,7,1270,0,1939,0.0,98199,47.6482,-122.39299999999999,1770,6000,4730,0.7883333333333333,1612900,36000000,34387100
374950.0,4,1.5,1970,14490,1.5,0,0,3,7,1970,0,1963,0.0,98059,47.4612,-122.069,1880,14880,12520,0.8640441683919945,3880900,209960100,206079200
247000.0,3,2.25,1640,7630,1.0,0,0,3,8,1180,460,1968,0.0,98032,47.3739,-122.29,1930,7630,5990,0.7850589777195282,2689600,58216900,55527300
475000.0,3,1.0,1600,7161,1.0,0,0,2,8,1600,0,1953,0.0,98118,47.5507,-122.26100000000001,1760,8280,5561,0.7765675185030023,2560000,51279921,48719921
275000.0,3,2.5,3020,5868,2.0,0,0,2,7,3020,0,2003,0.0,98092,47.3361,-122.175,2710,5470,2848,0.48534423994546694,9120400,34433424,25313024
355000.0,2,1.0,1350,368517,1.0,0,0,2,6,1350,0,1947,0.0,98077,47.7617,-122.061,2330,104108,367167,0.9963366683219499,1822500,135804779289,135802956789
285000.0,4,1.75,1870,22072,1.0,0,0,2,7,1070,800,1959,0.0,98042,47.3775,-122.165,2100,10185,20202,0.9152772743747735,3496900,487173184,483676284
1340000.0,3,2.75,2730,38869,1.5,0,4,2,9,1940,790,1963,2001.0,98146,47.4857,-122.361,2630,28188,36139,0.9297640793434356,7452900,1510799161,1503346261
325000.0,2,1.0,1100,17817,1.0,0,0,2,7,620,480,1980,0.0,98019,47.7728,-121.9,1790,20009,16717,0.9382612112027838,1210000,317445489,316235489
1670000.0,5,3.5,4320,40816,2.0,0,0,3,11,4320,0,1997,0.0,98004,47.644,-122.185,4320,44584,36496,0.8941591532732261,18662400,1665945856,1647283456
402000.0,3,2.5,2700,9994,1.0,0,3,3,7,1350,1350,1959,0.0,98198,47.397,-122.321,2470,10664,7294,0.729837902741645,7290000,99880036,92590036
1100000.0,3,3.0,3700,16857,1.0,0,0,2,10,2170,1530,2000,0.0,98117,47.6956,-122.39200000000001,2320,12000,13157,0.7805066144628344,13690000,284158449,270468449
375000.0,4,1.75,2190,9225,1.0,0,0,3,7,1250,940,1959,0.0,98028,47.7396,-122.256,2190,9225,7035,0.7626016260162601,4796100,85100625,80304525
396000.0,5,2.75,2840,12253,1.0,0,0,2,7,1420,1420,1960,0.0,98028,47.7618,-122.25299999999999,2210,11620,9413,0.7682200277483066,8065600,150136009,142070409
320000.0,4,2.75,2610,9077,1.0,0,0,3,8,1310,1300,1987,0.0,98058,47.4612,-122.147,1900,10500,6467,0.7124600638977636,6812100,82391929,75579829
610000.0,3,2.5,2630,5827,2.0,0,0,2,8,2630,0,2001,0.0,98053,47.688,-122.038,2330,4715,3197,0.548652823065042,6916900,33953929,27037029
249950.0,3,1.5,1090,7698,1.0,0,0,4,7,1090,0,1966,0.0,98058,47.4553,-122.17399999999999,1540,7624,6608,0.8584047804624578,1188100,59259204,58071104
675000.0,4,3.5,3090,100835,2.0,0,0,2,9,3090,0,1999,0.0,98092,47.3087,-122.088,2400,50543,97745,0.9693558784152329,9548100,10167697225,10158149125
448000.0,2,2.0,1670,7772,1.0,0,0,3,6,860,810,1919,0.0,98126,47.5461,-122.37700000000001,1300,7770,6102,0.7851260936695831,2788900,60403984,57615084
819000.0,3,1.0,1300,3600,2.0,0,0,2,7,1300,0,1900,0.0,98119,47.6345,-122.366,2510,4800,2300,0.6388888888888888,1690000,12960000,11270000
1250000.0,3,2.5,3670,18505,1.0,0,4,2,10,2530,1140,1983,0.0,98177,47.7588,-122.376,2920,20000,14835,0.8016752229127263,13468900,342435025,328966125
225000.0,4,2.5,1700,6031,2.0,0,0,2,8,1700,0,1994,0.0,98030,47.3582,-122.191,1930,6035,4331,0.7181230310064666,2890000,36372961,33482961
790000.0,2,3.0,2560,982278,1.0,0,0,2,8,2560,0,2004,0.0,98014,47.6955,-121.861,1620,40946,979718,0.9973938131567641,6553600,964870069284,964863515684
685000.0,4,2.5,2770,6000,2.0,0,0,2,8,2400,370,1993,0.0,98136,47.5536,-122.383,2120,6000,3230,0.5383333333333333,7672900,36000000,28327100
812000.0,3,3.25,3240,8338,2.0,0,0,2,9,3240,0,2001,0.0,98074,47.6321,-122.064,3420,8405,5098,0.6114176061405613,10497600,69522244,59024644
705000.0,2,2.5,2300,6400,1.0,0,0,2,8,2300,0,2007,0.0,98053,47.7196,-122.02,2300,6400,4100,0.640625,5290000,40960000,35670000
360000.0,4,3.0,2483,6870,2.0,0,0,2,8,2483,0,2005,0.0,98030,47.3627,-122.199,1943,6434,4387,0.6385735080058225,6165289,47196900,41031611
344000.0,1,1.5,760,779,3.0,0,0,2,8,760,0,2006,0.0,98107,47.6715,-122.382,1290,1189,19,0.024390243902439025,577600,606841,29241
825000.0,4,1.5,2040,6900,2.0,0,0,2,9,2040,0,1903,0.0,98112,47.6188,-122.285,3150,8220,4860,0.7043478260869566,4161600,47610000,43448400
476500.0,3,1.0,1200,6120,1.0,0,0,3,7,950,250,1945,0.0,98115,47.6929,-122.287,1550,6120,4920,0.803921568627451,1440000,37454400,36014400
379500.0,2,1.0,960,5096,1.0,0,0,4,7,960,0,1949,0.0,98126,47.5314,-122.37799999999999,1760,4488,4136,0.8116169544740973,921600,25969216,25047616
620000.0,3,1.75,2410,35236,1.0,0,0,2,8,2410,0,1980,0.0,98072,47.7651,-122.166,2110,16980,32826,0.9316040413213759,5808100,1241575696,1235767596
477590.0,3,3.25,2260,7701,2.0,0,0,2,8,1760,500,2000,0.0,98146,47.5053,-122.37700000000001,1880,7529,5441,0.7065316192702247,5107600,59305401,54197801
490000.0,3,1.0,1910,8190,1.0,0,0,3,7,1010,900,1946,0.0,98117,47.696999999999996,-122.365,1600,5042,6280,0.7667887667887668,3648100,67076100,63428000
470000.0,3,1.5,1500,5000,1.5,0,0,3,7,1140,360,1927,0.0,98117,47.678999999999995,-122.37299999999999,1500,5000,3500,0.7,2250000,25000000,22750000
500000.0,3,2.25,1360,1236,2.0,0,0,2,8,1140,220,2006,0.0,98112,47.6198,-122.29899999999999,1620,1231,-124,-0.10032362459546926,1849600,1527696,-321904
370000.0,3,1.0,1320,7341,1.0,0,0,2,7,1320,0,1982,0.0,98155,47.7367,-122.295,1160,7573,6021,0.8201879852881079,1742400,53890281,52147881
790000.0,2,1.5,1940,4400,1.0,0,0,2,7,970,970,1923,0.0,98112,47.6371,-122.279,1480,3080,2460,0.5590909090909091,3763600,19360000,15596400
725000.0,4,2.5,2650,18295,2.0,0,0,2,8,2650,0,1986,0.0,98005,47.6075,-122.154,2230,19856,15645,0.8551516807871004,7022500,334707025,327684525
840000.0,4,2.75,3040,2800,2.0,0,0,2,9,2100,940,1906,0.0,98102,47.6245,-122.32700000000001,1260,2178,-240,-0.08571428571428572,9241600,7840000,-1401600
390000.0,3,1.0,1240,11108,1.0,0,0,3,7,1240,0,1952,0.0,98166,47.4465,-122.354,2220,16533,9868,0.8883687432481094,1537600,123387664,121850064
507000.0,3,2.25,2210,11585,1.0,0,0,3,7,1510,700,1958,0.0,98155,47.7574,-122.279,1870,14092,9375,0.8092360811394044,4884100,134212225,129328125
263500.0,3,1.75,1540,6273,1.0,0,0,3,6,770,770,1951,0.0,98118,47.5305,-122.277,1140,5512,4733,0.7545034273872151,2371600,39350529,36978929
369000.0,3,2.5,1320,1683,2.0,0,0,2,8,1270,50,2004,0.0,98106,47.5357,-122.365,1320,2206,363,0.21568627450980393,1742400,2832489,1090089
500000.0,3,2.5,3040,5326,2.0,0,0,2,9,3040,0,2008,0.0,98055,47.4472,-122.20700000000001,3040,5442,2286,0.4292151708599324,9241600,28366276,19124676
570000.0,2,1.0,910,4301,1.0,0,0,3,7,910,0,1923,0.0,98117,47.6814,-122.399,1810,4301,3391,0.788421297372704,828100,18498601,17670501
284000.0,4,3.0,2040,7145,1.0,0,0,2,8,1490,550,1994,0.0,98092,47.3275,-122.171,1940,7145,5105,0.7144856543037089,4161600,51051025,46889425
415000.0,2,1.0,980,4108,1.0,0,0,2,7,980,0,1947,0.0,98117,47.687,-122.381,1500,4046,3128,0.7614410905550146,960400,16875664,15915264
197500.0,3,1.0,980,3090,1.5,0,0,2,6,980,0,1903,0.0,98118,47.5525,-122.277,980,3090,2110,0.6828478964401294,960400,9548100,8587700
925000.0,4,3.75,4420,9492,2.0,0,1,2,9,3420,1000,1962,0.0,98125,47.7211,-122.28299999999999,2880,9900,5072,0.5343447113358618,19536400,90098064,70561664
468000.0,3,2.0,1570,6300,1.0,0,0,2,7,820,750,1953,2005.0,98118,47.5565,-122.275,1510,4281,4730,0.7507936507936508,2464900,39690000,37225100
355000.0,3,1.0,1600,5001,1.5,0,0,4,6,1080,520,1930,0.0,98125,47.7232,-122.289,1340,5001,3401,0.6800639872025595,2560000,25010001,22450001
639000.0,4,1.75,1830,6000,1.0,0,0,3,7,930,900,1939,0.0,98199,47.6536,-122.41,1540,6000,4170,0.695,3348900,36000000,32651100
720000.0,3,2.5,2820,14250,2.0,0,0,2,11,2820,0,1991,0.0,98074,47.6396,-122.054,2820,12600,11430,0.8021052631578948,7952400,203062500,195110100
381000.0,3,1.75,1800,6000,1.0,0,0,4,6,900,900,1950,0.0,98155,47.7505,-122.31700000000001,1060,6628,4200,0.7,3240000,36000000,32760000
1050000.0,3,4.0,4380,42769,2.0,0,0,4,11,4380,0,1983,0.0,98052,47.7167,-122.109,3630,35425,38389,0.8975893754822418,19184400,1829187361,1810002961
670000.0,3,3.0,2980,3730,2.0,0,0,2,9,2980,0,2005,0.0,98029,47.5533,-121.995,2710,3640,750,0.20107238605898123,8880400,13912900,5032500
400000.0,3,1.0,1690,6658,1.0,0,0,2,7,1690,0,1942,1982.0,98133,47.7099,-122.35,1080,5925,4968,0.7461700210273355,2856100,44328964,41472864
910000.0,4,3.5,4040,50479,2.0,0,0,2,11,4040,0,1987,0.0,98077,47.7196,-122.04799999999999,3770,40899,46439,0.9199667188335744,16321600,2548129441,2531807841
294000.0,3,1.0,1250,9427,1.0,0,0,2,6,1250,0,1931,0.0,98034,47.7254,-122.175,1590,8250,8177,0.8674021427813726,1562500,88868329,87305829
315001.0,3,1.75,1500,10230,1.0,0,0,1,7,1500,0,1968,0.0,98058,47.4349,-122.16799999999999,1770,8374,8730,0.8533724340175953,2250000,104652900,102402900
360000.0,3,2.0,1630,10723,1.0,0,0,4,7,1630,0,1959,0.0,98059,47.4898,-122.133,1450,10723,9093,0.8479903012216731,2656900,114982729,112325829
520000.0,3,2.0,1410,2700,2.0,0,0,3,7,1410,0,1902,0.0,98122,47.6029,-122.302,1750,4000,1290,0.4777777777777778,1988100,7290000,5301900
474000.0,3,1.0,1140,4560,1.0,0,0,3,6,770,370,1944,0.0,98117,47.6889,-122.36200000000001,1340,3980,3420,0.75,1299600,20793600,19494000
702000.0,4,2.5,3280,5876,2.0,0,0,2,7,3280,0,2004,0.0,98053,47.6802,-122.03399999999999,2600,5000,2596,0.44179714091218514,10758400,34527376,23768976
728000.0,4,3.5,3490,87497,2.0,0,0,2,9,3490,0,2001,0.0,98038,47.4028,-122.00200000000001,2400,55657,84007,0.9601129181571939,12180100,7655725009,7643544909
308000.0,4,2.5,2020,7277,2.0,0,0,2,8,2020,0,1993,0.0,98055,47.4318,-122.19,2820,7284,5257,0.7224130823141405,4080400,52954729,48874329
2000000.0,5,4.0,4580,4443,3.0,1,4,2,10,4580,0,2004,0.0,98075,47.5682,-122.059,2710,4443,-137,-0.030835021381949133,20976400,19740249,-1236151
340000.0,3,2.5,2270,7917,2.0,0,0,2,8,2270,0,1986,0.0,98092,47.2643,-122.22,2160,7917,5647,0.7132752305166098,5152900,62678889,57525989
306500.0,2,1.75,1310,10200,1.0,0,0,3,6,1310,0,1947,0.0,98065,47.5231,-121.82,1500,7200,8890,0.8715686274509804,1716100,104040000,102323900
716000.0,3,2.0,1420,3600,1.5,0,0,3,7,1420,0,1904,0.0,98119,47.6367,-122.36399999999999,1250,3600,2180,0.6055555555555555,2016400,12960000,10943600
950000.0,4,3.0,2980,44431,2.0,0,0,1,10,2640,340,1981,0.0,98034,47.7154,-122.161,2010,7332,41451,0.9329297112376493,8880400,1974113761,1965233361
673200.0,5,3.0,4180,8561,2.0,0,0,2,7,4180,0,2003,0.0,98053,47.6833,-122.04,3425,6591,4381,0.5117392827940661,17472400,73290721,55818321
564500.0,4,2.25,1950,6000,1.0,0,0,2,7,1350,600,1961,0.0,98115,47.6909,-122.301,1980,6000,4050,0.675,3802500,36000000,32197500
393000.0,4,1.75,1790,11801,1.0,0,0,3,8,1790,0,1974,0.0,98056,47.5172,-122.17,2000,12988,10011,0.8483179391576985,3204100,139263601,136059501
425000.0,5,1.75,1400,5071,1.0,0,0,2,5,1400,0,1916,0.0,98014,47.6499,-121.90799999999999,1200,7500,3671,0.7239203312956024,1960000,25715041,23755041
150000.0,3,1.0,1320,24684,1.0,0,0,2,7,1320,0,1979,0.0,98168,47.4771,-122.322,1120,21214,23364,0.946524064171123,1742400,609299856,607557456
327000.0,4,2.25,1620,106722,1.0,0,0,2,8,1200,420,1980,0.0,98042,47.3394,-122.09100000000001,1620,38400,105102,0.9848203744307641,2624400,11389585284,11386960884
444900.0,4,2.5,3120,7448,2.0,0,0,2,9,3120,0,1998,0.0,98042,47.3645,-122.126,2980,8102,4328,0.5810955961331902,9734400,55472704,45738304
305000.0,4,2.5,2100,14773,2.0,0,0,2,8,2100,0,1998,0.0,98023,47.3045,-122.391,2370,15440,12673,0.8578487781764029,4410000,218241529,213831529
469000.0,3,3.25,1370,1194,3.0,0,0,2,8,1370,0,2004,0.0,98107,47.6718,-122.38799999999999,1800,2678,-176,-0.1474036850921273,1876900,1425636,-451264
525000.0,3,1.75,1520,7875,1.0,0,0,4,8,1520,0,1969,0.0,98006,47.5569,-122.176,2150,9428,6355,0.806984126984127,2310400,62015625,59705225
330000.0,3,2.5,2410,17424,1.0,0,0,2,7,1630,780,1978,0.0,98030,47.3741,-122.21799999999999,1530,11761,15014,0.8616850321395776,5808100,303595776,297787676
618000.0,4,1.0,1260,4080,1.0,0,0,3,7,1260,0,1911,0.0,98105,47.6644,-122.324,1340,4080,2820,0.6911764705882353,1587600,16646400,15058800
295500.0,4,2.5,2830,7350,1.0,0,0,2,8,1690,1140,1982,0.0,98023,47.3088,-122.34100000000001,2350,7768,4520,0.6149659863945578,8008900,54022500,46013600
567035.0,3,2.0,2064,46173,2.0,0,0,4,7,2064,0,1903,0.0,98070,47.4469,-122.455,1640,21780,44109,0.9552985511012929,4260096,2131945929,2127685833
518000.0,4,2.25,2640,34870,1.0,0,0,2,8,1770,870,1977,0.0,98027,47.4688,-122.009,2500,35580,32230,0.9242902208201893,6969600,1215916900,1208947300
303000.0,2,1.0,1020,9200,1.0,0,0,2,7,1020,0,1978,0.0,98045,47.4461,-121.76899999999999,1520,9600,8180,0.8891304347826087,1040400,84640000,83599600
300000.0,4,2.5,2200,8065,2.0,0,0,2,7,2200,0,1998,0.0,98031,47.4042,-122.213,2641,8535,5865,0.7272163670179789,4840000,65044225,60204225
413107.0,3,1.5,1420,7520,1.0,0,0,3,7,1420,0,1956,0.0,98007,47.601000000000006,-122.134,2000,7520,6100,0.8111702127659575,2016400,56550400,54534000
400000.0,3,1.0,1350,3090,1.5,0,0,4,6,1350,0,1914,0.0,98103,47.681999999999995,-122.348,1350,3090,1740,0.5631067961165048,1822500,9548100,7725600
535000.0,3,1.0,1290,6859,1.0,0,0,3,7,1290,0,1941,0.0,98136,47.5317,-122.387,1560,6369,5569,0.8119259367254702,1664100,47045881,45381781
555000.0,4,2.0,1680,2600,1.0,0,0,4,7,840,840,1915,0.0,98107,47.6648,-122.363,1680,3340,920,0.35384615384615387,2822400,6760000,3937600
312000.0,3,2.5,2280,6386,2.0,0,0,2,8,2280,0,2008,0.0,98042,47.3861,-122.096,2550,4835,4106,0.6429689946758534,5198400,40780996,35582596
785200.0,3,2.25,1840,3500,1.5,0,0,4,8,1540,300,1910,0.0,98122,47.6063,-122.292,1800,3300,1660,0.4742857142857143,3385600,12250000,8864400
749000.0,4,2.0,2040,11850,1.0,0,2,2,7,1020,1020,1959,0.0,98033,47.6891,-122.208,2040,8504,9810,0.8278481012658228,4161600,140422500,136260900
285000.0,3,1.5,1490,10367,1.0,0,0,2,7,1010,480,1957,0.0,98146,47.4973,-122.34700000000001,1000,8254,8877,0.8562747178547313,2220100,107474689,105254589
425000.0,4,2.5,2440,5088,2.0,0,0,2,7,2440,0,2007,0.0,98065,47.5406,-121.889,2440,5762,2648,0.5204402515723271,5953600,25887744,19934144
360000.0,3,2.0,1930,15540,1.0,0,0,2,8,1260,670,1958,0.0,98155,47.7675,-122.307,1900,12123,13610,0.8758043758043758,3724900,241491600,237766700
260000.0,3,1.0,1200,6615,1.0,0,0,3,7,1200,0,1954,0.0,98106,47.5168,-122.351,1230,6615,5415,0.81859410430839,1440000,43758225,42318225
369000.0,3,2.0,1550,8509,1.0,0,0,2,7,1150,400,1959,0.0,98106,47.5299,-122.344,1840,7620,6959,0.817839934187331,2402500,72403081,70000581
275000.0,4,2.5,2180,11132,1.0,0,0,3,8,1620,560,1978,0.0,98023,47.3187,-122.367,1950,13801,8952,0.8041681638519583,4752400,123921424,119169024
407000.0,3,2.25,1430,1448,3.0,0,0,2,8,1430,0,2005,0.0,98103,47.6916,-122.34100000000001,1430,1383,18,0.012430939226519336,2044900,2096704,51804
575000.0,2,1.75,1230,5418,1.0,0,0,2,8,990,240,1949,0.0,98117,47.6839,-122.376,1330,5074,4188,0.7729789590254706,1512900,29354724,27841824
1240000.0,3,1.5,1670,3852,2.0,0,3,3,8,1670,0,1928,0.0,98119,47.6411,-122.37100000000001,2320,4572,2182,0.5664589823468328,2788900,14837904,12049004
875000.0,2,2.5,2720,4913,1.0,0,1,3,8,1700,1020,1936,0.0,98199,47.6384,-122.404,2520,5303,2193,0.4463667820069204,7398400,24137569,16739169
320000.0,4,1.5,2220,6811,1.0,0,0,3,7,1270,950,1961,0.0,98056,47.5059,-122.193,1800,7350,4591,0.6740566730289238,4928400,46389721,41461321
810000.0,3,1.5,1520,9041,1.0,0,0,3,7,1520,0,1954,0.0,98004,47.6158,-122.213,3260,10020,7521,0.831877004756111,2310400,81739681,79429281
274000.0,3,1.75,1590,7620,1.0,0,0,3,7,1090,500,1984,0.0,98038,47.3655,-122.04799999999999,1590,7620,6030,0.7913385826771654,2528100,58064400,55536300
239900.0,4,1.75,1480,9523,1.0,0,0,2,7,1120,360,1959,0.0,98030,47.3732,-122.21700000000001,1590,8300,8043,0.8445867898771395,2190400,90687529,88497129
450000.0,4,1.5,1860,7808,1.0,0,0,2,7,1080,780,1953,0.0,98125,47.7314,-122.3,1530,7884,5948,0.7617827868852459,3459600,60964864,57505264
263400.0,4,2.0,1360,60548,1.0,0,0,2,6,960,400,1960,0.0,98001,47.2718,-122.265,1930,28800,59188,0.9775384818656273,1849600,3666060304,3664210704
265000.0,3,1.0,1360,5967,1.0,0,0,2,6,1360,0,1954,0.0,98178,47.4973,-122.256,1360,6052,4607,0.7720797720797721,1849600,35605089,33755489
418000.0,4,3.0,2360,6250,1.0,0,2,2,7,1460,900,1960,0.0,98118,47.512,-122.249,2500,6250,3890,0.6224,5569600,39062500,33492900
390000.0,3,2.0,2360,5737,2.0,0,0,2,8,2360,0,2003,0.0,98028,47.7633,-122.262,1600,9163,3377,0.5886351751786648,5569600,32913169,27343569
430000.0,3,2.0,1860,7500,1.0,0,0,2,7,930,930,1909,0.0,98106,47.5662,-122.36399999999999,1000,5000,5640,0.752,3459600,56250000,52790400
1440000.0,3,2.25,2630,9705,2.5,0,2,3,8,2630,0,1987,0.0,98052,47.6485,-122.12100000000001,2640,14284,7075,0.729005667181865,6916900,94187025,87270125
297000.0,2,1.75,1280,37373,1.0,0,0,3,7,1280,0,1996,0.0,98022,47.2631,-122.01899999999999,2180,48351,36093,0.9657506756214379,1638400,1396741129,1395102729
650000.0,4,2.25,2330,7220,2.0,0,0,2,8,1600,730,1988,0.0,98177,47.7764,-122.38600000000001,2220,9100,4890,0.6772853185595568,5428900,52128400,46699500
195000.0,2,1.0,720,18000,1.0,0,0,2,6,720,0,1950,0.0,98178,47.5054,-122.26100000000001,1250,7925,17280,0.96,518400,324000000,323481600
554000.0,3,3.5,3380,108900,2.0,0,0,2,9,2700,680,1999,0.0,98058,47.4316,-122.075,2250,130680,105520,0.9689623507805326,11424400,11859210000,11847785600
550000.0,3,2.0,3650,843309,2.0,0,0,3,7,3650,0,1991,0.0,98070,47.3627,-122.49600000000001,1870,273992,839659,0.9956718118744138,13322500,711170069481,711156746981
700000.0,3,1.75,1640,4590,1.5,0,0,4,7,1640,0,1951,0.0,98115,47.6846,-122.294,1760,5100,2950,0.6427015250544662,2689600,21068100,18378500
300000.0,4,1.0,1730,177657,1.5,0,0,2,5,1730,0,1948,0.0,98065,47.5163,-121.829,1400,45175,175927,0.9902621343375155,2992900,31562009649,31559016749
315000.0,2,1.0,1030,8576,1.5,0,0,4,6,1030,0,1952,0.0,98155,47.7352,-122.295,1310,8504,7546,0.8798973880597015,1060900,73547776,72486876
603000.0,3,1.0,1790,5250,1.0,0,0,2,7,1400,390,1943,0.0,98105,47.6627,-122.27600000000001,1790,5250,3460,0.659047619047619,3204100,27562500,24358400
530000.0,2,1.0,840,3400,1.0,0,2,3,7,840,0,1924,0.0,98119,47.6403,-122.37200000000001,2000,4000,2560,0.7529411764705882,705600,11560000,10854400
397500.0,3,1.75,1300,8480,1.0,0,0,2,7,1300,0,1969,0.0,98052,47.6991,-122.13,1740,7280,7180,0.8466981132075472,1690000,71910400,70220400
221000.0,3,1.0,1240,5250,1.5,0,0,3,6,1240,0,1904,0.0,98055,47.4917,-122.206,1240,5250,4010,0.7638095238095238,1537600,27562500,26024900
466000.0,4,2.25,2170,8050,1.0,0,0,2,7,1220,950,1976,0.0,98072,47.7354,-122.17399999999999,1820,7700,5880,0.7304347826086957,4708900,64802500,60093600
197500.0,3,1.0,1330,5412,2.0,0,0,4,7,1330,0,1905,0.0,98022,47.2053,-121.993,1710,10825,4082,0.754249815225425,1768900,29289744,27520844
280000.0,3,3.0,1390,1080,2.0,0,0,2,7,1140,250,2006,0.0,98118,47.5325,-122.28200000000001,1450,1461,-310,-0.28703703703703703,1932100,1166400,-765700
412000.0,2,1.5,1240,3873,1.0,0,0,3,6,860,380,1909,0.0,98116,47.5752,-122.38799999999999,1240,4336,2633,0.6798347534211205,1537600,15000129,13462529
454000.0,2,1.0,880,6731,1.0,0,0,3,7,880,0,1950,0.0,98116,47.5694,-122.395,1240,6731,5851,0.8692616253157035,774400,45306361,44531961
540000.0,4,2.25,2540,228254,1.0,0,0,2,8,1450,1090,1990,0.0,98019,47.718999999999994,-121.912,1780,59241,225714,0.9888720460539574,6451600,52099888516,52093436916
250000.0,5,1.5,2520,5753,1.5,0,0,3,7,1510,1010,1928,0.0,98022,47.2058,-121.99700000000001,1620,6875,3233,0.5619676690422388,6350400,33097009,26746609
900000.0,5,2.25,2510,35691,1.0,0,0,2,9,2510,0,1967,0.0,98005,47.6435,-122.154,3160,35037,33181,0.9296741475441989,6300100,1273847481,1267547381
245000.0,5,1.75,2020,7902,1.0,0,0,2,7,1220,800,1962,0.0,98168,47.51,-122.32700000000001,2220,8819,5882,0.7443685143001771,4080400,62441604,58361204
290000.0,3,1.75,2060,7251,1.0,0,0,2,7,1350,710,1987,0.0,98030,47.3569,-122.175,1520,7582,5191,0.7159012549993105,4243600,52577001,48333401
160000.0,2,1.0,930,7742,1.0,0,0,2,6,930,0,1933,0.0,98168,47.507,-122.302,2240,8723,6812,0.8798760010333248,864900,59938564,59073664
1260000.0,2,1.5,2700,7225,1.5,0,4,2,8,1660,1040,1910,2008.0,98116,47.5892,-122.383,2970,5150,4525,0.6262975778546713,7290000,52200625,44910625
325000.0,2,1.0,1060,6050,1.0,0,0,2,7,940,120,1939,0.0,98125,47.7028,-122.321,1540,5279,4990,0.824793388429752,1123600,36602500,35478900
185000.0,2,1.0,670,6750,1.0,0,0,3,5,670,0,1947,0.0,98188,47.4521,-122.28299999999999,1700,11520,6080,0.9007407407407407,448900,45562500,45113600
477000.0,3,2.0,1750,4990,1.0,0,0,2,7,950,800,1916,0.0,98107,47.6667,-122.361,1700,5000,3240,0.6492985971943888,3062500,24900100,21837600
100000.0,2,1.0,930,7623,1.0,0,0,1,6,930,0,1942,0.0,98166,47.467,-122.34899999999999,1300,7641,6693,0.8780007870916962,864900,58110129,57245229
345000.0,4,2.5,2420,11481,1.0,0,0,2,8,1370,1050,1985,0.0,98003,47.341,-122.318,2290,8985,9061,0.789216967163139,5856400,131813361,125956961
530000.0,4,2.25,2410,14985,1.0,0,1,3,7,1950,460,1965,0.0,98166,47.4278,-122.34299999999999,2510,15256,12575,0.8391725058391725,5808100,224550225,218742125
203000.0,3,1.0,1150,7156,1.0,0,0,3,6,1150,0,1953,0.0,98168,47.4864,-122.31700000000001,1210,7156,6006,0.8392956959195081,1322500,51208336,49885836
599000.0,4,2.5,2480,5000,2.0,0,0,2,7,2480,0,2004,0.0,98053,47.6811,-122.035,2410,5000,2520,0.504,6150400,25000000,18849600
370000.0,4,1.0,1310,6000,1.5,0,0,2,7,1310,0,1940,0.0,98144,47.5822,-122.295,1630,6000,4690,0.7816666666666666,1716100,36000000,34283900
140000.0,3,1.0,1240,8000,1.0,0,0,3,6,1040,200,1954,0.0,98198,47.4204,-122.316,1240,8000,6760,0.845,1537600,64000000,62462400
500000.0,3,1.0,1150,5100,2.0,0,0,2,8,1150,0,1911,2005.0,98136,47.5349,-122.384,1440,5100,3950,0.7745098039215687,1322500,26010000,24687500
527200.0,3,1.75,1460,4000,1.0,0,2,3,7,730,730,1929,0.0,98144,47.5768,-122.307,1360,4000,2540,0.635,2131600,16000000,13868400
549900.0,5,2.75,3060,7015,1.0,0,0,4,8,1600,1460,1979,0.0,98146,47.5052,-122.37200000000001,2190,7600,3955,0.5637918745545261,9363600,49210225,39846625
760000.0,4,2.5,3520,8095,2.0,0,0,2,9,3520,0,2006,0.0,98052,47.7065,-122.109,2460,4676,4575,0.5651636812847437,12390400,65529025,53138625
319000.0,2,1.0,960,4400,1.0,0,0,3,7,960,0,1951,0.0,98118,47.5269,-122.264,1520,5000,3440,0.7818181818181819,921600,19360000,18438400
362300.0,3,2.5,2430,15264,2.0,0,0,2,8,2430,0,1997,0.0,98030,47.3805,-122.208,2260,10416,12834,0.8408018867924528,5904900,232989696,227084796
421000.0,3,2.5,1930,4505,1.0,0,3,3,7,1440,490,1973,0.0,98198,47.3459,-122.32600000000001,1550,4505,2575,0.5715871254162043,3724900,20295025,16570125
690000.0,3,1.0,1090,4000,1.5,0,0,3,7,1090,0,1945,0.0,98117,47.6846,-122.38600000000001,1520,4000,2910,0.7275,1188100,16000000,14811900
640000.0,3,2.5,2790,31798,1.0,0,0,4,8,1650,1140,1953,0.0,98027,47.5241,-122.039,1400,14849,29008,0.9122586326184037,7784100,1011112804,1003328704
238000.0,4,1.75,1650,6900,1.0,0,0,2,7,910,740,1978,1993.0,98002,47.2802,-122.211,1540,7645,5250,0.7608695652173914,2722500,47610000,44887500
789000.0,3,3.0,3740,39640,2.0,0,2,2,10,3740,0,1991,0.0,98070,47.4036,-122.462,2930,26136,35900,0.9056508577194753,13987600,1571329600,1557342000
1050000.0,6,4.0,5310,12741,2.0,0,2,2,10,3600,1710,1967,0.0,98040,47.5696,-122.213,4190,12632,7431,0.5832352248646103,28196100,162333081,134136981
302500.0,3,2.5,1690,4476,2.0,0,0,2,7,1690,0,2008,0.0,98042,47.3663,-122.11399999999999,2250,4488,2786,0.6224307417336908,2856100,20034576,17178476
259950.0,4,1.75,1400,7920,1.0,0,0,2,7,1400,0,1963,0.0,98058,47.4658,-122.184,1910,7700,6520,0.8232323232323232,1960000,62726400,60766400
456000.0,3,1.5,1440,28516,1.0,0,0,3,7,1440,0,1975,0.0,98075,47.5829,-122.005,2080,27049,27076,0.949502033945855,2073600,813162256,811088656
369950.0,3,2.5,1360,3718,2.0,0,0,2,7,1360,0,1987,0.0,98052,47.6827,-122.09700000000001,1090,3718,2358,0.6342119419042496,1849600,13823524,11973924
363750.0,3,1.75,1726,197326,2.0,0,0,3,7,1726,0,1982,0.0,98070,47.3484,-122.505,2114,99316,195600,0.9912530533229276,2979076,38937550276,38934571200
585000.0,3,1.75,2220,216493,1.0,0,2,2,8,2220,0,1989,0.0,98014,47.6624,-121.95100000000001,2900,169884,214273,0.989745626879391,4928400,46869219049,46864290649
268000.0,3,2.5,1850,6676,2.0,0,0,2,7,1850,0,1986,0.0,98023,47.3103,-122.36,1700,6663,4826,0.7228879568603954,3422500,44568976,41146476
1200000.0,5,2.5,2860,4000,2.0,0,0,3,8,2160,700,1910,0.0,98102,47.6225,-122.318,1340,1224,1140,0.285,8179600,16000000,7820400
345000.0,3,1.0,1120,10176,1.0,0,0,2,6,920,200,1905,0.0,98118,47.5235,-122.277,1350,7500,9056,0.889937106918239,1254400,103550976,102296576
539000.0,4,2.5,2340,19850,2.0,0,0,2,9,2340,0,1993,0.0,98155,47.7672,-122.306,1930,15439,17510,0.8821158690176323,5475600,394022500,388546900
851000.0,5,3.25,3760,9792,2.0,0,0,2,9,2550,1210,1984,0.0,98006,47.5654,-122.115,2960,16500,6032,0.6160130718954249,14137600,95883264,81745664
900000.0,3,2.5,1920,7200,2.0,0,2,2,10,1780,140,1997,0.0,98116,47.5709,-122.40799999999999,2080,5000,5280,0.7333333333333333,3686400,51840000,48153600
850000.0,3,2.5,3230,5000,2.0,0,2,4,8,2430,800,1945,0.0,98117,47.7011,-122.389,1820,5000,1770,0.354,10432900,25000000,14567100
390000.0,3,1.75,1260,6500,1.0,0,0,3,7,1260,0,1966,0.0,98008,47.6224,-122.116,1500,7700,5240,0.8061538461538461,1587600,42250000,40662400
345000.0,3,1.75,1540,6909,1.0,0,0,3,7,920,620,1955,0.0,98155,47.7451,-122.31299999999999,1130,6908,5369,0.7771023302938197,2371600,47734281,45362681
534500.0,3,2.5,1700,3150,2.0,0,0,2,8,1700,0,2005,0.0,98029,47.5505,-121.99799999999999,1700,3600,1450,0.4603174603174603,2890000,9922500,7032500
643500.0,6,5.25,3600,3960,2.0,0,0,2,7,2400,1200,1971,0.0,98126,47.5656,-122.37200000000001,1450,4600,360,0.09090909090909091,12960000,15681600,2721600
1210000.0,3,2.75,3150,5520,1.5,0,0,3,8,2130,1020,1925,0.0,98112,47.6345,-122.302,3160,6200,2370,0.42934782608695654,9922500,30470400,20547900
495000.0,2,1.75,1280,4000,1.0,0,0,3,7,730,550,1929,0.0,98116,47.5798,-122.383,2250,5382,2720,0.68,1638400,16000000,14361600
535000.0,2,1.0,980,4120,1.0,0,0,2,7,830,150,1950,2014.0,98115,47.6815,-122.291,1760,4120,3140,0.7621359223300971,960400,16974400,16014000
435000.0,4,2.5,2190,6578,2.0,0,0,2,7,2190,0,2004,0.0,98065,47.5305,-121.84700000000001,2190,5416,4388,0.6670720583764062,4796100,43270084,38473984
305000.0,4,2.0,2470,1831,2.0,0,0,2,7,1970,500,2009,0.0,98166,47.4645,-122.337,1310,7500,-639,-0.3489896231567449,6100900,3352561,-2748339
799000.0,4,2.5,2590,7910,2.0,0,0,2,9,2590,0,2001,0.0,98115,47.6978,-122.28399999999999,1700,7488,5320,0.672566371681416,6708100,62568100,55860000
700000.0,4,2.5,2580,15031,2.0,0,0,2,9,2580,0,1999,0.0,98052,47.6895,-122.094,3030,10361,12451,0.8283547335506619,6656400,225930961,219274561
467000.0,3,2.25,1270,1213,2.0,0,0,2,8,1040,230,2005,0.0,98107,47.6736,-122.375,1410,1265,-57,-0.04699093157460841,1612900,1471369,-141531
263000.0,3,1.0,1250,7560,1.0,0,0,2,6,1250,0,1959,0.0,98058,47.4493,-122.17299999999999,1270,7615,6310,0.8346560846560847,1562500,57153600,55591100
760000.0,4,2.5,4660,7157,2.0,0,0,2,9,3020,1640,2003,0.0,98059,47.5352,-122.156,3300,7047,2497,0.3488891993852173,21715600,51222649,29507049
293000.0,4,2.5,2019,4435,2.0,0,3,2,8,2019,0,2008,0.0,98022,47.1958,-121.97399999999999,1950,4800,2416,0.5447576099210824,4076361,19669225,15592864
245000.0,3,2.0,1490,7929,1.0,0,0,2,7,1490,0,1989,0.0,98002,47.2875,-122.21799999999999,1650,7929,6439,0.8120822297893807,2220100,62869041,60648941
181000.0,2,1.5,1560,10807,1.0,0,0,1,7,1560,0,1949,0.0,98070,47.4444,-122.509,1660,196591,9247,0.8556491163135005,2433600,116791249,114357649
240000.0,3,1.0,1030,15264,1.0,0,0,3,7,1030,0,1962,0.0,98056,47.5016,-122.16799999999999,1430,14840,14234,0.932520964360587,1060900,232989696,231928796
880000.0,4,2.75,2560,7961,1.0,0,2,3,8,1450,1110,1975,0.0,98033,47.6499,-122.199,2500,9009,5401,0.678432357744002,6553600,63377521,56823921
285000.0,3,2.0,1460,6377,1.0,0,0,2,7,1460,0,1995,0.0,98038,47.3679,-122.02,1600,6250,4917,0.7710522189117139,2131600,40666129,38534529
407500.0,2,1.0,770,6017,1.0,0,0,2,7,770,0,1950,0.0,98125,47.7223,-122.321,1670,7500,5247,0.8720292504570384,592900,36204289,35611389
325000.0,4,2.5,1960,3543,2.0,0,0,2,7,1960,0,2004,0.0,98056,47.4849,-122.184,2420,3646,1583,0.4467965001411233,3841600,12552849,8711249
405000.0,3,1.75,1900,10454,1.0,0,0,2,7,1390,510,1978,0.0,98155,47.7748,-122.291,2000,12000,8554,0.8182513870288884,3610000,109286116,105676116
291700.0,3,2.5,1970,4120,1.5,0,0,2,6,1230,740,1927,0.0,98106,47.5328,-122.346,1470,4080,2150,0.5218446601941747,3880900,16974400,13093500
370000.0,3,2.5,2490,18525,2.0,0,3,2,8,2490,0,1995,0.0,98022,47.2119,-122.001,1850,9516,16035,0.8655870445344129,6200100,343175625,336975525
270000.0,3,1.5,1430,8960,1.0,0,0,3,6,1430,0,1953,0.0,98166,47.4759,-122.34899999999999,1560,10125,7530,0.8404017857142857,2044900,80281600,78236700
800000.0,4,2.5,2680,7200,1.0,0,0,2,8,1380,1300,1952,2013.0,98033,47.6835,-122.18700000000001,1950,8520,4520,0.6277777777777778,7182400,51840000,44657600
626500.0,3,1.75,1610,3210,1.0,0,0,4,7,910,0,1928,0.0,98103,47.6656,-122.335,1420,3210,1600,0.4984423676012461,2592100,10304100,7712000
1130000.0,4,3.5,4300,8406,2.0,0,1,2,11,3580,720,1987,0.0,98040,47.5396,-122.214,2770,10006,4106,0.4884606233642636,18490000,70660836,52170836
399950.0,4,2.5,3200,7545,2.0,0,0,2,7,3200,0,2003,0.0,98038,47.3666,-122.03,2840,7137,4345,0.5758780649436713,10240000,56927025,46687025
419000.0,3,1.75,2140,15030,1.0,0,0,3,7,1570,570,1958,0.0,98166,47.4181,-122.338,2170,15030,12890,0.8576180971390552,4579600,225900900,221321300
1160000.0,4,2.5,4240,43995,2.0,0,0,2,10,4240,0,1989,0.0,98075,47.6008,-122.044,3720,59522,39755,0.9036254119786339,17977600,1935560025,1917582425
1410000.0,4,3.5,3410,10769,2.0,0,0,2,10,3410,0,2008,0.0,98004,47.6081,-122.198,2650,10058,7359,0.6833503575076609,11628100,115971361,104343261
710000.0,4,2.75,2090,8064,2.0,0,0,4,7,2090,0,1967,0.0,98033,47.6829,-122.195,1460,8400,5974,0.7408234126984127,4368100,65028096,60659996
650000.0,3,1.0,1410,4840,1.0,0,2,3,6,1230,180,1942,0.0,98033,47.6646,-122.204,1410,5400,3430,0.7086776859504132,1988100,23425600,21437500
369900.0,4,2.5,2820,33750,2.0,0,0,3,9,2820,0,1984,0.0,98072,47.7387,-122.096,2510,36180,30930,0.9164444444444444,7952400,1139062500,1131110100
641000.0,4,2.5,2770,63118,2.0,0,0,2,9,2770,0,1997,0.0,98014,47.6622,-121.961,2770,44224,60348,0.9561139453087867,7672900,3983881924,3976209024
403000.0,3,1.0,1400,6879,1.0,0,0,2,7,1400,0,1951,0.0,98155,47.7508,-122.286,1950,7400,5479,0.7964820468091293,1960000,47320641,45360641
1020000.0,3,3.25,3620,4000,2.0,0,0,2,10,2730,890,2005,0.0,98199,47.6393,-122.40299999999999,1910,5000,380,0.095,13104400,16000000,2895600
865000.0,4,2.5,2260,13600,1.0,0,0,3,8,1770,490,1974,0.0,98040,47.5436,-122.23299999999999,2630,13995,11340,0.8338235294117647,5107600,184960000,179852400
2490000.0,4,2.5,3440,23954,1.5,1,3,4,10,2260,1180,1931,0.0,98040,47.5636,-122.23100000000001,4230,18723,20514,0.8563914168823579,11833600,573794116,561960516
810000.0,4,1.0,2150,3588,2.0,0,3,3,8,1850,300,1926,0.0,98126,47.5767,-122.37799999999999,1950,3588,1438,0.4007803790412486,4622500,12873744,8251244
316750.0,3,2.5,1256,1154,3.0,0,0,2,7,1256,0,2005,0.0,98125,47.7146,-122.311,1309,1232,-102,-0.08838821490467938,1577536,1331716,-245820
652500.0,4,2.25,2220,130244,2.0,0,0,2,8,2220,0,1989,0.0,98027,47.4989,-121.9,2680,130680,128024,0.9829550689475139,4928400,16963499536,16958571136
360000.0,6,2.75,2850,15240,1.0,0,0,2,7,1850,1000,1962,0.0,98106,47.5288,-122.345,2090,7620,12390,0.812992125984252,8122500,232257600,224135100
208000.0,2,1.0,700,5100,1.0,0,0,3,5,700,0,1953,0.0,98056,47.4957,-122.16799999999999,970,5811,4400,0.8627450980392157,490000,26010000,25520000
898000.0,4,2.5,3700,63991,2.0,0,0,2,10,3700,0,1992,0.0,98077,47.7319,-122.051,3210,47215,60291,0.942179368973762,13690000,4094848081,4081158081
295000.0,4,1.75,1400,11934,1.0,0,0,2,7,1050,350,1961,0.0,98028,47.7346,-122.244,2080,10400,10534,0.8826881179822357,1960000,142420356,140460356
652500.0,4,1.75,3130,18253,2.0,0,0,2,7,3130,0,1978,0.0,98133,47.7402,-122.348,1850,12220,15123,0.8285213389579795,9796900,333172009,323375109
560000.0,4,3.0,2170,5764,2.0,0,0,2,8,2170,0,1992,0.0,98029,47.5673,-121.999,2010,5681,3594,0.6235253296321999,4708900,33223696,28514796
280000.0,3,1.0,1020,8400,1.0,0,0,3,7,1020,0,1957,0.0,98056,47.4905,-122.18,1690,8030,7380,0.8785714285714286,1040400,70560000,69519600
289950.0,3,2.5,1760,8584,1.5,0,0,4,7,1760,0,1937,0.0,98148,47.4612,-122.325,2160,8584,6824,0.7949673811742777,3097600,73685056,70587456
397500.0,3,2.5,1860,44093,1.0,0,0,2,7,1860,0,1978,0.0,98055,47.4381,-122.18799999999999,1900,6130,42233,0.957816433447486,3459600,1944192649,1940733049
380000.0,2,1.0,1140,75132,1.0,0,0,2,7,1140,0,1956,0.0,98077,47.7349,-122.074,2570,35200,73992,0.9848267049992014,1299600,5644817424,5643517824
415900.0,3,2.5,1670,22703,1.0,0,0,2,7,1310,360,1988,0.0,98045,47.4708,-121.756,1510,16817,21033,0.9264414394573405,2788900,515426209,512637309
475000.0,2,1.75,1710,8645,1.0,0,0,3,7,1510,200,1923,0.0,98115,47.7005,-122.31299999999999,1280,5366,6935,0.8021978021978022,2924100,74736025,71811925
125000.0,1,1.0,500,7440,1.0,0,0,0,5,500,0,1928,0.0,98106,47.5252,-122.36200000000001,1350,7440,6940,0.9327956989247311,250000,55353600,55103600
238000.0,3,1.0,1470,32670,1.0,0,0,2,7,1020,450,1958,0.0,98042,47.3811,-122.14399999999999,2640,24100,31200,0.9550045913682277,2160900,1067328900,1065168000
296000.0,4,1.5,1370,9750,1.0,0,0,2,7,1070,300,1953,0.0,98168,47.4718,-122.323,1540,9789,8380,0.8594871794871795,1876900,95062500,93185600
475000.0,6,3.0,3470,117612,1.5,0,0,2,7,3470,0,1924,0.0,98028,47.7663,-122.234,2120,17100,114142,0.9704962078699453,12040900,13832582544,13820541644
390000.0,3,2.25,1650,6250,1.5,0,0,2,7,1650,0,1910,0.0,98116,47.5639,-122.4,2060,6250,4600,0.736,2722500,39062500,36340000
425000.0,3,1.0,1180,3750,1.0,0,0,2,6,1030,150,1940,0.0,98116,47.5726,-122.382,1280,3750,2570,0.6853333333333333,1392400,14062500,12670100
725000.0,6,3.0,3110,5000,1.5,0,0,4,7,1810,1300,1921,0.0,98103,47.6631,-122.348,1600,4000,1890,0.378,9672100,25000000,15327900
605000.0,3,2.25,2080,12134,1.0,0,0,3,8,1530,550,1973,0.0,98052,47.6315,-122.102,2320,12400,10054,0.8285808472061975,4326400,147233956,142907556
302000.0,3,1.0,1600,1950,2.0,0,0,1,7,1600,0,1906,0.0,98122,47.6028,-122.31200000000001,1310,1138,350,0.1794871794871795,2560000,3802500,1242500
886000.0,3,2.25,2380,6000,2.0,0,0,4,9,1650,730,1931,0.0,98199,47.6472,-122.39299999999999,2000,6000,3620,0.6033333333333334,5664400,36000000,30335600
540000.0,4,1.75,1630,6120,1.0,0,0,4,7,980,650,1918,0.0,98115,47.6821,-122.31,1630,4080,4490,0.7336601307189542,2656900,37454400,34797500
435000.0,4,2.25,1910,8400,2.0,0,0,2,7,1910,0,1975,0.0,98072,47.7352,-122.175,1910,8400,6490,0.7726190476190476,3648100,70560000,66911900
409000.0,4,3.25,3140,10752,2.0,0,0,2,7,2300,840,1992,0.0,98146,47.5022,-122.363,1300,9920,7612,0.7079613095238095,9859600,115605504,105745904
405000.0,3,1.0,1250,7280,1.0,0,0,2,7,1250,0,1975,0.0,98052,47.6986,-122.12899999999999,1690,7280,6030,0.8282967032967034,1562500,52998400,51435900
560200.0,3,2.5,1990,3984,2.0,0,0,2,8,1990,0,2004,0.0,98075,47.5914,-122.01700000000001,2320,3984,1994,0.5005020080321285,3960100,15872256,11912156
324000.0,4,1.75,2110,7208,1.0,0,0,2,8,1170,940,1975,0.0,98058,47.4464,-122.12899999999999,1820,7208,5098,0.7072697003329633,4452100,51955264,47503164
390000.0,4,2.5,2490,8290,2.0,0,0,2,9,2490,0,1999,0.0,98092,47.3305,-122.171,2690,7008,5800,0.6996381182147166,6200100,68724100,62524000
414000.0,2,1.0,800,5000,1.0,0,0,2,6,800,0,1938,0.0,98055,47.4914,-122.204,1220,5000,4200,0.84,640000,25000000,24360000
441500.0,3,2.5,2360,4670,2.0,0,0,2,7,2360,0,1998,0.0,98065,47.537,-121.87100000000001,2420,5620,2310,0.49464668094218417,5569600,21808900,16239300
375000.0,3,2.5,1770,5146,2.0,0,0,2,7,1770,0,1992,0.0,98106,47.5263,-122.35600000000001,1230,5160,3376,0.6560435289545278,3132900,26481316,23348416
668500.0,4,2.5,2710,5500,2.0,0,0,2,9,2710,0,1999,0.0,98074,47.6027,-122.023,2710,6242,2790,0.5072727272727273,7344100,30250000,22905900
540000.0,5,1.5,1940,10202,1.5,0,0,3,7,1940,0,1940,0.0,98125,47.7213,-122.31,1900,8000,8262,0.8098412076063517,3763600,104080804,100317204
1040000.0,4,3.25,3450,11240,2.0,0,3,3,10,2430,1020,1960,2001.0,98166,47.4556,-122.37200000000001,2412,19499,7790,0.6930604982206405,11902500,126337600,114435100
1350000.0,4,3.25,3440,4920,2.0,0,4,2,10,2520,920,2014,0.0,98116,47.5727,-122.40899999999999,2350,5166,1480,0.3008130081300813,11833600,24206400,12372800
758000.0,4,2.75,2410,9549,1.0,0,0,3,7,1780,630,1956,0.0,98033,47.6503,-122.197,2090,9549,7139,0.7476175515760812,5808100,91183401,85375301
949880.0,4,2.25,2290,10687,2.0,0,0,2,9,2290,0,1978,0.0,98004,47.5878,-122.20200000000001,2290,10300,8397,0.7857209694020773,5244100,114211969,108967869
570000.0,3,1.0,1030,4089,1.5,0,0,2,7,1030,0,1927,0.0,98116,47.574,-122.385,1440,4917,3059,0.7481046710687209,1060900,16719921,15659021
736000.0,4,2.5,2290,12047,2.0,0,0,3,9,2290,0,1988,0.0,98006,47.5599,-122.105,3130,15666,9757,0.8099111812069395,5244100,145130209,139886109
670000.0,3,1.5,1490,4400,1.5,0,0,3,7,1490,0,1906,0.0,98122,47.6113,-122.292,1560,4400,2910,0.6613636363636364,2220100,19360000,17139900
1130000.0,4,1.75,2370,8400,1.0,0,0,4,9,1270,1100,1949,0.0,98105,47.6716,-122.264,2370,8400,6030,0.7178571428571429,5616900,70560000,64943100
650000.0,4,2.0,1930,3976,1.5,0,0,3,8,1930,0,1914,0.0,98122,47.6117,-122.29700000000001,1470,4080,2046,0.5145875251509054,3724900,15808576,12083676
690000.0,2,1.75,1600,4000,1.0,0,0,4,7,850,750,1918,0.0,98112,47.6408,-122.3,1860,4000,2400,0.6,2560000,16000000,13440000
610000.0,4,2.25,2240,45738,2.0,0,0,2,7,2240,0,1988,0.0,98053,47.687,-122.04700000000001,3180,45738,43498,0.9510254055708601,5017600,2091964644,2086947044
413500.0,2,1.0,770,4000,1.0,0,0,4,5,770,0,1924,0.0,98117,47.6959,-122.36399999999999,1420,5040,3230,0.8075,592900,16000000,15407100
765000.0,3,2.5,2300,9752,2.0,0,2,2,8,2300,0,1968,2003.0,98075,47.5825,-122.07600000000001,2640,10764,7452,0.7641509433962265,5290000,95101504,89811504
828200.0,4,2.75,3400,7081,2.0,0,0,2,9,3400,0,2001,0.0,98006,47.5661,-122.12299999999999,3060,7081,3681,0.5198418302499647,11560000,50140561,38580561
205000.0,2,1.0,900,4397,1.0,0,0,2,6,900,0,1918,0.0,98055,47.4851,-122.205,1430,4500,3497,0.7953149874914714,810000,19333609,18523609
465000.0,3,2.5,1450,5175,1.0,0,0,2,8,1030,420,1995,0.0,98133,47.7082,-122.338,1740,9250,3725,0.7198067632850241,2102500,26780625,24678125
556000.0,4,2.5,2240,5402,2.0,0,0,2,8,2240,0,2005,0.0,98133,47.772,-122.35,2240,7560,3162,0.5853387634209553,5017600,29181604,24164004
540000.0,4,2.5,1780,4169,2.0,0,0,2,8,1780,0,1994,0.0,98029,47.5695,-122.006,1830,4164,2389,0.5730390981050612,3168400,17380561,14212161
423000.0,4,2.5,2320,4254,2.0,0,0,2,8,2320,0,2004,0.0,98059,47.48,-122.137,2330,4602,1934,0.4546309355900329,5382400,18096516,12714116
375000.0,3,1.75,1590,14766,1.0,0,0,2,8,1590,0,1963,0.0,98007,47.5902,-122.147,2040,10190,13176,0.8923201950426656,2528100,218034756,215506656
173250.0,3,1.0,990,12696,1.5,0,0,2,7,990,0,1936,0.0,98168,47.4776,-122.279,1260,8937,11706,0.9220226843100189,980100,161188416,160208316
599900.0,3,1.5,2605,12030,1.0,0,0,2,8,1355,1250,2003,0.0,98019,47.7725,-121.899,1590,15242,9425,0.7834580216126351,6786025,144720900,137934875
646000.0,5,2.75,2870,4461,1.0,0,0,2,7,1650,1220,1976,0.0,98107,47.675,-122.39,1890,4196,1591,0.35664649181797803,8236900,19900521,11663621
1080000.0,5,4.75,5180,17811,2.0,0,2,2,11,4070,1110,2001,0.0,98065,47.5405,-121.868,3960,15103,12631,0.7091684913817304,26832400,317231721,290399321
558000.0,4,2.0,2180,3870,1.0,0,0,2,7,1020,1160,1900,0.0,98122,47.6089,-122.303,1520,2580,1690,0.43669250645994834,4752400,14976900,10224500
354000.0,2,1.0,850,5225,1.0,0,0,2,7,850,0,1949,0.0,98126,47.5311,-122.38,1230,5225,4375,0.8373205741626795,722500,27300625,26578125
1200000.0,4,4.0,4050,9517,2.0,0,0,2,11,3360,690,1990,0.0,98040,47.5769,-122.215,3330,9436,5467,0.5744457286960176,16402500,90573289,74170789
670000.0,4,2.0,2250,4200,1.5,0,0,2,7,1650,600,1909,0.0,98122,47.6136,-122.29700000000001,1200,3360,1950,0.4642857142857143,5062500,17640000,12577500
1130000.0,6,4.25,3100,9378,3.0,0,2,2,11,3100,0,1978,0.0,98112,47.6381,-122.314,3270,6334,6278,0.6694391128172318,9610000,87946884,78336884
267500.0,2,1.0,1747,12250,2.5,0,0,3,6,1747,0,1948,0.0,98001,47.3282,-122.285,1620,10300,10503,0.8573877551020408,3052009,150062500,147010491
299800.0,4,2.5,2410,4708,2.0,0,0,2,8,2410,0,2002,0.0,98092,47.3229,-122.182,2517,5290,2298,0.4881053525913339,5808100,22165264,16357164
430000.0,4,1.75,2070,9120,1.0,0,0,3,7,1250,820,1958,0.0,98008,47.6045,-122.12299999999999,1650,8400,7050,0.7730263157894737,4284900,83174400,78889500
775000.0,5,1.0,1860,3040,1.5,0,0,2,7,1530,330,1921,0.0,98103,47.6559,-122.339,1910,3600,1180,0.3881578947368421,3459600,9241600,5782000
333000.0,3,1.0,950,5214,1.0,0,0,2,7,830,120,1944,0.0,98126,47.5362,-122.37899999999999,1490,7636,4264,0.8177982355197545,902500,27185796,26283296
336000.0,3,2.0,1060,11765,1.0,0,0,3,6,1060,0,1951,0.0,98125,47.7333,-122.302,1500,9151,10705,0.9099022524436889,1123600,138415225,137291625
323000.0,2,1.0,880,1712,2.0,0,0,3,7,880,0,1945,0.0,98199,47.6475,-122.397,1360,1748,832,0.48598130841121495,774400,2930944,2156544
575000.0,4,2.5,2550,56628,2.0,0,0,2,9,2550,0,2001,0.0,98027,47.4913,-122.081,1870,56628,54078,0.9549692731510914,6502500,3206730384,3200227884
328000.0,2,2.25,1550,2079,2.0,0,0,2,8,1550,0,2008,0.0,98106,47.54,-122.368,1420,1977,529,0.2544492544492544,2402500,4322241,1919741
572500.0,3,1.0,1590,4600,1.5,0,0,3,7,1290,300,1926,0.0,98117,47.6807,-122.399,1770,4350,3010,0.6543478260869565,2528100,21160000,18631900
600000.0,3,1.75,1650,5100,1.0,0,0,4,7,1040,610,1908,0.0,98115,47.6873,-122.321,1540,5100,3450,0.6764705882352942,2722500,26010000,23287500
412000.0,4,3.0,2430,7242,2.0,0,0,2,8,2430,0,2003,0.0,98038,47.3533,-122.015,2430,7242,4812,0.6644573322286661,5904900,52446564,46541664
827500.0,3,2.5,1810,7200,1.0,0,0,4,7,1310,500,1960,0.0,98033,47.6885,-122.211,2050,7200,5390,0.7486111111111111,3276100,51840000,48563900
300000.0,4,2.5,2890,17349,2.0,0,0,2,8,2890,0,1994,0.0,98023,47.2822,-122.34,2330,22356,14459,0.8334197936480489,8352100,300987801,292635701
415000.0,3,2.5,1280,5040,2.0,0,0,3,7,1280,0,1985,0.0,98118,47.5611,-122.27600000000001,1500,5040,3760,0.746031746031746,1638400,25401600,23763200
750000.0,7,2.75,3410,4056,1.5,0,0,3,8,2130,0,1906,0.0,98102,47.6454,-122.316,2510,4056,646,0.15927021696252466,11628100,16451136,4823036
800000.0,3,2.75,2220,4000,2.0,0,0,2,8,1700,520,1914,2000.0,98122,47.617,-122.291,1800,4000,1780,0.445,4928400,16000000,11071600
420000.0,3,1.0,1060,6000,1.0,0,0,2,8,1060,0,1954,0.0,98118,47.5427,-122.275,1240,7874,4940,0.8233333333333334,1123600,36000000,34876400
266000.0,3,1.5,1120,8250,1.0,0,0,3,7,1120,0,1957,0.0,98056,47.4905,-122.179,1320,8400,7130,0.8642424242424243,1254400,68062500,66808100
499000.0,4,2.5,2680,10590,2.0,0,0,2,8,2680,0,2004,0.0,98019,47.7377,-121.97,2330,5566,7910,0.7469310670443815,7182400,112148100,104965700
440000.0,4,1.5,1770,5750,2.0,0,0,2,7,1770,0,1947,0.0,98116,47.5621,-122.39399999999999,970,5750,3980,0.6921739130434783,3132900,33062500,29929600
495000.0,3,2.0,2950,12196,2.0,0,0,3,7,2310,640,1918,0.0,98166,47.4702,-122.365,2320,19844,9246,0.7581174155460807,8702500,148742416,140039916
630000.0,2,1.75,1260,5300,1.0,0,0,3,7,840,420,1951,0.0,98103,47.6809,-122.348,1280,3000,4040,0.7622641509433963,1587600,28090000,26502400
424000.0,3,1.75,1430,6818,1.0,0,0,4,7,1430,0,1972,0.0,98034,47.7271,-122.196,1480,7210,5388,0.7902610736286301,2044900,46485124,44440224
760000.0,4,2.5,2730,36183,2.0,0,0,2,9,2730,0,1986,0.0,98052,47.7036,-122.12700000000001,2710,5964,33453,0.9245502031340684,7452900,1309209489,1301756589
650000.0,4,3.5,3270,15704,2.0,0,0,2,9,2110,1160,1990,0.0,98074,47.6256,-122.042,3020,8582,12434,0.7917727967396841,10692900,246615616,235922716
248500.0,4,1.75,1720,10018,1.0,0,0,4,7,1720,0,1960,0.0,98042,47.3614,-122.119,1220,10018,8298,0.8283090437213017,2958400,100360324,97401924
379600.0,3,1.75,1270,12420,1.0,0,0,3,7,1270,0,1962,0.0,98056,47.5387,-122.179,1560,9910,11150,0.8977455716586151,1612900,154256400,152643500
538000.0,4,2.5,3260,10032,1.0,0,0,2,8,1960,1300,1978,0.0,98125,47.7203,-122.323,1802,7249,6772,0.6750398724082934,10627600,100641024,90013424
530000.0,4,2.5,2050,6360,2.0,0,0,2,8,2050,0,1988,0.0,98029,47.5641,-122.01100000000001,2070,7541,4310,0.6776729559748428,4202500,40449600,36247100
545000.0,4,2.25,2050,9720,2.0,0,0,2,8,2050,0,1967,0.0,98008,47.5911,-122.119,2310,9680,7670,0.7890946502057613,4202500,94478400,90275900
925000.0,4,3.0,3580,35261,1.5,0,0,2,10,3580,0,1985,0.0,98072,47.7577,-122.134,3540,36750,31681,0.898471398996058,12816400,1243338121,1230521721
565000.0,4,2.75,1960,48787,1.5,0,0,3,9,1960,0,1983,0.0,98072,47.7484,-122.111,1970,36425,46827,0.9598253633139976,3841600,2380171369,2376329769
405100.0,2,1.0,840,3522,1.0,0,0,2,6,840,0,1947,0.0,98199,47.6575,-122.395,1390,4800,2682,0.7614991482112436,705600,12404484,11698884
502000.0,3,1.75,1300,8800,1.0,0,0,3,8,1300,0,1963,0.0,98008,47.6199,-122.116,1350,8800,7500,0.8522727272727273,1690000,77440000,75750000
425000.0,3,2.25,1260,3000,2.0,0,0,2,7,1260,0,2003,0.0,98029,47.5454,-121.99700000000001,1630,3042,1740,0.58,1587600,9000000,7412400
233500.0,3,2.25,1650,2958,2.0,0,0,2,7,1650,0,1985,0.0,98031,47.3916,-122.167,1510,3788,1308,0.4421906693711968,2722500,8749764,6027264
287000.0,3,2.5,1710,10341,2.0,0,2,2,7,1710,0,1986,0.0,98030,47.3494,-122.171,1830,9358,8631,0.834638816362054,2924100,106936281,104012181
190000.0,3,1.0,1180,8775,1.0,0,0,2,7,1180,0,1966,0.0,98002,47.2848,-122.223,1300,8100,7595,0.8655270655270655,1392400,77000625,75608225
666000.0,3,2.25,2780,31510,2.0,0,0,2,8,2780,0,1979,0.0,98053,47.67,-122.024,2890,36400,28730,0.9117740399873057,7728400,992880100,985151700
330000.0,2,1.0,950,3090,1.0,0,0,3,6,950,0,1909,0.0,98118,47.551,-122.27600000000001,1230,4120,2140,0.6925566343042071,902500,9548100,8645600
1490000.0,5,3.5,3620,7821,2.0,0,2,2,10,2790,830,1958,2010.0,98040,47.5738,-122.215,2690,9757,4201,0.5371435877764992,13104400,61168041,48063641
393000.0,3,2.25,2140,10256,2.0,0,0,2,8,2140,0,1987,0.0,98038,47.3751,-122.044,2040,11717,8116,0.7913416536661466,4579600,105185536,100605936
353000.0,4,2.75,1920,4627,1.0,0,0,2,8,1010,910,1998,0.0,98178,47.5003,-122.23,1910,7210,2707,0.5850443051653339,3686400,21409129,17722729
260000.0,2,1.0,750,6720,1.0,0,0,2,6,750,0,1916,0.0,98108,47.552,-122.31,920,6720,5970,0.8883928571428571,562500,45158400,44595900
680000.0,3,2.5,2060,2551,2.0,0,0,2,8,1900,160,2001,0.0,98005,47.5881,-122.165,2060,2936,491,0.1924735397883183,4243600,6507601,2264001
921000.0,3,2.25,2380,11200,1.0,0,0,3,8,2380,0,1963,0.0,98004,47.5873,-122.193,2010,11200,8820,0.7875,5664400,125440000,119775600
319000.0,2,1.0,750,6380,1.0,0,0,2,7,750,0,1949,0.0,98125,47.7033,-122.30799999999999,1690,6495,5630,0.8824451410658307,562500,40704400,40141900
280000.0,3,1.0,1160,10881,1.0,0,0,1,7,920,240,1983,0.0,98074,47.6339,-122.03299999999999,1280,10843,9721,0.8933921514566676,1345600,118396161,117050561
220000.0,3,1.0,1050,6300,1.0,0,0,2,6,1050,0,1942,0.0,98146,47.5128,-122.374,740,6300,5250,0.8333333333333334,1102500,39690000,38587500
219000.0,3,1.5,1740,5200,1.0,0,0,3,7,1060,680,1977,0.0,98042,47.3657,-122.094,1540,5200,3460,0.6653846153846154,3027600,27040000,24012400
528000.0,4,2.75,2050,7171,1.0,0,0,2,8,1540,510,1988,0.0,98074,47.6194,-122.042,1960,7110,5121,0.7141263422116859,4202500,51423241,47220741
405000.0,3,1.75,1980,8100,1.0,0,0,3,7,1310,670,1949,0.0,98133,47.7353,-122.331,1450,8212,6120,0.7555555555555555,3920400,65610000,61689600
372977.0,3,2.5,1690,1618,2.0,0,0,2,8,1150,540,2014,0.0,98029,47.5518,-121.99799999999999,1690,1618,-72,-0.04449938195302843,2856100,2617924,-238176
934550.0,4,3.25,2320,5900,1.5,0,2,3,9,2320,0,1910,0.0,98144,47.597,-122.292,2320,6240,3580,0.6067796610169491,5382400,34810000,29427600
1470000.0,3,1.5,2480,9900,2.0,0,3,2,10,2130,350,1940,0.0,98177,47.7018,-122.381,2860,9288,7420,0.7494949494949495,6150400,98010000,91859600
975000.0,4,2.25,2290,5350,2.0,0,0,3,9,2120,170,1958,0.0,98199,47.6428,-122.411,2910,5350,3060,0.5719626168224299,5244100,28622500,23378400
800866.0,5,2.5,3180,13806,2.0,0,0,3,10,3180,0,1990,0.0,98033,47.652,-122.182,3180,13798,10626,0.7696653628857019,10112400,190605636,180493236
950000.0,7,3.5,3470,16264,2.0,0,0,3,9,3470,0,1980,0.0,98007,47.6203,-122.149,3040,13500,12794,0.7866453516969996,12040900,264517696,252476796
624000.0,4,3.0,1540,4140,1.5,0,0,4,7,1540,0,1902,0.0,98107,47.6728,-122.396,1460,5000,2600,0.6280193236714976,2371600,17139600,14768000
1850000.0,5,2.25,2800,8442,2.0,1,4,2,9,2800,0,1963,2001.0,98075,47.5784,-122.07600000000001,3220,9156,5642,0.6683250414593698,7840000,71267364,63427364
310000.0,3,1.0,1050,9876,1.0,0,0,2,7,1050,0,1953,0.0,98028,47.7635,-122.262,1760,9403,8826,0.893681652490887,1102500,97535376,96432876
315000.0,3,1.75,1480,6800,1.0,0,0,3,7,1480,0,1968,0.0,98055,47.4633,-122.18799999999999,1500,7900,5320,0.7823529411764706,2190400,46240000,44049600
675000.0,3,2.0,1010,5973,1.0,0,0,4,6,1010,0,1942,0.0,98033,47.6652,-122.20200000000001,1920,6015,4963,0.8309057425079525,1020100,35676729,34656629
490000.0,3,1.75,1660,8208,1.0,0,0,3,8,1660,0,1965,0.0,98005,47.5919,-122.154,2210,11000,6548,0.7977582846003899,2755600,67371264,64615664
600000.0,5,2.25,2760,6350,1.0,0,0,2,7,1380,0,1958,0.0,98126,47.5561,-122.37899999999999,2060,6342,3590,0.5653543307086614,7617600,40322500,32704900
154000.0,2,1.0,1040,20524,1.0,0,3,2,6,1040,0,1949,1989.0,98014,47.6981,-121.875,1880,38996,19484,0.9493276164490353,1081600,421234576,420152976
480000.0,4,1.75,2220,6500,2.0,0,3,3,8,2220,0,1964,0.0,98166,47.4519,-122.375,2430,11600,4280,0.6584615384615384,4928400,42250000,37321600
196900.0,3,1.0,1270,7500,1.0,0,0,2,6,1270,0,1954,0.0,98198,47.4214,-122.316,1250,8000,6230,0.8306666666666667,1612900,56250000,54637100
735000.0,3,3.25,2960,39370,2.0,0,0,2,10,2960,0,1989,0.0,98011,47.7452,-122.20200000000001,2960,56628,36410,0.9248158496316993,8761600,1549996900,1541235300
205500.0,3,2.0,1330,8748,1.0,0,0,2,7,1330,0,1986,0.0,98003,47.2619,-122.29799999999999,1510,8584,7418,0.8479652491998171,1768900,76527504,74758604
357186.0,2,1.75,1210,1040,2.0,0,0,2,8,1210,0,2014,0.0,98029,47.5519,-121.999,1210,1090,-170,-0.16346153846153846,1464100,1081600,-382500
275000.0,4,2.5,2120,6754,2.0,0,0,2,7,2120,0,1998,0.0,98030,47.3629,-122.184,2120,6937,4634,0.686111933668937,4494400,45616516,41122116
248500.0,3,1.75,2090,12026,1.0,0,0,3,7,2090,0,1948,0.0,98002,47.3095,-122.21700000000001,1700,9496,9936,0.8262098785963745,4368100,144624676,140256576
350000.0,3,2.5,2680,7836,2.0,0,0,2,8,2680,0,1990,2009.0,98092,47.3203,-122.185,2340,8040,5156,0.6579887697805002,7182400,61402896,54220496
390000.0,4,2.75,1790,47250,1.0,0,0,2,7,1220,570,1987,0.0,98045,47.5302,-121.74600000000001,1250,43791,45460,0.9621164021164021,3204100,2232562500,2229358400
390000.0,3,2.75,1950,12240,1.0,0,0,2,7,1250,700,1956,0.0,98028,47.7401,-122.258,1880,12000,10290,0.8406862745098039,3802500,149817600,146015100
660000.0,5,2.25,3740,14913,1.5,0,0,3,9,3740,0,1979,0.0,98074,47.6234,-122.059,2180,7600,11173,0.7492120968282706,13987600,222397569,208409969
310000.0,3,1.75,1140,8263,1.0,0,0,4,7,1140,0,1950,0.0,98155,47.7407,-122.32700000000001,1140,6770,7123,0.8620355802977127,1299600,68277169,66977569
717000.0,3,2.5,2480,5137,2.0,0,0,2,9,2480,0,2000,0.0,98052,47.684,-122.164,2480,6023,2657,0.5172279540587892,6150400,26388769,20238369
260000.0,5,2.5,2580,11250,1.0,0,0,2,7,1410,1170,1964,0.0,98198,47.397,-122.31299999999999,2240,11780,8670,0.7706666666666667,6656400,126562500,119906100
745000.0,3,2.0,2290,5001,1.0,0,0,3,7,1490,800,1960,0.0,98103,47.6909,-122.339,1230,5001,2711,0.5420915816836632,5244100,25010001,19765901
470000.0,4,2.5,2320,12042,1.0,0,0,3,7,1320,1000,1975,0.0,98072,47.76300000000001,-122.16,2160,7054,9722,0.8073409732602558,5382400,145009764,139627364
429000.0,3,2.5,2530,8820,2.0,0,0,2,8,2530,0,1997,0.0,98031,47.42,-122.205,2340,9472,6290,0.7131519274376418,6400900,77792400,71391500
220000.0,4,2.0,1400,7140,1.0,0,0,2,7,1400,0,1969,0.0,98155,47.7719,-122.309,1610,10500,5740,0.803921568627451,1960000,50979600,49019600
497000.0,3,3.0,2060,1850,2.0,0,0,2,8,1400,0,2007,0.0,98119,47.6543,-122.37299999999999,1910,2951,-210,-0.11351351351351352,4243600,3422500,-821100
716100.0,3,1.0,1640,4000,1.5,0,0,4,7,1640,0,1909,0.0,98103,47.6563,-122.351,2140,4000,2360,0.59,2689600,16000000,13310400
371000.0,4,1.0,1960,94525,1.5,0,0,2,6,1960,0,1979,0.0,98027,47.5418,-121.962,2430,188564,92565,0.9792647447765142,3841600,8934975625,8931134025
379000.0,5,2.75,3000,25175,1.0,0,0,3,7,1500,1500,1961,0.0,98027,47.497,-122.088,2170,40523,22175,0.8808341608738828,9000000,633780625,624780625
937500.0,3,1.0,1320,8500,1.0,0,0,3,7,1320,0,1954,0.0,98039,47.6187,-122.226,2790,10800,7180,0.8447058823529412,1742400,72250000,70507600
720000.0,4,2.0,1760,4500,1.5,0,0,4,7,1760,0,1906,0.0,98103,47.6711,-122.331,1740,4220,2740,0.6088888888888889,3097600,20250000,17152400
616000.0,3,3.25,2130,2306,2.0,0,1,4,7,1420,710,1924,0.0,98136,47.5424,-122.391,1560,4500,176,0.07632263660017347,4536900,5317636,780736
259000.0,3,2.0,1390,7120,1.0,0,0,2,7,1390,0,1988,0.0,98030,47.3786,-122.179,1530,7688,5730,0.8047752808988764,1932100,50694400,48762300
538000.0,3,1.75,1400,3825,1.5,0,0,3,6,1100,300,1904,0.0,98117,47.6793,-122.39299999999999,1720,5100,2425,0.6339869281045751,1960000,14630625,12670625
605000.0,3,2.75,3230,9576,1.5,0,0,3,8,3230,0,1966,0.0,98034,47.7307,-122.18299999999999,2820,9576,6346,0.6626984126984127,10432900,91699776,81266876
369950.0,3,1.0,1110,7603,1.0,0,0,2,7,1110,0,1967,0.0,98034,47.7262,-122.22399999999999,1260,8094,6493,0.8540049980270946,1232100,57805609,56573509
310000.0,3,2.5,1670,4220,2.0,0,0,2,7,1670,0,2002,0.0,98038,47.3834,-122.02799999999999,1670,4238,2550,0.6042654028436019,2788900,17808400,15019500
227500.0,3,1.0,1540,9450,1.0,0,0,3,7,1540,0,1960,0.0,98198,47.3612,-122.315,1210,9450,7910,0.837037037037037,2371600,89302500,86930900
274000.0,4,2.25,2090,7400,1.0,0,0,2,9,1670,420,1973,0.0,98023,47.3178,-122.38,2260,8000,5310,0.7175675675675676,4368100,54760000,50391900
410000.0,3,2.0,1410,8088,1.0,0,0,2,7,1410,0,1987,0.0,98034,47.7303,-122.227,1770,7401,6678,0.8256676557863502,1988100,65415744,63427644
354800.0,3,2.0,1370,78408,1.0,0,0,4,7,1370,0,1964,0.0,98042,47.3867,-122.081,1620,9690,77038,0.9825272931333537,1876900,6147814464,6145937564
650000.0,4,2.25,1910,5120,1.0,0,0,2,8,1300,610,1954,0.0,98199,47.6534,-122.40899999999999,1810,5153,3210,0.626953125,3648100,26214400,22566300
353000.0,3,2.0,1678,13862,1.0,0,0,2,7,1678,0,1994,0.0,98030,47.3744,-122.19,1550,11753,12184,0.8789496465156543,2815684,192155044,189339360
224975.0,3,1.0,960,12745,1.0,0,0,3,6,960,0,1977,0.0,98038,47.3617,-122.03,1160,10488,11785,0.924676343664182,921600,162435025,161513425
600000.0,2,1.75,2080,13054,1.0,0,1,2,7,2080,0,1951,0.0,98155,47.7435,-122.292,2440,13054,10974,0.8406618660946836,4326400,170406916,166080516
437500.0,3,2.25,1790,7700,1.0,0,0,3,7,1340,450,1976,0.0,98034,47.7205,-122.16799999999999,1610,7350,5910,0.7675324675324675,3204100,59290000,56085900
567000.0,3,2.5,2540,6093,2.0,0,0,2,9,2540,0,1999,0.0,98034,47.7042,-122.236,2540,5924,3553,0.5831281798785491,6451600,37124649,30673049
225000.0,5,1.5,1790,11656,2.0,0,0,2,7,1790,0,1963,0.0,98198,47.3961,-122.30799999999999,2040,9790,9866,0.8464310226492794,3204100,135862336,132658236
255000.0,2,1.0,940,9330,1.0,0,0,2,6,940,0,1941,0.0,98118,47.5445,-122.273,1900,6145,8390,0.8992497320471597,883600,87048900,86165300
2480000.0,5,3.75,6810,7500,2.5,0,0,2,13,6110,700,1922,0.0,98102,47.6285,-122.322,2660,7500,690,0.092,46376100,56250000,9873900
370000.0,2,1.0,900,4600,1.0,0,0,2,6,900,0,1951,0.0,98117,47.6918,-122.361,1060,4600,3700,0.8043478260869565,810000,21160000,20350000
675000.0,4,1.75,1900,8800,1.0,0,0,2,8,1140,760,1975,0.0,98033,47.6579,-122.197,2280,8800,6900,0.7840909090909091,3610000,77440000,73830000
285000.0,3,1.0,1440,4268,1.0,0,0,2,7,1040,400,1953,0.0,98108,47.5468,-122.29299999999999,1370,4268,2828,0.662605435801312,2073600,18215824,16142224
310000.0,3,1.75,2070,37904,1.0,0,0,3,7,1420,650,1973,0.0,98058,47.425,-122.186,2011,19110,35834,0.9453883495145631,4284900,1436713216,1432428316
475000.0,4,2.5,2240,7245,1.0,0,0,3,7,1140,1100,1972,0.0,98034,47.7161,-122.17,1740,7350,5005,0.6908212560386473,5017600,52490025,47472425
410000.0,4,2.5,3320,5034,2.0,0,0,3,7,3320,0,2006,0.0,98042,47.4011,-122.164,2580,4950,1714,0.3404847040127135,11022400,25341156,14318756
895000.0,4,2.25,1950,5950,1.0,0,0,2,8,1330,620,1947,0.0,98109,47.638999999999996,-122.34700000000001,2600,5593,4000,0.6722689075630253,3802500,35402500,31600000
375000.0,3,1.5,1240,7733,1.0,0,0,2,6,790,450,1941,0.0,98125,47.714,-122.28299999999999,1130,7733,6493,0.8396482607008923,1537600,59799289,58261689
349000.0,4,2.5,1830,4694,2.0,0,0,2,7,1830,0,2003,0.0,98038,47.3573,-122.016,1830,5175,2864,0.610140605027695,3348900,22033636,18684736
650500.0,3,1.75,1740,4400,1.5,0,0,2,8,1740,0,1903,0.0,98122,47.6115,-122.292,1740,4400,2660,0.6045454545454545,3027600,19360000,16332400
760000.0,3,1.75,1410,15120,1.0,0,0,3,7,1410,0,1950,0.0,98004,47.5974,-122.195,1880,15120,13710,0.9067460317460317,1988100,228614400,226626300
480000.0,4,2.75,2050,3960,1.0,0,0,3,7,1180,870,1986,0.0,98116,47.5808,-122.39399999999999,1440,5040,1910,0.4823232323232323,4202500,15681600,11479100
689000.0,4,2.75,3220,16145,2.0,0,0,2,10,3220,0,1993,0.0,98075,47.5786,-121.995,3200,12921,12925,0.8005574481263549,10368400,260661025,250292625
415000.0,3,1.75,1960,5000,1.0,0,0,4,6,980,980,1911,0.0,98108,47.5576,-122.31700000000001,1790,5000,3040,0.608,3841600,25000000,21158400
195000.0,3,1.75,1070,6110,1.0,0,0,3,7,1070,0,1968,0.0,98002,47.3249,-122.20700000000001,1350,6148,5040,0.8248772504091653,1144900,37332100,36187200
318000.0,5,2.5,2820,9956,1.0,0,0,3,7,1410,1410,1967,0.0,98168,47.4715,-122.33,2700,9956,7136,0.7167537163519486,7952400,99121936,91169536
404000.0,4,3.0,4060,35621,1.0,0,0,2,9,2030,2030,1989,0.0,98092,47.3059,-122.10799999999999,2950,35259,31561,0.88602229022206,16483600,1268855641,1252372041
339950.0,2,1.0,800,3090,1.0,0,0,3,6,800,0,1925,0.0,98118,47.5518,-122.277,1400,3090,2290,0.7411003236245954,640000,9548100,8908100
215000.0,3,1.0,1260,7897,1.0,0,0,2,7,1260,0,1979,0.0,98022,47.1946,-122.00299999999999,1560,8285,6637,0.8404457388881854,1587600,62362609,60775009
339900.0,3,2.5,2420,7423,2.0,0,0,2,8,2420,0,1990,0.0,98092,47.3199,-122.186,2260,7629,5003,0.673986258924963,5856400,55100929,49244529
285000.0,1,1.5,810,3211,2.0,0,0,3,7,810,0,1982,0.0,98033,47.6939,-122.184,1320,3298,2401,0.747742136406104,656100,10310521,9654421
550000.0,3,1.0,1600,5000,1.5,0,0,2,7,1110,490,1947,0.0,98107,47.655,-122.35799999999999,1380,5000,3400,0.68,2560000,25000000,22440000
430000.0,4,1.0,1350,9000,1.5,0,0,3,7,1350,0,1964,0.0,98103,47.6953,-122.33200000000001,1940,8000,7650,0.85,1822500,81000000,79177500
219000.0,3,1.0,970,7790,1.0,0,0,2,6,970,0,1967,0.0,98003,47.3165,-122.325,1150,8160,6820,0.8754813863928113,940900,60684100,59743200
555000.0,2,1.5,1780,4750,1.0,0,0,3,7,1080,700,1947,0.0,98117,47.6859,-122.395,1690,5962,2970,0.6252631578947369,3168400,22562500,19394100
233000.0,3,2.0,1350,7686,1.0,0,0,2,7,1350,0,1989,0.0,98038,47.3609,-122.053,1470,7686,6336,0.8243559718969555,1822500,59074596,57252096
248000.0,3,1.75,1840,19501,1.0,0,0,3,8,1270,570,1972,0.0,98003,47.3364,-122.318,1910,12000,17661,0.9056458643146506,3385600,380289001,376903401
454000.0,5,2.25,2550,9200,1.0,0,0,3,8,1580,970,1975,0.0,98166,47.4673,-122.363,2090,9200,6650,0.7228260869565217,6502500,84640000,78137500
950000.0,4,2.5,1700,4418,2.0,0,0,2,8,1700,0,1931,2000.0,98112,47.6434,-122.3,2090,4174,2718,0.6152105024898143,2890000,19518724,16628724
359000.0,3,2.5,2430,7857,2.0,0,0,4,8,1730,700,1980,0.0,98055,47.4546,-122.211,2160,8740,5427,0.6907216494845361,5904900,61732449,55827549
407500.0,5,2.0,2740,8230,1.5,0,0,2,7,2210,530,1962,0.0,98155,47.7352,-122.29700000000001,2130,8232,5490,0.6670716889428918,7507600,67732900,60225300
224000.0,3,1.5,1560,7300,1.0,0,0,3,7,1040,520,1964,0.0,98001,47.3427,-122.281,1460,7910,5740,0.7863013698630137,2433600,53290000,50856400
210000.0,2,1.0,1040,4590,1.0,0,0,2,7,1040,0,1954,0.0,98146,47.5078,-122.337,1040,6120,3550,0.7734204793028322,1081600,21068100,19986500
261000.0,4,1.75,1820,9824,1.0,0,0,4,7,1820,0,1968,0.0,98042,47.3833,-122.09299999999999,1410,11013,8004,0.8147394136807817,3312400,96510976,93198576
719000.0,3,3.0,1833,1706,3.0,0,0,2,9,1833,0,1998,0.0,98115,47.6827,-122.325,1466,1455,-127,-0.07444314185228605,3359889,2910436,-449453
440000.0,3,2.5,2160,3738,2.0,0,0,2,8,2160,0,1994,0.0,98126,47.5661,-122.375,1500,4000,1578,0.42215088282504015,4665600,13972644,9307044
525000.0,3,2.75,2100,10362,2.0,0,0,2,9,1510,590,1998,0.0,98045,47.4347,-121.417,2240,11842,8262,0.7973364215402432,4410000,107371044,102961044
375000.0,3,1.5,1370,9720,2.0,0,0,2,7,1370,0,1968,0.0,98034,47.7302,-122.197,1510,8775,8350,0.8590534979423868,1876900,94478400,92601500
428000.0,2,2.5,1414,1960,2.0,0,0,2,8,1414,0,1986,0.0,98006,47.5423,-122.189,1414,2511,546,0.2785714285714286,1999396,3841600,1842204
988830.0,5,3.25,4115,7910,2.0,0,0,2,9,4115,0,2014,0.0,98053,47.6847,-122.016,3950,6765,3795,0.4797724399494311,16933225,62568100,45634875
199950.0,3,1.75,1550,6225,1.0,0,0,3,7,1550,0,1949,0.0,98002,47.3098,-122.21799999999999,1760,9496,4675,0.751004016064257,2402500,38750625,36348125
840000.0,4,2.25,2100,3671,1.5,0,0,2,8,1750,350,1929,0.0,98112,47.6359,-122.3,1800,4560,1571,0.4279487877962408,4410000,13476241,9066241
285000.0,3,1.75,1160,7006,1.0,0,0,3,7,1160,0,1992,0.0,98022,47.1937,-121.98,1670,7750,5846,0.8344276334570369,1345600,49084036,47738436
330000.0,5,2.5,3597,4972,2.0,0,0,2,7,3597,0,2006,0.0,98001,47.3002,-122.28200000000001,3193,6000,1375,0.27654867256637167,12938409,24720784,11782375
147500.0,3,1.5,1230,10125,1.0,0,0,2,7,1230,0,1960,0.0,98198,47.397,-122.29899999999999,1970,10125,8895,0.8785185185185185,1512900,102515625,101002725
320000.0,4,2.5,2190,7125,2.0,0,0,4,8,2190,0,1978,0.0,98032,47.3709,-122.285,2190,8075,4935,0.6926315789473684,4796100,50765625,45969525
382500.0,3,1.75,1040,9000,1.0,0,0,3,7,1040,0,1967,0.0,98027,47.5253,-122.04299999999999,1750,10878,7960,0.8844444444444445,1081600,81000000,79918400
2050000.0,5,4.0,4690,8208,2.0,0,0,2,9,3040,1650,1926,0.0,98112,47.6321,-122.304,3300,8001,3518,0.42860623781676416,21996100,67371264,45375164
596000.0,4,2.25,2270,10000,1.0,0,0,4,8,1720,550,1974,0.0,98006,47.5599,-122.14200000000001,2270,10148,7730,0.773,5152900,100000000,94847100
220000.0,4,2.25,1950,7280,2.0,0,0,3,8,1950,0,1979,0.0,98023,47.2957,-122.37,1910,7280,5330,0.7321428571428571,3802500,52998400,49195900
325000.0,3,2.5,1880,6818,2.0,0,0,2,8,1880,0,1993,0.0,98031,47.4206,-122.18299999999999,1970,7000,4938,0.7242593135816955,3534400,46485124,42950724
679950.0,4,2.5,2850,5664,2.0,0,0,2,9,2850,0,2001,0.0,98075,47.5835,-121.99600000000001,2850,5475,2814,0.4968220338983051,8122500,32080896,23958396
175000.0,2,1.0,1160,6911,1.0,0,0,2,7,1160,0,1947,0.0,98125,47.7149,-122.318,1120,6948,5751,0.8321516423093619,1345600,47761921,46416321
268000.0,3,1.75,1370,10050,1.0,0,1,3,7,1370,0,1966,0.0,98023,47.3338,-122.34100000000001,1720,10050,8680,0.863681592039801,1876900,101002500,99125600
715000.0,4,3.5,3260,110579,2.0,0,0,2,10,3260,0,1997,0.0,98053,47.6436,-121.99700000000001,3470,97895,107319,0.9705188146031344,10627600,12227715241,12217087641
600000.0,7,2.25,3170,36384,2.0,0,0,2,8,3170,0,1969,0.0,98027,47.4654,-122.00299999999999,2460,38370,33214,0.9128737906772207,10048900,1323795456,1313746556
950000.0,5,2.5,3450,35880,2.0,0,0,2,11,3450,0,1992,0.0,98052,47.7173,-122.09899999999999,3450,26820,32430,0.9038461538461539,11902500,1287374400,1275471900
475000.0,2,1.75,1490,224334,1.0,0,2,2,8,1490,0,1983,0.0,98092,47.2645,-122.163,2350,213879,222844,0.993358117806485,2220100,50325743556,50323523456
700000.0,3,1.5,1460,78408,1.0,0,0,3,7,1460,0,1963,0.0,98075,47.59,-122.05799999999999,3320,7787,76948,0.9813794510764208,2131600,6147814464,6145682864
275000.0,3,1.75,1300,20700,1.0,0,0,2,7,1300,0,1962,0.0,98024,47.5587,-121.904,1930,37638,19400,0.9371980676328503,1690000,428490000,426800000
369500.0,3,1.75,1300,20700,1.0,0,0,2,7,1300,0,1962,0.0,98024,47.5587,-121.904,1930,37638,19400,0.9371980676328503,1690000,428490000,426800000
215000.0,4,2.0,1540,7575,1.0,0,0,3,7,1040,500,1978,0.0,98032,47.3664,-122.279,1720,7575,6035,0.7966996699669967,2371600,57380625,55009025
593450.0,4,2.25,2130,7172,2.0,0,0,3,8,2130,0,1964,0.0,98008,47.6271,-122.11200000000001,1910,7653,5042,0.7030117122141663,4536900,51437584,46900684
498800.0,2,1.75,1350,4614,1.0,0,0,2,8,1350,0,2008,0.0,98053,47.7091,-122.015,1680,4775,3264,0.7074122236671001,1822500,21288996,19466496
849000.0,5,3.25,2450,6534,2.0,0,0,2,8,1770,680,1951,2014.0,98115,47.688,-122.281,1620,6534,4084,0.6250382614018978,6002500,42693156,36690656
1150000.0,4,2.5,1940,4875,2.0,0,0,3,9,1940,0,1925,0.0,98112,47.6427,-122.304,1790,4875,2935,0.602051282051282,3763600,23765625,20002025
825000.0,5,2.5,2890,5110,2.0,0,2,2,9,2890,0,2003,0.0,98029,47.5453,-121.995,3010,5110,2220,0.4344422700587084,8352100,26112100,17760000
265000.0,3,1.75,1680,9769,1.0,0,0,2,8,1340,340,1989,0.0,98058,47.4631,-122.126,1730,9686,8089,0.8280274337189067,2822400,95433361,92610961
285000.0,4,2.25,1960,10400,1.0,0,0,3,8,1220,740,1985,0.0,98023,47.3199,-122.39200000000001,1650,8660,8440,0.8115384615384615,3841600,108160000,104318400
240000.0,3,1.75,1590,7931,1.0,0,0,2,7,1190,400,1979,0.0,98038,47.3628,-122.05,1680,7931,6341,0.7995208674820325,2528100,62900761,60372661
261000.0,4,1.0,1390,17739,1.0,0,0,2,7,1390,0,1958,0.0,98003,47.3457,-122.302,1230,7840,16349,0.9216415806978973,1932100,314672121,312740021
330000.0,4,1.75,2440,7350,1.0,0,0,2,8,1610,830,1978,0.0,98032,47.3743,-122.285,2180,7680,4910,0.6680272108843538,5953600,54022500,48068900
250000.0,4,2.0,1850,7560,1.0,0,0,3,7,1540,310,1978,0.0,98032,47.3666,-122.277,1620,7658,5710,0.7552910052910053,3422500,57153600,53731100
350000.0,4,2.5,2800,9538,2.0,0,0,2,8,2800,0,1993,0.0,98003,47.2675,-122.307,1970,7750,6738,0.7064374082616901,7840000,90973444,83133444
930000.0,3,2.5,3780,35273,1.5,0,0,2,10,3780,0,1986,0.0,98072,47.7499,-122.119,3450,35273,31493,0.8928358801349474,14288400,1244184529,1229896129
275000.0,3,2.0,1910,8050,1.0,0,0,3,7,1000,910,1980,0.0,98030,47.37,-122.17,1780,7344,6140,0.7627329192546584,3648100,64802500,61154400
325000.0,4,2.25,2460,7620,1.0,0,0,2,7,1230,1230,1969,0.0,98106,47.5285,-122.345,2090,7620,5160,0.6771653543307087,6051600,58064400,52012800
255000.0,1,1.0,810,5000,1.0,0,1,2,7,590,220,1936,0.0,98106,47.5696,-122.36,1920,5000,4190,0.838,656100,25000000,24343900
562200.0,3,1.5,1900,5250,1.0,0,0,3,7,1500,400,1943,0.0,98117,47.6991,-122.39200000000001,1810,5250,3350,0.638095238095238,3610000,27562500,23952500
952000.0,2,1.75,3490,88909,1.0,0,3,2,10,2320,1170,1980,0.0,98006,47.5462,-122.11200000000001,3490,40185,85419,0.9607463811312691,12180100,7904810281,7892630181
365000.0,3,2.5,2200,7350,1.0,0,0,4,8,1570,630,1988,0.0,98058,47.4395,-122.161,2350,7557,5150,0.7006802721088435,4840000,54022500,49182500
332900.0,3,1.5,1190,11996,1.0,0,0,3,7,1190,0,1969,0.0,98077,47.7561,-122.071,1190,9756,10806,0.9008002667555852,1416100,143904016,142487916
721000.0,3,2.25,2040,18360,2.0,0,0,3,8,2040,0,1983,0.0,98052,47.6976,-122.137,2590,21315,16320,0.8888888888888888,4161600,337089600,332928000
487275.0,4,2.5,2400,3986,2.0,0,0,2,8,2400,0,1999,0.0,98065,47.5344,-121.87700000000001,2070,3986,1586,0.39789262418464627,5760000,15888196,10128196
310000.0,3,2.5,1670,5791,2.0,0,0,2,7,1670,0,1995,0.0,98055,47.4424,-122.18799999999999,1610,6034,4121,0.7116214816093939,2788900,33535681,30746781
245000.0,2,1.0,990,4800,1.0,0,0,2,6,990,0,1908,0.0,98118,47.5615,-122.28,1700,5400,3810,0.79375,980100,23040000,22059900
325000.0,3,1.75,2920,10573,1.0,0,0,3,7,2920,0,1964,0.0,98055,47.4429,-122.195,1560,10572,7653,0.7238248368485766,8526400,111788329,103261929
550000.0,3,1.75,1840,9401,1.0,0,0,2,8,1840,0,1971,0.0,98075,47.5847,-122.075,2850,14323,7561,0.8042761408360812,3385600,88378801,84993201
350000.0,2,1.0,910,4500,1.5,0,0,3,7,910,0,1906,0.0,98118,47.5633,-122.289,1270,3500,3590,0.7977777777777778,828100,20250000,19421900
599000.0,5,2.5,2950,72309,2.0,0,0,2,8,2950,0,2006,0.0,98058,47.4186,-122.079,1480,56192,69359,0.9592028654800924,8702500,5228591481,5219888981
259950.0,3,1.5,1240,9500,1.0,0,0,3,7,1240,0,1955,0.0,98166,47.4756,-122.35,1845,10125,8260,0.8694736842105263,1537600,90250000,88712400
240000.0,4,2.5,1980,7264,2.0,0,0,2,7,1980,0,1996,0.0,98038,47.3678,-122.01899999999999,1600,6380,5284,0.7274229074889867,3920400,52765696,48845296
186000.0,3,1.0,1200,10080,1.0,0,0,3,7,1200,0,1969,0.0,98042,47.3261,-122.135,1230,9800,8880,0.8809523809523809,1440000,101606400,100166400
395000.0,3,1.5,1280,15028,1.0,0,0,2,7,1280,0,1982,0.0,98074,47.6304,-122.035,1470,13698,13748,0.9148256587702954,1638400,225840784,224202384
475000.0,4,2.5,3150,5757,2.0,0,0,2,9,3150,0,2004,0.0,98058,47.4568,-122.117,3100,5757,2607,0.4528400208441897,9922500,33143049,23220549
815000.0,5,3.5,3500,10794,2.0,0,0,2,10,3500,0,1996,0.0,98075,47.5887,-121.97399999999999,3110,10837,7294,0.6757457846952011,12250000,116510436,104260436
572000.0,3,1.5,1680,13751,1.0,0,0,3,7,1680,0,1951,0.0,98040,47.5716,-122.227,1760,13500,12071,0.8778270671223911,2822400,189090001,186267601
419500.0,3,2.5,1360,3188,2.0,0,0,2,7,1360,0,1986,0.0,98052,47.6831,-122.096,1090,3188,1828,0.5734002509410289,1849600,10163344,8313744
298700.0,3,2.25,2110,7350,1.0,0,0,2,8,1530,580,1980,0.0,98023,47.3088,-122.34100000000001,2640,7777,5240,0.7129251700680272,4452100,54022500,49570400
549000.0,2,1.0,2034,13392,1.0,1,4,4,7,1159,875,1947,0.0,98070,47.3312,-122.50299999999999,1156,15961,11358,0.8481182795698925,4137156,179345664,175208508
278000.0,3,1.5,1900,9994,1.0,0,0,2,7,1120,780,1960,0.0,98168,47.4729,-122.301,1900,9994,8094,0.8098859315589354,3610000,99880036,96270036
455000.0,4,2.0,2380,4500,1.5,0,0,2,6,1470,910,1926,2014.0,98118,47.5652,-122.281,1300,4500,2120,0.4711111111111111,5664400,20250000,14585600
925000.0,5,3.5,4050,13495,1.0,0,2,3,9,2230,0,1988,0.0,98166,47.4384,-122.352,3210,13495,9445,0.6998888477213783,16402500,182115025,165712525
465000.0,2,1.5,1120,1201,3.0,0,0,2,8,1120,0,1999,0.0,98103,47.6524,-122.353,1370,1298,81,0.06744379683597003,1254400,1442401,188001
620000.0,4,4.0,2850,2970,2.0,0,0,2,8,2120,730,1999,0.0,98029,47.547,-122.01,2380,3559,120,0.04040404040404041,8122500,8820900,698400
499900.0,4,2.25,2360,7650,1.0,0,0,2,8,1640,0,1963,0.0,98155,47.75,-122.292,2320,11060,5290,0.6915032679738562,5569600,58522500,52952900
620000.0,5,3.0,2540,11422,1.0,0,0,2,8,1270,1270,1962,2014.0,98006,47.5459,-122.176,2090,10741,8882,0.7776221327263176,6451600,130462084,124010484
450000.0,3,1.75,1160,6120,1.0,0,0,2,7,1040,120,1941,0.0,98115,47.6926,-122.287,1530,6120,4960,0.8104575163398693,1345600,37454400,36108800
690000.0,4,3.5,2710,2147,2.0,0,0,2,10,2220,490,2007,0.0,98029,47.5468,-121.994,2650,2252,-563,-0.2622263623660922,7344100,4609609,-2734491
1900000.0,5,2.25,3120,16672,2.0,0,0,3,9,3120,0,1969,0.0,98004,47.6458,-122.219,3740,17853,13552,0.8128598848368522,9734400,277955584,268221184
1940000.0,5,2.25,3120,16672,2.0,0,0,3,9,3120,0,1969,0.0,98004,47.6458,-122.219,3740,17853,13552,0.8128598848368522,9734400,277955584,268221184
832500.0,3,2.0,1870,9527,1.0,0,0,3,7,1870,0,1951,1997.0,98040,47.5777,-122.22399999999999,1970,11904,7657,0.8037157552220007,3496900,90763729,87266829
245000.0,3,1.0,1010,9678,1.0,0,0,4,7,1010,0,1955,0.0,98188,47.4396,-122.285,1010,9375,8668,0.8956395949576359,1020100,93663684,92643584
820000.0,3,2.5,2980,18935,1.5,0,0,2,11,2980,0,1990,0.0,98077,47.7133,-122.079,3670,18225,15955,0.8426194877211514,8880400,358534225,349653825
369000.0,4,2.75,2420,6495,2.0,0,0,2,8,2420,0,2005,0.0,98038,47.3771,-122.029,2420,6200,4075,0.6274056966897613,5856400,42185025,36328625
1050000.0,4,3.25,3830,8331,2.0,0,0,2,9,3830,0,2014,0.0,98053,47.6906,-122.01899999999999,4080,8425,4501,0.540271275957268,14668900,69405561,54736661
653000.0,3,3.0,3040,5067,3.0,0,2,2,10,3040,0,1993,0.0,98118,47.5409,-122.26700000000001,1820,5998,2027,0.40003947108742843,9241600,25674489,16432889
220650.0,2,1.75,1460,10500,1.0,0,0,2,7,1460,0,1980,0.0,98045,47.4461,-121.76799999999999,1340,9600,9040,0.8609523809523809,2131600,110250000,108118400
300000.0,5,3.0,1940,6355,1.0,0,0,2,8,1200,740,2007,0.0,98168,47.49800000000001,-122.322,1940,5033,4415,0.6947285601888277,3763600,40386025,36622425
970000.0,4,3.5,3780,20023,2.0,0,2,2,10,3780,0,2001,0.0,98029,47.5491,-122.006,2150,3675,16243,0.8112171003346151,14288400,400920529,386632129
360000.0,4,2.5,1950,5451,2.0,0,0,2,7,1950,0,2004,0.0,98058,47.4341,-122.14399999999999,2240,6221,3501,0.6422674738580078,3802500,29713401,25910901
672500.0,3,2.5,2450,5760,2.0,0,0,2,9,2450,0,2000,0.0,98074,47.6145,-122.02600000000001,2450,5762,3310,0.5746527777777778,6002500,33177600,27175100
268000.0,4,1.5,1730,7020,1.5,0,0,3,5,1730,0,1953,0.0,98056,47.4939,-122.167,1110,7020,5290,0.7535612535612536,2992900,49280400,46287500
440000.0,4,1.5,1690,3245,1.5,0,0,2,8,1690,0,1929,0.0,98126,47.5445,-122.375,1380,1590,1555,0.47919876733436056,2856100,10530025,7673925
1400000.0,3,2.5,2550,7200,2.0,0,2,2,10,2550,0,1981,2013.0,98144,47.5996,-122.288,2030,3500,4650,0.6458333333333334,6502500,51840000,45337500
590000.0,4,2.5,2290,11072,2.0,0,0,2,9,2290,0,1986,0.0,98074,47.6283,-122.03,2340,9774,8782,0.7931719653179191,5244100,122589184,117345084
359000.0,4,2.25,2710,22860,1.0,0,0,3,7,1850,860,1962,0.0,98001,47.3207,-122.266,1700,22860,20150,0.8814523184601925,7344100,522579600,515235500
266500.0,4,1.75,1880,7632,1.0,0,0,3,7,1180,700,1978,0.0,98023,47.3068,-122.37200000000001,1840,8528,5752,0.7536687631027253,3534400,58247424,54713024
635000.0,4,2.5,2930,8679,2.0,0,0,2,8,2930,0,2014,0.0,98056,47.5164,-122.19,2030,7264,5749,0.6624035027076852,8584900,75325041,66740141
559000.0,3,2.5,3110,217800,2.0,0,0,2,9,3110,0,2001,0.0,98092,47.3281,-122.124,2220,217800,214690,0.9857208448117539,9672100,47436840000,47427167900
895000.0,4,2.5,3480,38985,2.0,0,0,2,10,3480,0,1989,0.0,98053,47.6895,-122.052,3630,36290,35505,0.9107348980377068,12110400,1519830225,1507719825
625000.0,2,1.5,1110,118047,1.0,0,0,2,7,1110,0,1961,0.0,98072,47.7467,-122.12799999999999,2970,43500,116937,0.9905969656153905,1232100,13935094209,13933862109
650000.0,4,2.25,2440,9320,1.0,0,0,3,7,1880,560,1957,0.0,98007,47.5933,-122.135,1530,9335,6880,0.7381974248927039,5953600,86862400,80908800
312500.0,4,1.75,2280,7840,1.0,0,0,2,7,1280,1000,1957,0.0,98055,47.4809,-122.22399999999999,2120,7260,5560,0.7091836734693877,5198400,61465600,56267200
225000.0,3,1.0,900,6099,1.0,0,0,2,6,790,110,1944,0.0,98168,47.4807,-122.289,1240,6099,5199,0.8524348253812101,810000,37197801,36387801
425000.0,4,1.75,1980,8400,1.0,0,0,2,7,1330,650,1968,0.0,98052,47.6721,-122.152,1920,8400,6420,0.7642857142857142,3920400,70560000,66639600
329999.0,3,2.75,3360,41250,1.0,0,0,3,7,1820,1540,1988,0.0,98022,47.2604,-122.023,2580,98881,37890,0.9185454545454546,11289600,1701562500,1690272900
572000.0,5,2.25,2340,9225,2.0,0,0,2,8,2340,0,1973,0.0,98052,47.6369,-122.098,2140,9348,6885,0.7463414634146341,5475600,85100625,79625025
386500.0,4,2.5,3110,5048,2.0,0,0,2,8,3110,0,2002,0.0,98042,47.3782,-122.125,3110,5190,1938,0.38391442155309036,9672100,25482304,15810204
452000.0,2,1.0,980,5000,1.0,0,0,2,6,980,0,1904,0.0,98107,47.6744,-122.369,1270,4500,4020,0.804,960400,25000000,24039600
278000.0,4,2.0,1480,6324,1.0,0,0,2,7,1480,0,1943,0.0,98122,47.6147,-122.302,1480,3600,4844,0.7659709044908286,2190400,39992976,37802576
474900.0,3,2.25,1800,43647,1.0,0,0,3,8,1800,0,1976,0.0,98072,47.7757,-122.132,2480,25608,41847,0.9587600522372671,3240000,1905060609,1901820609
450000.0,2,1.75,2130,6574,1.0,0,0,2,8,1500,630,1946,0.0,98199,47.6529,-122.411,2130,6275,4444,0.6759963492546395,4536900,43217476,38680576
611000.0,2,1.0,1270,5100,1.0,0,0,2,7,1100,170,1900,0.0,98115,47.6771,-122.32799999999999,1670,3900,3830,0.7509803921568627,1612900,26010000,24397100
214100.0,2,2.5,1150,2064,2.0,0,0,2,7,1150,0,2004,0.0,98001,47.3516,-122.292,1880,2855,914,0.4428294573643411,1322500,4260096,2937596
317000.0,3,2.5,1840,5011,2.0,0,0,2,8,1840,0,2012,0.0,98038,47.3555,-122.054,2000,4793,3171,0.6328078227898623,3385600,25110121,21724521
1000000.0,4,3.5,3180,12528,2.0,0,1,3,9,2060,1120,1979,0.0,98177,47.7058,-122.37899999999999,2850,11410,9348,0.7461685823754789,10112400,156950784,146838384
1000000.0,5,2.75,1510,5700,2.0,0,1,3,7,1510,0,1946,0.0,98105,47.6653,-122.27,2190,5700,4190,0.7350877192982456,2280100,32490000,30209900
525000.0,4,2.5,3070,7200,2.0,0,0,2,8,3070,0,2005,0.0,98059,47.4899,-122.13799999999999,2590,7200,4130,0.5736111111111111,9424900,51840000,42415100
436000.0,3,2.25,1800,6680,2.0,0,0,2,8,1800,0,1983,0.0,98034,47.7293,-122.223,1630,8621,4880,0.7305389221556886,3240000,44622400,41382400
450000.0,3,1.75,1540,9154,1.0,0,0,2,8,1540,0,1983,0.0,98074,47.6207,-122.042,1990,10273,7614,0.8317675333187677,2371600,83795716,81424116
588500.0,3,1.75,2330,14892,1.0,0,0,2,8,1970,360,1980,0.0,98074,47.6267,-122.046,2570,14217,12562,0.8435401557883427,5428900,221771664,216342764
340000.0,4,1.75,1400,8374,1.0,0,0,2,7,1400,0,1953,0.0,98166,47.4735,-122.344,1420,8360,6974,0.8328158586099833,1960000,70123876,68163876
482000.0,4,2.5,2846,85377,1.5,0,0,2,8,1976,870,2000,0.0,98001,47.317,-122.281,1696,57934,82531,0.9666654953910304,8099716,7289232129,7281132413
1580000.0,4,3.5,5830,131116,2.0,0,0,2,11,5830,0,2005,0.0,98024,47.5986,-121.949,5340,207206,125286,0.9555355563012905,33988900,17191405456,17157416556
749000.0,3,2.5,3380,7126,2.0,0,0,2,8,3380,0,1965,2003.0,98008,47.6276,-122.12200000000001,1810,7308,3746,0.5256806062307045,11424400,50779876,39355476
330000.0,3,1.5,1440,7875,1.0,0,0,3,8,1440,0,1968,0.0,98058,47.4561,-122.148,1800,8964,6435,0.8171428571428572,2073600,62015625,59942025
568000.0,3,2.5,1740,1279,3.0,0,0,2,8,1740,0,2008,0.0,98116,47.5891,-122.387,1740,1280,-461,-0.3604378420641126,3027600,1635841,-1391759
239000.0,3,1.75,1470,8925,1.0,0,0,3,7,1470,0,1957,0.0,98022,47.2026,-122.0,1430,9282,7455,0.8352941176470589,2160900,79655625,77494725
528000.0,3,2.5,2810,4932,2.0,0,0,2,8,2810,0,2003,0.0,98011,47.7739,-122.227,2470,4919,2122,0.4302514193025142,7896100,24324624,16428524
385000.0,4,3.0,2090,5102,1.0,0,0,2,7,1350,740,1994,0.0,98106,47.5427,-122.35600000000001,2090,5102,3012,0.5903567228537828,4368100,26030404,21662304
825000.0,4,3.25,4110,14219,2.0,0,2,3,10,2570,1540,1979,0.0,98028,47.7382,-122.264,2760,12283,10109,0.7109501371404459,16892100,202179961,185287861
815000.0,5,3.25,3230,5000,2.0,0,1,2,9,2350,880,2002,0.0,98136,47.5202,-122.39299999999999,1520,5000,1770,0.354,10432900,25000000,14567100
625000.0,4,2.5,2601,34335,2.0,0,0,2,9,2601,0,1995,0.0,98072,47.742,-122.087,2080,32336,31734,0.9242463958060289,6765201,1178892225,1172127024
690000.0,3,1.75,2070,6000,1.0,0,3,2,8,1340,730,1955,0.0,98136,47.5226,-122.382,2200,6000,3930,0.655,4284900,36000000,31715100
210000.0,3,1.0,1660,7440,1.0,0,0,2,7,1270,390,1957,0.0,98106,47.5242,-122.36200000000001,1540,7440,5780,0.7768817204301075,2755600,55353600,52598000
599000.0,4,1.0,1590,4280,1.5,0,0,2,7,1590,0,1924,0.0,98103,47.667,-122.335,2230,4280,2690,0.6285046728971962,2528100,18318400,15790300
860000.0,3,1.75,1860,5584,1.0,0,0,2,8,1310,550,1951,0.0,98199,47.637,-122.4,1630,6022,3724,0.6669054441260746,3459600,31181056,27721456
147200.0,3,1.0,1420,9600,1.0,0,0,3,6,1420,0,1954,0.0,98188,47.4232,-122.292,1400,8415,8180,0.8520833333333333,2016400,92160000,90143600
476900.0,3,1.0,1240,5758,1.5,0,0,3,6,960,280,1910,0.0,98116,47.5675,-122.396,1460,5750,4518,0.7846474470302188,1537600,33154564,31616964
450000.0,4,2.5,2500,36254,1.0,0,0,3,8,1590,910,1978,0.0,98027,47.4685,-122.00399999999999,2360,36254,33754,0.9310420919070999,6250000,1314352516,1308102516
570000.0,4,2.5,2640,11816,2.0,0,0,2,8,2640,0,1999,0.0,98019,47.733000000000004,-121.96799999999999,2400,11816,9176,0.7765741367637102,6969600,139617856,132648256
567500.0,3,1.0,1440,3060,1.5,0,0,3,7,1440,0,1910,0.0,98115,47.6769,-122.307,1440,3570,1620,0.5294117647058824,2073600,9363600,7290000
790000.0,5,3.25,3030,20446,2.0,0,2,2,9,2130,900,1976,0.0,98008,47.6133,-122.10600000000001,2890,20908,17416,0.8518047539861098,9180900,418038916,408858016
875000.0,3,1.5,1820,12686,1.0,0,0,3,7,1820,0,1952,0.0,98004,47.5886,-122.195,3020,11550,10866,0.8565347627305692,3312400,160934596,157622196
490000.0,3,2.0,2220,10275,2.0,0,0,2,9,1640,580,1980,0.0,98027,47.5304,-122.055,2300,9975,8055,0.7839416058394161,4928400,105575625,100647225
335000.0,3,1.75,2430,9133,1.0,0,0,3,7,1410,1020,1978,0.0,98059,47.5116,-122.15700000000001,1980,9592,6703,0.7339318953246469,5904900,83411689,77506789
550000.0,3,1.75,1670,10798,1.0,0,0,3,8,1670,0,1962,0.0,98006,47.549,-122.17,2290,10798,9128,0.8453417299499908,2788900,116596804,113807904
385000.0,3,1.75,1180,10541,1.0,0,0,3,7,940,240,1981,0.0,98074,47.6348,-122.03200000000001,1230,10879,9361,0.888056161654492,1392400,111112681,109720281
395000.0,3,1.75,1620,8085,1.0,0,0,2,7,1210,410,1976,0.0,98011,47.7349,-122.197,1700,8085,6465,0.7996289424860853,2624400,65367225,62742825
650000.0,2,1.0,1030,5750,1.0,0,0,4,8,1030,0,1928,0.0,98116,47.5861,-122.391,1570,5750,4720,0.8208695652173913,1060900,33062500,32001600
637000.0,4,2.75,2900,5803,2.0,0,0,2,9,2900,0,2007,0.0,98028,47.7368,-122.23200000000001,2900,6212,2903,0.5002584869894882,8410000,33674809,25264809
692500.0,3,2.25,3420,9900,1.0,0,0,2,9,1710,1710,1963,2004.0,98028,47.7412,-122.256,2290,10700,6480,0.6545454545454545,11696400,98010000,86313600
322400.0,3,1.75,1710,15844,1.0,0,0,3,8,1710,0,1964,0.0,98059,47.4706,-122.1,1990,20359,14134,0.8920727089118909,2924100,251032336,248108236
233500.0,3,1.5,1580,10517,1.0,0,0,3,6,1580,0,1957,0.0,98002,47.2903,-122.214,1400,10658,8937,0.8497670438337929,2496400,110607289,108110889
400000.0,3,2.0,1230,11413,1.0,0,0,2,7,990,240,1984,0.0,98074,47.6321,-122.03399999999999,1570,11517,10183,0.8922281608691842,1512900,130256569,128743669
547000.0,5,2.5,2200,4080,1.5,0,0,4,7,1420,780,1916,0.0,98103,47.6872,-122.35,1300,4080,1880,0.46078431372549017,4840000,16646400,11806400
519000.0,5,2.25,2570,13054,1.0,0,1,2,8,1470,1100,1950,1992.0,98166,47.4487,-122.352,2570,19807,10484,0.8031254787804505,6604900,170406916,163802016
1030000.0,4,3.5,3320,19850,1.0,0,2,3,10,2040,0,1977,0.0,98040,47.527,-122.228,3240,15470,16530,0.8327455919395466,11022400,394022500,383000100
365000.0,3,1.0,1090,6435,1.0,0,0,3,7,1090,0,1955,0.0,98106,47.5334,-122.365,1340,6435,5345,0.8306138306138307,1188100,41409225,40221125
699000.0,5,2.75,2970,36817,2.0,0,0,3,8,2970,0,1978,0.0,98072,47.7731,-122.139,2730,29150,33847,0.9193307439498059,8820900,1355491489,1346670589
525000.0,3,1.75,1970,8000,1.0,0,0,3,8,1970,0,1968,0.0,98052,47.6324,-122.1,1910,8000,6030,0.75375,3880900,64000000,60119100
430000.0,4,3.0,3220,8936,2.0,0,0,2,9,2450,770,1990,0.0,98031,47.4208,-122.213,2810,10500,5716,0.6396598030438675,10368400,79852096,69483696
325000.0,3,1.0,1600,7500,1.0,0,0,2,7,1600,0,1966,0.0,98034,47.7198,-122.182,2050,7200,5900,0.7866666666666666,2560000,56250000,53690000
279000.0,2,1.0,670,6300,1.0,0,0,4,6,670,0,1942,0.0,98126,47.5161,-122.374,760,6300,5630,0.8936507936507937,448900,39690000,39241100
805000.0,4,1.75,2360,4750,2.0,0,0,4,7,1660,700,1911,0.0,98115,47.6729,-122.29299999999999,1810,4750,2390,0.5031578947368421,5569600,22562500,16992900
419950.0,3,3.0,2150,3962,1.5,0,0,2,7,1540,610,1949,0.0,98125,47.7183,-122.285,1730,4609,1812,0.4573447753659768,4622500,15697444,11074944
425000.0,2,1.0,620,4455,1.0,0,0,2,6,620,0,1927,0.0,98117,47.6877,-122.395,1180,5000,3835,0.8608305274971941,384400,19847025,19462625
446000.0,4,1.75,1730,5922,2.0,0,0,4,7,1730,0,1949,0.0,98125,47.7188,-122.321,1700,6127,4192,0.7078689631881121,2992900,35070084,32077184
455000.0,5,2.0,2500,7860,1.0,0,0,2,7,1040,1460,1963,0.0,98034,47.7212,-122.226,2060,9684,5360,0.6819338422391857,6250000,61779600,55529600
226550.0,3,1.0,990,4440,1.0,0,0,2,6,990,0,1943,0.0,98106,47.522,-122.354,990,6771,3450,0.777027027027027,980100,19713600,18733500
764000.0,3,2.0,1420,4080,1.5,0,0,4,8,1420,0,1904,0.0,98103,47.6801,-122.348,1220,3060,2660,0.6519607843137255,2016400,16646400,14630000
439950.0,3,2.25,2170,15000,2.0,0,0,3,8,2170,0,1978,0.0,98042,47.3863,-122.15799999999999,2430,14256,12830,0.8553333333333333,4708900,225000000,220291100
453000.0,4,2.0,1880,5100,1.0,0,0,2,8,1880,0,1952,0.0,98103,47.6872,-122.34899999999999,1610,4590,3220,0.6313725490196078,3534400,26010000,22475600
219950.0,3,1.0,1300,9620,1.0,0,0,2,7,1300,0,1971,0.0,98003,47.282,-122.331,1420,9620,8320,0.8648648648648649,1690000,92544400,90854400
702500.0,3,1.5,2360,6750,2.0,0,0,4,7,1930,430,1926,0.0,98103,47.6923,-122.33200000000001,1320,4500,4390,0.6503703703703704,5569600,45562500,39992900
285000.0,3,1.5,1780,12231,1.0,0,0,3,8,1780,0,1956,0.0,98003,47.335,-122.321,2460,12663,10451,0.8544681546889052,3168400,149597361,146428961
798750.0,2,2.25,2160,2578,3.0,0,0,2,8,2160,0,2005,0.0,98103,47.6607,-122.354,1800,2142,418,0.1621411947245927,4665600,6646084,1980484
320000.0,2,1.0,950,5316,1.0,0,2,2,7,950,0,1948,0.0,98126,47.57,-122.38,1620,6085,4366,0.8212942061700527,902500,28259856,27357356
425000.0,3,1.75,1680,14630,1.5,0,0,2,8,1680,0,1985,0.0,98027,47.5272,-122.044,1920,14630,12950,0.8851674641148325,2822400,214036900,211214500
540000.0,4,2.5,2290,4450,2.0,0,0,2,9,2290,0,2004,0.0,98072,47.7385,-122.169,2570,5096,2160,0.4853932584269663,5244100,19802500,14558400
1060000.0,4,5.25,4140,14757,2.0,0,2,2,11,4140,0,2005,0.0,98075,47.5871,-121.969,4440,15523,10617,0.7194551738158163,17139600,217769049,200629449
1170000.0,4,3.75,3920,4500,3.0,0,0,2,8,3920,0,2013,0.0,98103,47.6805,-122.346,2040,3000,580,0.1288888888888889,15366400,20250000,4883600
576000.0,3,1.75,1500,13891,1.0,0,0,3,7,1500,0,1951,0.0,98005,47.5866,-122.175,2020,13891,12391,0.8920164135051473,2250000,192959881,190709881
525000.0,3,1.75,1720,7200,1.0,0,0,2,7,1140,580,1977,0.0,98052,47.6977,-122.132,1700,8400,5480,0.7611111111111111,2958400,51840000,48881600
324950.0,4,2.5,2641,8615,2.0,0,0,2,7,2641,0,1998,0.0,98031,47.4038,-122.213,2641,8091,5974,0.6934416715031921,6974881,74218225,67243344
600000.0,3,2.5,4930,77536,2.0,0,0,2,9,3930,1000,1981,0.0,98072,47.7634,-122.139,2760,7351,72606,0.9364166322740405,24304900,6011831296,5987526396
464000.0,3,2.5,2460,5400,1.0,0,0,3,8,1520,940,2001,0.0,98056,47.5231,-122.20200000000001,1745,5400,2940,0.5444444444444444,6051600,29160000,23108400
266000.0,4,2.25,1995,7102,2.0,0,0,3,8,1995,0,1981,0.0,98023,47.2986,-122.37,1880,7950,5107,0.7190932131793861,3980025,50438404,46458379
775000.0,3,2.5,3010,74390,2.0,0,0,2,10,3010,0,1998,0.0,98053,47.6442,-121.999,3240,109771,71380,0.9595375722543352,9060100,5533872100,5524812000
415000.0,3,1.75,1270,4800,1.0,0,0,2,7,1270,0,1952,2014.0,98126,47.5362,-122.376,1220,4800,3530,0.7354166666666667,1612900,23040000,21427100
550000.0,4,2.75,3080,6731,2.0,0,3,2,9,3080,0,2003,0.0,98058,47.4522,-122.118,3080,6731,3651,0.5424156886049621,9486400,45306361,35819961
235000.0,3,2.25,1670,7606,2.0,0,0,2,7,1670,0,1990,0.0,98022,47.1949,-121.98200000000001,1670,7433,5936,0.7804364975019721,2788900,57851236,55062336
280000.0,3,2.0,1470,8089,1.0,0,0,2,7,1470,0,1987,0.0,98198,47.3878,-122.316,1530,7721,6619,0.8182717270367166,2160900,65431921,63271021
459000.0,3,1.75,1730,7807,1.0,0,0,2,7,1260,470,1976,0.0,98034,47.7211,-122.169,1800,7650,6077,0.7784039964134751,2992900,60949249,57956349
195000.0,3,1.0,1070,7615,1.0,0,0,3,7,1070,0,1969,0.0,98023,47.3189,-122.37299999999999,1240,6906,6545,0.8594878529218647,1144900,57988225,56843325
235000.0,3,1.5,1660,8738,1.0,0,0,3,7,1080,580,1959,0.0,98002,47.3117,-122.208,1500,8466,7078,0.8100251773861296,2755600,76352644,73597044
711800.0,4,2.25,2410,16650,1.0,0,0,3,8,2410,0,1965,0.0,98006,47.5706,-122.163,2720,11141,14240,0.8552552552552553,5808100,277222500,271414400
440000.0,3,2.5,1040,1032,3.0,0,0,2,7,1040,0,2007,0.0,98107,47.6673,-122.37700000000001,1290,1275,-8,-0.007751937984496124,1081600,1065024,-16576
515000.0,2,1.0,970,3300,1.0,0,0,3,7,970,0,1916,0.0,98103,47.6609,-122.34299999999999,1060,3600,2330,0.706060606060606,940900,10890000,9949100
1200000.0,5,2.75,2910,9480,1.5,0,0,2,8,2910,0,1939,0.0,98105,47.6552,-122.27799999999999,2940,6600,6570,0.6930379746835443,8468100,89870400,81402300
560000.0,3,1.75,2340,12443,1.5,0,0,3,8,2340,0,1965,0.0,98006,47.5432,-122.177,1970,9600,10103,0.8119424576066865,5475600,154828249,149352649
340000.0,3,1.75,1880,11249,1.0,0,0,2,7,1330,550,1985,0.0,98001,47.3295,-122.257,1870,14547,9369,0.8328740332473997,3534400,126540001,123005601
600000.0,2,1.0,1110,3500,1.5,0,0,2,6,970,140,1912,0.0,98102,47.6453,-122.32700000000001,1884,1778,2390,0.6828571428571428,1232100,12250000,11017900
764000.0,4,2.5,2790,7938,2.0,0,0,2,9,2790,0,1997,0.0,98074,47.6223,-122.02600000000001,2780,7779,5148,0.6485260770975056,7784100,63011844,55227744
337000.0,4,2.0,1590,8779,1.0,0,0,2,8,1590,0,2001,0.0,98019,47.7408,-121.97399999999999,2090,9600,7189,0.8188859779018112,2528100,77070841,74542741
1390000.0,6,2.75,5700,20000,1.0,0,4,3,10,2850,2850,1977,0.0,98006,47.5601,-122.16,3690,15700,14300,0.715,32490000,400000000,367510000
249000.0,4,1.0,1200,7552,1.0,0,0,2,6,1060,140,1919,0.0,98126,47.5317,-122.37,1580,7680,6352,0.8411016949152542,1440000,57032704,55592704
350000.0,3,3.0,3200,35782,1.0,0,0,2,8,2360,840,1978,0.0,98042,47.4121,-122.154,3090,37887,32582,0.9105695601140238,10240000,1280351524,1270111524
269950.0,3,2.25,1510,6000,1.0,0,0,3,7,1150,360,1993,0.0,98038,47.3484,-122.036,1510,6000,4490,0.7483333333333333,2280100,36000000,33719900
735000.0,3,1.75,1880,108900,1.0,0,0,2,7,1880,0,1978,0.0,98075,47.5913,-122.01,2730,37731,107020,0.9827364554637282,3534400,11859210000,11855675600
1300000.0,4,2.5,3070,4000,2.0,0,0,3,8,2070,1000,1940,0.0,98105,47.659,-122.281,2560,4000,930,0.2325,9424900,16000000,6575100
475000.0,4,2.25,2110,7560,2.0,0,0,3,8,2110,0,1974,0.0,98034,47.7331,-122.18299999999999,2110,7560,5450,0.7208994708994709,4452100,57153600,52701500
339000.0,3,2.0,2350,8459,1.5,0,0,2,9,2350,0,1989,0.0,98023,47.3043,-122.34899999999999,2430,8459,6109,0.7221893840879536,5522500,71554681,66032181
600000.0,4,3.5,3270,15160,1.0,0,2,2,8,1660,1610,1997,0.0,98155,47.7437,-122.287,2790,15160,11890,0.7843007915567283,10692900,229825600,219132700
397500.0,4,1.75,2220,4760,1.0,0,0,2,7,1320,900,1918,0.0,98106,47.5215,-122.348,940,4760,2540,0.5336134453781513,4928400,22657600,17729200
1530000.0,4,3.5,5990,111078,2.0,0,0,2,11,5990,0,2004,0.0,98053,47.667,-121.994,4690,118918,105088,0.9460739300311493,35880100,12338322084,12302441984
460000.0,3,2.0,1760,9055,2.0,0,0,3,7,1760,0,1985,0.0,98052,47.6534,-122.12799999999999,2010,9383,7295,0.8056322473771397,3097600,81993025,78895425
370000.0,4,2.75,2200,5207,1.0,0,0,4,7,1120,1080,1951,0.0,98133,47.74,-122.34299999999999,1210,6008,3007,0.5774918379105051,4840000,27112849,22272849
250000.0,4,1.0,1550,7296,1.5,0,0,2,6,1550,0,1957,0.0,98106,47.5184,-122.366,1370,7680,5746,0.7875548245614035,2402500,53231616,50829116
1100000.0,4,3.75,5070,60123,2.0,0,0,2,11,5070,0,2000,0.0,98053,47.6567,-122.00399999999999,4920,101930,55053,0.9156728706152387,25704900,3614775129,3589070229
430000.0,2,2.25,1040,1516,2.0,0,0,2,8,1040,0,2008,0.0,98122,47.6037,-122.307,1560,1920,476,0.31398416886543534,1081600,2298256,1216656
1090000.0,3,1.5,2560,4000,1.5,0,0,4,8,1660,900,1927,0.0,98112,47.6384,-122.279,2560,4000,1440,0.36,6553600,16000000,9446400
670000.0,3,1.75,1850,8160,1.0,0,0,2,8,1850,0,1952,0.0,98177,47.7241,-122.363,1600,8160,6310,0.7732843137254902,3422500,66585600,63163100
461550.0,3,1.5,2090,11895,1.0,0,0,2,7,1790,300,1954,0.0,98118,47.5362,-122.26700000000001,2180,11072,9805,0.8242959226565784,4368100,141491025,137122925
479990.0,3,2.5,2010,2386,2.0,0,0,2,8,1390,620,2014,0.0,98029,47.5525,-121.99799999999999,1690,1870,376,0.15758591785414922,4040100,5692996,1652896
643000.0,4,2.5,2518,4663,2.0,0,0,2,8,2518,0,2005,0.0,98075,47.5894,-122.01700000000001,2280,4525,2145,0.4600042890842805,6340324,21743569,15403245
607000.0,3,2.75,2810,12813,2.0,0,0,2,8,2040,770,1988,0.0,98052,47.6796,-122.11399999999999,1890,10336,10003,0.7806914852103333,7896100,164172969,156276869
625000.0,3,2.5,2600,10092,1.0,0,0,2,9,2600,0,1984,0.0,98074,47.6223,-122.03200000000001,2440,9298,7492,0.7423701942132382,6760000,101848464,95088464
731100.0,3,2.5,2060,8778,1.0,0,0,2,8,1160,900,1953,2010.0,98136,47.5245,-122.384,1990,7560,6718,0.7653223969013443,4243600,77053284,72809684
859000.0,3,2.5,2920,434728,2.0,0,3,3,8,2920,0,1999,0.0,98042,47.3809,-122.13,3150,55216,431808,0.9932831563644394,8526400,188988433984,188979907584
435000.0,4,2.5,2130,10375,2.0,0,0,3,8,2130,0,1986,0.0,98058,47.4381,-122.16,2220,8508,8245,0.7946987951807228,4536900,107640625,103103725
465000.0,3,3.0,2290,15600,1.0,0,0,2,8,1420,870,1948,1990.0,98001,47.3558,-122.29,1890,14143,13310,0.8532051282051282,5244100,243360000,238115900
740000.0,3,1.0,1230,6380,1.5,0,0,2,7,1230,0,1927,0.0,98115,47.6947,-122.315,1250,6380,5150,0.8072100313479624,1512900,40704400,39191500
740000.0,3,1.75,2020,9478,1.0,0,0,3,9,2020,0,1961,0.0,98040,47.5383,-122.238,3050,15594,7458,0.7868748681156362,4080400,89832484,85752084
250000.0,3,2.0,1430,7280,1.0,0,0,2,7,990,440,1980,0.0,98030,47.3742,-122.18,1430,7280,5850,0.8035714285714286,2044900,52998400,50953500
656000.0,2,2.5,2270,1763,3.0,0,0,2,7,1820,450,2009,0.0,98052,47.6757,-122.12100000000001,2180,1763,-507,-0.2875779920589904,5152900,3108169,-2044731
300000.0,4,2.5,1910,8058,2.0,0,0,2,8,1910,0,1992,0.0,98031,47.3891,-122.17200000000001,1910,6500,6148,0.7629684785306527,3648100,64931364,61283264
643000.0,3,1.5,1780,214315,1.0,0,0,2,7,1780,0,1954,0.0,98077,47.7631,-122.02799999999999,2740,133419,212535,0.9916944684226489,3168400,45930919225,45927750825
311000.0,4,2.5,2690,6124,2.0,0,0,2,7,2690,0,2007,0.0,98042,47.3343,-122.05799999999999,2300,6002,3434,0.5607446113651209,7236100,37503376,30267276
360000.0,3,1.75,1330,7482,1.0,0,0,3,7,1330,0,1975,0.0,98034,47.7322,-122.20700000000001,1480,8096,6152,0.8222400427693131,1768900,55980324,54211424
475000.0,4,2.5,3060,10043,1.0,0,0,3,8,1700,1360,1968,0.0,98133,47.7387,-122.337,1630,8296,6983,0.6953101662849747,9363600,100861849,91498249
469950.0,3,3.25,1760,1778,3.0,0,0,2,8,1760,0,2008,0.0,98125,47.7201,-122.301,1520,1615,18,0.010123734533183352,3097600,3161284,63684
240000.0,3,1.75,1570,8750,1.0,0,0,2,7,1570,0,1960,0.0,98148,47.4425,-122.333,1890,8825,7180,0.8205714285714286,2464900,76562500,74097600
232000.0,2,1.0,960,8100,1.0,0,0,2,6,810,150,1936,0.0,98168,47.494,-122.304,960,12150,7140,0.8814814814814815,921600,65610000,64688400
350000.0,3,2.0,1680,81893,1.0,0,0,2,7,1680,0,1991,0.0,98092,47.3248,-122.179,2480,38637,80213,0.9794854261047953,2822400,6706463449,6703641049
803000.0,2,1.0,1440,33747,1.5,0,0,2,7,1440,0,1928,0.0,98034,47.7223,-122.209,1980,8400,32307,0.9573295404035914,2073600,1138860009,1136786409
355000.0,3,2.25,1960,7000,1.0,0,0,2,8,1600,360,1980,0.0,98058,47.4427,-122.126,1980,7140,5040,0.72,3841600,49000000,45158400
475000.0,4,2.0,1790,2250,1.0,0,2,3,7,840,950,1909,0.0,98103,47.6526,-122.345,1440,1545,460,0.20444444444444446,3204100,5062500,1858400
823000.0,3,2.5,2560,9825,2.0,0,0,3,9,2560,0,1988,0.0,98006,47.5497,-122.145,2710,12034,7265,0.739440203562341,6553600,96530625,89977025
395000.0,2,1.5,1010,3060,1.0,0,0,3,7,1010,0,1918,0.0,98103,47.6897,-122.354,1160,4080,2050,0.6699346405228758,1020100,9363600,8343500
499000.0,4,3.75,2560,5250,2.0,0,0,2,7,1900,660,1963,2006.0,98133,47.7326,-122.34200000000001,1400,5250,2690,0.5123809523809524,6553600,27562500,21008900
420000.0,2,1.75,1200,3136,1.0,0,0,2,7,800,400,1904,2005.0,98122,47.6132,-122.29700000000001,1330,3164,1936,0.6173469387755102,1440000,9834496,8394496
961500.0,3,2.5,3910,14000,2.0,0,0,2,10,3910,0,1999,0.0,98008,47.6374,-122.12,2280,14000,10090,0.7207142857142858,15288100,196000000,180711900
833000.0,4,1.75,2260,12238,1.0,0,0,2,9,2260,0,1967,0.0,98005,47.5976,-122.178,2430,10204,9978,0.8153293021735578,5107600,149768644,144661044
479000.0,3,2.25,2110,11319,2.0,0,0,3,8,2110,0,1978,0.0,98072,47.742,-122.105,1860,11319,9209,0.8135877727714462,4452100,128119761,123667661
1150000.0,4,2.5,3340,10422,2.0,0,0,2,10,3340,0,1996,0.0,98033,47.6515,-122.197,1770,9490,7082,0.6795240836691614,11155600,108618084,97462484
267000.0,3,1.0,1400,8100,1.5,0,0,2,6,1400,0,1944,0.0,98125,47.7124,-122.289,1420,8100,6700,0.8271604938271605,1960000,65610000,63650000
555000.0,4,1.75,1760,94525,1.5,0,0,2,7,1760,0,1988,0.0,98075,47.5882,-122.07,3030,34848,92765,0.9813805871462576,3097600,8934975625,8931878025
490000.0,3,2.5,2010,9725,2.0,0,0,3,8,2010,0,1987,0.0,98029,47.56800000000001,-122.01799999999999,1850,6858,7715,0.7933161953727507,4040100,94575625,90535525
619000.0,4,2.0,2300,3400,1.5,0,0,4,8,1550,750,1915,0.0,98117,47.678000000000004,-122.361,1670,4200,1100,0.3235294117647059,5290000,11560000,6270000
569950.0,5,2.75,2510,28185,1.0,0,0,3,7,1600,910,1963,0.0,98155,47.7719,-122.28200000000001,2910,14880,25675,0.910945538406954,6300100,794394225,788094125
549000.0,3,2.0,1340,3000,2.0,0,0,4,7,1340,0,1905,0.0,98103,47.6857,-122.34899999999999,1120,3000,1660,0.5533333333333333,1795600,9000000,7204400
422500.0,3,1.75,1560,7245,1.5,0,0,2,7,1560,0,1962,1985.0,98052,47.6868,-122.119,2220,8502,5685,0.7846790890269151,2433600,52490025,50056425
400000.0,4,3.5,3350,9681,1.0,0,1,2,7,2140,1210,1980,0.0,98198,47.3978,-122.322,2580,9681,6331,0.6539613676273113,11222500,93721761,82499261
692500.0,4,2.75,3710,7984,2.0,0,0,2,9,3710,0,1999,0.0,98065,47.5352,-121.868,2950,7984,4274,0.5353206412825652,13764100,63744256,49980156
310000.0,4,2.5,2430,5499,2.0,0,0,2,8,2430,0,2002,0.0,98042,47.3779,-122.125,2890,5190,3069,0.55810147299509,5904900,30239001,24334101
499900.0,3,1.75,2430,8820,1.0,0,2,2,8,1630,800,1977,0.0,98178,47.4972,-122.23299999999999,2390,10050,6390,0.7244897959183674,5904900,77792400,71887500
492000.0,3,2.25,2100,7335,2.0,0,0,2,8,2100,0,1983,0.0,98074,47.647,-122.061,2050,8930,5235,0.7137014314928425,4410000,53802225,49392225
460000.0,2,2.5,1880,40575,1.0,0,0,2,9,1880,0,1987,0.0,98024,47.5614,-121.899,1930,32935,38695,0.9536660505237216,3534400,1646330625,1642796225
800000.0,3,2.5,1630,2640,2.0,0,0,4,8,1630,0,1919,0.0,98119,47.6452,-122.37100000000001,1630,3000,1010,0.38257575757575757,2656900,6969600,4312700
832600.0,4,1.0,1640,4200,1.5,0,0,2,7,1640,0,1925,0.0,98103,47.6601,-122.33200000000001,1730,3990,2560,0.6095238095238096,2689600,17640000,14950400
470000.0,4,2.75,2310,7350,1.0,0,0,2,8,1670,640,1989,0.0,98011,47.7505,-122.182,2600,6077,5040,0.6857142857142857,5336100,54022500,48686400
542000.0,2,2.0,1930,4500,1.0,0,0,2,8,1930,0,2003,0.0,98053,47.7104,-122.031,1670,5200,2570,0.5711111111111111,3724900,20250000,16525100
1310000.0,4,4.5,4750,13912,2.0,0,2,2,10,3600,1150,2005,0.0,98118,47.5332,-122.265,3600,22124,9162,0.6585681426106959,22562500,193543744,170981244
308130.0,4,2.5,2300,7500,1.0,0,3,1,7,1650,650,1959,0.0,98198,47.4125,-122.33,2300,7500,5200,0.6933333333333334,5290000,56250000,50960000
310000.0,2,1.0,1050,2699,1.0,0,0,2,7,1050,0,2005,0.0,98029,47.5471,-121.99600000000001,1240,2671,1649,0.6109670248240089,1102500,7284601,6182101
235000.0,2,1.0,1500,8015,1.0,0,0,2,6,1500,0,1947,0.0,98146,47.5027,-122.348,1130,8015,6515,0.8128509045539614,2250000,64240225,61990225
215000.0,3,1.0,1150,7560,1.0,0,0,3,6,1150,0,1958,0.0,98058,47.4613,-122.184,1230,7560,6410,0.8478835978835979,1322500,57153600,55831100
210000.0,4,1.5,1920,10403,1.0,0,0,2,7,1370,550,1959,0.0,98023,47.2987,-122.366,1550,9619,8483,0.8154378544650581,3686400,108222409,104536009
730000.0,4,2.75,3660,150282,2.0,0,0,2,10,3660,0,1990,0.0,98053,47.6813,-122.04799999999999,3090,53578,146622,0.9756457859224658,13395600,22584679524,22571283924
245000.0,3,1.75,1720,9342,1.0,0,0,3,7,1140,580,1981,0.0,98092,47.3177,-122.182,1330,7540,7622,0.815885249411261,2958400,87272964,84314564
540000.0,3,2.25,2100,20018,1.0,0,4,2,8,1470,630,1948,0.0,98166,47.4544,-122.366,2410,17196,17918,0.8950944150264761,4410000,400720324,396310324
299000.0,4,2.5,2400,6078,2.0,0,0,2,8,2400,0,2001,0.0,98001,47.2606,-122.285,2406,7642,3678,0.6051332675222113,5760000,36942084,31182084
510000.0,3,2.5,2540,40106,2.0,0,0,2,10,2540,0,1991,0.0,98074,47.6037,-122.04299999999999,3190,71797,37566,0.9366678302498379,6451600,1608491236,1602039636
198000.0,4,1.75,2080,7200,1.0,0,0,3,7,1050,1030,1966,0.0,98001,47.3385,-122.28200000000001,1500,7350,5120,0.7111111111111111,4326400,51840000,47513600
950000.0,5,3.25,3400,7452,2.0,0,0,2,10,3400,0,1999,0.0,98007,47.6141,-122.13600000000001,2650,8749,4052,0.5437466451959205,11560000,55532304,43972304
300000.0,4,1.75,2200,7600,2.0,0,0,2,8,2200,0,1978,0.0,98092,47.3131,-122.191,1910,7600,5400,0.7105263157894737,4840000,57760000,52920000
528000.0,5,1.75,2140,8580,1.0,0,0,2,7,1200,940,1962,0.0,98033,47.6625,-122.178,1600,9206,6440,0.7505827505827506,4579600,73616400,69036800
507000.0,5,3.25,3850,16249,2.0,0,2,2,9,3030,820,2002,0.0,98092,47.3324,-122.16799999999999,2640,7393,12399,0.7630623422979875,14822500,264030001,249207501
770000.0,4,3.25,4270,6384,2.0,0,0,2,9,3060,1210,2001,0.0,98065,47.5362,-121.874,2850,6285,2114,0.33114035087719296,18232900,40755456,22522556
255000.0,3,1.75,1340,7210,1.0,0,0,3,7,1340,0,1975,0.0,98031,47.4182,-122.167,1370,7210,5870,0.8141470180305131,1795600,51984100,50188500
220000.0,1,1.5,1100,3451,1.5,0,0,3,8,1100,0,1978,0.0,98198,47.3829,-122.322,1400,4560,2351,0.6812518110692553,1210000,11909401,10699401
690700.0,5,2.75,2870,5349,2.0,0,0,2,9,2870,0,2005,0.0,98059,47.5405,-122.18700000000001,2800,5000,2479,0.46345111235745,8236900,28611801,20374901
447000.0,2,1.0,1320,8380,1.0,0,0,2,7,1320,0,1953,0.0,98177,47.705,-122.367,1290,8025,7060,0.8424821002386634,1742400,70224400,68482000
755000.0,6,2.0,2150,4505,1.0,0,0,2,7,1270,880,1952,0.0,98119,47.6514,-122.369,1740,4505,2355,0.5227524972253053,4622500,20295025,15672525
700000.0,4,1.5,2470,6000,1.5,0,0,2,7,1480,990,1940,0.0,98199,47.6365,-122.391,2140,4000,3530,0.5883333333333334,6100900,36000000,29899100
250000.0,4,2.75,1910,7700,1.0,0,0,3,7,1000,910,1980,0.0,98030,47.369,-122.17,1880,7875,5790,0.7519480519480519,3648100,59290000,55641900
320000.0,3,2.5,2130,6969,2.0,0,0,2,7,2130,0,2003,0.0,98038,47.3655,-122.027,1670,9545,4839,0.6943607404218682,4536900,48566961,44030061
565000.0,4,2.5,2240,14667,2.0,0,0,3,9,2240,0,1989,0.0,98059,47.5276,-122.161,2410,11243,12427,0.8472761982682212,5017600,215120889,210103289
754300.0,5,2.75,1800,4500,2.0,0,0,3,7,1680,120,1939,0.0,98107,47.6648,-122.35799999999999,1730,4500,2700,0.6,3240000,20250000,17010000
650000.0,3,1.5,2160,9000,1.0,0,2,3,8,1400,0,1949,0.0,98177,47.7241,-122.369,3010,9000,6840,0.76,4665600,81000000,76334400
529888.0,4,2.5,3140,8455,2.0,0,0,2,8,3140,0,2003,0.0,98059,47.4866,-122.147,3140,7391,5315,0.628622117090479,9859600,71487025,61627425
432000.0,3,2.5,1920,9812,2.0,0,0,2,8,1920,0,2000,0.0,98028,47.7633,-122.243,1830,10534,7892,0.8043212392988178,3686400,96275344,92588944
235000.0,3,1.0,1050,7670,1.5,0,0,4,7,1050,0,1955,0.0,98022,47.2046,-121.99600000000001,1220,7670,6620,0.863102998696219,1102500,58828900,57726400
994900.0,4,3.5,3695,6556,2.0,0,0,2,9,3695,0,2014,0.0,98053,47.683,-122.015,4160,6786,2861,0.4363941427699817,13653025,42981136,29328111
489000.0,4,2.5,3910,8442,2.0,0,0,2,9,2710,1200,2000,0.0,98038,47.3766,-122.027,2650,7576,4532,0.5368396114664772,15288100,71267364,55979264
800000.0,4,2.75,3010,7427,2.0,0,0,2,8,3010,0,2010,0.0,98052,47.7068,-122.11200000000001,3000,4929,4417,0.5947219604147032,9060100,55160329,46100229
370000.0,4,1.5,1370,9957,1.0,0,0,2,7,900,470,1972,0.0,98034,47.7237,-122.181,1510,8088,8587,0.8624083559305011,1876900,99141849,97264949
436000.0,4,2.75,2080,9600,1.0,0,0,2,8,1240,840,1979,0.0,98034,47.7149,-122.235,1880,9525,7520,0.7833333333333333,4326400,92160000,87833600
395000.0,3,2.5,2250,3757,2.0,0,0,2,7,2250,0,2006,0.0,98059,47.4787,-122.12899999999999,2250,4556,1507,0.4011179132286399,5062500,14115049,9052549
377691.0,5,1.75,2120,8399,1.0,0,0,3,7,1320,800,1942,0.0,98133,47.7621,-122.335,2120,8398,6279,0.7475889986903202,4494400,70543201,66048801
370000.0,5,3.0,2220,5185,2.0,0,3,2,7,2220,0,2003,0.0,98118,47.543,-122.29,2340,6316,2965,0.5718418514946962,4928400,26884225,21955825
515000.0,3,2.5,1440,4394,1.0,0,0,4,8,1440,0,1987,0.0,98029,47.5688,-122.01899999999999,1900,5893,2954,0.6722803823395539,2073600,19307236,17233636
169000.0,3,1.0,910,7686,1.0,0,0,2,7,910,0,1969,0.0,98001,47.3405,-122.288,1020,7686,6776,0.8816029143897997,828100,59074596,58246496
475000.0,3,1.0,1270,4268,1.0,0,0,2,7,1270,0,1921,0.0,98117,47.6848,-122.39200000000001,1310,4080,2998,0.7024367385192127,1612900,18215824,16602924
420000.0,3,2.5,2480,6180,2.0,0,0,2,9,2480,0,1999,0.0,98031,47.4044,-122.208,2870,6180,3700,0.598705501618123,6150400,38192400,32042000
1300000.0,6,2.75,2630,9420,2.0,0,0,4,9,2510,120,1900,0.0,98103,47.6695,-122.337,1540,4969,6790,0.7208067940552016,6916900,88736400,81819500
822000.0,3,2.0,2410,13300,2.0,0,0,2,9,1840,570,1985,0.0,98006,47.5632,-122.148,2930,10900,10890,0.818796992481203,5808100,176890000,171081900
1500000.0,4,2.75,2930,25697,1.0,0,0,3,9,2310,620,1964,0.0,98004,47.6264,-122.226,3810,20681,22767,0.8859789080437405,8584900,660335809,651750909
485000.0,3,2.25,1570,6810,1.0,0,0,2,8,1180,390,1988,0.0,98074,47.6176,-122.044,1620,6584,5240,0.7694566813509545,2464900,46376100,43911200
270000.0,4,1.0,1900,8505,1.0,0,0,2,7,1200,700,1956,0.0,98055,47.4406,-122.196,1440,8505,6605,0.7766019988242211,3610000,72335025,68725025
300000.0,6,2.5,2590,11250,1.0,0,0,3,8,1390,1200,1978,0.0,98055,47.4608,-122.196,2270,8360,8660,0.7697777777777778,6708100,126562500,119854400
878000.0,4,2.5,3810,7728,2.0,0,0,2,9,3810,0,2007,0.0,98074,47.5925,-122.05799999999999,3290,7728,3918,0.5069875776397516,14516100,59721984,45205884
590000.0,3,2.5,2290,4203,2.0,0,0,2,9,2290,0,2001,0.0,98006,47.5441,-122.17200000000001,2290,5089,1913,0.45515108256007614,5244100,17665209,12421109
611900.0,1,2.25,1220,2100,2.0,0,2,3,8,1220,0,1946,1979.0,98033,47.6703,-122.204,3150,6000,880,0.41904761904761906,1488400,4410000,2921600
240000.0,3,1.75,1100,7373,1.0,0,0,3,7,1100,0,1968,0.0,98092,47.3124,-122.18299999999999,1430,8415,6273,0.85080699850807,1210000,54361129,53151129
395000.0,4,2.5,2810,10951,2.0,0,0,2,8,2810,0,2003,0.0,98092,47.3249,-122.18700000000001,1680,6625,8141,0.7434024290019177,7896100,119924401,112028301
169000.0,3,1.0,890,7110,1.0,0,0,2,6,890,0,1957,0.0,98178,47.4971,-122.26100000000001,1100,8375,6220,0.8748241912798875,792100,50552100,49760000
200500.0,3,2.0,1280,14972,1.0,0,0,2,7,1280,0,1963,0.0,98031,47.4129,-122.209,1800,9698,13692,0.9145070798824473,1638400,224160784,222522384
308000.0,3,2.5,2320,7140,2.0,0,0,2,8,2320,0,1990,0.0,98003,47.275,-122.295,2360,7955,4820,0.6750700280112045,5382400,50979600,45597200
290256.0,3,2.25,1720,7885,2.0,0,0,2,8,1720,0,1983,0.0,98023,47.3136,-122.344,2340,7885,6165,0.781864299302473,2958400,62173225,59214825
279950.0,3,1.75,1530,8800,1.0,0,0,3,7,1040,490,1967,0.0,98058,47.4483,-122.15799999999999,1530,8690,7270,0.8261363636363637,2340900,77440000,75099100
195000.0,3,1.75,1580,7875,1.0,0,0,2,7,1580,0,1979,0.0,98022,47.1958,-122.00299999999999,1560,8314,6295,0.7993650793650794,2496400,62015625,59519225
630000.0,3,1.0,1360,13000,1.0,0,0,4,6,1360,0,1945,0.0,98010,47.3359,-122.03299999999999,1890,19650,11640,0.8953846153846153,1849600,169000000,167150400
1160000.0,4,3.0,2680,15438,2.0,0,2,2,8,2680,0,1902,1956.0,98039,47.6109,-122.226,4480,14406,12758,0.8264023837284622,7182400,238331844,231149444
478000.0,3,2.25,1640,3896,2.0,0,0,2,8,1640,0,1994,0.0,98029,47.5689,-122.006,1780,3999,2256,0.5790554414784395,2689600,15178816,12489216
835000.0,3,2.25,2520,6690,2.0,0,2,4,8,1700,820,1944,1990.0,98126,47.5705,-122.381,1990,5792,4170,0.6233183856502242,6350400,44756100,38405700
639000.0,3,2.25,1400,2421,2.0,0,0,2,9,1400,0,2005,0.0,98034,47.695,-122.169,1500,2743,1021,0.42172655927302766,1960000,5861241,3901241
623000.0,4,2.75,2300,12633,2.0,0,0,2,9,2300,0,1984,0.0,98074,47.6218,-122.03200000000001,2240,9246,10333,0.8179371487374337,5290000,159592689,154302689
220000.0,3,1.75,1900,7680,1.0,0,0,2,7,1260,640,1959,0.0,98178,47.5081,-122.266,2000,7740,5780,0.7526041666666666,3610000,58982400,55372400
526000.0,3,2.25,2000,18099,1.0,0,0,3,8,1250,750,1978,0.0,98006,47.5443,-122.18,2060,12000,16099,0.8894966572738825,4000000,327573801,323573801
243500.0,2,1.0,900,5016,1.0,0,0,2,6,900,0,1948,0.0,98118,47.542,-122.28200000000001,1420,5184,4116,0.8205741626794258,810000,25160256,24350256
750000.0,4,2.5,2980,4930,2.0,0,0,2,9,2890,90,2000,0.0,98006,47.5445,-122.12,2980,6099,1950,0.39553752535496955,8880400,24304900,15424500
329000.0,4,2.0,1850,9126,1.0,0,0,4,7,1850,0,1963,0.0,98059,47.5009,-122.164,1730,9110,7276,0.7972824895901819,3422500,83283876,79861376
525000.0,4,1.0,1570,4000,1.5,0,0,2,7,1570,0,1920,0.0,98102,47.6275,-122.321,1610,4000,2430,0.6075,2464900,16000000,13535100
190000.0,2,1.0,670,3101,1.0,0,0,3,6,670,0,1948,0.0,98118,47.5546,-122.274,1660,4100,2431,0.7839406643018381,448900,9616201,9167301
772650.0,4,2.5,2660,10800,1.0,0,0,2,7,2660,0,1955,2014.0,98005,47.5894,-122.17200000000001,2640,10800,8140,0.7537037037037037,7075600,116640000,109564400
355000.0,3,2.5,2110,4038,2.0,0,0,3,8,2110,0,1989,0.0,98042,47.3875,-122.15299999999999,2110,3727,1928,0.4774640911342249,4452100,16305444,11853344
650000.0,3,1.75,1970,54450,1.0,0,0,2,8,1570,400,1980,0.0,98075,47.5936,-122.012,2460,36677,52480,0.9638200183654729,3880900,2964802500,2960921600
678500.0,3,2.75,1210,3600,1.5,0,2,4,7,1210,0,1910,0.0,98103,47.6798,-122.354,1630,3910,2390,0.6638888888888889,1464100,12960000,11495900
669950.0,4,2.5,2670,11877,2.0,0,0,2,9,2670,0,1996,0.0,98074,47.6327,-122.036,2430,11333,9207,0.7751957565041677,7128900,141063129,133934229
850000.0,3,2.25,3000,18450,1.0,0,0,2,10,3000,0,1983,0.0,98077,47.7274,-122.06200000000001,2980,12304,15450,0.8373983739837398,9000000,340402500,331402500
572000.0,3,2.75,2200,3885,2.0,0,0,2,8,2200,0,2002,0.0,98074,47.6171,-122.02799999999999,2710,6000,1685,0.4337194337194337,4840000,15093225,10253225
492450.0,3,1.75,1540,13002,1.0,0,0,1,8,1200,0,1984,0.0,98074,47.6231,-122.044,1620,10098,11462,0.8815566835871405,2371600,169052004,166680404
813000.0,3,1.75,2080,11866,1.0,0,0,2,8,2080,0,1960,0.0,98005,47.5872,-122.17299999999999,2240,10696,9786,0.8247092533288387,4326400,140801956,136475556
710000.0,3,2.0,1780,9732,1.0,0,0,2,8,1780,0,1967,0.0,98040,47.5796,-122.229,1900,10200,7952,0.8170982326346075,3168400,94711824,91543424
792500.0,3,1.5,1960,2400,2.0,0,0,2,8,1330,630,1911,0.0,98119,47.6423,-122.37,2090,4000,440,0.18333333333333332,3841600,5760000,1918400
285900.0,5,1.5,1690,7725,1.5,0,0,3,7,1690,0,1961,0.0,98032,47.3859,-122.288,1690,7739,6035,0.7812297734627832,2856100,59675625,56819525
389000.0,3,2.0,2080,12972,1.0,0,0,3,7,1250,830,1981,0.0,98070,47.3733,-122.432,1530,10089,10892,0.8396546407647241,4326400,168272784,163946384
675000.0,3,2.25,2070,2833,2.0,0,2,2,8,1490,580,1966,0.0,98136,47.5543,-122.398,1940,3794,763,0.26932580303565123,4284900,8025889,3740989
352000.0,2,0.75,760,33801,1.0,0,0,3,4,760,0,1931,0.0,98059,47.4703,-122.07600000000001,1100,39504,33041,0.9775154581225407,577600,1142507601,1141930001
1050000.0,4,3.25,4020,11588,2.0,0,0,2,11,4020,0,2000,0.0,98059,47.5217,-122.155,3190,8066,7568,0.6530894028305143,16160400,134281744,118121344
768500.0,4,1.75,3620,10400,1.0,0,0,3,8,1820,1800,1965,0.0,98005,47.6069,-122.167,2410,10400,6780,0.6519230769230769,13104400,108160000,95055600
500000.0,4,2.0,2330,7778,1.0,0,0,2,7,1230,1100,1961,0.0,98125,47.7109,-122.323,1250,8160,5448,0.7004371303677038,5428900,60497284,55068384
685000.0,3,2.5,1460,8800,1.0,0,0,3,7,1460,0,1956,0.0,98040,47.5895,-122.23200000000001,2200,8800,7340,0.8340909090909091,2131600,77440000,75308400
648475.0,4,2.75,2250,5700,1.0,0,0,2,8,1200,1050,1951,0.0,98109,47.6406,-122.344,1720,3850,3450,0.6052631578947368,5062500,32490000,27427500
655000.0,6,5.0,2850,6600,2.0,0,0,2,7,2850,0,1994,0.0,98033,47.6813,-122.18700000000001,1870,9900,3750,0.5681818181818182,8122500,43560000,35437500
895000.0,4,2.75,2640,4000,2.0,0,0,4,8,1730,910,1925,0.0,98115,47.6727,-122.29700000000001,1530,3740,1360,0.34,6969600,16000000,9030400
195000.0,3,1.0,1310,9554,1.0,0,0,2,7,960,350,1962,0.0,98001,47.2949,-122.285,1310,9845,8244,0.8628846556416161,1716100,91278916,89562816
368000.0,4,2.5,2720,7350,2.0,0,0,2,9,2720,0,1989,0.0,98023,47.3028,-122.35,2570,8336,4630,0.6299319727891156,7398400,54022500,46624100
997000.0,4,3.5,3430,13609,2.0,0,0,2,11,3430,0,2001,0.0,98059,47.5196,-122.15100000000001,3880,11614,10179,0.7479609082224998,11764900,185204881,173439981
335000.0,3,2.75,1990,19991,1.0,0,0,2,7,1340,650,1977,0.0,98072,47.7434,-122.10600000000001,1750,9775,18001,0.900455204842179,3960100,399640081,395679981
250000.0,3,2.0,1170,7258,1.0,0,0,2,7,1170,0,1984,0.0,98001,47.3333,-122.266,1410,7750,6088,0.8387985670983742,1368900,52678564,51309664
278500.0,3,1.75,1390,8980,1.0,0,0,3,8,1390,0,1985,0.0,98022,47.2015,-122.005,1770,9085,7590,0.8452115812917594,1932100,80640400,78708300
260000.0,4,1.5,1540,7300,2.0,0,0,2,7,1540,0,1973,0.0,98001,47.3317,-122.27600000000001,1580,7650,5760,0.7890410958904109,2371600,53290000,50918400
162500.0,2,1.0,760,6141,1.0,0,0,1,6,760,0,1920,0.0,98118,47.5469,-122.277,900,4120,5381,0.8762416544536721,577600,37711881,37134281
239000.0,4,1.0,1280,8316,1.0,0,0,2,6,1280,0,1950,0.0,98168,47.4989,-122.302,1310,7830,7036,0.8460798460798461,1638400,69155856,67517456
600000.0,4,2.5,2990,5122,2.0,0,0,2,8,2990,0,2004,0.0,98075,47.5773,-122.055,3140,7875,2132,0.41624365482233505,8940100,26234884,17294784
350000.0,4,2.25,1770,7778,2.0,0,0,2,7,1770,0,1998,0.0,98031,47.4192,-122.20100000000001,1770,7591,6008,0.7724350732836205,3132900,60497284,57364384
852500.0,5,3.75,3830,8131,2.0,0,0,2,10,3830,0,2005,0.0,98075,47.5837,-121.971,3570,7290,4301,0.5289632271553314,14668900,66113161,51444261
485000.0,3,2.5,2870,5490,2.0,0,0,2,9,2870,0,2008,0.0,98055,47.4471,-122.20700000000001,3040,5442,2620,0.4772313296903461,8236900,30140100,21903200
299000.0,3,1.0,1520,8320,1.0,0,0,2,6,1520,0,1953,0.0,98133,47.7699,-122.335,1500,8320,6800,0.8173076923076923,2310400,69222400,66912000
227450.0,2,1.0,660,6509,1.0,0,0,3,5,660,0,1952,0.0,98056,47.4938,-122.171,970,5713,5849,0.898601935781226,435600,42367081,41931481
383000.0,3,1.0,1800,5612,1.0,0,0,3,7,1200,600,1942,0.0,98126,47.525,-122.37799999999999,1450,5250,3812,0.6792587312900926,3240000,31494544,28254544
835000.0,2,3.25,3570,392475,1.0,0,0,2,9,2370,1200,1998,0.0,98024,47.5448,-121.93,3190,217800,388905,0.9909038792279763,12744900,154036625625,154023880725
760000.0,5,1.5,3050,2992,1.5,0,0,3,8,1920,1130,1931,0.0,98112,47.621,-122.302,1200,1209,-58,-0.019385026737967916,9302500,8952064,-350436
532500.0,2,1.0,820,3000,1.0,0,0,3,7,820,0,1924,0.0,98103,47.6842,-122.348,1490,3000,2180,0.7266666666666667,672400,9000000,8327600
635000.0,3,2.5,3610,26359,1.0,0,0,2,8,1950,1660,1998,0.0,98053,47.6306,-121.96799999999999,2620,26427,22749,0.8630448803065367,13032100,694796881,681764781
438500.0,3,2.0,1490,3072,1.0,0,0,4,7,770,720,1912,0.0,98144,47.5772,-122.307,1320,3072,1582,0.5149739583333334,2220100,9437184,7217084
545500.0,3,2.5,1560,9361,1.5,0,0,3,7,1360,200,1936,0.0,98108,47.5591,-122.295,1670,6244,7801,0.8333511376989637,2433600,87628321,85194721
675000.0,3,1.75,1660,9549,1.0,0,0,2,7,1660,0,1956,0.0,98033,47.6503,-122.198,2090,9549,7889,0.826159807309666,2755600,91183401,88427801
450000.0,3,1.75,1180,4080,1.0,0,0,3,6,760,420,1928,0.0,98117,47.6825,-122.391,1490,4080,2900,0.7107843137254902,1392400,16646400,15254000
199999.0,3,1.0,960,10815,1.0,0,0,4,5,960,0,1900,0.0,98010,47.3091,-122.006,1330,10815,9855,0.9112343966712899,921600,116964225,116042625
375000.0,3,1.5,1630,16170,1.0,0,0,2,7,1630,0,1988,0.0,98034,47.7104,-122.235,1630,9931,14540,0.8991960420531849,2656900,261468900,258812000
600000.0,4,2.25,2260,43847,2.0,0,0,2,8,2260,0,1982,0.0,98072,47.7713,-122.12899999999999,2470,37304,41587,0.9484571350377449,5107600,1922559409,1917451809
292600.0,3,1.5,1520,7123,1.0,0,0,3,7,1520,0,1959,0.0,98056,47.4991,-122.176,1450,8023,5603,0.7866067668117366,2310400,50737129,48426729
1040000.0,5,2.75,3050,8904,1.0,0,0,3,8,1650,1400,1956,0.0,98040,47.5709,-122.214,2920,8904,5854,0.6574573225516622,9302500,79281216,69978716
610000.0,3,1.0,1000,4959,1.0,0,0,2,8,1000,0,1945,0.0,98105,47.6629,-122.277,2240,4959,3959,0.7983464408146804,1000000,24591681,23591681
397450.0,4,2.5,2650,9451,2.0,0,0,3,8,2650,0,1993,0.0,98042,47.3693,-122.12899999999999,2510,8850,6801,0.7196063908581103,7022500,89321401,82298901
382000.0,3,2.25,1750,15528,1.0,0,0,2,8,1270,480,1963,0.0,98155,47.7739,-122.274,2170,12000,13778,0.887300360638846,3062500,241118784,238056284
370000.0,3,2.25,1770,7667,1.0,0,0,2,8,1270,500,1966,0.0,98177,47.7724,-122.36200000000001,2180,8103,5897,0.7691404721533847,3132900,58782889,55649989
520000.0,3,2.25,1770,7667,1.0,0,0,2,8,1270,500,1966,0.0,98177,47.7724,-122.36200000000001,2180,8103,5897,0.7691404721533847,3132900,58782889,55649989
260000.0,2,1.0,770,7906,1.0,0,0,3,6,770,0,1948,0.0,98155,47.76600000000001,-122.32,990,7906,7136,0.9026056159878573,592900,62504836,61911936
890000.0,4,2.5,3370,7200,2.0,0,0,2,8,3370,0,2014,0.0,98177,47.7698,-122.384,1880,7200,3830,0.5319444444444444,11356900,51840000,40483100
344000.0,5,2.0,2130,8412,1.0,0,0,2,7,1440,690,1946,2000.0,98155,47.7403,-122.318,2310,7474,6282,0.7467902995720399,4536900,70761744,66224844
205000.0,3,1.0,1050,8498,1.0,0,0,2,7,1050,0,1958,0.0,98031,47.4038,-122.20299999999999,1340,8498,7448,0.8764415156507414,1102500,72216004,71113504
379000.0,5,2.5,2803,8550,1.0,0,0,2,8,2803,0,1963,2011.0,98003,47.3032,-122.306,1810,8550,5747,0.6721637426900585,7856809,73102500,65245691
424240.0,3,2.0,2080,12094,2.0,0,0,3,8,2080,0,1982,0.0,98052,47.7035,-122.164,2230,12204,10014,0.8280138911857119,4326400,146264836,141938436
589950.0,3,2.0,2080,12094,2.0,0,0,3,8,2080,0,1982,0.0,98052,47.7035,-122.164,2230,12204,10014,0.8280138911857119,4326400,146264836,141938436
582000.0,4,1.75,2120,4650,1.0,0,1,2,7,1190,930,1951,0.0,98117,47.6964,-122.4,2070,6487,2530,0.5440860215053763,4494400,21622500,17128100
349000.0,3,2.5,2550,7709,2.0,0,0,2,9,2550,0,1989,0.0,98023,47.3081,-122.391,2410,9250,5159,0.6692177973796861,6502500,59428681,52926181
658000.0,3,1.0,1290,12005,1.0,0,0,3,7,1290,0,1966,0.0,98033,47.6835,-122.199,1930,8000,10715,0.8925447730112454,1664100,144120025,142455925
294000.0,5,2.75,1790,5000,1.5,0,0,3,7,1060,730,1915,0.0,98106,47.5655,-122.363,1400,5000,3210,0.642,3204100,25000000,21795900
690000.0,5,3.5,2720,7598,2.0,0,0,2,8,1860,860,1993,0.0,98115,47.6931,-122.28299999999999,2430,7728,4878,0.6420110555409319,7398400,57729604,50331204
600000.0,3,1.0,1040,5000,1.5,0,2,2,7,1040,0,1912,0.0,98107,47.6754,-122.359,1440,4400,3960,0.792,1081600,25000000,23918400
199990.0,3,1.0,840,5200,1.0,0,0,2,6,840,0,1969,2014.0,98042,47.3685,-122.07700000000001,870,5200,4360,0.8384615384615385,705600,27040000,26334400
220000.0,3,1.75,1650,8850,1.0,0,0,2,7,1650,0,1959,0.0,98188,47.4331,-122.291,1400,8800,7200,0.8135593220338984,2722500,78322500,75600000
440000.0,4,2.25,2080,15750,1.0,0,0,2,8,1460,620,1976,0.0,98034,47.7225,-122.2,1960,10500,13670,0.8679365079365079,4326400,248062500,243736100
439990.0,4,2.5,1540,1994,2.0,0,0,2,8,1540,0,2014,0.0,98029,47.5526,-121.999,1540,1689,454,0.22768304914744233,2371600,3976036,1604436
815000.0,4,2.5,3880,7208,2.0,0,0,2,10,3880,0,2006,0.0,98075,47.5841,-121.971,3280,7221,3328,0.46170921198668147,15054400,51955264,36900864
535000.0,4,2.25,1860,3766,2.0,0,0,2,8,1860,0,1995,0.0,98029,47.5699,-122.006,1860,4169,1906,0.5061072756240043,3459600,14182756,10723156
215000.0,3,1.75,1280,10016,1.0,0,0,3,7,1280,0,1975,0.0,98003,47.2823,-122.333,1670,9764,8736,0.8722044728434505,1638400,100320256,98681856
605000.0,3,2.5,3200,35012,1.5,0,0,2,8,2100,1100,1965,0.0,98027,47.4651,-121.993,2690,35100,31812,0.9086027647663658,10240000,1225840144,1215600144
349900.0,3,2.5,2200,7278,2.0,0,0,2,8,2200,0,1990,0.0,98058,47.4624,-122.132,2190,8580,5078,0.6977191536136301,4840000,52969284,48129284
495000.0,3,1.0,1570,5510,1.0,0,0,3,7,1070,500,1940,0.0,98115,47.6942,-122.319,1770,6380,3940,0.7150635208711433,2464900,30360100,27895200
515100.0,3,2.5,2074,4900,2.0,0,0,2,8,2074,0,1997,0.0,98034,47.7327,-122.23299999999999,1840,7382,2826,0.576734693877551,4301476,24010000,19708524
620000.0,4,2.5,2450,55387,2.0,0,0,2,9,2450,0,1994,0.0,98053,47.6323,-121.985,2730,38827,52937,0.9557657934172279,6002500,3067719769,3061717269
657500.0,4,2.25,2520,10370,2.0,0,0,2,9,2520,0,1980,0.0,98074,47.6377,-122.04899999999999,2848,12682,7850,0.7569913211186113,6350400,107536900,101186500
250000.0,5,1.75,2190,8250,1.0,0,2,2,7,1190,1000,1963,0.0,98055,47.4887,-122.223,2570,8250,6060,0.7345454545454545,4796100,68062500,63266400
385000.0,5,1.75,2190,8250,1.0,0,2,2,7,1190,1000,1963,0.0,98055,47.4887,-122.223,2570,8250,6060,0.7345454545454545,4796100,68062500,63266400
307000.0,3,1.5,2320,7500,1.0,0,0,2,7,2320,0,1976,0.0,98019,47.7413,-121.979,1480,10000,5180,0.6906666666666667,5382400,56250000,50867600
288000.0,3,2.5,1370,9253,1.0,0,0,2,7,1090,280,1994,0.0,98042,47.3717,-122.073,1470,9253,7883,0.851939911380093,1876900,85618009,83741109
226450.0,3,1.75,1730,7200,1.5,0,0,3,6,1730,0,1944,0.0,98032,47.3774,-122.236,860,7200,5470,0.7597222222222222,2992900,51840000,48847100
390000.0,3,2.5,1640,6991,1.0,0,0,2,7,1110,530,1967,0.0,98125,47.7255,-122.32700000000001,1860,7342,5351,0.7654126734372765,2689600,48874081,46184481
350000.0,3,1.0,1300,10236,1.0,0,0,3,6,1300,0,1971,0.0,98045,47.5028,-121.77,1380,11325,8936,0.8729972645564674,1690000,104775696,103085696
368000.0,3,1.5,1560,7884,1.0,0,0,2,7,1060,500,1969,0.0,98125,47.7312,-122.29799999999999,1820,9000,6324,0.802130898021309,2433600,62157456,59723856
469000.0,2,1.0,1120,4284,1.0,0,0,2,6,730,390,1921,0.0,98105,47.6688,-122.324,2050,4160,3164,0.738562091503268,1254400,18352656,17098256
865000.0,3,2.25,2670,150270,2.0,0,0,2,9,2670,0,1985,0.0,98072,47.7601,-122.134,3080,81054,147600,0.9822319824316231,7128900,22581072900,22573944000
515000.0,5,2.5,3810,15916,1.5,0,0,4,8,3810,0,1967,0.0,98058,47.4521,-122.14,2470,11662,12106,0.7606182457903996,14516100,253319056,238802956
410000.0,3,1.75,1440,8560,1.0,0,0,3,7,1440,0,1979,0.0,98034,47.7296,-122.23200000000001,1460,7560,7120,0.8317757009345794,2073600,73273600,71200000
210000.0,4,1.0,1200,43560,1.0,0,0,2,5,1200,0,1968,0.0,98042,47.3375,-122.12299999999999,1400,54450,42360,0.9724517906336089,1440000,1897473600,1896033600
460000.0,3,1.75,1520,7700,1.0,0,0,2,7,820,700,1969,0.0,98034,47.7226,-122.219,1420,7674,6180,0.8025974025974026,2310400,59290000,56979600
241500.0,4,2.5,2500,9654,1.0,0,0,2,8,1830,670,1979,0.0,98023,47.3137,-122.34299999999999,2500,8839,7154,0.741039983426559,6250000,93199716,86949716
322200.0,4,2.25,2010,19000,2.0,0,0,3,8,2010,0,1975,0.0,98042,47.3734,-122.119,1950,19626,16990,0.8942105263157895,4040100,361000000,356959900
279000.0,4,1.0,1210,6000,1.5,0,2,2,7,1210,0,1943,0.0,98178,47.5026,-122.234,1470,6000,4790,0.7983333333333333,1464100,36000000,34535900
303000.0,2,1.0,1100,27007,1.0,0,0,3,6,1100,0,1943,0.0,98070,47.4471,-122.473,1746,91476,25907,0.9592698189358314,1210000,729378049,728168049
420000.0,3,1.5,1050,6615,1.0,0,0,3,6,800,250,1950,0.0,98199,47.6578,-122.39,1530,5250,5565,0.8412698412698413,1102500,43758225,42655725
249000.0,3,1.75,2120,18335,1.0,0,0,2,7,1380,740,1961,0.0,98188,47.451,-122.273,2050,18333,16215,0.884374147804745,4494400,336172225,331677825
294950.0,3,1.0,1240,8840,1.0,0,0,2,6,1240,0,1952,0.0,98125,47.7277,-122.30799999999999,1250,8840,7600,0.8597285067873304,1537600,78145600,76608000
1320000.0,4,3.5,3460,3997,2.0,0,0,2,10,2560,900,2004,0.0,98103,47.6718,-122.329,1860,4000,537,0.13435076307230423,11971600,15976009,4004409
335000.0,3,1.75,1270,4800,1.0,0,0,2,7,1270,0,1953,0.0,98117,47.69300000000001,-122.361,1490,4800,3530,0.7354166666666667,1612900,23040000,21427100
1160000.0,4,2.25,2980,8051,1.5,0,2,3,10,2020,960,1935,0.0,98199,47.6426,-122.40899999999999,2760,5499,5071,0.6298596447646255,8880400,64818601,55938201
520000.0,2,1.0,1250,3708,1.5,0,0,2,7,1250,0,1926,0.0,98117,47.685,-122.363,1430,3708,2458,0.662891046386192,1562500,13749264,12186764
560000.0,4,1.75,1740,8800,1.0,0,0,3,8,1740,0,1965,0.0,98007,47.6232,-122.14200000000001,2180,8436,7060,0.8022727272727272,3027600,77440000,74412400
243400.0,4,1.5,1730,7464,2.0,0,0,3,7,1730,0,1959,0.0,98032,47.3782,-122.304,1370,7860,5734,0.7682207931404073,2992900,55711296,52718396
405000.0,3,2.0,1240,14404,1.0,0,0,2,7,1240,0,1988,0.0,98053,47.6614,-122.06,1350,9990,13164,0.9139128019994446,1537600,207475216,205937616
495000.0,2,1.0,1670,14695,1.5,0,0,4,7,1670,0,1930,0.0,98033,47.7001,-122.2,1800,11355,13025,0.8863559033684927,2788900,215943025,213154125
350000.0,4,2.5,2140,7095,2.0,0,0,2,8,2140,0,1992,0.0,98038,47.3528,-122.057,1600,7182,4955,0.6983791402396053,4579600,50339025,45759425
368500.0,5,2.75,2530,7601,1.0,0,0,2,7,1520,1010,1992,0.0,98188,47.4683,-122.26299999999999,2400,7776,5071,0.6671490593342981,6400900,57775201,51374301
99000.0,2,1.0,960,8236,1.0,0,0,1,6,960,0,1948,0.0,98058,47.4698,-122.166,1260,8236,7276,0.8834385624089364,921600,67831696,66910096
1070000.0,4,3.75,4130,12320,2.0,0,0,2,11,4130,0,2001,0.0,98059,47.5194,-122.15100000000001,3690,11227,8190,0.6647727272727273,17056900,151782400,134725500
430000.0,4,1.75,1710,7724,1.0,0,0,2,8,1710,0,1983,0.0,98155,47.7721,-122.29299999999999,1940,7724,6014,0.778612118073537,2924100,59660176,56736076
412500.0,3,1.5,1490,8475,1.0,0,0,3,7,1490,0,1963,0.0,98052,47.6571,-122.133,1490,8540,6985,0.824188790560472,2220100,71825625,69605525
1120000.0,4,3.25,4750,62365,2.0,0,0,2,11,4750,0,1988,0.0,98052,47.7149,-122.09899999999999,3300,31866,57615,0.9238354846468372,22562500,3889393225,3866830725
915000.0,4,2.5,3400,35062,2.0,0,0,3,11,3400,0,1988,0.0,98052,47.7168,-122.113,2880,9705,31662,0.9030289201985056,11560000,1229343844,1217783844
535000.0,3,2.5,2210,7620,2.0,0,0,2,8,2210,0,1994,0.0,98052,47.6938,-122.13,1920,7440,5410,0.7099737532808399,4884100,58064400,53180300
390000.0,3,1.5,1650,8676,1.0,0,0,3,8,1130,520,1979,0.0,98133,47.7471,-122.352,1400,8499,7026,0.809820193637621,2722500,75272976,72550476
499000.0,3,1.5,1260,3135,1.0,0,0,3,7,780,480,1944,0.0,98107,47.6693,-122.37100000000001,1540,3025,1875,0.5980861244019139,1587600,9828225,8240625
375000.0,3,1.0,1960,7955,1.0,0,0,3,7,1260,700,1963,0.0,98177,47.7641,-122.36399999999999,1850,8219,5995,0.7536140791954745,3841600,63282025,59440425
349000.0,4,2.5,1800,7620,2.0,0,0,2,8,1800,0,1995,0.0,98055,47.4346,-122.20100000000001,1800,6879,5820,0.7637795275590551,3240000,58064400,54824400
635000.0,3,2.25,1940,7482,1.0,0,0,3,7,1240,700,1964,0.0,98004,47.6004,-122.195,2340,9310,5542,0.7407110398289227,3763600,55980324,52216724
682000.0,4,2.75,2820,8009,2.0,0,0,2,9,2820,0,2001,0.0,98075,47.6,-121.977,2820,7398,5189,0.6478961168685229,7952400,64144081,56191681
321027.0,4,2.25,2820,16770,1.0,0,0,3,8,1920,900,1966,0.0,98023,47.3186,-122.36399999999999,2320,13850,13950,0.8318425760286225,7952400,281232900,273280500
150000.0,2,1.0,720,4120,1.0,0,0,4,5,720,0,1915,0.0,98002,47.303000000000004,-122.21700000000001,940,6180,3400,0.8252427184466019,518400,16974400,16456000
410000.0,3,1.75,1640,17583,1.0,0,0,2,7,1110,530,1969,0.0,98034,47.726000000000006,-122.20299999999999,1420,11680,15943,0.9067280896320309,2689600,309161889,306472289
449950.0,3,2.0,1560,4080,2.0,0,0,2,7,1560,0,1923,1982.0,98115,47.6892,-122.319,1900,4080,2520,0.6176470588235294,2433600,16646400,14212800
194990.0,6,2.5,1560,7144,1.0,0,0,2,6,1060,500,1913,0.0,98118,47.5335,-122.272,1300,6232,5584,0.7816349384098544,2433600,51036736,48603136
475000.0,4,1.75,1910,8775,1.0,0,0,2,7,1210,700,1956,0.0,98028,47.7396,-122.24700000000001,2210,8778,6865,0.7823361823361823,3648100,77000625,73352525
530000.0,5,1.75,1570,3000,2.0,0,0,3,7,1570,0,1908,0.0,98105,47.6677,-122.316,1610,3000,1430,0.4766666666666667,2464900,9000000,6535100
319950.0,4,2.5,2038,7643,2.0,0,0,2,8,2038,0,2011,0.0,98092,47.3296,-122.18,2634,6824,5605,0.7333507784901216,4153444,58415449,54262005
210000.0,3,2.25,1720,9435,1.0,0,0,3,7,1220,500,1978,0.0,98023,47.2979,-122.37700000000001,1690,7215,7715,0.8177000529941706,2958400,89019225,86060825
485000.0,3,2.75,1670,3330,1.5,0,0,3,7,1670,0,1925,0.0,98107,47.6551,-122.36,1370,5000,1660,0.4984984984984985,2788900,11088900,8300000
774000.0,4,2.75,2830,10240,2.0,0,0,3,9,2830,0,1998,0.0,98075,47.5903,-121.986,3490,10240,7410,0.7236328125,8008900,104857600,96848700
478000.0,4,2.0,1690,8208,1.0,0,0,3,7,1210,480,1958,0.0,98008,47.6052,-122.126,1620,8496,6518,0.794103313840156,2856100,67371264,64515164
385000.0,4,2.5,1620,5280,2.0,0,0,3,7,1620,0,1924,0.0,98146,47.5132,-122.384,1590,5280,3660,0.6931818181818182,2624400,27878400,25254000
595000.0,4,2.5,2360,43017,2.0,0,0,2,9,2360,0,1989,0.0,98077,47.773999999999994,-122.07700000000001,2750,40334,40657,0.9451379687100449,5569600,1850462289,1844892689
285000.0,3,1.5,1480,7117,1.0,0,0,2,7,1170,310,1960,0.0,98028,47.7766,-122.24799999999999,2230,14775,5637,0.7920472109034705,2190400,50651689,48461289
723000.0,4,2.5,2700,4004,2.0,0,0,2,9,2700,0,2004,0.0,98029,47.5521,-121.995,2260,4459,1304,0.3256743256743257,7290000,16032016,8742016
279000.0,3,1.5,1780,16000,1.0,0,0,1,7,1240,540,1960,0.0,98198,47.419,-122.322,1860,9775,14220,0.88875,3168400,256000000,252831600
195000.0,3,1.5,1430,7560,1.0,0,0,4,6,1430,0,1958,0.0,98058,47.4518,-122.179,1150,7560,6130,0.8108465608465608,2044900,57153600,55108700
625000.0,2,1.0,2160,2192,1.0,0,0,4,8,1170,990,1925,0.0,98119,47.6364,-122.37100000000001,1150,2152,32,0.014598540145985401,4665600,4804864,139264
270000.0,3,1.75,1800,9314,2.0,0,0,2,8,1800,0,1979,0.0,98011,47.7762,-122.198,2100,9658,7514,0.8067425381146661,3240000,86750596,83510596
559000.0,2,2.0,1930,5520,1.0,0,0,2,8,1930,0,2006,0.0,98053,47.7191,-122.022,1640,4533,3590,0.6503623188405797,3724900,30470400,26745500
474000.0,4,2.25,1960,14834,1.0,0,0,3,8,1330,630,1976,0.0,98072,47.7434,-122.095,1540,15000,12874,0.8678711069165431,3841600,220047556,216205956
303500.0,4,2.5,1920,7345,2.0,0,0,2,8,1920,0,1992,0.0,98038,47.3526,-122.055,1860,7364,5425,0.7385976855003403,3686400,53949025,50262625
350000.0,3,1.75,1470,8645,1.0,0,0,2,6,1470,0,1949,0.0,98155,47.7524,-122.323,1470,7680,7175,0.8299595141700404,2160900,74736025,72575125
367500.0,5,3.0,2980,10064,1.0,0,0,2,7,1680,1300,1940,0.0,98155,47.7372,-122.316,1590,7800,7084,0.7038950715421304,8880400,101284096,92403696
595000.0,5,3.0,2980,10064,1.0,0,0,2,7,1680,1300,1940,0.0,98155,47.7372,-122.316,1590,7800,7084,0.7038950715421304,8880400,101284096,92403696
589000.0,3,2.0,2360,118483,1.0,0,0,2,8,2360,0,1981,0.0,98024,47.5595,-121.867,2660,91476,116123,0.9800815306837268,5569600,14038221289,14032651689
585000.0,3,1.75,1790,87213,1.0,0,0,3,7,1790,0,1974,0.0,98077,47.732,-122.07700000000001,3270,39586,85423,0.979475536903902,3204100,7606107369,7602903269
482975.0,3,2.25,2130,8801,1.0,0,0,2,8,1370,760,1976,0.0,98155,47.7462,-122.29,2820,8801,6671,0.7579820474946029,4536900,77457601,72920701
365500.0,4,2.5,2030,4499,2.0,0,0,2,8,2030,0,2003,0.0,98058,47.4511,-122.119,2030,4539,2469,0.5487886196932652,4120900,20241001,16120101
570000.0,4,2.0,1790,7800,1.0,0,0,4,8,1790,0,1972,0.0,98008,47.6266,-122.103,2150,7838,6010,0.7705128205128206,3204100,60840000,57635900
335000.0,3,2.5,2260,8040,2.0,0,0,2,8,2260,0,1990,0.0,98092,47.3203,-122.184,2390,8040,5780,0.7189054726368159,5107600,64641600,59534000
767500.0,4,2.0,2350,4815,1.5,0,0,3,7,1450,900,1914,0.0,98103,47.6681,-122.338,1640,4013,2465,0.5119418483904465,5522500,23184225,17661725
386591.0,3,2.5,1690,1613,2.0,0,0,2,8,1150,540,2014,0.0,98029,47.5518,-121.99799999999999,1690,1662,-77,-0.04773713577185369,2856100,2601769,-254331
279000.0,3,1.0,1320,5750,1.5,0,0,2,7,1320,0,1913,0.0,98108,47.5288,-122.325,1010,5700,4430,0.7704347826086957,1742400,33062500,31320100
620000.0,4,2.5,2690,32780,2.0,0,0,2,9,2690,0,1998,0.0,98014,47.6612,-121.955,2840,36555,30090,0.9179377669310556,7236100,1074528400,1067292300
407000.0,4,2.25,2810,23400,1.0,0,1,2,7,1710,1100,1958,0.0,98198,47.395,-122.311,1860,14900,20590,0.8799145299145299,7896100,547560000,539663900
364250.0,3,2.5,2280,213879,2.0,0,0,2,8,2280,0,1994,0.0,98038,47.4213,-122.03299999999999,2380,178160,211599,0.9893397668775336,5198400,45744226641,45739028241
399000.0,4,2.5,2870,9292,2.0,0,0,2,8,2540,330,1979,0.0,98058,47.4522,-122.12299999999999,2590,7533,6422,0.6911321566939302,8236900,86341264,78104364
766950.0,3,2.5,3030,30007,1.5,0,0,3,10,3030,0,1992,0.0,98077,47.743,-122.036,3360,34983,26977,0.8990235611690606,9180900,900420049,891239149
710000.0,4,2.75,2940,4232,2.0,0,0,2,9,2940,0,2004,0.0,98029,47.5529,-121.99,2410,4000,1292,0.3052930056710775,8643600,17909824,9266224
320000.0,3,1.0,1190,4120,1.0,0,0,2,6,1190,0,1929,0.0,98118,47.5513,-122.272,1360,4635,2930,0.7111650485436893,1416100,16974400,15558300
300000.0,3,2.5,1800,3253,2.0,0,0,2,7,1800,0,2001,0.0,98108,47.5401,-122.292,1800,3081,1453,0.4466646172763603,3240000,10582009,7342009
263000.0,3,1.75,1580,9187,1.0,0,0,2,8,1180,400,1993,0.0,98038,47.3538,-122.04700000000001,1620,6397,7607,0.828017851311636,2496400,84400969,81904569
445000.0,3,2.5,1730,4408,2.0,0,0,2,8,1730,0,1996,0.0,98029,47.5683,-122.005,1730,4408,2678,0.6075317604355717,2992900,19430464,16437564
554000.0,3,2.0,1910,9001,1.0,0,0,3,7,1910,0,1957,0.0,98008,47.6037,-122.119,2040,8700,7091,0.787801355404955,3648100,81018001,77369901
335000.0,2,1.75,1000,5100,1.0,0,0,2,6,940,60,1906,0.0,98117,47.6787,-122.391,1900,5100,4100,0.803921568627451,1000000,26010000,25010000
307000.0,4,2.75,2520,6964,1.0,0,0,3,7,1260,1260,1987,0.0,98031,47.4038,-122.175,1930,6949,4444,0.6381390005743826,6350400,48497296,42146896
404000.0,3,1.0,1420,8160,1.0,0,0,2,7,970,450,1947,0.0,98125,47.7164,-122.306,1340,8160,6740,0.8259803921568627,2016400,66585600,64569200
775000.0,4,3.5,3080,5250,2.0,0,0,2,9,3080,0,2003,0.0,98075,47.5992,-121.97200000000001,2980,5509,2170,0.41333333333333333,9486400,27562500,18076100
220000.0,3,1.0,1060,9126,1.0,0,2,4,7,1060,0,1956,0.0,98022,47.201,-121.999,1300,9126,8066,0.8838483453868069,1123600,83283876,82160276
518000.0,4,2.5,2160,9750,2.0,0,0,2,8,2160,0,1983,0.0,98028,47.7438,-122.24600000000001,2840,10535,7590,0.7784615384615384,4665600,95062500,90396900
1600000.0,4,3.5,4060,9486,2.0,0,0,2,10,4060,0,2005,0.0,98033,47.6634,-122.2,2410,9486,5426,0.5720008433480919,16483600,89984196,73500596
315000.0,1,2.25,1940,2550,2.0,0,0,3,7,1100,840,1979,0.0,98133,47.7313,-122.34299999999999,1580,5100,610,0.23921568627450981,3763600,6502500,2738900
572650.0,4,2.5,2250,11349,2.0,0,0,2,8,2250,0,1991,0.0,98034,47.7111,-122.23899999999999,2110,9964,9099,0.8017446471054719,5062500,128799801,123737301
350000.0,2,1.0,1620,9205,1.0,0,0,4,6,850,770,1921,0.0,98034,47.7119,-122.23,2460,5469,7585,0.824008690928843,2624400,84732025,82107625
285000.0,2,1.0,920,5850,1.0,0,0,3,6,920,0,1900,0.0,98108,47.5441,-122.304,1640,5476,4930,0.8427350427350427,846400,34222500,33376100
231000.0,3,2.5,1370,7247,2.0,0,0,2,7,1370,0,1995,0.0,98032,47.3767,-122.303,1720,8085,5877,0.8109562577618324,1876900,52519009,50642109
179000.0,3,1.0,920,5200,1.0,0,0,3,6,920,0,1969,0.0,98042,47.3603,-122.085,920,5200,4280,0.823076923076923,846400,27040000,26193600
244000.0,3,1.5,1360,9625,1.0,0,0,2,7,1360,0,1963,0.0,98030,47.3799,-122.211,1890,9625,8265,0.8587012987012987,1849600,92640625,90791025
185850.0,3,1.5,1630,11662,1.0,0,0,2,7,1630,0,1943,1963.0,98188,47.4455,-122.27799999999999,1700,11662,10032,0.8602298062081976,2656900,136002244,133345344
610000.0,6,2.5,3610,12033,2.0,0,0,2,8,3210,400,1970,0.0,98011,47.7692,-122.219,2210,8577,8423,0.6999916895204853,13032100,144793089,131760989
419000.0,4,2.5,3010,9155,2.0,0,0,2,9,3010,0,2005,0.0,98038,47.3542,-122.027,3010,5762,6145,0.671217913708356,9060100,83814025,74753925
779000.0,3,1.75,2320,6400,1.0,0,2,3,8,1420,900,1957,0.0,98199,47.6449,-122.389,2540,7680,4080,0.6375,5382400,40960000,35577600
695000.0,5,3.0,3290,14134,1.0,0,0,2,7,1870,1420,2004,0.0,98052,47.6708,-122.14,1970,11470,10844,0.7672279609452385,10824100,199769956,188945856
319900.0,3,2.5,2040,7580,2.0,0,2,2,8,2040,0,1998,0.0,98092,47.2618,-122.209,1960,7820,5540,0.7308707124010554,4161600,57456400,53294800
329000.0,3,2.75,1920,7700,1.0,0,0,3,8,1320,600,1978,0.0,98023,47.3213,-122.37799999999999,2040,8000,5780,0.7506493506493507,3686400,59290000,55603600
475226.0,3,2.5,2120,4512,2.0,0,0,2,8,2120,0,1988,0.0,98011,47.75,-122.18299999999999,2000,4553,2392,0.5301418439716312,4494400,20358144,15863744
638000.0,3,2.5,2170,5000,2.0,0,0,2,9,2170,0,2003,0.0,98029,47.5453,-121.99600000000001,2170,5000,2830,0.566,4708900,25000000,20291100
440000.0,2,1.5,1330,15873,1.0,0,0,2,7,900,430,1984,0.0,98074,47.6359,-122.03299999999999,1610,12043,14543,0.9162099162099162,1768900,251952129,250183229
214000.0,3,2.0,1580,5080,1.0,0,0,3,6,800,780,1942,0.0,98146,47.4963,-122.35,1580,7114,3500,0.6889763779527559,2496400,25806400,23310000
600000.0,3,2.75,3580,14217,2.0,0,3,3,10,2210,1370,1989,0.0,98023,47.3244,-122.37899999999999,3990,14674,10637,0.7481887880706197,12816400,202123089,189306689
935000.0,4,2.0,2580,4500,2.0,0,0,3,9,1850,730,1905,0.0,98102,47.6245,-122.316,2590,4100,1920,0.4266666666666667,6656400,20250000,13593600
630000.0,4,1.75,1930,10210,1.5,0,2,2,8,1670,260,1941,0.0,98125,47.7078,-122.277,2730,6600,8280,0.8109696376101861,3724900,104244100,100519200
575000.0,3,2.5,2120,4780,2.0,0,0,2,7,2120,0,2004,0.0,98053,47.681000000000004,-122.03200000000001,1690,2650,2660,0.5564853556485355,4494400,22848400,18354000
345000.0,3,2.5,1990,20466,1.5,0,0,3,8,1410,0,1987,0.0,98010,47.3259,-121.896,1660,93393,18476,0.9027655623961692,3960100,418857156,414897056
323000.0,4,1.75,1310,9690,1.0,0,0,3,7,1310,0,1967,0.0,98011,47.7559,-122.226,2280,9618,8380,0.8648090815273478,1716100,93896100,92180000
425000.0,3,2.5,2670,13218,1.0,0,0,3,10,2670,0,1988,0.0,98042,47.3683,-122.15299999999999,1960,13130,10548,0.7980027235587834,7128900,174715524,167586624
411000.0,2,2.25,1910,108900,1.0,0,0,3,7,1010,900,1972,0.0,98038,47.4206,-122.023,2050,108900,106990,0.9824609733700643,3648100,11859210000,11855561900
299800.0,4,1.5,1530,9000,1.0,0,0,3,6,1530,0,1976,0.0,98014,47.6492,-121.90799999999999,1520,8500,7470,0.83,2340900,81000000,78659100
823000.0,6,1.75,2920,5000,2.5,0,0,3,9,2780,140,1908,0.0,98122,47.6024,-122.295,2020,5000,2080,0.416,8526400,25000000,16473600
200000.0,3,1.0,1010,8108,1.0,0,0,2,7,1010,0,1955,0.0,98155,47.735,-122.309,1110,8108,7098,0.8754316724222989,1020100,65739664,64719564
760000.0,4,1.75,2450,13300,1.0,0,0,3,9,1630,820,1987,0.0,98006,47.5564,-122.13,3150,15500,10850,0.8157894736842105,6002500,176890000,170887500
359950.0,4,2.5,1820,3899,2.0,0,0,2,7,1820,0,1999,0.0,98019,47.735,-121.985,1820,3899,2079,0.533213644524237,3312400,15202201,11889801
375000.0,4,2.5,2090,8325,1.0,0,0,3,7,1470,620,1983,0.0,98056,47.4888,-122.184,1700,8025,6235,0.7489489489489489,4368100,69305625,64937525
295000.0,2,1.75,2200,89298,1.0,0,0,2,7,1100,1100,1973,0.0,98027,47.4633,-121.976,2590,89298,87098,0.9753633899975364,4840000,7974132804,7969292804
250000.0,4,3.0,2250,7882,2.0,0,0,2,8,1570,680,1986,0.0,98198,47.3703,-122.314,1550,7508,5632,0.7145394569906115,5062500,62125924,57063424
497000.0,3,2.25,1450,1387,3.0,0,0,2,8,1450,0,2000,0.0,98115,47.6765,-122.302,1450,1429,-63,-0.04542177361211247,2102500,1923769,-178731
520000.0,4,2.5,2280,8798,2.0,0,0,3,8,2280,0,1987,0.0,98028,47.7471,-122.24700000000001,2180,8632,6518,0.7408501932257331,5198400,77404804,72206404
365000.0,4,3.5,2720,6781,2.0,0,0,2,8,2100,620,1999,0.0,98055,47.4612,-122.215,2280,5942,4061,0.5988792213537826,7398400,45981961,38583561
459900.0,3,2.25,2250,8000,1.0,0,0,2,8,1460,790,1976,0.0,98034,47.7229,-122.20200000000001,1930,9000,5750,0.71875,5062500,64000000,58937500
158000.0,3,2.0,1090,6090,1.0,0,0,2,7,940,150,1940,0.0,98118,47.5118,-122.259,1840,6090,5000,0.8210180623973727,1188100,37088100,35900000
294700.0,3,2.0,1970,9600,1.0,0,0,3,7,1300,0,1967,0.0,98003,47.2824,-122.301,1710,7703,7630,0.7947916666666667,3880900,92160000,88279100
439950.0,4,2.25,2780,15075,2.0,0,0,2,7,2780,0,1985,0.0,98059,47.477,-122.116,1650,25542,12295,0.8155887230514096,7728400,227255625,219527225
899000.0,4,2.25,2290,40946,1.0,0,3,3,8,1550,740,1960,0.0,98008,47.61600000000001,-122.103,2790,20076,38656,0.9440726810921701,5244100,1676574916,1671330816
535000.0,3,1.75,2330,12141,1.0,0,0,2,7,1390,940,1983,0.0,98072,47.7607,-122.146,1850,12141,9811,0.8080882958570135,5428900,147403881,141974981
530000.0,4,4.5,4060,10800,2.0,0,0,2,10,4060,0,2007,0.0,98188,47.4241,-122.29,1830,9768,6740,0.6240740740740741,16483600,116640000,100156400
215000.0,4,2.0,1470,7000,1.0,0,0,3,8,1470,0,1967,0.0,98032,47.3742,-122.289,1640,7000,5530,0.79,2160900,49000000,46839100
290000.0,2,1.0,1620,5400,1.0,0,0,2,6,920,0,1926,0.0,98125,47.7069,-122.29899999999999,1540,7245,3780,0.7,2624400,29160000,26535600
798000.0,5,2.75,3220,5934,2.0,0,0,2,9,3220,0,2006,0.0,98052,47.7076,-122.101,3100,5934,2714,0.4573643410852713,10368400,35212356,24843956
785000.0,4,2.5,3270,9578,2.0,0,0,2,9,3270,0,1993,0.0,98027,47.5373,-122.051,3120,8784,6308,0.6585926080601379,10692900,91738084,81045184
433000.0,3,1.75,2160,8565,1.0,0,0,2,8,1730,430,1971,0.0,98028,47.7664,-122.262,2910,9570,6405,0.7478108581436077,4665600,73359225,68693625
425000.0,2,1.0,1150,6835,1.0,0,1,2,7,1010,140,1922,0.0,98118,47.5567,-122.273,1150,6561,5685,0.8317483540599854,1322500,46717225,45394725
654000.0,4,2.5,2240,7540,1.0,0,0,2,8,1540,700,1962,0.0,98115,47.6965,-122.30799999999999,1960,7250,5300,0.7029177718832891,5017600,56851600,51834000
215000.0,3,1.5,1280,5065,2.0,0,0,3,6,1280,0,1983,0.0,98002,47.3343,-122.21700000000001,1070,4491,3785,0.7472852912142152,1638400,25654225,24015825
232000.0,3,1.0,840,6540,1.0,0,0,2,6,840,0,1970,2014.0,98042,47.3743,-122.116,1010,6600,5700,0.8715596330275229,705600,42771600,42066000
675000.0,3,1.75,1680,10500,1.0,0,0,3,8,1680,0,1959,0.0,98005,47.6098,-122.169,2250,10400,8820,0.84,2822400,110250000,107427600
665000.0,5,2.75,2330,8000,1.0,0,0,3,7,1550,780,1972,0.0,98052,47.6651,-122.14399999999999,1750,8419,5670,0.70875,5428900,64000000,58571100
835000.0,4,2.5,3030,29163,2.0,0,0,2,10,3030,0,1998,0.0,98053,47.6569,-122.02,2780,40669,26133,0.8961012241538936,9180900,850480569,841299669
525000.0,6,3.0,2880,7560,2.0,0,0,2,7,2880,0,1980,0.0,98144,47.5959,-122.3,1470,1815,4680,0.6190476190476191,8294400,57153600,48859200
780000.0,3,2.75,2910,3094,2.0,0,2,4,7,2010,900,1939,0.0,98125,47.7071,-122.27600000000001,2400,7530,184,0.059469941822882996,8468100,9572836,1104736
844000.0,4,3.25,3090,67518,2.0,0,0,2,10,3090,0,1988,0.0,98053,47.6674,-122.046,3200,65775,64428,0.9542344263751888,9548100,4558680324,4549132224
680000.0,4,2.75,2720,54048,2.0,0,0,2,8,2720,0,1985,0.0,98072,47.7181,-122.089,2580,37721,51328,0.9496743635287153,7398400,2921186304,2913787904
290000.0,3,1.5,1310,8100,1.0,0,0,2,7,1310,0,1965,0.0,98034,47.7328,-122.20100000000001,1330,8100,6790,0.8382716049382716,1716100,65610000,63893900
560000.0,2,1.0,1790,15783,1.0,0,0,3,8,1360,430,1959,0.0,98117,47.691,-122.387,1790,7494,13993,0.8865868339352467,3204100,249103089,245898989
605500.0,3,2.5,2830,6536,2.0,0,0,2,9,2830,0,1989,0.0,98072,47.7462,-122.17200000000001,2710,6954,3706,0.5670134638922889,8008900,42719296,34710396
762500.0,4,2.5,3150,5979,2.0,0,0,2,9,3150,0,2005,0.0,98052,47.7082,-122.101,3150,6595,2829,0.4731560461615655,9922500,35748441,25825941
1740000.0,5,3.25,3930,5500,2.0,0,0,2,9,2910,1020,2014,0.0,98033,47.6802,-122.208,2040,5115,1570,0.28545454545454546,15444900,30250000,14805100
665000.0,6,2.75,2840,8346,1.0,0,0,4,8,1420,1420,1961,0.0,98118,47.5518,-122.266,2250,8346,5506,0.6597172298106877,8065600,69655716,61590116
540000.0,5,1.0,2480,4400,1.5,0,0,2,7,1640,840,1919,0.0,98122,47.6046,-122.3,1940,4400,1920,0.43636363636363634,6150400,19360000,13209600
375000.0,3,2.5,1930,6180,1.0,0,0,2,7,1330,600,1961,0.0,98155,47.7481,-122.32700000000001,1940,6180,4250,0.6877022653721683,3724900,38192400,34467500
342000.0,3,1.0,1260,6826,1.0,0,0,2,6,720,540,1944,0.0,98125,47.731,-122.303,1300,6826,5566,0.8154116612950484,1587600,46594276,45006676
340000.0,3,1.0,670,23522,1.0,0,0,3,6,670,0,1968,0.0,98024,47.5329,-121.89,1880,20270,22852,0.9715160275486778,448900,553284484,552835584
1250000.0,5,3.25,3930,12719,2.0,0,2,3,10,2540,1390,1974,0.0,98040,47.5631,-122.213,3600,15909,8789,0.6910134444531802,15444900,161772961,146328061
693000.0,4,2.5,3160,13063,2.0,0,0,2,10,3160,0,1999,0.0,98075,47.5996,-122.021,3350,14213,9903,0.7580953839087499,9985600,170641969,160656369
638500.0,4,1.75,1770,12462,1.0,0,2,3,8,1770,0,1962,0.0,98166,47.4355,-122.338,2310,14810,10692,0.8579682233991334,3132900,155301444,152168544
805000.0,5,3.0,2240,18265,2.0,0,0,3,8,2240,0,1963,0.0,98027,47.5171,-122.029,1990,18265,16025,0.8773610730906105,5017600,333610225,328592625
250000.0,3,1.0,990,8062,1.0,0,0,3,7,990,0,1960,0.0,98198,47.4151,-122.334,1420,8790,7072,0.8772016869263211,980100,64995844,64015744
325000.0,3,2.5,1580,4698,2.0,0,0,2,7,1580,0,1998,0.0,98038,47.3539,-122.025,2070,4698,3118,0.663686675180928,2496400,22071204,19574804
270000.0,4,1.75,1560,4290,2.0,0,0,2,7,1560,0,1994,0.0,98108,47.5292,-122.323,1250,6000,2730,0.6363636363636364,2433600,18404100,15970500
880000.0,6,2.5,2640,3680,2.0,0,0,4,8,1760,880,1922,0.0,98126,47.5771,-122.38,1960,3680,1040,0.2826086956521739,6969600,13542400,6572800
300000.0,2,1.75,2120,6350,1.0,0,0,3,6,1440,680,1924,0.0,98103,47.6974,-122.35600000000001,1590,6350,4230,0.6661417322834645,4494400,40322500,35828100
290000.0,2,1.0,1200,8750,1.0,0,0,2,6,1200,0,1948,0.0,98155,47.7548,-122.32700000000001,1100,8408,7550,0.8628571428571429,1440000,76562500,75122500
2850000.0,4,4.0,5040,17208,1.0,0,0,4,10,2870,2170,1976,0.0,98006,47.5701,-122.18799999999999,4050,18647,12168,0.7071129707112971,25401600,296115264,270713664
259950.0,3,1.0,1460,5825,1.0,0,0,4,5,1260,200,1942,0.0,98056,47.4958,-122.191,1150,5926,4365,0.7493562231759656,2131600,33930625,31799025
1780000.0,4,3.25,4890,13402,2.0,0,0,2,13,4890,0,2004,0.0,98059,47.5303,-122.131,5790,13539,8512,0.6351290852111625,23912100,179613604,155701504
299950.0,3,1.0,1580,5250,1.0,0,0,4,7,1580,0,1954,0.0,98056,47.4964,-122.16799999999999,1180,5940,3670,0.699047619047619,2496400,27562500,25066100
483000.0,3,2.25,2100,43560,1.0,0,0,3,8,1330,770,1977,0.0,98077,47.7511,-122.072,2100,43560,41460,0.9517906336088154,4410000,1897473600,1893063600
890000.0,3,2.25,2060,8640,1.0,0,0,3,8,2060,0,1966,0.0,98033,47.6534,-122.195,2030,9000,6580,0.7615740740740741,4243600,74649600,70406000
719000.0,3,2.5,1690,4500,1.5,0,1,3,8,1690,0,1928,0.0,98116,47.5841,-122.383,2140,7200,2810,0.6244444444444445,2856100,20250000,17393900
785000.0,4,3.0,3370,100681,1.0,0,0,4,8,1920,1450,1977,0.0,98058,47.4319,-122.148,2440,43705,97311,0.9665279446966161,11356900,10136663761,10125306861
660000.0,3,2.5,2330,3995,2.0,0,0,2,9,2330,0,2006,0.0,98029,47.5542,-122.001,2330,3740,1665,0.4167709637046308,5428900,15960025,10531125
264000.0,4,1.75,1820,8118,1.0,0,0,3,7,1080,740,1980,0.0,98031,47.4104,-122.17200000000001,1810,8050,6298,0.7758068489775807,3312400,65901924,62589524
575000.0,3,1.75,1890,11141,1.0,0,0,3,8,1890,0,1968,0.0,98006,47.5697,-122.163,2720,11144,9251,0.8303563414415223,3572100,124121881,120549781
1220000.0,4,3.75,3820,53574,1.0,0,0,2,10,3820,0,1994,0.0,98072,47.7337,-122.12100000000001,3140,54014,49754,0.9286967558890507,14592400,2870173476,2855581076
475000.0,3,2.5,2770,98881,2.0,0,0,2,9,2770,0,1991,0.0,98022,47.2568,-121.95200000000001,1830,74923,96111,0.9719865292624468,7672900,9777452161,9769779261
845800.0,4,3.5,3020,12750,2.0,0,0,2,10,3020,0,1990,0.0,98033,47.6524,-122.184,3120,14351,9730,0.7631372549019608,9120400,162562500,153442100
352500.0,3,1.75,1170,8182,1.0,0,0,2,7,1170,0,1962,0.0,98155,47.7368,-122.29799999999999,1610,8183,7012,0.8570031777071621,1368900,66945124,65576224
347000.0,3,1.0,1270,8400,1.0,0,0,2,7,1270,0,1955,0.0,98011,47.7604,-122.198,1390,8400,7130,0.8488095238095238,1612900,70560000,68947100
560000.0,4,2.75,1950,6192,2.0,0,0,2,8,1950,0,1992,0.0,98029,47.5698,-121.999,2040,5441,4242,0.685077519379845,3802500,38340864,34538364
323000.0,4,2.75,2230,50094,1.0,0,2,3,7,1330,900,1977,0.0,98092,47.2576,-122.09899999999999,2230,40770,47864,0.9554836906615563,4972900,2509408836,2504435936
595000.0,3,1.75,2220,22081,1.5,0,0,3,7,2220,0,1922,0.0,98166,47.4693,-122.36399999999999,2010,12360,19861,0.8994610751324669,4928400,487570561,482642161
257500.0,4,2.0,2060,6400,1.0,0,0,2,7,1170,890,1977,0.0,98002,47.2924,-122.197,1890,8736,4340,0.678125,4243600,40960000,36716400
450000.0,3,1.0,1100,4600,1.0,0,0,2,7,1100,0,1917,0.0,98116,47.5686,-122.385,1200,5175,3500,0.7608695652173914,1210000,21160000,19950000
410000.0,4,1.0,1140,7208,1.0,0,0,2,7,900,240,1970,0.0,98072,47.742,-122.17299999999999,1300,7991,6068,0.841842397336293,1299600,51955264,50655664
810000.0,3,1.75,1980,13503,1.0,0,2,3,9,1320,660,1952,0.0,98008,47.5867,-122.111,2450,10890,11523,0.8533659186847368,3920400,182331009,178410609
372500.0,5,3.0,2480,10090,1.0,0,0,2,7,1300,1180,2004,0.0,98178,47.4964,-122.26299999999999,2290,9900,7610,0.7542120911793855,6150400,101808100,95657700
325000.0,3,1.0,1050,9083,1.0,0,0,2,7,1050,0,1951,0.0,98155,47.7533,-122.307,1440,9071,8033,0.8843994275019267,1102500,82500889,81398389
280000.0,3,1.0,1260,7660,1.0,0,0,2,6,1260,0,1947,0.0,98133,47.7476,-122.35,1990,7861,6400,0.835509138381201,1587600,58675600,57088000
258000.0,3,2.0,1680,19978,1.0,0,0,2,6,880,800,1948,0.0,98198,47.3924,-122.30799999999999,2150,11588,18298,0.9159074982480728,2822400,399120484,396298084
329950.0,4,1.0,1360,5900,1.5,0,0,3,7,1360,0,1949,0.0,98155,47.7512,-122.318,1050,5900,4540,0.7694915254237288,1849600,34810000,32960400
836000.0,4,2.5,2450,12987,1.0,0,0,3,9,2030,420,1980,0.0,98007,47.6197,-122.15,2730,13685,10537,0.8113498113498113,6002500,168662169,162659669
365000.0,5,2.5,2260,7040,2.0,0,0,2,8,2260,0,1999,0.0,98038,47.352,-122.038,2180,6910,4780,0.6789772727272727,5107600,49561600,44454000
111300.0,2,1.0,1060,6000,1.0,0,0,3,5,1060,0,1908,0.0,98002,47.3066,-122.223,940,6000,4940,0.8233333333333334,1123600,36000000,34876400
864000.0,4,2.5,3720,105850,2.0,0,0,3,10,3720,0,1984,0.0,98053,47.655,-122.029,2830,88256,102130,0.9648559282002834,13838400,11204222500,11190384100
725000.0,3,1.75,1610,8613,1.0,0,0,4,7,1610,0,1962,0.0,98033,47.6527,-122.195,2010,8670,7003,0.8130732613491234,2592100,74183769,71591669
550000.0,4,2.5,3350,6605,2.0,0,0,2,8,2670,680,1990,0.0,98011,47.7498,-122.181,2730,5962,3255,0.4928084784254353,11222500,43626025,32403525
130000.0,2,1.0,790,7500,1.0,0,0,2,7,790,0,1951,0.0,98198,47.4007,-122.294,1560,7794,6710,0.8946666666666667,624100,56250000,55625900
765000.0,2,1.75,1660,4000,1.0,0,0,2,7,990,670,1940,0.0,98112,47.6394,-122.28,2070,4000,2340,0.585,2755600,16000000,13244400
255000.0,3,1.5,1420,7480,1.0,0,0,3,7,1420,0,1963,0.0,98058,47.4651,-122.184,1720,7700,6060,0.8101604278074866,2016400,55950400,53934000
439500.0,3,2.5,2050,40003,1.0,0,0,3,8,1570,0,1977,0.0,98027,47.47,-122.0,2700,46769,37953,0.9487538434617404,4202500,1600240009,1596037509
268000.0,3,1.75,1250,5546,1.0,0,0,3,7,1250,0,1987,0.0,98055,47.4725,-122.18700000000001,1640,4791,4296,0.7746123332131266,1562500,30758116,29195616
985000.0,3,1.75,1700,8534,1.0,0,0,3,7,1700,0,1953,0.0,98004,47.6276,-122.205,2100,10443,6834,0.8007968127490039,2890000,72829156,69939156
751305.0,4,2.5,2660,8469,2.0,0,0,2,10,2660,0,1994,0.0,98006,47.5529,-122.12,2920,10697,5809,0.6859133309717794,7075600,71723961,64648361
280000.0,3,1.0,1350,7553,1.5,0,0,2,6,1350,0,1914,0.0,98118,47.5345,-122.274,1380,7470,6203,0.8212630742751225,1822500,57047809,55225309
304000.0,4,2.0,1810,8750,1.0,0,0,1,7,1110,700,1967,0.0,98058,47.4307,-122.17,1810,8750,6940,0.7931428571428571,3276100,76562500,73286400
200000.0,4,2.75,2210,13235,2.0,0,0,2,8,1730,480,1988,0.0,98003,47.3541,-122.303,1750,7542,11025,0.8330185115224783,4884100,175165225,170281125
325000.0,3,1.5,2120,41325,1.0,0,0,3,7,1420,700,1973,0.0,98092,47.2906,-122.055,1780,42000,39205,0.9486993345432547,4494400,1707755625,1703261225
736000.0,3,2.25,2470,11603,2.0,0,2,2,8,1540,930,1988,0.0,98052,47.6569,-122.12299999999999,2850,11250,9133,0.7871240196500905,6100900,134629609,128528709
426500.0,4,2.5,2700,6515,2.0,0,0,2,9,2700,0,1998,0.0,98058,47.4356,-122.11,2900,6710,3815,0.5855717574827322,7290000,42445225,35155225
640000.0,2,1.75,1760,4400,1.0,0,0,3,7,880,880,1930,0.0,98103,47.65,-122.34,1330,4180,2640,0.6,3097600,19360000,16262400
230000.0,5,2.0,1930,6120,1.5,0,0,2,6,1930,0,1941,1969.0,98146,47.5073,-122.337,1130,6120,4190,0.684640522875817,3724900,37454400,33729500
366350.0,4,1.0,1680,5043,1.5,0,0,3,6,1680,0,1911,0.0,98118,47.5354,-122.273,1560,5765,3363,0.6668649613325401,2822400,25431849,22609449
365000.0,2,1.0,1390,8336,1.0,0,0,3,6,910,480,1946,0.0,98166,47.4646,-122.361,1610,7847,6946,0.833253358925144,1932100,69488896,67556796
482000.0,4,2.25,2240,8322,2.0,0,0,2,8,2240,0,1979,0.0,98034,47.728,-122.206,2240,6448,6082,0.7308339341504446,5017600,69255684,64238084
345000.0,4,1.0,1980,7991,1.5,0,0,2,7,1980,0,1962,0.0,98058,47.4604,-122.17,1730,7700,6011,0.7522212489050182,3920400,63856081,59935681
682000.0,3,1.75,1830,5120,1.5,0,2,4,8,1830,0,1903,0.0,98122,47.6051,-122.311,2120,5120,3290,0.642578125,3348900,26214400,22865500
657500.0,3,1.75,980,6002,1.0,0,0,3,6,980,0,1942,0.0,98033,47.6643,-122.20299999999999,1150,6054,5022,0.8367210929690103,960400,36024004,35063604
895000.0,6,2.5,3550,6533,2.0,0,0,2,8,3550,0,1925,0.0,98144,47.5719,-122.28399999999999,3140,6234,2983,0.4566049288228991,12602500,42680089,30077589
425000.0,3,1.5,1660,5665,1.0,0,0,4,7,920,740,1918,0.0,98118,47.5391,-122.274,1530,5665,4005,0.706972639011474,2755600,32092225,29336625
532500.0,4,2.5,2490,8750,2.0,0,0,2,8,2040,450,1976,0.0,98008,47.5931,-122.116,2120,10240,6260,0.7154285714285714,6200100,76562500,70362400
540000.0,4,2.5,2329,9436,2.0,0,0,2,9,2329,0,1995,0.0,98011,47.7366,-122.204,2660,10252,7107,0.7531793132683341,5424241,89038096,83613855
578000.0,3,2.25,1790,9580,2.0,0,0,2,8,1790,0,1984,0.0,98006,47.5541,-122.162,2060,9995,7790,0.8131524008350731,3204100,91776400,88572300
1090000.0,3,3.0,2830,6041,2.0,0,3,2,8,1840,990,1915,0.0,98118,47.5694,-122.28299999999999,3420,6360,3211,0.5315345141532859,8008900,36493681,28484781
322500.0,3,1.0,1160,9750,1.0,0,0,2,7,1160,0,1968,0.0,98077,47.7429,-122.072,1160,10565,8590,0.8810256410256411,1345600,95062500,93716900
140000.0,3,1.0,1000,10560,1.0,0,0,2,7,1000,0,1955,0.0,98003,47.3217,-122.31700000000001,1190,9375,9560,0.9053030303030303,1000000,111513600,110513600
485000.0,3,2.5,2540,51836,1.0,0,0,3,8,1820,720,1976,0.0,98042,47.388999999999996,-122.088,1650,51836,49296,0.9509993055019678,6451600,2686970896,2680519296
575000.0,2,1.5,1750,19709,1.5,0,0,3,8,1440,310,1978,0.0,98010,47.3351,-122.044,1950,21075,17959,0.9112080775280329,3062500,388444681,385382181
421000.0,3,2.5,2890,21780,2.0,0,0,2,8,2890,0,2000,0.0,98188,47.4326,-122.286,2120,8117,18890,0.8673094582185491,8352100,474368400,466016300
355000.0,4,2.0,1870,3497,1.0,0,0,2,7,1200,670,1954,0.0,98106,47.5309,-122.34700000000001,1270,3497,1627,0.46525593365742063,3496900,12229009,8732109
515000.0,4,2.25,2200,6967,2.0,0,0,2,8,2200,0,1986,0.0,98011,47.7355,-122.20200000000001,1970,7439,4767,0.6842256351370748,4840000,48539089,43699089
309000.0,3,1.0,1300,7200,1.0,0,0,3,7,1300,0,1952,0.0,98146,47.5063,-122.369,1740,7100,5900,0.8194444444444444,1690000,51840000,50150000
815000.0,5,2.25,3410,35536,2.0,0,0,2,10,2530,880,1974,0.0,98005,47.65,-122.155,3140,43453,32126,0.9040409725348942,11628100,1262807296,1251179196
285000.0,3,1.0,1160,7875,1.0,0,0,2,7,1160,0,1953,0.0,98125,47.724,-122.323,1600,7875,6715,0.8526984126984127,1345600,62015625,60670025
700000.0,3,1.75,2100,5000,1.5,0,0,2,8,2100,0,1916,0.0,98117,47.6776,-122.36,1830,4200,2900,0.58,4410000,25000000,20590000
289000.0,3,2.5,1490,8628,2.0,0,0,2,7,1490,0,1994,0.0,98038,47.3643,-122.041,1640,8514,7138,0.8273064441353732,2220100,74442384,72222284
458000.0,4,3.0,3280,62726,1.5,0,0,2,7,3280,0,1979,0.0,98077,47.7509,-122.056,3210,73616,59446,0.947709083952428,10758400,3934551076,3923792676
230000.0,3,1.75,1450,8378,1.0,0,0,3,8,1450,0,1978,0.0,98023,47.3093,-122.385,1860,8496,6928,0.826927667701122,2102500,70190884,68088384
432500.0,3,2.5,1930,7120,1.0,0,0,3,7,1420,510,1961,0.0,98133,47.7715,-122.34,1600,8352,5190,0.7289325842696629,3724900,50694400,46969500
288000.0,3,1.75,1660,10440,1.0,0,0,2,7,1040,620,1978,0.0,98045,47.4448,-121.77,1240,10380,8780,0.8409961685823755,2755600,108993600,106238000
354000.0,3,1.75,1260,12330,1.0,0,0,2,7,1260,0,1968,0.0,98072,47.7412,-122.095,1320,12800,11070,0.8978102189781022,1587600,152028900,150441300
119500.0,3,1.0,1170,11000,1.0,0,0,1,6,1170,0,1980,0.0,98019,47.7346,-121.98299999999999,1590,10894,9830,0.8936363636363637,1368900,121000000,119631100
805000.0,4,3.0,3350,23781,1.0,0,0,3,9,2020,1330,1979,0.0,98006,47.56,-122.132,2870,12036,20431,0.8591312392245911,11222500,565535961,554313461
435000.0,3,2.5,1420,2581,3.0,0,0,2,7,1420,0,2004,0.0,98133,47.7027,-122.35700000000001,1420,2509,1161,0.44982564897326616,2016400,6661561,4645161
260000.0,3,1.75,2170,10018,1.0,0,0,3,7,1630,540,1978,0.0,98001,47.3087,-122.264,2049,15263,7848,0.7833898981832701,4708900,100360324,95651424
377000.0,4,1.75,1800,8385,1.0,0,0,4,6,900,900,1950,0.0,98133,47.7744,-122.338,1770,8385,6585,0.7853309481216458,3240000,70308225,67068225
602000.0,4,2.5,2000,7376,2.0,0,0,2,8,2000,0,1990,0.0,98029,47.5719,-121.999,1950,5218,5376,0.7288503253796096,4000000,54405376,50405376
530000.0,3,1.75,1660,4800,1.0,0,0,2,7,960,700,1941,0.0,98116,47.5734,-122.412,1510,4800,3140,0.6541666666666667,2755600,23040000,20284400
525000.0,4,2.0,1540,3740,1.0,0,0,3,7,770,770,1946,0.0,98117,47.6886,-122.375,1090,5080,2200,0.5882352941176471,2371600,13987600,11616000
250000.0,2,1.5,1160,1086,2.0,0,0,2,7,890,270,2006,0.0,98155,47.768,-122.315,1160,1086,-74,-0.06813996316758748,1345600,1179396,-166204
681000.0,3,1.0,1700,6356,1.5,0,0,2,7,1700,0,1907,0.0,98118,47.5677,-122.281,2080,6000,4656,0.7325361862806796,2890000,40398736,37508736
625000.0,3,1.75,1580,20588,1.0,0,0,2,8,1580,0,1970,0.0,98125,47.706,-122.29,2080,7800,19008,0.9232562657858947,2496400,423865744,421369344
448500.0,3,2.5,2080,3920,2.0,0,0,2,8,2080,0,2010,0.0,98118,47.5412,-122.286,2110,3710,1840,0.46938775510204084,4326400,15366400,11040000
260000.0,3,2.0,1030,7260,1.0,0,0,2,6,1030,0,1947,0.0,98146,47.5113,-122.34700000000001,1380,8100,6230,0.8581267217630854,1060900,52707600,51646700
538000.0,3,1.75,1770,8050,1.0,0,0,3,7,1020,750,1963,0.0,98008,47.5862,-122.118,2000,7875,6280,0.7801242236024845,3132900,64802500,61669600
385500.0,3,2.0,1540,7947,1.0,0,0,2,7,1120,420,1961,0.0,98011,47.7605,-122.21700000000001,1910,7950,6407,0.8062161822071222,2371600,63154809,60783209
428400.0,4,2.5,2650,6000,2.0,0,0,2,9,2650,0,2000,0.0,98038,47.3768,-122.02799999999999,2630,6381,3350,0.5583333333333333,7022500,36000000,28977500
346290.0,4,2.75,2690,9240,2.0,0,0,2,8,2690,0,1998,0.0,98022,47.1896,-122.014,2640,9240,6550,0.7088744588744589,7236100,85377600,78141500
587000.0,4,2.75,2210,8430,2.0,0,0,2,9,2210,0,1999,0.0,98075,47.5994,-122.01700000000001,2460,8069,6220,0.7378410438908659,4884100,71064900,66180800
355000.0,4,2.5,2390,6775,2.0,0,0,2,7,2390,0,2003,0.0,98056,47.4811,-122.182,2560,6346,4385,0.6472324723247233,5712100,45900625,40188525
650000.0,5,2.75,2580,7865,1.0,0,0,3,8,1480,1100,1964,0.0,98007,47.6208,-122.139,2140,8400,5285,0.6719643992371265,6656400,61858225,55201825
340000.0,4,2.5,2160,5455,2.0,0,0,2,7,2160,0,2003,0.0,98056,47.4799,-122.18299999999999,2160,5257,3295,0.6040329972502292,4665600,29757025,25091425
565000.0,4,2.5,2230,8624,1.0,0,0,3,8,1430,0,1969,0.0,98052,47.6623,-122.152,1970,8402,6394,0.7414192949907236,4972900,74373376,69400476
630000.0,4,2.0,2000,5000,1.5,0,0,4,7,2000,0,1925,0.0,98144,47.5787,-122.29299999999999,2200,5000,3000,0.6,4000000,25000000,21000000
227000.0,3,1.0,1280,7198,1.0,0,0,4,6,1280,0,1916,1983.0,98022,47.2094,-121.99600000000001,1260,7198,5918,0.8221728257849402,1638400,51811204,50172804
600000.0,4,2.75,2810,17674,1.0,0,0,3,8,1640,1170,1978,0.0,98052,47.6745,-122.14399999999999,2400,11240,14864,0.841009392327713,7896100,312370276,304474176
540400.0,4,1.75,1680,6758,1.0,0,0,2,8,1680,0,1974,0.0,98008,47.64100000000001,-122.113,1910,7000,5078,0.7514057413435927,2822400,45670564,42848164
569000.0,3,2.5,2150,8060,2.0,0,0,2,8,2150,0,1995,0.0,98033,47.6952,-122.18799999999999,2150,7172,5910,0.7332506203473945,4622500,64963600,60341100
735000.0,3,2.5,2820,8159,2.0,0,0,2,9,2820,0,2004,0.0,98029,47.5527,-121.992,2910,5000,5339,0.6543694080156882,7952400,66569281,58616881
434000.0,3,2.25,1750,9353,1.0,0,0,2,7,1210,540,1987,0.0,98034,47.7305,-122.225,1930,8545,7603,0.812894258526676,3062500,87478609,84416109
578888.0,2,2.0,1060,4000,1.0,0,0,1,7,1000,60,1914,0.0,98103,47.6626,-122.337,1310,4000,2940,0.735,1123600,16000000,14876400
465425.0,4,2.75,2430,20720,1.0,0,0,2,7,2430,0,1967,0.0,98072,47.775,-122.139,2580,26950,18290,0.8827220077220077,5904900,429318400,423413500
280500.0,4,2.75,2660,7754,1.5,0,0,2,8,1590,1070,1986,0.0,98023,47.3078,-122.337,2250,7754,5094,0.6569512509672427,7075600,60124516,53048916
539950.0,2,2.0,1670,3507,1.0,0,0,2,9,1670,0,2007,0.0,98029,47.5545,-122.00299999999999,2330,3889,1837,0.5238095238095238,2788900,12299049,9510149
406430.0,3,2.0,1380,15426,1.0,0,0,3,7,1380,0,1968,0.0,98075,47.5951,-122.036,1380,15426,14046,0.9105406456631661,1904400,237961476,236057076
1150000.0,4,3.75,4160,35000,2.0,0,0,2,11,4160,0,1991,0.0,98053,47.669,-122.06700000000001,5330,36446,30840,0.8811428571428571,17305600,1225000000,1207694400
250000.0,3,2.5,1790,6191,2.0,0,0,2,8,1790,0,1992,0.0,98031,47.4102,-122.195,1790,6758,4401,0.7108706186399613,3204100,38328481,35124381
266000.0,3,2.5,1940,8547,1.0,0,0,2,7,1460,480,1989,0.0,98030,47.3491,-122.177,1750,7803,6607,0.773019773019773,3763600,73051209,69287609
258000.0,3,2.0,1390,7200,1.0,0,0,2,7,1390,0,1996,0.0,98058,47.434,-122.154,1630,7340,5810,0.8069444444444445,1932100,51840000,49907900
472000.0,3,2.0,2200,21890,1.0,0,2,2,8,1200,1000,1961,0.0,98155,47.7584,-122.271,2600,15162,19690,0.8994974874371859,4840000,479172100,474332100
530000.0,3,2.25,1264,1536,2.0,0,0,2,8,1264,0,2003,0.0,98105,47.6694,-122.279,1264,2067,272,0.17708333333333334,1597696,2359296,761600
302282.0,2,1.0,1095,5120,1.5,0,0,2,7,1095,0,1901,0.0,98122,47.6058,-122.31299999999999,1310,5120,4025,0.7861328125,1199025,26214400,25015375
370000.0,2,1.0,850,6213,1.0,0,0,2,6,750,100,1916,0.0,98136,47.5282,-122.384,1880,5500,5363,0.8631900853050056,722500,38601369,37878869
625000.0,4,2.0,1760,5307,1.5,0,0,3,7,1170,590,1948,0.0,98105,47.6714,-122.28,1850,6600,3547,0.6683625400414547,3097600,28164249,25066649
142500.0,1,1.0,690,6825,1.0,0,0,3,5,690,0,1917,0.0,98002,47.3109,-122.225,1330,5381,6135,0.8989010989010989,476100,46580625,46104525
334000.0,3,1.75,1400,7405,1.0,0,0,2,7,1400,0,1961,0.0,98133,47.7569,-122.334,1820,7440,6005,0.8109385550303849,1960000,54834025,52874025
362000.0,5,3.0,1810,3000,2.0,0,0,2,7,1810,0,1998,0.0,98118,47.5622,-122.291,1670,3000,1190,0.39666666666666667,3276100,9000000,5723900
181000.0,2,1.0,1310,4000,1.0,0,0,2,7,950,360,1942,0.0,98144,47.5798,-122.306,1310,4000,2690,0.6725,1716100,16000000,14283900
241500.0,3,1.0,1400,10425,1.0,0,0,3,7,1400,0,1968,0.0,98003,47.2738,-122.301,1440,10425,9025,0.8657074340527577,1960000,108680625,106720625
245000.0,3,1.75,2350,12720,1.0,0,0,3,7,1180,1170,1964,0.0,98030,47.3594,-122.175,1680,10400,10370,0.815251572327044,5522500,161798400,156275900
227500.0,3,1.0,1150,8848,1.0,0,0,2,7,1150,0,1968,0.0,98042,47.3626,-122.111,1220,9576,7698,0.8700271247739603,1322500,78287104,76964604
158550.0,5,1.5,1710,8100,1.5,0,0,3,7,1710,0,1961,0.0,98032,47.3839,-122.288,1480,8025,6390,0.7888888888888889,2924100,65610000,62685900
450000.0,3,2.25,1660,10247,1.0,0,0,4,7,1130,530,1968,0.0,98034,47.7262,-122.22200000000001,1680,7637,8587,0.8380013662535376,2755600,105001009,102245409
485000.0,3,1.75,1950,10080,1.0,0,0,3,7,1950,0,1967,0.0,98034,47.7282,-122.186,2340,8800,8130,0.8065476190476191,3802500,101606400,97803900
353000.0,4,1.75,1780,9794,1.0,0,0,2,7,1780,0,1967,0.0,98077,47.7419,-122.073,1160,9750,8014,0.8182560751480499,3168400,95922436,92754036
500000.0,4,3.0,2450,4668,2.0,0,0,2,8,2450,0,2004,0.0,98028,47.7721,-122.235,2460,4895,2218,0.47514995715509856,6002500,21790224,15787724
360000.0,1,2.25,2060,10600,1.5,0,0,2,7,1560,500,1927,1983.0,98003,47.3291,-122.304,2060,11880,8540,0.8056603773584906,4243600,112360000,108116400
357500.0,3,1.5,1540,11858,1.0,0,0,3,7,1540,0,1966,0.0,98059,47.4755,-122.15700000000001,1550,11473,10318,0.8701298701298701,2371600,140612164,138240564
272000.0,3,2.5,1650,13816,2.0,0,0,2,7,1650,0,1998,0.0,98014,47.6553,-121.912,1650,15144,12166,0.8805732484076433,2722500,190881856,188159356
422000.0,3,1.0,1160,7854,1.0,0,0,2,7,1160,0,1960,0.0,98125,47.7304,-122.30799999999999,1300,8317,6694,0.8523045581869111,1345600,61685316,60339716
365000.0,2,2.0,1440,15000,1.0,0,0,2,7,1440,0,1985,0.0,98072,47.7648,-122.15899999999999,1780,15000,13560,0.904,2073600,225000000,222926400
450000.0,3,1.75,2150,13789,1.0,0,0,3,8,1610,540,1966,0.0,98155,47.7591,-122.295,2150,15480,11639,0.8440786133874828,4622500,190136521,185514021
275053.0,2,1.0,1060,6504,1.0,0,0,2,6,1060,0,1950,0.0,98155,47.7412,-122.32700000000001,1100,7200,5444,0.8370233702337023,1123600,42302016,41178416
1880000.0,3,2.75,2620,17919,1.0,0,1,3,9,2620,0,1949,0.0,98039,47.6144,-122.228,3400,14400,15299,0.8537864836207377,6864400,321090561,314226161
725000.0,3,1.75,1630,9000,1.0,0,0,2,7,960,670,1955,0.0,98004,47.6023,-122.205,1880,9000,7370,0.8188888888888889,2656900,81000000,78343100
235000.0,3,1.75,1840,9697,1.0,0,0,3,7,1500,340,1985,0.0,98030,47.3764,-122.179,1430,8079,7857,0.8102505929668969,3385600,94031809,90646209
510000.0,2,1.0,820,4206,1.0,0,0,2,5,820,0,1949,0.0,98125,47.7076,-122.28399999999999,1810,7200,3386,0.8050404184498335,672400,17690436,17018036
489950.0,2,1.0,820,4206,1.0,0,0,2,5,820,0,1949,0.0,98125,47.7076,-122.28399999999999,1810,7200,3386,0.8050404184498335,672400,17690436,17018036
463000.0,3,2.5,2010,4195,2.0,0,0,2,8,2010,0,1998,0.0,98034,47.732,-122.197,2010,5779,2185,0.5208581644815257,4040100,17598025,13557925
536000.0,4,2.25,1990,5948,2.0,0,0,2,8,1990,0,1991,0.0,98029,47.5712,-121.995,2150,6459,3958,0.6654337592468057,3960100,35378704,31418604
375000.0,4,2.5,2990,6145,2.0,0,0,2,8,2990,0,2003,0.0,98003,47.2612,-122.294,2590,6512,3155,0.5134255492270138,8940100,37761025,28820925
630000.0,4,2.5,2540,4727,2.0,0,0,2,9,2540,0,1999,0.0,98034,47.7034,-122.236,3640,5129,2187,0.4626613073831183,6451600,22344529,15892929
362000.0,3,2.25,1640,14374,1.0,0,0,3,7,1140,500,1963,0.0,98148,47.4476,-122.33200000000001,2020,10500,12734,0.8859051064421872,2689600,206611876,203922276
350000.0,4,2.75,2500,11659,1.0,0,2,2,9,1490,1010,1979,0.0,98003,47.3381,-122.33200000000001,2830,9915,9159,0.7855733767904624,6250000,135932281,129682281
1690000.0,4,3.5,4020,13515,2.0,0,0,2,11,4020,0,2001,0.0,98004,47.6462,-122.212,3930,13515,9495,0.7025527192008879,16160400,182655225,166494825
255000.0,3,2.0,1500,8775,1.0,0,0,2,6,1390,110,1943,0.0,98166,47.4809,-122.335,1310,8775,7275,0.8290598290598291,2250000,77000625,74750625
269000.0,4,2.5,1594,7665,1.0,0,0,4,7,1088,506,1975,0.0,98002,47.3262,-122.211,1536,6000,6071,0.7920417482061317,2540836,58752225,56211389
370000.0,4,3.0,2130,4838,1.5,0,0,3,7,2130,0,1930,0.0,98055,47.4871,-122.20299999999999,1070,4838,2708,0.5597354278627532,4536900,23406244,18869344
270000.0,3,1.0,1130,7920,1.0,0,0,2,7,1130,0,1961,0.0,98059,47.4852,-122.125,1390,8580,6790,0.8573232323232324,1276900,62726400,61449500
265000.0,3,2.0,1690,9516,1.0,0,0,2,7,1690,0,1997,0.0,98022,47.2132,-122.001,1850,9516,7826,0.8224043715846995,2856100,90554256,87698156
487000.0,2,1.0,1440,4046,1.0,0,0,2,7,960,480,1946,0.0,98117,47.6901,-122.382,1400,4046,2606,0.6440929312901631,2073600,16370116,14296516
835000.0,4,3.25,3270,6027,2.0,0,0,2,10,3270,0,2001,0.0,98074,47.6346,-122.06299999999999,3270,6546,2757,0.45744151319064214,10692900,36324729,25631829
850000.0,4,3.25,4350,112750,1.0,0,0,2,9,2200,2150,2006,0.0,98027,47.5435,-121.96600000000001,2180,223027,108400,0.9614190687361419,18922500,12712562500,12693640000
575000.0,4,2.75,1610,11201,1.0,0,0,4,7,1020,590,1982,0.0,98033,47.7024,-122.198,1610,9000,9591,0.8562628336755647,2592100,125462401,122870301
335000.0,3,1.0,950,8000,1.0,0,0,2,7,950,0,1968,0.0,98034,47.7193,-122.184,2270,8540,7050,0.88125,902500,64000000,63097500
318000.0,3,1.0,1010,7200,1.0,0,0,4,6,1010,0,1948,0.0,98155,47.7601,-122.307,1590,7663,6190,0.8597222222222223,1020100,51840000,50819900
510000.0,3,2.0,1420,11325,1.0,0,0,2,7,1420,0,1980,0.0,98027,47.5356,-122.046,2330,3474,9905,0.8746136865342163,2016400,128255625,126239225
242500.0,3,1.5,1200,9720,1.0,0,0,3,7,1200,0,1965,0.0,98042,47.4225,-122.15299999999999,1380,10284,8520,0.8765432098765432,1440000,94478400,93038400
750000.0,5,2.25,2020,8400,1.0,0,0,3,7,1010,1010,1963,0.0,98040,47.5763,-122.219,1890,9233,6380,0.7595238095238095,4080400,70560000,66479600
439900.0,5,3.5,3390,7950,2.0,0,2,2,7,3390,0,2003,0.0,98056,47.4792,-122.181,2580,6900,4560,0.5735849056603773,11492100,63202500,51710400
710000.0,2,1.0,1700,3040,1.5,0,0,2,8,1460,240,1914,0.0,98119,47.6442,-122.369,1620,3230,1340,0.4407894736842105,2890000,9241600,6351600
2400000.0,5,3.25,3410,9088,2.0,0,3,2,9,2760,650,1912,0.0,98119,47.6285,-122.361,3540,7100,5678,0.6247799295774648,11628100,82591744,70963644
435000.0,3,1.75,2030,13700,1.0,0,0,2,8,1630,400,1976,0.0,98011,47.7726,-122.197,2120,11200,11670,0.8518248175182481,4120900,187690000,183569100
874000.0,4,2.75,2860,6867,1.0,0,1,4,7,1560,1300,1946,0.0,98115,47.6723,-122.26299999999999,2290,5350,4007,0.5835153633318771,8179600,47155689,38976089
385000.0,4,1.75,1690,4080,1.0,0,0,3,7,870,820,1984,0.0,98144,47.571999999999996,-122.289,1320,4080,2390,0.5857843137254902,2856100,16646400,13790300
110000.0,2,1.0,760,4746,1.0,0,0,2,5,760,0,1930,0.0,98055,47.4836,-122.214,1360,7810,3986,0.8398651495996629,577600,22524516,21946916
477000.0,3,1.75,1780,8085,1.0,0,0,2,7,1210,570,1976,0.0,98011,47.7357,-122.197,1780,8085,6305,0.779839208410637,3168400,65367225,62198825
500000.0,3,2.0,1550,6394,1.5,0,0,4,8,1550,0,1918,0.0,98126,47.5222,-122.37899999999999,1440,6387,4844,0.757585236158899,2402500,40883236,38480736
885000.0,4,2.5,4090,11225,2.0,0,0,2,10,4090,0,2005,0.0,98075,47.581,-121.971,3510,8762,7135,0.6356347438752784,16728100,126000625,109272525
235000.0,2,1.0,880,5600,1.0,0,0,4,7,880,0,1955,0.0,98178,47.5071,-122.265,1240,7015,4720,0.8428571428571429,774400,31360000,30585600
210000.0,3,2.75,1320,15236,1.0,0,0,2,7,880,440,1995,0.0,98030,47.365,-122.184,1490,8351,13916,0.9133630874245209,1742400,232135696,230393296
320000.0,2,1.0,950,4000,1.0,0,0,2,6,950,0,1910,0.0,98144,47.5728,-122.31200000000001,1480,4000,3050,0.7625,902500,16000000,15097500
406000.0,3,1.75,1390,7904,1.0,0,0,2,7,1390,0,1985,0.0,98056,47.4892,-122.181,1910,7904,6514,0.8241396761133604,1932100,62473216,60541116
350000.0,3,1.75,1900,10225,1.0,0,0,3,8,1220,680,1963,0.0,98166,47.4781,-122.35700000000001,1850,12630,8325,0.8141809290953546,3610000,104550625,100940625
350000.0,2,0.75,1392,43710,1.5,0,0,3,7,1392,0,1978,0.0,98070,47.4491,-122.45299999999999,1640,99316,42318,0.9681537405628002,1937664,1910564100,1908626436
720000.0,4,2.5,3340,8930,2.0,0,2,2,10,3340,0,1999,0.0,98065,47.535,-121.867,3160,7865,5590,0.6259798432250839,11155600,79744900,68589300
604700.0,4,2.75,2750,14982,1.0,0,3,2,9,1720,0,1981,0.0,98198,47.3566,-122.32,2860,16344,12232,0.8164464023494861,7562500,224460324,216897824
343000.0,3,1.0,1400,5662,1.5,0,0,4,5,1400,0,1920,0.0,98027,47.5271,-122.036,1250,14375,4262,0.7527375485694101,1960000,32058244,30098244
558000.0,3,2.25,2220,15757,1.0,0,0,2,8,1280,940,1982,0.0,98074,47.6212,-122.04299999999999,2020,14098,13537,0.8591102367201878,4928400,248283049,243354649
364000.0,4,1.0,1210,7740,1.5,0,0,2,7,1210,0,1922,0.0,98126,47.5216,-122.374,1100,7740,6530,0.8436692506459949,1464100,59907600,58443500
420000.0,3,1.75,2390,11242,1.0,0,0,2,7,1290,1100,1959,0.0,98155,47.7759,-122.272,2270,9650,8852,0.7874043764454723,5712100,126382564,120670464
450000.0,5,2.0,1870,7344,1.5,0,0,2,7,1870,0,1960,0.0,98007,47.5951,-122.14399999999999,1870,7650,5474,0.7453703703703703,3496900,53934336,50437436
392000.0,2,1.5,940,5000,1.0,0,0,3,7,810,130,1925,0.0,98126,47.5375,-122.374,940,5026,4060,0.812,883600,25000000,24116400
100000.0,4,1.0,1120,2685,1.0,0,0,2,5,860,260,1939,0.0,98055,47.4904,-122.20299999999999,1120,4838,1565,0.5828677839851024,1254400,7209225,5954825
480000.0,3,2.5,1250,1103,3.0,0,2,2,8,1250,0,2005,0.0,98103,47.6619,-122.352,1250,1188,-147,-0.13327289211242066,1562500,1216609,-345891
212000.0,3,1.5,1060,9225,1.0,0,0,3,7,1060,0,1955,0.0,98003,47.3217,-122.318,1270,9375,8165,0.8850948509485095,1123600,85100625,83977025
560000.0,5,2.5,2410,8960,1.0,0,0,4,7,1600,810,1978,0.0,98011,47.7372,-122.2,2410,11514,6550,0.7310267857142857,5808100,80281600,74473500
359950.0,5,2.75,2844,3990,2.0,0,0,2,8,2844,0,2013,0.0,98092,47.3259,-122.167,2273,3900,1146,0.28721804511278193,8088336,15920100,7831764
535000.0,4,2.5,2200,110642,1.0,0,0,4,7,1330,870,1979,0.0,98077,47.7409,-122.052,2290,51400,108442,0.9801160499629435,4840000,12241652164,12236812164
980000.0,5,4.0,3460,5400,2.0,0,0,2,10,2830,630,2012,0.0,98056,47.5201,-122.204,1890,5400,1940,0.3592592592592593,11971600,29160000,17188400
720000.0,2,1.0,1580,2199,2.0,0,2,2,8,1580,0,1921,1995.0,98103,47.6541,-122.329,2170,4405,619,0.28149158708503863,2496400,4835601,2339201
619950.0,2,1.0,1520,5400,1.0,0,0,2,7,920,600,1951,0.0,98115,47.6796,-122.279,1600,5400,3880,0.7185185185185186,2310400,29160000,26849600
489000.0,3,2.5,2260,19821,2.0,0,0,2,9,2260,0,1994,0.0,98058,47.448,-122.088,2750,22718,17561,0.8859795166742344,5107600,392872041,387764441
415000.0,4,2.0,1800,2970,1.0,0,0,3,7,1000,800,1923,0.0,98115,47.6833,-122.31200000000001,1690,3801,1170,0.3939393939393939,3240000,8820900,5580900
672500.0,4,2.5,2650,11108,2.0,0,0,2,10,2650,0,1987,0.0,98074,47.6304,-122.051,2650,11585,8458,0.7614332012963629,7022500,123387664,116365164
352500.0,3,1.0,1000,4171,1.0,0,0,2,7,1000,0,1985,0.0,98052,47.6834,-122.09700000000001,1090,3479,3171,0.7602493406856868,1000000,17397241,16397241
258750.0,4,2.0,2300,8400,1.0,0,0,3,6,1150,1150,1962,0.0,98003,47.3282,-122.33200000000001,1230,8400,6100,0.7261904761904762,5290000,70560000,65270000
350000.0,3,1.0,1080,7000,1.0,0,0,3,6,1080,0,1916,0.0,98133,47.7637,-122.351,1410,7214,5920,0.8457142857142858,1166400,49000000,47833600
152000.0,3,1.0,902,10464,1.0,0,0,2,7,902,0,1965,0.0,98198,47.363,-122.30799999999999,1510,7210,9562,0.9137996941896025,813604,109495296,108681692
378500.0,2,1.0,730,7528,1.0,0,0,2,7,730,0,1946,0.0,98115,47.6997,-122.305,1620,7528,6798,0.9030286928799149,532900,56670784,56137884
1020000.0,4,1.75,2600,41041,1.5,0,0,3,8,2600,0,1965,0.0,98033,47.6634,-122.17200000000001,2750,37318,38441,0.936648717136522,6760000,1684363681,1677603681
419000.0,3,1.5,1570,6700,1.0,0,0,3,7,1570,0,1956,0.0,98007,47.6022,-122.134,1570,7300,5130,0.7656716417910447,2464900,44890000,42425100
895000.0,5,3.0,2876,13927,1.0,0,2,3,9,1970,906,1973,0.0,98040,47.5528,-122.229,3500,14454,11051,0.7934946506785381,8271376,193961329,185689953
668500.0,4,2.25,2290,9546,1.0,0,0,3,8,1780,510,1976,0.0,98006,47.5617,-122.13,2360,8864,7256,0.7601089461554578,5244100,91126116,85882016
487000.0,2,2.5,1470,2533,2.0,0,0,2,8,1470,0,2005,0.0,98033,47.6874,-122.165,1470,6511,1063,0.41966048164232134,2160900,6416089,4255189
538000.0,3,3.5,2620,10137,2.0,0,0,2,8,1970,650,1992,0.0,98146,47.4979,-122.37100000000001,1960,7680,7517,0.7415408898096084,6864400,102758769,95894369
898000.0,5,1.5,2680,28014,1.0,0,0,3,8,1450,1230,1963,0.0,98004,47.6348,-122.196,2900,22180,25334,0.9043335475119583,7182400,784784196,777601796
315000.0,4,2.0,2020,7767,1.0,0,0,2,8,2020,0,1995,0.0,98003,47.3391,-122.309,1940,8239,5747,0.7399253250933436,4080400,60326289,56245889
800000.0,3,2.5,2100,4440,2.0,0,4,2,7,2100,0,1945,0.0,98116,47.5865,-122.397,2100,6000,2340,0.527027027027027,4410000,19713600,15303600
516130.0,3,1.75,1510,8250,1.0,0,0,3,8,1510,0,1962,0.0,98008,47.6183,-122.113,1770,8250,6740,0.816969696969697,2280100,68062500,65782400
1600000.0,3,2.5,2850,19593,1.5,1,4,2,10,1790,1060,1978,0.0,98008,47.5894,-122.111,2850,18782,16743,0.8545398866942275,8122500,383885649,375763149
1200000.0,4,2.5,4280,12796,2.0,0,0,2,11,3400,880,1999,0.0,98006,47.5588,-122.124,3520,9593,8516,0.6655204751484839,18318400,163737616,145419216
355425.0,4,2.5,3238,9112,1.0,0,2,3,8,1678,1560,1979,0.0,98198,47.4005,-122.311,3056,9668,5874,0.6446444249341527,10484644,83028544,72543900
1160000.0,3,2.5,2740,5925,2.0,0,2,2,10,2740,0,1913,1992.0,98112,47.6313,-122.303,2740,5948,3185,0.5375527426160338,7507600,35105625,27598025
689000.0,4,2.5,2020,9600,2.0,0,0,3,7,2020,0,1954,0.0,98136,47.5434,-122.395,2250,8550,7580,0.7895833333333333,4080400,92160000,88079600
500000.0,3,3.25,1520,1500,3.0,0,0,2,7,1520,0,2000,0.0,98107,47.67,-122.389,1520,1323,-20,-0.013333333333333334,2310400,2250000,-60400
430000.0,5,2.5,3860,42733,1.0,0,3,3,8,2300,1560,1955,0.0,98001,47.3117,-122.25399999999999,2520,19353,38873,0.9096716823064143,14899600,1826109289,1811209689
299500.0,4,2.25,1600,15312,1.0,0,0,3,7,1080,520,1979,0.0,98045,47.4629,-121.743,1620,12375,13712,0.8955067920585162,2560000,234457344,231897344
349950.0,4,2.5,2090,5289,2.0,0,0,2,8,2090,0,1989,0.0,98058,47.4289,-122.164,2080,7109,3199,0.6048402344488562,4368100,27973521,23605421
1420000.0,5,3.25,4020,4500,2.0,0,0,2,9,3120,900,2010,0.0,98004,47.6349,-122.204,3550,5775,480,0.10666666666666667,16160400,20250000,4089600
998000.0,4,2.25,2910,10189,2.0,0,0,2,9,2910,0,1988,0.0,98006,47.5465,-122.155,2780,10125,7279,0.7143978800667387,8468100,103815721,95347621
329000.0,3,1.0,900,9600,1.0,0,0,3,7,900,0,1970,0.0,98072,47.7423,-122.17299999999999,1220,8240,8700,0.90625,810000,92160000,91350000
575000.0,3,1.75,1720,5956,2.0,0,0,2,8,1720,0,1981,0.0,98033,47.6875,-122.20200000000001,1620,9324,4236,0.7112155809267965,2958400,35473936,32515536
529900.0,5,2.25,3030,9430,2.0,0,0,3,8,2600,430,1961,0.0,98133,47.7515,-122.353,2230,8425,6400,0.6786850477200425,9180900,88924900,79744000
1470000.0,4,2.5,3030,10189,1.0,0,0,2,9,2380,650,2003,0.0,98004,47.6367,-122.206,1940,10189,7159,0.7026204730591815,9180900,103815721,94634821
725000.0,4,1.75,2190,9400,1.0,0,0,3,7,1450,740,1962,0.0,98033,47.6531,-122.196,1980,9000,7210,0.7670212765957447,4796100,88360000,83563900
286000.0,3,2.5,1680,5000,2.0,0,0,2,8,1680,0,1987,0.0,98023,47.3196,-122.395,1720,5000,3320,0.664,2822400,25000000,22177600
335000.0,3,2.0,1210,9926,1.0,0,0,3,7,1210,0,1954,2015.0,98006,47.5731,-122.135,1690,9737,8716,0.8780979246423534,1464100,98525476,97061376
395300.0,3,1.5,1120,7000,1.0,0,0,2,7,1120,0,1955,0.0,98007,47.5987,-122.146,1470,7950,5880,0.84,1254400,49000000,47745600
510000.0,4,2.75,3180,13348,2.0,0,0,2,8,3020,160,2004,0.0,98019,47.7439,-121.977,3020,10029,10168,0.7617620617320947,10112400,178169104,168056704
203000.0,3,1.0,920,7500,1.0,0,0,3,7,920,0,1970,0.0,98032,47.3791,-122.289,1660,8000,6580,0.8773333333333333,846400,56250000,55403600
248000.0,2,1.0,700,8301,1.0,0,0,2,6,700,0,1953,0.0,98155,47.7712,-122.323,1250,8304,7601,0.9156728105047585,490000,68906601,68416601
265000.0,3,2.25,2540,7216,2.0,0,0,2,8,2540,0,1991,0.0,98023,47.2906,-122.34899999999999,2140,7531,4676,0.6480044345898004,6451600,52070656,45619056
1000000.0,4,1.5,2100,4560,1.5,0,0,3,8,2100,0,1912,0.0,98103,47.6497,-122.336,1930,4560,2460,0.5394736842105263,4410000,20793600,16383600
1000000.0,3,1.0,1540,24500,1.5,0,0,2,7,1540,0,1949,0.0,98125,47.7213,-122.29,1540,7250,22960,0.9371428571428572,2371600,600250000,597878400
241400.0,3,2.0,1420,9828,1.0,0,0,3,7,1420,0,1990,0.0,98010,47.3287,-122.01100000000001,1550,7227,8408,0.8555148555148555,2016400,96589584,94573184
309950.0,4,1.75,1450,10074,1.0,0,0,3,7,1450,0,1966,0.0,98058,47.4546,-122.182,1340,8023,8624,0.8560651181258686,2102500,101485476,99382976
294010.0,3,1.75,1550,4057,1.0,0,0,2,6,830,720,1945,0.0,98106,47.5291,-122.351,1100,4116,2507,0.6179442938131624,2402500,16459249,14056749
345000.0,3,2.25,1920,9672,2.0,0,0,3,8,1920,0,1984,0.0,98074,47.6233,-122.046,1950,10125,7752,0.8014888337468983,3686400,93547584,89861184
625000.0,3,2.25,1920,9672,2.0,0,0,3,8,1920,0,1984,0.0,98074,47.6233,-122.046,1950,10125,7752,0.8014888337468983,3686400,93547584,89861184
660000.0,4,2.5,2510,4543,2.0,0,0,2,8,2510,0,2002,0.0,98075,47.5962,-122.039,2550,4675,2033,0.4475016508914814,6300100,20638849,14338749
559000.0,2,2.0,1660,4500,1.0,0,0,2,8,1660,0,2003,0.0,98053,47.7094,-122.031,1670,5580,2840,0.6311111111111111,2755600,20250000,17494400
866000.0,4,3.25,3990,9786,2.0,0,0,2,9,3990,0,2004,0.0,98053,47.6784,-122.02600000000001,3920,8200,5796,0.592274678111588,15920100,95765796,79845696
770000.0,3,2.0,2350,5700,1.5,0,0,3,8,1810,540,1939,0.0,98112,47.638999999999996,-122.31,2170,6000,3350,0.5877192982456141,5522500,32490000,26967500
259950.0,3,1.5,1350,7827,1.0,0,0,3,7,1350,0,1968,0.0,98030,47.3786,-122.219,1900,7827,6477,0.8275201226523572,1822500,61261929,59439429
352000.0,5,2.75,2980,9838,1.0,0,0,2,7,1710,1270,1968,0.0,98030,47.3807,-122.22200000000001,2240,9838,6858,0.6970929050620045,8880400,96786244,87905844
2470000.0,5,4.75,6390,13180,2.0,0,0,2,10,4560,1830,1940,0.0,98112,47.6312,-122.291,4010,8137,6790,0.5151745068285281,40832100,173712400,132880300
395000.0,3,2.0,1590,10229,1.0,0,0,2,7,1590,0,1966,0.0,98034,47.7239,-122.227,1320,10222,8639,0.844559585492228,2528100,104632441,102104341
276500.0,4,1.75,1400,6650,1.5,0,0,3,6,1400,0,1942,0.0,98168,47.4888,-122.33200000000001,1120,8645,5250,0.7894736842105263,1960000,44222500,42262500
530000.0,3,2.25,1880,100623,1.5,0,0,2,8,1880,0,1987,2007.0,98024,47.5342,-121.883,2520,21689,98743,0.9813163988352563,3534400,10124988129,10121453729
798000.0,4,3.25,3500,10260,2.0,0,0,2,10,3500,0,1987,0.0,98008,47.5902,-122.13,3500,10658,6760,0.6588693957115009,12250000,105267600,93017600
380000.0,2,2.0,1370,5756,1.0,0,0,2,8,1370,0,1986,0.0,98034,47.714,-122.205,1380,5444,4386,0.7619874913134121,1876900,33131536,31254636
350000.0,4,2.5,2810,10433,2.0,0,0,2,8,2810,0,2001,0.0,98022,47.1895,-122.015,2640,9240,7623,0.7306623214799195,7896100,108847489,100951389
325000.0,3,2.5,2220,6049,2.0,0,0,3,8,2220,0,1990,0.0,98031,47.3972,-122.182,1980,7226,3829,0.6329971896181187,4928400,36590401,31662001
336000.0,3,2.5,2110,4549,2.0,0,0,3,8,2110,0,1989,0.0,98042,47.3885,-122.154,2110,4030,2439,0.5361617938008354,4452100,20693401,16241301
286900.0,3,2.25,1720,17235,1.0,0,0,3,7,1440,280,1974,0.0,98042,47.3438,-122.073,1990,35048,15515,0.900203075137801,2958400,297045225,294086825
472000.0,5,2.25,1780,7245,1.0,0,0,3,8,1330,450,1976,0.0,98052,47.6946,-122.12,1780,7653,5465,0.7543133195307108,3168400,52490025,49321625
263000.0,3,1.75,1410,8100,2.0,0,0,2,7,1410,0,1985,0.0,98038,47.3617,-122.046,1560,8100,6690,0.825925925925926,1988100,65610000,63621900
565000.0,3,3.0,2110,4000,1.0,0,2,3,7,1110,1000,1965,0.0,98126,47.5696,-122.375,1730,4000,1890,0.4725,4452100,16000000,11547900
765000.0,3,2.5,2700,8444,2.0,0,0,2,10,2700,0,1992,0.0,98006,47.5597,-122.113,2840,9165,5744,0.6802463287541449,7290000,71301136,64011136
1520000.0,3,2.25,2610,9409,1.0,0,4,3,8,2610,0,1963,0.0,98075,47.5789,-122.07600000000001,2970,9156,6799,0.7226060155170582,6812100,88529281,81717181
405000.0,3,2.0,1660,8174,1.0,0,0,2,7,830,830,1981,0.0,98034,47.7103,-122.199,1610,9318,6514,0.7969170540738928,2755600,66814276,64058676
1100000.0,4,3.5,4570,16219,2.0,0,0,2,11,4570,0,2002,0.0,98075,47.5859,-121.96799999999999,4700,16500,11649,0.718231703557556,20884900,263055961,242171061
555000.0,3,3.0,3760,188760,1.0,0,0,3,10,2640,1120,1979,0.0,98092,47.308,-122.087,2820,50543,185000,0.980080525535071,14137600,35630337600,35616200000
305000.0,3,2.5,1610,3516,2.0,0,0,2,8,1610,0,2006,0.0,98055,47.4491,-122.18799999999999,1610,3056,1906,0.5420932878270762,2592100,12362256,9770156
289950.0,3,2.25,1740,9370,1.0,0,0,2,7,1390,350,1992,0.0,98198,47.39100000000001,-122.316,1740,7555,7630,0.8143009605122732,3027600,87796900,84769300
487500.0,5,3.5,3530,218472,2.0,0,0,2,7,2380,1150,1999,0.0,98019,47.7309,-121.905,2110,211404,214942,0.9838423230436852,12460900,47730014784,47717553884
96500.0,3,1.0,840,12091,1.0,0,0,2,6,840,0,1959,0.0,98023,47.3281,-122.34299999999999,840,9324,11251,0.9305268381440741,705600,146192281,145486681
185000.0,3,1.0,840,12091,1.0,0,0,2,6,840,0,1959,0.0,98023,47.3281,-122.34299999999999,840,9324,11251,0.9305268381440741,705600,146192281,145486681
150550.0,4,1.0,1470,6061,1.5,0,0,2,7,1470,0,1945,0.0,98168,47.4819,-122.289,1230,6175,4591,0.7574657647252928,2160900,36735721,34574821
339000.0,4,2.0,2470,5080,1.5,0,0,2,6,1970,500,1948,1988.0,98106,47.5308,-122.348,1060,5080,2610,0.5137795275590551,6100900,25806400,19705500
675000.0,4,1.75,2220,7230,1.0,0,1,2,8,1280,940,1950,0.0,98125,47.7065,-122.279,2210,7230,5010,0.6929460580912863,4928400,52272900,47344500
615000.0,3,1.75,1720,4080,1.0,0,0,3,7,960,760,1924,0.0,98144,47.5747,-122.287,1660,4080,2360,0.5784313725490197,2958400,16646400,13688000
837500.0,4,2.5,2700,9320,2.0,0,0,3,8,2700,0,1994,0.0,98033,47.6861,-122.198,2120,8056,6620,0.7103004291845494,7290000,86862400,79572400
250000.0,2,1.0,950,11835,1.0,0,0,2,5,950,0,1932,0.0,98028,47.7494,-122.23700000000001,1690,12586,10885,0.9197296155471061,902500,140067225,139164725
583000.0,3,2.5,1790,8144,2.0,0,0,2,8,1790,0,1989,0.0,98074,47.6169,-122.045,1800,7503,6354,0.7802062868369352,3204100,66324736,63120636
499000.0,3,2.5,1610,1728,3.0,0,0,2,8,1610,0,2000,0.0,98115,47.6776,-122.318,1540,3090,118,0.06828703703703703,2592100,2985984,393884
550000.0,3,2.5,2290,6328,2.0,0,0,2,8,2290,0,2001,0.0,98146,47.5103,-122.382,1600,6180,4038,0.6381163084702908,5244100,40043584,34799484
400000.0,4,2.5,2170,204296,1.0,0,0,3,7,2170,0,1980,0.0,98022,47.28100000000001,-121.93299999999999,1760,154202,202126,0.9893781571836943,4708900,41736855616,41732146716
990400.0,3,2.5,2100,4097,2.0,0,0,2,9,2100,0,2008,0.0,98004,47.5983,-122.2,1820,4764,1997,0.4874298267024652,4410000,16785409,12375409
600000.0,3,2.5,2320,52272,1.5,0,0,2,8,2320,0,1974,0.0,98075,47.586999999999996,-122.068,2200,52272,49952,0.955616773798592,5382400,2732361984,2726979584
325000.0,2,1.0,1120,6236,1.0,0,0,3,6,1120,0,1954,0.0,98155,47.76300000000001,-122.291,1340,7784,5116,0.8203976908274535,1254400,38887696,37633296
265000.0,3,2.5,1530,6000,2.0,0,0,3,7,1530,0,1991,0.0,98038,47.3487,-122.036,1360,6000,4470,0.745,2340900,36000000,33659100
1620000.0,3,2.5,3490,9362,1.0,0,3,4,9,1770,1720,1960,0.0,98105,47.6605,-122.27,3640,7425,5872,0.6272164067506943,12180100,87647044,75466944
347500.0,3,1.5,1180,8353,1.0,0,0,2,7,1180,0,1960,0.0,98155,47.7652,-122.274,1710,8748,7173,0.8587333892014845,1392400,69772609,68380209
629000.0,5,2.0,2050,3000,1.5,0,0,2,7,1470,580,1912,1984.0,98103,47.6864,-122.352,1560,4500,950,0.31666666666666665,4202500,9000000,4797500
1090000.0,2,2.0,2360,11340,1.5,0,0,2,9,2360,0,1997,0.0,98040,47.5835,-122.227,3030,11340,8980,0.7918871252204586,5569600,128595600,123026000
397500.0,4,2.5,2570,7859,2.0,0,0,2,8,2570,0,1992,0.0,98038,47.3736,-122.045,2150,7284,5289,0.6729863850362642,6604900,61763881,55158981
404500.0,2,1.0,1270,3700,1.5,0,0,2,7,1270,0,1909,0.0,98144,47.5949,-122.307,1980,3200,2430,0.6567567567567567,1612900,13690000,12077100
225000.0,3,1.5,1250,7500,1.0,0,0,2,7,1250,0,1967,0.0,98030,47.3719,-122.215,1260,7563,6250,0.8333333333333334,1562500,56250000,54687500
267000.0,3,2.25,2510,9900,1.0,0,0,2,8,1610,900,1978,0.0,98023,47.2988,-122.374,1940,8510,7390,0.7464646464646465,6300100,98010000,91709900
800000.0,4,3.75,2690,4000,2.0,0,3,3,9,2120,570,1909,1989.0,98119,47.6418,-122.37200000000001,2830,4000,1310,0.3275,7236100,16000000,8763900
339000.0,4,2.5,2900,6918,2.0,0,0,2,8,2900,0,2001,0.0,98001,47.3504,-122.28399999999999,2720,10376,4018,0.5808037004914716,8410000,47858724,39448724
1850000.0,4,2.5,3830,11972,1.0,1,4,2,11,2370,1460,1981,0.0,98155,47.7404,-122.28399999999999,3080,12297,8142,0.6800868693618443,14668900,143328784,128659884
525000.0,5,1.0,1280,3876,1.5,0,0,2,7,1280,0,1923,0.0,98105,47.6605,-122.324,1420,3825,2596,0.6697626418988648,1638400,15023376,13384976
1150000.0,5,3.5,4350,6218,2.0,0,0,2,10,3520,830,2007,0.0,98027,47.5396,-121.99700000000001,3260,5989,1868,0.3004181408813123,18922500,38663524,19741024
565000.0,1,1.0,1370,6250,1.5,0,0,3,7,1370,0,1921,0.0,98136,47.5571,-122.385,1450,6250,4880,0.7808,1876900,39062500,37185600
387000.0,2,2.25,1230,1280,2.0,0,0,2,8,960,270,2012,0.0,98144,47.5942,-122.29799999999999,1130,1357,50,0.0390625,1512900,1638400,125500
720000.0,4,2.5,2440,34290,2.0,0,0,2,9,2440,0,1987,0.0,98053,47.6685,-122.044,2860,38119,31850,0.9288422280548265,5953600,1175804100,1169850500
1500000.0,4,3.5,4410,12426,2.0,0,2,2,12,3420,990,1996,0.0,98006,47.5518,-122.10700000000001,4090,12127,8016,0.6450989859971028,19448100,154405476,134957376
235000.0,2,1.0,910,7617,1.0,0,0,2,6,910,0,1936,0.0,98125,47.7332,-122.305,1310,6624,6707,0.8805303925429959,828100,58018689,57190589
365000.0,2,1.0,910,7617,1.0,0,0,2,6,910,0,1936,0.0,98125,47.7332,-122.305,1310,6624,6707,0.8805303925429959,828100,58018689,57190589
368250.0,3,2.5,2150,7484,2.0,0,0,2,8,2150,0,1988,0.0,98074,47.6191,-122.04299999999999,2150,6879,5334,0.7127204703367184,4622500,56010256,51387756
580000.0,3,2.5,2150,7484,2.0,0,0,2,8,2150,0,1988,0.0,98074,47.6191,-122.04299999999999,2150,6879,5334,0.7127204703367184,4622500,56010256,51387756
1100000.0,4,3.25,3190,11774,2.0,1,4,2,8,2610,580,1956,1991.0,98178,47.5033,-122.225,2240,8725,8584,0.729064039408867,10176100,138627076,128450976
215000.0,4,2.5,2130,4496,2.0,0,0,2,7,2130,0,2004,0.0,98001,47.3041,-122.28,3220,5400,2366,0.5262455516014235,4536900,20214016,15677116
648000.0,4,2.5,2740,9959,2.0,0,0,2,9,2740,0,1989,0.0,98029,47.5672,-122.01100000000001,2630,9905,7219,0.7248719750979014,7507600,99181681,91674081
705000.0,4,3.0,3150,9318,2.0,0,0,2,9,3150,0,2001,0.0,98075,47.5959,-122.01799999999999,3150,9318,6168,0.6619446233097231,9922500,86825124,76902624
465000.0,3,2.25,1450,1540,2.0,0,0,2,8,1180,270,2005,0.0,98107,47.6685,-122.365,1450,1540,90,0.05844155844155844,2102500,2371600,269100
650000.0,5,2.0,2400,3500,1.5,0,0,2,8,1900,500,1911,0.0,98103,47.6762,-122.35600000000001,1520,4000,1100,0.3142857142857143,5760000,12250000,6490000
335000.0,4,2.25,2280,7500,1.0,0,0,3,7,1140,1140,1963,0.0,98198,47.4182,-122.33200000000001,1660,8000,5220,0.696,5198400,56250000,51051600
640000.0,4,2.0,2310,31850,1.5,0,0,3,8,2310,0,1984,0.0,98072,47.7713,-122.12200000000001,2710,36042,29540,0.9274725274725275,5336100,1014422500,1009086400
638250.0,4,2.5,2460,8029,2.0,0,0,2,9,2460,0,1989,0.0,98074,47.6262,-122.03,2420,7987,5569,0.6936106613525969,6051600,64464841,58413241
1460000.0,4,3.5,4200,14353,2.0,0,2,2,12,3640,560,1996,0.0,98040,47.5331,-122.21700000000001,3750,16316,10153,0.7073782484498015,17640000,206008609,188368609
375000.0,4,2.0,1620,4600,2.0,0,0,2,7,1620,0,1909,0.0,98108,47.5533,-122.307,1620,4500,2980,0.6478260869565218,2624400,21160000,18535600
842000.0,4,1.75,2170,9525,1.0,0,0,2,8,2170,0,1960,0.0,98040,47.5685,-122.21700000000001,1910,9525,7355,0.7721784776902887,4708900,90725625,86016725
499950.0,3,2.25,2880,7200,1.0,0,0,2,8,1710,1170,1970,0.0,98133,47.7707,-122.35,1880,10200,4320,0.6,8294400,51840000,43545600
810000.0,4,2.5,3280,25211,2.0,0,3,2,11,3280,0,1985,0.0,98074,47.6398,-122.05,3280,25211,21931,0.8698980603704732,10758400,635594521,624836121
310000.0,5,2.0,2900,11970,2.0,0,0,3,7,2900,0,1969,0.0,98072,47.74100000000001,-122.095,1260,12398,9070,0.7577276524644946,8410000,143280900,134870900
730000.0,3,2.5,2160,8809,1.0,0,0,2,9,1540,620,2014,0.0,98103,47.6994,-122.34899999999999,930,5420,6649,0.7547962311272562,4665600,77598481,72932881
637800.0,4,1.75,2250,4750,1.5,0,0,3,7,1420,830,1924,0.0,98115,47.6738,-122.292,1930,4750,2500,0.5263157894736842,5062500,22562500,17500000
225000.0,3,1.0,1340,4800,1.5,0,0,3,5,1340,0,1903,0.0,98055,47.477,-122.209,1240,4800,3460,0.7208333333333333,1795600,23040000,21244400
417500.0,4,1.0,1390,10800,1.5,0,0,3,7,1390,0,1941,0.0,98177,47.7248,-122.359,1390,9360,9410,0.8712962962962963,1932100,116640000,114707900
265000.0,4,2.0,1600,10160,1.0,0,0,3,7,1600,0,1972,0.0,98022,47.2015,-122.00299999999999,1540,9352,8560,0.84251968503937,2560000,103225600,100665600
550000.0,4,2.5,2050,8683,2.0,0,0,2,8,2050,0,1987,0.0,98074,47.62,-122.04299999999999,2010,8744,6633,0.7639064839341242,4202500,75394489,71191989
625700.0,3,2.0,2570,159865,1.0,0,0,4,7,2570,0,1968,0.0,98024,47.5547,-121.89200000000001,2010,38322,157295,0.9839239358208488,6604900,25556818225,25550213325
595000.0,3,2.5,2660,10637,2.0,0,0,2,9,2660,0,1991,0.0,98011,47.7383,-122.22,2590,8637,7977,0.7499294913979505,7075600,113145769,106070169
270000.0,3,1.5,1540,13475,1.0,0,0,3,7,1540,0,1972,0.0,98059,47.4766,-122.15299999999999,1550,13475,11935,0.8857142857142857,2371600,181575625,179204025
739375.0,5,3.0,2640,3200,2.0,0,0,3,7,2140,500,1906,0.0,98112,47.6188,-122.30799999999999,1540,2242,560,0.175,6969600,10240000,3270400
357562.0,2,1.75,1210,1032,2.0,0,0,2,8,1210,0,2014,0.0,98029,47.5522,-121.999,1210,1090,-178,-0.17248062015503876,1464100,1065024,-399076
1010000.0,4,2.5,3760,29224,2.0,0,0,2,11,3760,0,1987,0.0,98052,47.7203,-122.12799999999999,3930,19916,25464,0.8713386257870244,14137600,854042176,839904576
455000.0,2,1.75,1350,4286,1.0,0,0,2,8,1350,0,2004,0.0,98053,47.7171,-122.03299999999999,1440,4839,2936,0.6850209986000934,1822500,18369796,16547296
310000.0,5,2.25,2600,9600,1.0,0,2,3,8,1810,790,1969,0.0,98023,47.3257,-122.365,2070,9660,7000,0.7291666666666666,6760000,92160000,85400000
415000.0,3,2.75,3900,111514,2.0,0,0,2,6,3460,440,1967,0.0,98024,47.5621,-121.92399999999999,2460,217800,107614,0.9650268127768711,15210000,12435372196,12420162196
452000.0,2,1.0,1340,8100,1.0,0,2,2,8,1340,0,1950,0.0,98177,47.7212,-122.36399999999999,1680,7752,6760,0.8345679012345679,1795600,65610000,63814400
810000.0,3,2.0,1760,16928,1.0,0,0,2,7,1760,0,1953,0.0,98004,47.6363,-122.20200000000001,3430,10059,15168,0.8960302457466919,3097600,286557184,283459584
730001.0,3,2.0,1840,4750,1.0,0,0,4,7,1010,830,1951,0.0,98117,47.6862,-122.395,1760,5510,2910,0.6126315789473684,3385600,22562500,19176900
825000.0,3,2.25,2980,86636,1.0,0,0,2,9,2230,750,1989,0.0,98053,47.6627,-122.00299999999999,2980,107157,83656,0.9656032134447574,8880400,7505796496,7496916096
665000.0,3,2.5,1730,3000,2.0,0,0,2,8,1730,0,1996,0.0,98103,47.6532,-122.34,1730,1774,1270,0.42333333333333334,2992900,9000000,6007100
327500.0,4,1.75,1650,7800,1.0,0,0,2,8,1650,0,1968,0.0,98058,47.4507,-122.139,1750,10400,6150,0.7884615384615384,2722500,60840000,58117500
699950.0,3,2.5,3370,36218,2.0,0,0,3,9,3370,0,1988,0.0,98075,47.5855,-121.98700000000001,2980,31793,32848,0.9069523441382737,11356900,1311743524,1300386624
424000.0,3,2.5,2200,34680,2.0,0,0,2,9,2200,0,1985,0.0,98092,47.3139,-122.116,2560,35840,32480,0.936562860438293,4840000,1202702400,1197862400
657000.0,4,2.5,2180,3375,1.5,0,0,3,7,1420,760,1926,0.0,98117,47.6846,-122.361,1560,3375,1195,0.3540740740740741,4752400,11390625,6638225
445000.0,3,1.75,1490,10844,1.0,0,0,2,7,1210,280,1974,0.0,98008,47.6208,-122.10600000000001,2090,9944,9354,0.8625968277388417,2220100,117592336,115372236
450000.0,3,2.5,1530,762,2.0,0,0,2,8,1050,480,2007,0.0,98119,47.641999999999996,-122.374,1610,1482,-768,-1.0078740157480315,2340900,580644,-1760256
350000.0,3,1.0,1180,7455,1.0,0,0,3,7,1180,0,1964,0.0,98034,47.7276,-122.241,1450,8154,6275,0.8417169684775319,1392400,55577025,54184625
460000.0,4,2.5,2080,17532,2.0,0,0,2,9,2080,0,1996,0.0,98059,47.4835,-122.13600000000001,2550,12560,15452,0.8813597992242757,4326400,307371024,303044624
385000.0,4,2.5,3200,22651,1.0,0,0,4,8,1610,0,1970,0.0,98031,47.3931,-122.18299999999999,2030,5500,19451,0.8587258840669286,10240000,513067801,502827801
272000.0,4,2.25,1880,6160,2.0,0,0,2,7,1880,0,1993,0.0,98023,47.3214,-122.34700000000001,1580,6405,4280,0.6948051948051948,3534400,37945600,34411200
535000.0,3,2.5,2510,5544,2.0,0,0,2,7,2510,0,2001,0.0,98053,47.6903,-122.042,2660,5614,3034,0.5472582972582972,6300100,30735936,24435836
216500.0,2,1.0,1060,5200,1.0,0,0,2,6,1060,0,1969,0.0,98042,47.3688,-122.08,910,5200,4140,0.7961538461538461,1123600,27040000,25916400
325000.0,3,2.5,2130,12245,2.0,0,0,2,8,2130,0,1989,0.0,98042,47.3406,-122.057,1910,12216,10115,0.8260514495712535,4536900,149940025,145403125
420200.0,3,1.75,1320,7280,1.0,0,0,2,7,1320,0,1968,0.0,98034,47.7229,-122.18,1370,7800,5960,0.8186813186813187,1742400,52998400,51256000
258000.0,3,1.75,1040,5650,1.0,0,0,4,6,1040,0,1951,0.0,98178,47.5111,-122.256,1290,5650,4610,0.815929203539823,1081600,31922500,30840900
450000.0,3,2.0,1150,4500,1.5,0,0,2,7,1150,0,1917,1991.0,98103,47.6985,-122.348,1230,5400,3350,0.7444444444444445,1322500,20250000,18927500
720168.0,4,2.25,2120,3794,2.0,0,0,3,7,1420,700,1926,0.0,98117,47.6893,-122.359,1420,3840,1674,0.441222983658408,4494400,14394436,9900036
652000.0,3,2.0,2130,5000,1.5,0,0,4,7,1330,800,1925,0.0,98107,47.6746,-122.36200000000001,2010,5000,2870,0.574,4536900,25000000,20463100
569500.0,4,2.5,2340,8248,2.0,0,0,2,8,2340,0,1989,0.0,98074,47.6314,-122.03,2140,9963,5908,0.7162948593598448,5475600,68029504,62553904
411000.0,4,1.75,2250,292288,1.0,0,0,3,7,2250,0,1963,0.0,98042,47.3787,-122.09100000000001,1550,23798,290038,0.9923021129844537,5062500,85432274944,85427212444
524950.0,3,1.75,1890,3825,1.0,0,0,2,7,1290,600,1974,0.0,98117,47.6831,-122.381,1320,3825,1935,0.5058823529411764,3572100,14630625,11058525
153000.0,2,1.0,1140,10152,1.0,0,0,2,6,760,380,1942,0.0,98155,47.7369,-122.321,1340,10141,9012,0.8877068557919622,1299600,103063104,101763504
775000.0,3,2.5,2780,5467,2.0,0,2,2,9,2780,0,2000,0.0,98126,47.5791,-122.37799999999999,2630,5000,2687,0.49149442107188585,7728400,29888089,22159689
338500.0,4,2.5,2390,6111,2.0,0,0,2,8,2390,0,1997,0.0,98030,47.3677,-122.17299999999999,2520,6500,3721,0.6089019800360006,5712100,37344321,31632221
570000.0,3,1.75,2390,9000,1.0,0,0,2,8,1500,890,1975,0.0,98052,47.6809,-122.113,2040,9000,6610,0.7344444444444445,5712100,81000000,75287900
653000.0,3,2.0,2680,8429,1.0,0,0,3,9,1880,800,1950,1991.0,98038,47.372,-122.036,1570,8640,5749,0.6820500652509195,7182400,71048041,63865641
435000.0,2,2.5,1560,1222,2.0,0,0,2,8,1080,480,2008,0.0,98122,47.604,-122.307,1560,2081,-338,-0.2765957446808511,2433600,1493284,-940316
207000.0,2,1.0,1130,8160,1.0,0,0,3,6,1130,0,1952,0.0,98168,47.4997,-122.31700000000001,1060,6120,7030,0.8615196078431373,1276900,66585600,65308700
540000.0,2,1.0,1120,7500,1.0,0,2,3,7,1120,0,1971,0.0,98008,47.619,-122.096,3040,16940,6380,0.8506666666666667,1254400,56250000,54995600
386000.0,4,2.25,2050,9583,2.0,0,2,2,8,1770,280,1965,0.0,98198,47.3978,-122.31299999999999,2230,9730,7533,0.7860795158092455,4202500,91833889,87631389
265000.0,5,2.25,2600,8075,1.5,0,0,3,8,2600,0,1969,0.0,98092,47.2961,-122.18799999999999,2200,8800,5475,0.6780185758513931,6760000,65205625,58445625
250000.0,3,2.25,1050,572,2.0,0,0,2,7,740,310,2006,0.0,98106,47.5549,-122.363,1260,1062,-478,-0.8356643356643356,1102500,327184,-775316
1700000.0,3,2.0,2600,6600,2.0,0,4,2,10,1930,670,1970,2014.0,98122,47.6055,-122.285,2670,6270,4000,0.6060606060606061,6760000,43560000,36800000
455000.0,4,2.5,2811,7251,2.0,0,0,2,9,2811,0,2009,0.0,98038,47.3686,-122.05799999999999,3040,7250,4440,0.6123293338849813,7901721,52577001,44675280
1800000.0,4,3.25,4060,13000,2.0,0,3,2,11,4060,0,2000,0.0,98040,47.581,-122.24600000000001,3220,13800,8940,0.6876923076923077,16483600,169000000,152516400
759000.0,3,2.0,2260,7200,1.0,0,3,2,7,1130,1130,1941,0.0,98144,47.5886,-122.288,2260,6000,4940,0.6861111111111111,5107600,51840000,46732400
970000.0,4,2.75,4430,74358,2.0,0,0,2,10,4430,0,1990,0.0,98053,47.6392,-121.988,3820,80875,69928,0.940423357271578,19624900,5529112164,5509487264
690000.0,3,2.25,2430,8327,1.0,0,0,3,9,1430,1000,1978,0.0,98006,47.5534,-122.16,2550,10427,5897,0.7081782154437373,5904900,69338929,63434029
789900.0,3,2.5,3420,25150,1.0,0,0,3,10,1750,1670,1987,0.0,98006,47.5706,-122.152,2900,19604,21730,0.8640159045725646,11696400,632522500,620826100
447500.0,2,1.0,1180,5100,1.5,0,0,2,7,1180,0,1926,0.0,98103,47.6947,-122.346,980,5100,3920,0.7686274509803922,1392400,26010000,24617600
440000.0,4,2.25,2010,7575,1.0,0,0,2,7,1220,790,1974,0.0,98034,47.7328,-122.2,1820,7831,5565,0.7346534653465346,4040100,57380625,53340525
278000.0,3,2.0,1230,7789,1.0,0,0,2,7,1230,0,1994,0.0,98042,47.3718,-122.073,1470,8670,6559,0.8420849916548979,1512900,60668521,59155621
980000.0,5,2.5,2750,6000,1.5,0,0,2,8,1750,1000,1904,1994.0,98103,47.6729,-122.334,1520,4158,3250,0.5416666666666666,7562500,36000000,28437500
245000.0,3,2.75,1300,14197,1.0,0,0,2,7,860,440,1996,0.0,98030,47.3652,-122.18299999999999,1550,7596,12897,0.9084313587377615,1690000,201554809,199864809
287000.0,3,1.5,1150,11475,1.0,0,0,2,7,1150,0,1971,0.0,98045,47.4629,-121.744,1640,11475,10325,0.8997821350762527,1322500,131675625,130353125
435000.0,3,1.75,2220,132858,1.0,0,0,2,7,1110,1110,1988,0.0,98027,47.4853,-122.03399999999999,2130,77536,130638,0.9832904303843201,4928400,17651248164,17646319764
585000.0,3,2.5,2050,11690,2.0,0,0,3,9,2050,0,1989,0.0,98059,47.5279,-122.161,2410,10172,9640,0.8246364414029085,4202500,136656100,132453600
616000.0,4,1.75,1700,5846,1.0,0,0,2,8,1700,0,1957,0.0,98199,47.6539,-122.40799999999999,1480,5177,4146,0.7092028737598358,2890000,34175716,31285716
203000.0,3,1.75,1610,9000,1.0,0,0,3,7,1100,510,1978,0.0,98092,47.3187,-122.179,1610,8000,7390,0.8211111111111111,2592100,81000000,78407900
860000.0,4,2.75,2720,3840,2.0,0,0,2,8,1790,930,1920,2009.0,98107,47.6624,-122.361,1360,3880,1120,0.2916666666666667,7398400,14745600,7347200
833000.0,4,2.5,2190,12690,1.0,0,2,2,8,1170,1020,1973,0.0,98033,47.6627,-122.189,2630,10843,10500,0.8274231678486997,4796100,161036100,156240000
565000.0,4,2.75,2730,6856,2.0,0,0,2,8,2730,0,2003,0.0,98072,47.7739,-122.164,2520,5569,4126,0.601808634772462,7452900,47004736,39551836
572500.0,3,2.5,2490,7589,2.0,0,0,2,9,2490,0,1991,0.0,98056,47.5355,-122.179,2500,10386,5099,0.6718935301093688,6200100,57592921,51392821
254000.0,4,2.0,1510,4235,1.0,0,0,2,7,1510,0,1955,0.0,98108,47.54600000000001,-122.29299999999999,1510,4268,2725,0.6434474616292798,2280100,17935225,15655125
1530000.0,4,4.25,4720,21000,3.0,0,4,4,11,4720,0,1971,0.0,98177,47.7591,-122.376,3010,20000,16280,0.7752380952380953,22278400,441000000,418721600
900000.0,4,3.0,3810,217800,2.0,0,0,2,9,3810,0,2003,0.0,98077,47.7696,-122.021,2580,217364,213990,0.9825068870523416,14516100,47436840000,47422323900
899000.0,3,2.5,1950,3730,2.0,0,0,2,9,1950,0,1996,0.0,98033,47.6731,-122.199,2080,4000,1780,0.4772117962466488,3802500,13912900,10110400
560000.0,3,2.0,1300,6000,1.0,0,0,4,7,1300,0,1943,0.0,98136,47.5482,-122.39200000000001,1230,6000,4700,0.7833333333333333,1690000,36000000,34310000
512500.0,3,1.75,1610,7200,1.0,0,0,2,7,1180,430,1976,0.0,98007,47.5966,-122.14399999999999,1520,7973,5590,0.7763888888888889,2592100,51840000,49247900
775000.0,4,2.5,2040,5000,1.5,0,0,4,7,1180,860,1924,0.0,98117,47.6786,-122.36,1540,5000,2960,0.592,4161600,25000000,20838400
200000.0,2,1.0,700,4700,1.0,0,0,4,5,700,0,1953,0.0,98056,47.4953,-122.169,960,5200,4000,0.851063829787234,490000,22090000,21600000
172000.0,3,1.0,970,4700,1.0,0,0,3,6,720,250,1943,0.0,98106,47.5285,-122.354,1560,4600,3730,0.7936170212765957,940900,22090000,21149100
219900.0,3,1.0,910,6000,1.0,0,0,1,6,910,0,1956,0.0,98146,47.5065,-122.338,1090,6957,5090,0.8483333333333334,828100,36000000,35171900
641200.0,3,1.0,1060,9123,1.0,0,0,2,7,1060,0,1952,0.0,98004,47.6218,-122.193,1620,9121,8063,0.8838101501699003,1123600,83229129,82105529
473000.0,5,3.25,2180,7200,2.0,0,0,3,7,2180,0,1982,0.0,98034,47.7078,-122.234,1840,7644,5020,0.6972222222222222,4752400,51840000,47087600
540000.0,3,1.75,2050,9580,1.0,0,0,2,8,1400,650,1984,0.0,98074,47.6212,-122.038,1740,11952,7530,0.7860125260960334,4202500,91776400,87573900
295000.0,2,1.0,750,4500,1.0,0,0,2,6,750,0,1945,0.0,98122,47.607,-122.29700000000001,1540,4000,3750,0.8333333333333334,562500,20250000,19687500
370000.0,3,1.0,800,2296,1.0,0,0,3,6,800,0,1908,0.0,98103,47.6546,-122.35600000000001,1480,1472,1496,0.6515679442508711,640000,5271616,4631616
1730000.0,4,2.25,3470,8000,1.5,0,1,2,9,2360,1110,1906,0.0,98122,47.6149,-122.287,3010,8000,4530,0.56625,12040900,64000000,51959100
275000.0,3,1.5,1390,48257,1.0,0,0,2,6,1390,0,1922,0.0,98024,47.5603,-121.89399999999999,1440,45302,46867,0.9711958886793626,1932100,2328738049,2326805949
89000.0,3,1.0,900,4750,1.0,0,0,3,6,900,0,1969,0.0,98023,47.3026,-122.363,900,3404,3850,0.8105263157894737,810000,22562500,21752500
175000.0,2,1.75,1050,9800,1.5,0,0,3,6,1050,0,1975,0.0,98019,47.7595,-121.473,1230,12726,8750,0.8928571428571429,1102500,96040000,94937500
490000.0,3,2.5,2410,11900,1.0,0,2,3,9,1600,810,1989,0.0,98023,47.3384,-122.34,3090,11902,9490,0.7974789915966387,5808100,141610000,135801900
342400.0,3,2.25,1180,9630,2.0,0,0,2,7,1180,0,1986,0.0,98028,47.7352,-122.23200000000001,2660,5979,8450,0.877466251298027,1392400,92736900,91344500
345000.0,3,1.0,1140,4200,2.0,0,0,3,7,1140,0,1904,0.0,98144,47.6012,-122.296,1510,4000,3060,0.7285714285714285,1299600,17640000,16340400
399000.0,2,1.0,700,3400,1.0,0,0,2,6,700,0,1946,0.0,98112,47.6212,-122.296,1570,4512,2700,0.7941176470588235,490000,11560000,11070000
550000.0,4,2.5,2060,9719,1.0,0,0,3,8,1320,740,1960,0.0,98006,47.5549,-122.176,2050,9643,7659,0.7880440374524128,4243600,94458961,90215361
652450.0,3,2.25,2230,11835,1.0,0,0,4,8,1630,600,1974,0.0,98006,47.563,-122.178,2190,10384,9605,0.8115758343895226,4972900,140067225,135094325
438000.0,2,2.25,1950,29347,1.0,0,0,2,8,1350,600,1953,0.0,98133,47.739,-122.351,2125,7751,27397,0.933553685214843,3802500,861246409,857443909
605000.0,3,1.75,2100,5058,1.0,0,2,2,7,1340,760,1941,0.0,98126,47.5743,-122.37799999999999,1640,5000,2958,0.5848161328588375,4410000,25583364,21173364
395000.0,4,2.5,2130,11733,1.0,0,0,4,7,1330,800,1969,0.0,98059,47.512,-122.16,1800,9131,9603,0.8184607517259013,4536900,137663289,133126389
449950.0,3,2.0,1880,3048,2.0,0,0,3,7,1880,0,1902,0.0,98122,47.6031,-122.303,1680,3600,1168,0.38320209973753283,3534400,9290304,5755904
651100.0,4,2.5,2310,5526,2.0,0,0,2,9,2310,0,2003,0.0,98074,47.6299,-122.02,2500,5769,3216,0.5819761129207384,5336100,30536676,25200576
241000.0,3,1.0,880,6050,1.0,0,0,2,6,880,0,1945,0.0,98178,47.4995,-122.24799999999999,1130,6050,5170,0.8545454545454545,774400,36602500,35828100
3420000.0,5,5.0,5450,20412,2.0,0,0,2,11,5450,0,2014,0.0,98039,47.6209,-122.23700000000001,3160,17825,14962,0.7330001959631589,29702500,416649744,386947244
268500.0,2,1.5,1290,1749,1.0,0,0,2,8,660,630,1969,0.0,98008,47.6118,-122.116,1860,1749,459,0.2624356775300172,1664100,3059001,1394901
200000.0,2,1.0,1010,7200,1.0,0,0,2,6,1010,0,1956,0.0,98166,47.4815,-122.339,1290,9000,6190,0.8597222222222223,1020100,51840000,50819900
400375.0,4,1.75,1690,7680,1.0,0,0,4,6,890,800,1946,0.0,98126,47.5296,-122.375,1060,7680,5990,0.7799479166666666,2856100,58982400,56126300
429000.0,2,1.75,1350,6315,1.0,0,0,2,8,1350,0,2005,0.0,98053,47.7141,-122.03200000000001,1665,5390,4965,0.7862232779097387,1822500,39879225,38056725
230000.0,3,1.0,680,2400,1.0,0,0,3,6,680,0,1903,0.0,98144,47.5982,-122.29899999999999,1470,3600,1720,0.7166666666666667,462400,5760000,5297600
1200000.0,4,2.25,2860,10702,2.0,0,0,2,10,2860,0,1982,0.0,98004,47.6451,-122.189,2890,10572,7842,0.7327602317323865,8179600,114532804,106353204
314200.0,1,1.0,610,6000,1.0,0,0,3,5,610,0,1918,0.0,98117,47.6911,-122.367,970,5000,5390,0.8983333333333333,372100,36000000,35627900
513000.0,4,2.5,2660,8887,1.0,0,0,3,8,1880,780,1967,0.0,98166,47.43899999999999,-122.34200000000001,1910,9620,6227,0.7006863958591201,7075600,78978769,71903169
535000.0,2,1.0,1390,5346,1.0,0,0,4,7,960,430,1908,0.0,98118,47.5567,-122.279,1450,5040,3956,0.7399925177702955,1932100,28579716,26647616
420000.0,6,3.0,2290,6344,2.0,0,0,2,7,2290,0,1980,0.0,98126,47.565,-122.37,1360,3202,4054,0.6390290037831021,5244100,40246336,35002236
345950.0,3,2.5,2110,4118,2.0,0,0,2,8,2110,0,1989,0.0,98042,47.3878,-122.15299999999999,2110,4044,2008,0.4876153472559495,4452100,16957924,12505824
483500.0,3,2.0,1200,2016,1.0,0,1,3,7,600,600,1931,0.0,98116,47.5811,-122.404,1730,4520,816,0.40476190476190477,1440000,4064256,2624256
695000.0,4,2.25,2360,2500,2.0,0,3,2,8,1520,840,2001,0.0,98117,47.6771,-122.35799999999999,1810,3900,140,0.056,5569600,6250000,680400
295000.0,4,2.5,2350,8906,2.0,0,0,2,7,2350,0,1993,0.0,98031,47.4205,-122.215,2000,8165,6556,0.736132944082641,5522500,79316836,73794336
434975.0,3,2.25,1590,9960,1.0,0,0,2,7,1060,530,1976,0.0,98155,47.7742,-122.287,1860,9760,8370,0.8403614457831325,2528100,99201600,96673500
513000.0,3,2.5,1810,4592,2.0,0,0,2,8,1810,0,1992,0.0,98029,47.5764,-121.99600000000001,1810,4758,2782,0.605836236933798,3276100,21086464,17810364
360000.0,3,1.75,1900,11407,1.0,0,0,2,8,1900,0,1963,0.0,98155,47.7455,-122.294,1710,11407,9507,0.833435609713334,3610000,130119649,126509649
234900.0,3,1.0,1250,8000,1.0,0,0,2,7,1250,0,1956,0.0,98146,47.5065,-122.337,1040,6973,6750,0.84375,1562500,64000000,62437500
963000.0,4,3.5,3280,6603,2.0,0,0,2,10,3280,0,2007,0.0,98027,47.5642,-122.126,3280,7333,3323,0.5032560957140694,10758400,43599609,32841209
595000.0,2,1.5,870,4800,1.0,0,0,2,7,870,0,1924,0.0,98119,47.6509,-122.37,2090,4800,3930,0.81875,756900,23040000,22283100
942500.0,4,3.25,3570,14408,2.0,0,2,2,10,3570,0,2006,0.0,98065,47.536,-121.85700000000001,4100,14577,10838,0.7522209883398112,12744900,207590464,194845564
1030000.0,4,3.25,3780,11200,2.0,0,0,2,11,3780,0,2002,0.0,98059,47.521,-122.15,3720,11813,7420,0.6625,14288400,125440000,111151600
350000.0,3,1.0,1190,3600,1.5,0,0,2,6,1190,0,1904,0.0,98144,47.5985,-122.29799999999999,1680,3600,2410,0.6694444444444444,1416100,12960000,11543900
416500.0,4,2.0,2280,39848,2.0,0,0,3,8,2280,0,1991,0.0,98070,47.5003,-122.465,1900,38472,37568,0.9427825737803653,5198400,1587863104,1582664704
209900.0,3,1.0,1030,60720,1.5,0,0,2,5,1030,0,1912,0.0,98042,47.375,-122.166,1330,10342,59690,0.9830368906455863,1060900,3686918400,3685857500
802000.0,3,1.75,2870,5000,1.5,0,0,3,8,1840,1030,1907,0.0,98144,47.5788,-122.292,2200,5000,2130,0.426,8236900,25000000,16763100
230000.0,4,1.5,1520,8800,1.0,0,0,3,7,1520,0,1960,0.0,98002,47.3136,-122.208,1370,8800,7280,0.8272727272727273,2310400,77440000,75129600
489000.0,3,3.0,3700,10375,2.0,0,0,2,9,3700,0,1982,0.0,98188,47.4286,-122.291,2130,9132,6675,0.6433734939759036,13690000,107640625,93950625
497000.0,3,1.5,2240,28750,1.0,0,0,2,8,1620,620,1956,0.0,98034,47.7137,-122.25399999999999,3200,23873,26510,0.9220869565217391,5017600,826562500,821544900
250000.0,3,2.25,1920,7738,1.0,0,0,2,8,1520,400,1965,0.0,98148,47.4562,-122.33,2170,8452,5818,0.751873869216852,3686400,59876644,56190244
925000.0,3,3.0,2560,3600,2.0,0,0,2,10,2110,450,1994,0.0,98119,47.633,-122.37,2160,3600,1040,0.28888888888888886,6553600,12960000,6406400
390000.0,4,2.5,1840,15496,2.0,0,0,2,8,1840,0,1991,0.0,98059,47.4683,-122.07,1840,15040,13656,0.8812596799173981,3385600,240126016,236740416
415000.0,3,2.75,2080,9600,1.0,0,0,2,7,2080,0,1988,0.0,98028,47.7698,-122.238,2220,9600,7520,0.7833333333333333,4326400,92160000,87833600
785000.0,3,2.0,1600,9638,1.0,0,0,4,7,1600,0,1952,0.0,98040,47.5753,-122.22399999999999,1800,11400,8038,0.833990454451131,2560000,92891044,90331044
575000.0,3,2.0,2168,4000,1.5,0,0,2,8,2168,0,1907,0.0,98105,47.6561,-122.325,1770,4000,1832,0.458,4700224,16000000,11299776
170000.0,2,1.0,860,8636,1.0,0,0,2,6,860,0,1924,0.0,98146,47.5081,-122.35600000000001,1100,8636,7776,0.9004168596572487,739600,74580496,73840896
750000.0,4,1.75,2100,3400,1.0,0,0,4,7,1100,1000,1915,0.0,98119,47.6429,-122.37100000000001,1890,3771,1300,0.38235294117647056,4410000,11560000,7150000
230000.0,3,1.0,1140,9639,1.0,0,0,3,7,1140,0,1967,0.0,98001,47.3112,-122.265,1140,9639,8499,0.8817304699657641,1299600,92910321,91610721
855000.0,4,3.0,3090,35074,2.0,0,0,2,9,3090,0,1978,0.0,98005,47.6359,-122.15899999999999,3120,35150,31984,0.9119005531162685,9548100,1230185476,1220637376
235000.0,3,1.0,1330,45738,2.0,0,0,1,6,1330,0,1967,0.0,98058,47.43600000000001,-122.185,1490,24000,44408,0.9709213345576982,1768900,2091964644,2090195744
335000.0,2,1.0,1360,69260,1.0,0,0,3,5,1360,0,1937,0.0,98065,47.5229,-121.838,1460,69260,67900,0.9803638463759746,1849600,4796947600,4795098000
1200000.0,5,3.0,3420,18129,2.0,0,0,2,9,2540,880,1952,2005.0,98040,47.5333,-122.21700000000001,3750,16316,14709,0.8113519774946218,11696400,328660641,316964241
677000.0,4,2.0,2180,6000,1.5,0,0,2,8,2060,120,1927,0.0,98144,47.5958,-122.306,1370,4500,3820,0.6366666666666667,4752400,36000000,31247600
575000.0,3,2.0,1800,5000,2.0,0,0,4,7,1600,200,1925,0.0,98136,47.5447,-122.389,1640,5000,3200,0.64,3240000,25000000,21760000
450000.0,2,1.0,1120,4590,1.0,0,0,2,7,1120,0,1924,0.0,98118,47.5663,-122.285,1120,5100,3470,0.7559912854030502,1254400,21068100,19813700
817250.0,3,2.5,2980,7202,2.0,0,0,2,8,2980,0,1999,0.0,98033,47.6769,-122.177,2430,7280,4222,0.5862260483199111,8880400,51868804,42988404
440000.0,4,2.25,2600,28600,1.0,0,0,2,8,1810,790,1968,0.0,98072,47.7757,-122.139,2580,26950,26000,0.9090909090909091,6760000,817960000,811200000
526000.0,2,2.0,1550,2400,1.5,0,0,3,7,1550,0,1900,0.0,98103,47.653999999999996,-122.346,1180,1224,850,0.3541666666666667,2402500,5760000,3357500
762500.0,3,2.25,3330,15258,2.0,0,0,2,10,3330,0,1986,0.0,98077,47.7262,-122.06,3360,14850,11928,0.7817538340542666,11088900,232806564,221717664
325000.0,4,2.5,2200,7719,2.0,0,0,2,8,2200,0,2000,0.0,98030,47.3649,-122.194,2460,7348,5519,0.7149889882109082,4840000,59582961,54742961
840000.0,4,3.5,3840,85728,2.0,0,0,2,11,3840,0,1998,0.0,98014,47.615,-121.954,2430,42643,81888,0.9552071668533034,14745600,7349289984,7334544384
377500.0,2,1.0,840,4500,1.0,0,0,2,6,840,0,1939,0.0,98136,47.5441,-122.39,1300,5000,3660,0.8133333333333334,705600,20250000,19544400
212500.0,3,1.5,1270,7128,1.0,0,0,3,6,1270,0,1954,0.0,98198,47.422,-122.321,1270,7986,5858,0.8218294051627385,1612900,50808384,49195484
749400.0,4,2.5,3240,20301,2.0,0,0,2,10,3240,0,1985,0.0,98052,47.718999999999994,-122.11399999999999,3010,23650,17061,0.8404019506428255,10497600,412130601,401633001
663000.0,3,2.5,2480,37843,1.5,0,3,3,8,2480,0,1974,0.0,98070,47.4003,-122.42200000000001,2350,42122,35363,0.9344660835557435,6150400,1432092649,1425942249
1480000.0,3,2.25,4470,22518,2.0,0,2,2,9,3240,1230,1953,0.0,98006,47.574,-122.18,2930,21837,18048,0.801492139621636,19980900,507060324,487079424
261000.0,3,1.0,1780,7800,1.0,0,0,2,7,1060,720,1957,0.0,98178,47.4932,-122.26299999999999,1450,7800,6020,0.7717948717948718,3168400,60840000,57671600
515000.0,4,2.5,1850,9248,2.0,0,0,2,8,1850,0,1997,0.0,98028,47.735,-122.244,2080,8711,7398,0.7999567474048442,3422500,85525504,82103004
410000.0,3,2.25,2200,16921,2.0,0,0,2,8,2200,0,1987,0.0,98038,47.3727,-122.051,2060,16921,14721,0.8699840434962473,4840000,286320241,281480241
336000.0,3,2.25,2760,10160,1.0,0,0,2,8,2760,0,1969,0.0,98058,47.4504,-122.15,2760,9600,7400,0.7283464566929134,7617600,103225600,95608000
440000.0,2,1.0,1090,4128,1.0,0,0,2,7,1090,0,1948,0.0,98115,47.69600000000001,-122.314,1090,5413,3038,0.7359496124031008,1188100,17040384,15852284
908950.0,4,2.75,3090,6200,2.0,0,0,2,9,3090,0,2014,0.0,98006,47.5538,-122.189,2890,10108,3110,0.5016129032258064,9548100,38440000,28891900
554000.0,2,1.0,820,3700,1.0,0,0,4,7,820,0,1968,0.0,98040,47.588,-122.251,1750,9000,2880,0.7783783783783784,672400,13690000,13017600
387000.0,3,2.25,1445,1606,2.0,0,0,2,7,1300,145,2003,0.0,98027,47.5348,-122.072,1410,1286,161,0.10024906600249066,2088025,2579236,491211
268643.0,4,2.25,1810,9240,2.0,0,0,2,7,1810,0,1961,0.0,98055,47.4362,-122.18700000000001,1660,9240,7430,0.8041125541125541,3276100,85377600,82101500
514000.0,3,1.75,1620,5000,1.0,0,0,2,7,920,700,1954,0.0,98117,47.681000000000004,-122.37200000000001,1610,5000,3380,0.676,2624400,25000000,22375600
420000.0,2,1.75,1060,4182,2.0,0,0,2,7,1060,0,1977,0.0,98115,47.6787,-122.30799999999999,1760,4590,3122,0.7465327594452416,1123600,17489124,16365524
199000.0,3,1.75,1050,9871,1.0,0,0,4,7,1050,0,1968,0.0,98042,47.3816,-122.087,1300,10794,8821,0.8936277986019654,1102500,97436641,96334141
225000.0,3,1.0,1010,15701,1.0,0,0,3,7,1010,0,1949,0.0,98188,47.4518,-122.292,1260,9800,14691,0.9356728870772563,1020100,246521401,245501301
320000.0,4,2.5,2050,8424,2.0,0,0,3,8,2050,0,1993,0.0,98022,47.19600000000001,-122.01100000000001,1970,8448,6374,0.75664767331434,4202500,70963776,66761276
204995.0,2,1.0,970,8185,1.0,0,0,4,6,970,0,1904,0.0,98031,47.4025,-122.20100000000001,1500,12541,7215,0.8814905314599878,940900,66994225,66053325
376000.0,3,2.0,1540,1827,2.0,0,0,2,8,1540,0,2005,0.0,98029,47.5479,-121.999,1560,2058,287,0.15708812260536398,2371600,3337929,966329
705000.0,4,2.75,3000,6222,2.0,0,0,2,9,3000,0,2004,0.0,98029,47.5582,-122.025,3340,7222,3222,0.5178399228543876,9000000,38713284,29713284
725995.0,4,2.5,3190,7869,2.0,0,2,2,9,3190,0,2001,0.0,98065,47.5317,-121.866,2630,6739,4679,0.5946117676960224,10176100,61921161,51745061
285000.0,4,2.5,1870,8190,1.0,0,0,2,7,1100,770,1977,0.0,98058,47.4521,-122.161,1590,9150,6320,0.7716727716727717,3496900,67076100,63579200
285000.0,4,2.5,2200,9397,2.0,0,0,2,8,2200,0,1987,0.0,98001,47.3406,-122.26899999999999,2310,9176,7197,0.7658827285303821,4840000,88303609,83463609
731000.0,4,2.5,3070,5936,2.0,0,0,2,9,3070,0,2005,0.0,98075,47.5902,-121.988,3160,5936,2866,0.4828167115902965,9424900,35236096,25811196
1560000.0,4,3.75,3730,17000,2.0,0,3,3,10,2820,910,1986,0.0,98040,47.5355,-122.242,3880,15550,13270,0.7805882352941177,13912900,289000000,275087100
510000.0,4,2.5,2440,10423,1.0,0,0,2,7,2440,0,1955,0.0,98034,47.725,-122.17200000000001,1990,7758,7983,0.7659023313825194,5953600,108638929,102685329
620000.0,2,1.0,990,4332,1.0,0,0,2,7,990,0,1909,0.0,98103,47.6528,-122.331,1920,3420,3342,0.7714681440443213,980100,18766224,17786124
1110000.0,3,4.0,4160,31796,2.0,0,0,2,11,4160,0,1989,0.0,98053,47.6635,-122.01700000000001,4300,36192,27636,0.8691659328217386,17305600,1010985616,993680016
796000.0,4,3.5,3670,4960,2.0,0,0,2,9,2870,800,2005,0.0,98177,47.7022,-122.374,1520,6335,1290,0.2600806451612903,13468900,24601600,11132700
255000.0,3,1.5,910,25500,1.0,0,0,2,5,910,0,1943,0.0,98188,47.4565,-122.27600000000001,1580,10019,24590,0.9643137254901961,828100,650250000,649421900
807000.0,3,2.5,1940,4000,2.0,0,0,3,9,1940,0,2000,0.0,98199,47.659,-122.398,1410,4000,2060,0.515,3763600,16000000,12236400
315000.0,4,2.5,1780,6000,2.0,0,0,2,9,1780,0,2000,0.0,98038,47.3774,-122.027,2650,6000,4220,0.7033333333333334,3168400,36000000,32831600
637000.0,3,2.25,2200,7355,2.0,0,0,3,8,2200,0,1986,0.0,98052,47.7266,-122.103,2290,7868,5155,0.7008837525492863,4840000,54096025,49256025
2730000.0,4,4.25,6410,43838,2.5,0,2,3,12,5610,800,1906,0.0,98144,47.5703,-122.28,2270,6630,37428,0.8537798257219764,41088100,1921770244,1880682144
490000.0,3,2.0,2070,10023,1.0,0,0,2,8,1220,850,1981,0.0,98074,47.6492,-122.06200000000001,2130,9694,7953,0.7934750074827895,4284900,100460529,96175629
253000.0,3,1.75,2040,7281,1.0,0,0,2,7,1020,1020,1962,0.0,98188,47.4681,-122.28200000000001,1740,7527,5241,0.7198187062216729,4161600,53012961,48851361
325900.0,4,2.5,2320,6270,2.0,0,0,2,8,2320,0,2004,0.0,98042,47.3501,-122.14,2150,6270,3950,0.6299840510366826,5382400,39312900,33930500
425000.0,2,2.0,1440,6677,1.0,0,0,2,7,870,570,1952,0.0,98118,47.5513,-122.264,2020,7642,5237,0.7843342818631122,2073600,44582329,42508729
215000.0,4,2.5,1700,6675,2.0,0,0,2,7,1700,0,1997,0.0,98038,47.3638,-122.053,1570,7540,4975,0.7453183520599251,2890000,44555625,41665625
315000.0,4,2.5,1700,6675,2.0,0,0,2,7,1700,0,1997,0.0,98038,47.3638,-122.053,1570,7540,4975,0.7453183520599251,2890000,44555625,41665625
724800.0,3,2.0,2050,3933,1.0,0,0,2,8,1180,870,1926,2001.0,98112,47.6436,-122.303,1940,4000,1883,0.47876938723620643,4202500,15468489,11265989
295000.0,2,1.0,800,6500,1.0,0,0,3,6,800,0,1953,0.0,98133,47.7621,-122.35799999999999,1220,7000,5700,0.8769230769230769,640000,42250000,41610000
509007.0,3,1.75,1800,7620,1.0,0,0,2,8,1350,450,1951,0.0,98177,47.7165,-122.361,1770,7620,5820,0.7637795275590551,3240000,58064400,54824400
306000.0,5,2.0,1460,169448,1.5,0,0,2,6,1460,0,1910,0.0,98030,47.3714,-122.177,2250,6059,167988,0.9913837873565932,2131600,28712624704,28710493104
205000.0,3,1.75,1290,7210,1.0,0,0,2,7,1290,0,1984,0.0,98023,47.2889,-122.363,1350,7509,5920,0.8210818307905686,1664100,51984100,50320000
275000.0,3,1.5,1900,9737,1.0,0,0,3,7,1200,700,1968,0.0,98031,47.4125,-122.20700000000001,1670,9737,7837,0.8048680291670945,3610000,94809169,91199169
685000.0,3,1.75,1480,7000,1.0,0,2,2,8,1480,0,1963,0.0,98122,47.6018,-122.291,1850,4000,5520,0.7885714285714286,2190400,49000000,46809600
465000.0,4,2.5,2090,12833,1.0,0,0,2,7,1220,870,1969,0.0,98034,47.7266,-122.175,1740,11200,10743,0.8371386269773241,4368100,164685889,160317789
560000.0,4,2.25,1950,9800,1.0,0,0,2,8,1330,620,1968,0.0,98033,47.666000000000004,-122.178,2170,9800,7850,0.8010204081632653,3802500,96040000,92237500
458500.0,3,1.75,1250,9605,1.0,0,0,2,7,1250,0,1964,0.0,98008,47.6325,-122.12100000000001,1570,9605,8355,0.8698594482040604,1562500,92256025,90693525
354000.0,3,1.0,990,7590,1.0,0,0,2,6,990,0,1959,0.0,98008,47.6228,-122.12100000000001,1100,7590,6600,0.8695652173913043,980100,57608100,56628000
441000.0,3,2.5,2740,7923,2.0,0,0,2,9,2740,0,1998,0.0,98058,47.4349,-122.105,2740,8815,5183,0.6541713997223274,7507600,62773929,55266329
194000.0,3,1.75,1260,10488,1.0,0,0,1,7,1110,150,1952,0.0,98106,47.5417,-122.35700000000001,1540,9120,9228,0.879862700228833,1587600,109998144,108410544
316500.0,4,2.5,2150,6807,2.0,0,0,3,8,2150,0,1991,0.0,98031,47.4053,-122.189,1910,7240,4657,0.6841486704862642,4622500,46335249,41712749
524950.0,3,1.75,1750,3250,1.5,0,0,3,7,1230,520,1929,0.0,98117,47.6807,-122.366,1480,3600,1500,0.46153846153846156,3062500,10562500,7500000
1050000.0,3,2.25,2880,6092,2.0,0,4,3,8,1920,960,1983,0.0,98116,47.5878,-122.381,2880,5308,3212,0.5272488509520683,8294400,37112464,28818064
925000.0,4,2.25,2590,13894,2.0,0,0,3,9,2590,0,1975,0.0,98005,47.6351,-122.165,2720,13894,11304,0.8135885993954225,6708100,193043236,186335136
780000.0,3,1.75,2430,4524,1.5,0,0,3,7,1830,600,1924,0.0,98103,47.674,-122.35,1610,4100,2094,0.46286472148541113,5904900,20466576,14561676
241000.0,2,2.0,1470,3128,2.0,0,0,2,6,1470,0,2005,0.0,98038,47.349,-122.021,1180,2576,1658,0.5300511508951407,2160900,9784384,7623484
519000.0,3,2.75,2020,10744,1.0,0,0,4,7,1270,750,1954,0.0,98166,47.4403,-122.34299999999999,2020,11069,8724,0.81198808637379,4080400,115433536,111353136
286000.0,2,1.0,610,4000,1.0,0,0,3,6,610,0,1918,0.0,98136,47.5469,-122.391,870,5160,3390,0.8475,372100,16000000,15627900
400000.0,3,2.0,3000,17800,1.0,0,0,2,8,1500,1500,1962,0.0,98125,47.7058,-122.315,2400,8300,14800,0.8314606741573034,9000000,316840000,307840000
255000.0,2,1.0,920,43560,1.0,0,0,3,5,920,0,1923,0.0,98024,47.5245,-121.931,1530,11875,42640,0.9788797061524335,846400,1897473600,1896627200
152000.0,3,1.75,1070,7754,1.0,0,0,2,6,1070,0,1953,0.0,98146,47.5079,-122.344,950,7740,6684,0.8620067062161465,1144900,60124516,58979616
599000.0,4,2.0,3410,15143,2.0,0,0,3,8,3410,0,1972,1987.0,98052,47.6709,-122.052,2350,25936,11733,0.7748134451561778,11628100,229310449,217682349
330000.0,4,2.5,1820,3905,2.0,0,0,2,7,1820,0,2001,0.0,98019,47.7346,-121.985,1820,3863,2085,0.5339308578745199,3312400,15249025,11936625
461000.0,2,1.0,1060,7193,1.0,0,0,2,7,1060,0,1926,0.0,98133,47.7102,-122.35600000000001,1980,7560,6133,0.8526345057694982,1123600,51739249,50615649
620000.0,5,2.5,3070,34991,2.0,0,0,2,9,3070,0,1995,0.0,98059,47.4721,-122.148,2150,19515,31921,0.9122631533822984,9424900,1224370081,1214945181
352500.0,4,2.5,2300,219106,1.0,0,0,3,7,1840,460,1958,0.0,98038,47.4044,-121.963,2120,123710,216806,0.9895027977326043,5290000,48007439236,48002149236
435000.0,3,2.0,1610,6911,1.0,0,0,2,7,1260,350,1988,0.0,98034,47.7188,-122.177,1630,6911,5301,0.7670380552742005,2592100,47761921,45169821
725000.0,5,2.75,2830,5310,2.0,0,0,2,9,2830,0,2006,0.0,98052,47.7074,-122.101,3150,6581,2480,0.4670433145009416,8008900,28196100,20187200
300000.0,3,1.0,970,12300,1.0,0,0,2,7,970,0,1982,0.0,98028,47.7335,-122.227,2040,9994,11330,0.9211382113821138,940900,151290000,150349100
252000.0,3,2.5,1680,8284,2.0,0,0,2,7,1680,0,1989,0.0,98038,47.3609,-122.04799999999999,1550,8284,6604,0.7971994205697731,2822400,68624656,65802256
464625.0,4,2.75,2040,8996,1.0,0,0,3,8,1260,780,1974,0.0,98033,47.666000000000004,-122.185,2470,9180,6956,0.7732325477990218,4161600,80928016,76766416
340000.0,3,1.0,1450,9586,2.0,0,0,2,7,1450,0,1950,0.0,98155,47.7443,-122.32600000000001,1500,8592,8136,0.8487377425412059,2102500,91891396,89788896
1330000.0,4,2.25,2870,6280,1.5,0,0,3,9,1980,890,1905,0.0,98112,47.6329,-122.31,2370,4760,3410,0.5429936305732485,8236900,39438400,31201500
455000.0,5,2.0,1870,13970,1.0,0,0,3,7,1120,0,1969,0.0,98027,47.5243,-122.042,1860,13970,12100,0.8661417322834646,3496900,195160900,191664000
495000.0,4,3.5,2490,18042,2.0,0,0,2,8,2490,0,2003,0.0,98070,47.4161,-122.441,1960,21107,15552,0.8619886930495511,6200100,325513764,319313664
925000.0,4,2.5,3350,4501,2.0,0,0,2,9,2640,710,2002,0.0,98117,47.688,-122.37899999999999,1000,4500,1151,0.25572095089980007,11222500,20259001,9036501
587000.0,4,2.75,3190,8737,2.0,0,0,2,9,3190,0,2006,0.0,98065,47.523,-121.87700000000001,3240,7131,5547,0.6348861165159666,10176100,76335169,66159069
524000.0,3,1.75,1560,5520,1.0,0,0,3,6,780,780,1944,0.0,98199,47.6515,-122.399,1470,6000,3960,0.717391304347826,2433600,30470400,28036800
1030000.0,4,2.5,2750,4800,2.0,0,0,2,9,1960,790,1905,2005.0,98103,47.6709,-122.337,2400,5300,2050,0.4270833333333333,7562500,23040000,15477500
176000.0,2,1.0,920,2332,1.0,0,0,3,8,920,0,1980,0.0,98198,47.3779,-122.32,1310,2853,1412,0.6054888507718696,846400,5438224,4591824
249900.0,2,1.0,1140,5500,1.0,0,0,2,6,1140,0,1947,0.0,98106,47.5187,-122.363,1110,5500,4360,0.7927272727272727,1299600,30250000,28950400
499500.0,3,2.5,2520,53143,1.5,0,0,2,7,2520,0,1988,0.0,98019,47.743,-121.925,2020,56628,50623,0.9525807726323317,6350400,2824178449,2817828049
600000.0,5,3.5,3150,10542,1.0,0,0,4,9,1620,1530,1974,0.0,98011,47.7469,-122.21700000000001,3150,11807,7392,0.701195219123506,9922500,111133764,101211264
294000.0,4,2.5,2040,7800,2.0,0,0,2,7,2040,0,2003,0.0,98168,47.473,-122.29299999999999,1860,10954,5760,0.7384615384615385,4161600,60840000,56678400
272000.0,4,2.0,1780,19843,1.0,0,0,2,7,1780,0,1963,0.0,98058,47.4414,-122.154,2210,13500,18063,0.9102958222043038,3168400,393744649,390576249
390000.0,3,2.5,2240,10800,2.0,0,0,2,8,2240,0,1996,0.0,98028,47.7433,-122.229,1900,9900,8560,0.7925925925925926,5017600,116640000,111622400
700000.0,4,2.5,3270,9650,1.0,0,3,3,9,2320,950,1971,0.0,98166,47.409,-122.333,2340,17357,6380,0.661139896373057,10692900,93122500,82429600
635000.0,5,2.75,3110,6621,2.0,0,0,2,9,3110,0,2006,0.0,98065,47.543,-121.88799999999999,3550,7953,3511,0.5302824346775411,9672100,43837641,34165541
920000.0,4,1.5,1850,3600,2.0,0,0,2,8,1660,190,1929,0.0,98112,47.6376,-122.307,1970,3600,1750,0.4861111111111111,3422500,12960000,9537500
500000.0,3,1.75,1570,8530,1.0,0,0,3,7,1190,380,1983,0.0,98033,47.6881,-122.184,1530,8708,6960,0.8159437280187574,2464900,72760900,70296000
263500.0,2,1.0,750,4515,1.0,0,0,2,6,750,0,1942,0.0,98106,47.5198,-122.351,1020,5000,3765,0.8338870431893688,562500,20385225,19822725
975000.0,4,2.25,2240,9990,2.0,0,0,3,10,2240,0,1967,0.0,98040,47.5516,-122.21700000000001,2600,11480,7750,0.7757757757757757,5017600,99800100,94782500
575000.0,3,2.5,1870,3485,2.0,0,0,2,8,1870,0,2001,0.0,98029,47.5493,-122.00399999999999,1940,3485,1615,0.4634146341463415,3496900,12145225,8648325
822000.0,4,2.5,2683,40386,2.0,0,0,3,9,2683,0,1987,0.0,98052,47.6982,-122.13799999999999,2683,34800,37703,0.9335660872579606,7198489,1631028996,1623830507
300000.0,3,1.0,1490,7200,1.0,0,0,2,7,1490,0,1954,0.0,98125,47.7276,-122.307,1280,7200,5710,0.7930555555555555,2220100,51840000,49619900
487600.0,4,2.5,2340,12080,2.0,0,0,2,8,2340,0,1999,0.0,98019,47.7325,-121.969,2200,12403,9740,0.8062913907284768,5475600,145926400,140450800
500000.0,4,2.0,1700,8640,1.0,0,0,2,7,850,850,1955,2010.0,98006,47.5774,-122.15299999999999,1620,9000,6940,0.8032407407407407,2890000,74649600,71759600
680000.0,2,2.0,1450,989,3.0,0,0,2,9,1450,0,2014,0.0,98109,47.6354,-122.346,1490,1240,-461,-0.4661274014155713,2102500,978121,-1124379
419000.0,3,2.5,3310,21096,2.0,0,2,2,9,3310,0,2004,0.0,98023,47.3049,-122.38600000000001,3310,13835,17786,0.8430982176715965,10956100,445041216,434085116
450000.0,4,1.75,1520,5250,1.0,0,0,2,6,1520,0,1949,0.0,98199,47.6581,-122.39,1530,5250,3730,0.7104761904761905,2310400,27562500,25252100
650000.0,5,1.75,1260,4500,1.5,0,0,2,7,1260,0,1926,0.0,98119,47.6452,-122.369,1410,4388,3240,0.72,1587600,20250000,18662400
550000.0,3,1.75,1840,8086,1.0,0,0,3,8,1840,0,1964,0.0,98052,47.67,-122.155,1840,8060,6246,0.7724462033143705,3385600,65383396,61997796
330000.0,4,2.0,1750,5202,1.0,0,1,3,6,1070,680,1942,0.0,98108,47.5677,-122.31700000000001,2090,5400,3452,0.6635909265667052,3062500,27060804,23998304
282510.0,4,1.0,1450,32234,1.5,0,0,3,6,1450,0,1932,0.0,98030,47.3818,-122.21,1530,10125,30784,0.9550164422659304,2102500,1039030756,1036928256
2390000.0,4,4.0,6330,13296,2.0,0,2,2,13,4900,1430,2000,0.0,98033,47.6488,-122.20100000000001,2200,9196,6966,0.5239169675090253,40068900,176783616,136714716
230000.0,2,2.0,1260,10200,1.0,0,0,2,7,1020,240,1983,0.0,98003,47.2593,-122.31200000000001,1560,10200,8940,0.8764705882352941,1587600,104040000,102452400
750000.0,4,1.75,2100,6613,2.0,0,0,2,8,2100,0,1909,2004.0,98116,47.567,-122.385,1630,5750,4513,0.682443671556026,4410000,43731769,39321769
321000.0,4,2.5,2430,5366,2.0,0,0,2,8,2430,0,2002,0.0,98092,47.3352,-122.19,2100,5414,2936,0.5471487141259784,5904900,28793956,22889056
2200000.0,4,3.25,4250,18000,2.0,0,3,4,10,3350,900,1980,0.0,98040,47.5612,-122.229,3790,14537,13750,0.7638888888888888,18062500,324000000,305937500
245000.0,4,2.0,1830,10416,1.0,0,0,2,7,1370,460,1958,0.0,98146,47.4878,-122.34100000000001,1830,9271,8586,0.8243087557603687,3348900,108493056,105144156
510000.0,2,1.0,1310,4000,1.0,0,0,2,6,1310,0,1913,0.0,98103,47.6854,-122.329,1550,4000,2690,0.6725,1716100,16000000,14283900
751000.0,4,3.25,3090,9571,2.0,0,0,2,9,2370,720,2004,0.0,98052,47.7058,-122.131,3630,9110,6481,0.6771497231219308,9548100,91604041,82055941
675000.0,4,2.5,2560,36601,2.0,0,0,3,9,2560,0,1987,0.0,98075,47.5851,-121.992,2790,36601,34041,0.9300565558318079,6553600,1339633201,1333079601
295000.0,3,1.75,1930,13350,1.0,0,0,2,8,1930,0,1967,0.0,98023,47.3317,-122.365,2270,13350,11420,0.8554307116104869,3724900,178222500,174497600
312000.0,2,1.0,1460,6000,1.0,0,0,1,7,1260,200,1925,0.0,98115,47.7009,-122.31700000000001,1580,6380,4540,0.7566666666666667,2131600,36000000,33868400
730000.0,3,3.0,3460,13129,2.0,0,0,2,9,2560,900,1988,0.0,98077,47.7315,-122.05799999999999,3460,12568,9669,0.7364612689466068,11971600,172370641,160399041
762500.0,5,3.5,3290,5880,2.0,0,0,2,9,2670,620,2005,0.0,98052,47.7067,-122.119,3090,5680,2590,0.44047619047619047,10824100,34574400,23750300
150000.0,3,1.0,820,7680,1.5,0,0,2,6,820,0,1910,0.0,98106,47.528,-122.359,1470,6912,6860,0.8932291666666666,672400,58982400,58310000
270000.0,3,1.0,1480,7374,1.0,0,0,2,6,760,720,1954,0.0,98133,47.7775,-122.336,1480,8934,5894,0.7992948196365609,2190400,54375876,52185476
400000.0,4,2.0,1420,9301,1.0,0,0,3,7,1420,0,1963,0.0,98008,47.6325,-122.12100000000001,1530,8075,7881,0.8473282442748091,2016400,86508601,84492201
650000.0,3,2.5,2790,6720,2.0,0,0,2,8,2790,0,2002,0.0,98075,47.5958,-122.038,2620,6720,3930,0.5848214285714286,7784100,45158400,37374300
530000.0,2,1.5,1390,5000,1.0,0,0,3,8,970,420,1954,0.0,98116,47.5673,-122.40100000000001,1610,5000,3610,0.722,1932100,25000000,23067900
248000.0,3,1.0,950,9400,1.0,0,0,3,7,950,0,1954,0.0,98006,47.5746,-122.13600000000001,1260,9400,8450,0.898936170212766,902500,88360000,87457500
760000.0,4,3.5,3000,5300,1.0,0,0,4,7,1780,1220,1949,0.0,98115,47.6748,-122.279,1360,5450,2300,0.4339622641509434,9000000,28090000,19090000
199000.0,4,1.0,1280,10521,1.5,0,0,2,7,1280,0,1960,0.0,98198,47.4215,-122.289,1540,9384,9241,0.8783385609732915,1638400,110691441,109053041
240000.0,2,1.0,870,8400,1.0,0,0,2,7,870,0,1960,0.0,98188,47.4493,-122.28200000000001,1070,12465,7530,0.8964285714285715,756900,70560000,69803100
415000.0,3,1.5,1360,1795,2.0,0,0,2,7,1360,0,1945,0.0,98199,47.6471,-122.397,1580,1795,435,0.24233983286908078,1849600,3222025,1372425
228000.0,3,1.0,1000,16376,1.0,0,0,2,7,1000,0,1959,0.0,98059,47.4825,-122.10799999999999,1420,16192,15376,0.9389350268685882,1000000,268173376,267173376
525000.0,4,2.5,2740,12106,1.0,0,0,2,8,1980,760,1992,0.0,98133,47.7648,-122.355,2170,11156,9366,0.7736659507682141,7507600,146555236,139047636
399950.0,3,1.75,1560,5223,1.0,0,0,3,7,810,750,1940,0.0,98125,47.7175,-122.288,1440,8491,3663,0.7013210798391729,2433600,27279729,24846129
781000.0,4,2.5,2590,8571,2.0,0,0,2,9,2590,0,1988,0.0,98052,47.691,-122.105,2360,8155,5981,0.6978182242445455,6708100,73462041,66753941
827000.0,3,2.5,1850,1330,2.5,0,0,2,9,1560,290,2004,0.0,98115,47.6831,-122.325,1810,2071,-520,-0.39097744360902253,3422500,1768900,-1653600
525000.0,5,2.25,2500,8621,1.5,0,0,3,7,2500,0,1968,0.0,98034,47.7379,-122.185,1980,7395,6121,0.7100104396241735,6250000,74321641,68071641
671300.0,4,2.5,3280,5232,2.0,0,0,2,7,3280,0,2004,0.0,98053,47.6798,-122.03299999999999,2600,5080,1952,0.3730886850152905,10758400,27373824,16615424
175000.0,2,1.0,670,2378,1.0,0,0,2,5,670,0,1919,0.0,98126,47.5769,-122.37200000000001,700,2970,1708,0.7182506307821699,448900,5654884,5205984
1100000.0,5,2.75,2890,22547,1.0,0,0,3,10,2150,740,1963,0.0,98040,47.5476,-122.219,3010,17809,19657,0.8718233024349137,8352100,508367209,500015109
800000.0,5,2.5,3000,10560,1.0,0,0,2,8,1500,1500,1966,0.0,98004,47.6249,-122.206,2690,11616,7560,0.7159090909090909,9000000,111513600,102513600
329950.0,4,2.5,1920,4600,2.0,0,0,2,7,1920,0,2002,0.0,98038,47.3795,-122.023,2200,6600,2680,0.5826086956521739,3686400,21160000,17473600
445000.0,4,3.25,1960,7200,2.0,0,0,2,7,1960,0,1979,0.0,98034,47.7291,-122.21799999999999,1980,7529,5240,0.7277777777777777,3841600,51840000,47998400
237000.0,3,1.75,2000,12208,1.0,0,0,2,7,1140,860,1979,0.0,98032,47.3752,-122.236,1060,8194,10208,0.836173001310616,4000000,149035264,145035264
1110000.0,6,4.0,3600,6224,2.0,0,0,2,9,2610,990,1945,2006.0,98199,47.6531,-122.405,1430,6224,2624,0.42159383033419023,12960000,38738176,25778176
438900.0,4,2.5,2740,5700,2.0,0,0,2,9,2740,0,2006,0.0,98038,47.3535,-122.02600000000001,3010,5281,2960,0.519298245614035,7507600,32490000,24982400
1280000.0,9,4.5,3650,5000,2.0,0,0,2,8,2530,1120,1915,2010.0,98105,47.6604,-122.289,2510,5000,1350,0.27,13322500,25000000,11677500
600000.0,4,2.5,2310,3866,2.0,0,0,2,8,2310,0,2005,0.0,98029,47.5498,-121.99600000000001,1950,4023,1556,0.4024831867563373,5336100,14945956,9609856
670000.0,4,2.5,2095,4569,2.0,0,0,2,9,2095,0,2002,0.0,98052,47.6603,-122.087,2095,4385,2474,0.5414751586780477,4389025,20875761,16486736
519000.0,2,2.0,1560,4823,1.0,0,0,2,8,1560,0,2004,0.0,98053,47.7111,-122.03200000000001,1855,4989,3263,0.6765498652291105,2433600,23261329,20827729
320000.0,3,2.25,1880,7350,1.0,0,0,2,8,1390,490,1984,0.0,98058,47.4457,-122.12299999999999,1910,8400,5470,0.7442176870748299,3534400,54022500,50488100
270000.0,2,1.5,840,867,2.0,0,0,2,7,840,0,2005,0.0,98115,47.6955,-122.304,840,1322,27,0.031141868512110725,705600,751689,46089
1000000.0,3,2.5,2730,5832,2.0,0,0,2,9,2730,0,1998,0.0,98005,47.6216,-122.161,2360,5832,3102,0.5318930041152263,7452900,34012224,26559324
330000.0,1,1.0,860,4800,1.0,0,0,2,6,860,0,1907,0.0,98122,47.6146,-122.29899999999999,1380,4800,3940,0.8208333333333333,739600,23040000,22300400
657500.0,3,2.0,2320,10960,1.0,0,0,2,7,1510,810,1956,0.0,98005,47.6157,-122.17399999999999,2160,10960,8640,0.7883211678832117,5382400,120121600,114739200
450000.0,3,1.75,1540,61419,1.0,0,0,2,7,1540,0,1967,0.0,98028,47.7663,-122.228,3790,8529,59879,0.9749263257298231,2371600,3772293561,3769921961
150000.0,3,1.0,890,6488,1.5,0,0,2,5,890,0,1928,0.0,98014,47.7087,-121.352,1330,16250,5598,0.8628236744759556,792100,42094144,41302044
792500.0,4,2.5,4290,175421,2.0,0,0,2,10,4290,0,2004,0.0,98010,47.3585,-121.988,3370,63162,171131,0.9755445471180759,18404100,30772527241,30754123141
540000.0,3,2.5,1950,13227,2.0,0,0,3,9,1950,0,1978,0.0,98034,47.7217,-122.256,2650,12943,11277,0.8525742798820595,3802500,174953529,171151029
229900.0,3,1.0,1010,8848,1.0,0,0,3,7,1010,0,1968,0.0,98003,47.2742,-122.29899999999999,1380,10650,7838,0.8858499095840868,1020100,78287104,77267004
533000.0,4,2.5,2830,6536,2.0,0,0,2,8,2830,0,2003,0.0,98038,47.3888,-122.03200000000001,2830,6872,3706,0.5670134638922889,8008900,42719296,34710396
239000.0,4,1.75,1500,12560,1.0,0,0,3,7,1000,500,1977,0.0,98002,47.2918,-122.197,1700,9020,11060,0.8805732484076433,2250000,157753600,155503600
713900.0,3,2.5,3370,167706,1.0,0,0,2,10,3370,0,2000,0.0,98038,47.4379,-122.022,3350,213444,164336,0.9799053104838229,11356900,28125302436,28113945536
427500.0,4,2.5,3160,8726,2.0,0,0,2,9,3160,0,1999,0.0,98092,47.2582,-122.223,2500,8648,5566,0.6378638551455421,9985600,76143076,66157476
302000.0,3,1.0,1110,7000,1.5,0,0,3,7,1110,0,1955,0.0,98133,47.754,-122.34100000000001,1800,7000,5890,0.8414285714285714,1232100,49000000,47767900
1150000.0,3,2.5,3830,48743,2.0,0,0,2,11,3830,0,1991,0.0,98006,47.5663,-122.125,2950,8299,44913,0.9214246148164865,14668900,2375880049,2361211149
555000.0,3,2.5,3160,4270,2.0,0,0,2,8,2650,510,2006,0.0,98011,47.7453,-122.194,2720,12523,1110,0.25995316159250587,9985600,18232900,8247300
495000.0,3,2.25,2100,3000,2.0,0,0,2,7,2100,0,1996,0.0,98144,47.595,-122.306,1650,4500,900,0.3,4410000,9000000,4590000
495000.0,3,1.5,2240,13288,1.0,0,0,2,7,2240,0,1953,0.0,98033,47.6762,-122.17,2150,9900,11048,0.831426851294401,5017600,176570944,171553344
340000.0,2,0.75,1060,48292,1.0,1,2,4,6,560,500,1947,0.0,98070,47.4285,-122.51100000000001,750,80201,47232,0.9780501946492173,1123600,2332117264,2330993664
464950.0,4,2.25,2350,36116,1.0,0,0,3,9,2350,0,1983,0.0,98042,47.3533,-122.08200000000001,2580,36116,33766,0.9349318861446451,5522500,1304365456,1298842956
320000.0,4,2.5,1940,7040,2.0,0,0,2,8,1940,0,1998,0.0,98092,47.2632,-122.209,2400,7145,5100,0.7244318181818182,3763600,49561600,45798000
440000.0,1,1.0,1160,64469,1.0,0,0,2,7,1160,0,2009,0.0,98072,47.7433,-122.08200000000001,1580,48352,63309,0.982006856008314,1345600,4156251961,4154906361
686000.0,3,1.5,1840,9990,2.0,0,0,4,8,1840,0,1961,0.0,98177,47.7145,-122.369,2100,12474,8150,0.8158158158158159,3385600,99800100,96414500
555000.0,4,1.75,2260,11000,1.0,0,0,2,8,1620,640,1976,0.0,98008,47.6224,-122.109,1960,10000,8740,0.7945454545454546,5107600,121000000,115892400
361500.0,2,1.0,840,3860,1.0,0,0,3,6,840,0,1909,0.0,98117,47.6842,-122.365,1390,3860,3020,0.7823834196891192,705600,14899600,14194000
1240000.0,5,3.0,2830,7500,2.0,0,0,2,9,2460,370,1923,0.0,98105,47.6579,-122.277,2900,5000,4670,0.6226666666666667,8008900,56250000,48241100
154950.0,4,1.0,1600,10183,1.0,0,0,3,6,1600,0,1966,0.0,98002,47.277,-122.211,1410,10416,8583,0.8428753805361877,2560000,103693489,101133489
247200.0,3,1.75,1370,8719,1.0,0,0,2,7,1370,0,1982,0.0,98042,47.3664,-122.087,1370,7525,7349,0.8428718889780938,1876900,76020961,74144061
250000.0,3,2.25,1960,7414,1.0,0,0,2,7,1490,470,1984,0.0,98023,47.2977,-122.374,1580,8038,5454,0.7356352845967089,3841600,54967396,51125796
590300.0,3,1.5,1470,7200,2.0,0,0,3,7,1470,0,1907,0.0,98118,47.5602,-122.28,1530,7200,5730,0.7958333333333333,2160900,51840000,49679100
541125.0,5,2.75,2740,8426,1.0,0,0,3,8,1370,1370,1960,0.0,98006,47.5563,-122.184,2020,8783,5686,0.6748160455732257,7507600,70997476,63489876
310000.0,2,2.5,1090,923,2.0,0,0,2,7,1090,0,2004,0.0,98027,47.5347,-122.071,1410,1326,-167,-0.180931744312026,1188100,851929,-336171
704111.0,4,2.75,2460,9520,1.0,0,1,2,8,1680,780,1976,0.0,98034,47.7021,-122.23299999999999,2380,9600,7060,0.7415966386554622,6051600,90630400,84578800
277500.0,3,2.25,1820,19602,1.0,0,0,3,7,1820,0,1964,0.0,98001,47.331,-122.286,1520,8773,17782,0.9071523313947556,3312400,384238404,380926004
325000.0,4,2.75,1960,8937,1.0,0,0,4,7,980,980,1954,0.0,98188,47.451,-122.27799999999999,1480,10016,6977,0.7806870314423184,3841600,79869969,76028369
289200.0,3,2.25,1760,7023,2.0,0,0,2,7,1760,0,1995,0.0,98019,47.7468,-121.98,1760,7082,5263,0.7493948455076178,3097600,49322529,46224929
185000.0,1,1.0,720,5000,1.0,0,0,3,6,720,0,1908,0.0,98118,47.5289,-122.272,1170,5000,4280,0.856,518400,25000000,24481600
1450000.0,4,3.5,3470,8580,2.0,0,0,2,11,2500,970,2007,0.0,98199,47.6433,-122.40299999999999,1940,7920,5110,0.5955710955710956,12040900,73616400,61575500
420550.0,4,2.0,1370,8100,1.0,0,0,1,7,1370,0,1947,0.0,98155,47.748999999999995,-122.31200000000001,1280,8100,6730,0.8308641975308642,1876900,65610000,63733100
603000.0,4,2.25,2370,11310,1.0,0,0,2,8,1550,820,1968,0.0,98155,47.7684,-122.289,1890,8621,8940,0.7904509283819628,5616900,127916100,122299200
345000.0,3,1.0,1390,2640,1.5,0,0,2,7,1230,160,1903,0.0,98122,47.6078,-122.307,1780,3920,1250,0.4734848484848485,1932100,6969600,5037500
650000.0,3,2.0,1840,3075,1.0,0,0,4,7,920,920,1928,0.0,98103,47.6894,-122.35,1480,3774,1235,0.4016260162601626,3385600,9455625,6070025
589950.0,5,3.0,2790,19439,1.0,0,3,4,7,1500,1290,1973,0.0,98058,47.4088,-122.089,1620,19439,16649,0.8564740984618551,7784100,377874721,370090621
309950.0,2,2.25,1460,1607,2.0,0,0,2,8,1460,0,2007,0.0,98106,47.5395,-122.369,1460,1826,147,0.09147479775980087,2131600,2582449,450849
775000.0,3,2.5,2620,241200,1.5,0,0,3,9,2620,0,1998,0.0,98027,47.4574,-122.01,2620,172933,238580,0.9891376451077943,6864400,58177440000,58170575600
590000.0,4,1.5,2230,5109,1.5,0,0,2,7,1330,900,1918,0.0,98115,47.6996,-122.31,1630,5109,2879,0.5635153650420825,4972900,26101881,21128981
863500.0,4,3.0,3250,2760,2.5,0,0,2,8,2420,830,1905,2007.0,98122,47.6104,-122.303,1260,2780,-490,-0.17753623188405798,10562500,7617600,-2944900
517500.0,3,1.0,1190,7000,1.0,0,0,2,7,1190,0,1943,0.0,98199,47.6453,-122.40299999999999,1350,7000,5810,0.83,1416100,49000000,47583900
700000.0,3,3.0,2090,7440,1.5,0,0,4,7,1290,800,1922,0.0,98103,47.6891,-122.331,1570,4960,5350,0.7190860215053764,4368100,55353600,50985500
699000.0,3,2.5,2580,8154,1.0,0,0,2,10,2090,490,1956,1997.0,98177,47.7259,-122.361,1660,8155,5574,0.6835908756438558,6656400,66487716,59831316
350000.0,3,2.5,2100,3574,2.0,0,0,2,7,1690,410,2005,0.0,98019,47.7453,-121.984,1970,2962,1474,0.4124230554001119,4410000,12773476,8363476
795000.0,4,2.5,3160,16564,2.0,0,0,2,10,3160,0,1987,0.0,98074,47.6365,-122.04,3160,12415,13404,0.8092248249215166,9985600,274366096,264380496
543000.0,3,2.5,2090,7640,1.0,0,0,2,7,1360,730,1962,2014.0,98133,47.7369,-122.338,2090,7668,5550,0.7264397905759162,4368100,58369600,54001500
325000.0,3,2.5,1570,3143,2.0,0,0,2,7,1570,0,2001,0.0,98019,47.7364,-121.969,1740,3591,1573,0.500477251034044,2464900,9878449,7413549
337500.0,3,1.0,1020,6000,1.5,0,0,2,7,1020,0,1900,0.0,98108,47.5254,-122.318,1240,6000,4980,0.83,1040400,36000000,34959600
425000.0,2,1.0,1300,11080,1.0,0,0,3,7,1300,0,1955,0.0,98034,47.7281,-122.23299999999999,1600,9259,9780,0.8826714801444043,1690000,122766400,121076400
780000.0,3,2.5,2110,9773,1.0,0,0,2,9,2110,0,1986,0.0,98006,47.5628,-122.115,2560,11787,7663,0.7840990483986493,4452100,95511529,91059429
259000.0,2,1.0,1210,17389,1.0,0,0,3,5,1210,0,1948,0.0,98059,47.5044,-122.148,2140,14419,16179,0.930415780090862,1464100,302377321,300913221
524400.0,4,1.75,1990,12950,1.0,0,0,3,8,1850,140,1968,0.0,98006,47.5434,-122.166,2090,12850,10960,0.8463320463320463,3960100,167702500,163742400
260000.0,3,2.0,1630,8018,1.0,0,0,2,7,1630,0,2003,0.0,98001,47.2638,-122.243,1610,8397,6388,0.7967074083312546,2656900,64288324,61631424
273000.0,2,2.0,1384,1822,2.0,0,0,2,7,1384,0,1990,0.0,98028,47.7525,-122.244,1078,1315,438,0.24039517014270034,1915456,3319684,1404228
639900.0,4,2.5,3380,75794,2.0,0,0,2,10,3380,0,1997,0.0,98001,47.3511,-122.266,3710,17913,72414,0.9554054410639364,11424400,5744730436,5733306036
420000.0,4,2.5,2480,8626,2.0,0,0,2,10,2480,0,2001,0.0,98001,47.3185,-122.262,2990,9033,6146,0.7124971017853002,6150400,74407876,68257476
510500.0,3,1.0,1270,8000,1.0,0,0,3,7,1270,0,1957,0.0,98007,47.5874,-122.13600000000001,1470,8000,6730,0.84125,1612900,64000000,62387100
290000.0,4,1.0,1010,7200,1.5,0,0,2,6,1010,0,1947,0.0,98155,47.742,-122.325,1360,7200,6190,0.8597222222222223,1020100,51840000,50819900
226000.0,3,1.75,1490,6269,1.0,0,0,3,6,990,500,1944,0.0,98056,47.4917,-122.18799999999999,1490,7722,4779,0.7623225394799809,2220100,39300361,37080261
300000.0,2,1.0,820,3844,1.0,0,0,3,6,820,0,1916,0.0,98133,47.7049,-122.34899999999999,1520,3844,3024,0.7866805411030177,672400,14776336,14103936
407450.0,3,2.0,1810,10860,1.0,0,0,2,7,1810,0,1967,0.0,98053,47.6393,-121.96700000000001,1420,11982,9050,0.8333333333333334,3276100,117939600,114663500
390000.0,4,2.25,3060,7920,1.0,0,0,2,7,1530,1530,1965,0.0,98178,47.4879,-122.245,1850,7800,4860,0.6136363636363636,9363600,62726400,53362800
1060000.0,6,2.75,2980,20000,1.0,0,4,2,8,2130,850,1965,0.0,98177,47.7599,-122.375,2730,20000,17020,0.851,8880400,400000000,391119600
610000.0,3,2.5,3440,18167,2.0,0,0,2,11,3440,0,1991,0.0,98023,47.2909,-122.34200000000001,3990,20239,14727,0.8106456762261243,11833600,330039889,318206289
239975.0,3,2.5,1820,7242,1.0,0,0,2,7,1220,600,1959,0.0,98188,47.4318,-122.292,1350,8214,5422,0.7486882076774372,3312400,52446564,49134164
375000.0,3,2.5,2320,5760,1.0,0,0,2,7,1480,840,1987,0.0,98178,47.504,-122.24799999999999,1660,5762,3440,0.5972222222222222,5382400,33177600,27795200
742500.0,4,2.5,2620,4400,2.0,0,0,2,9,2620,0,2004,0.0,98029,47.5524,-121.991,2640,4554,1780,0.40454545454545454,6864400,19360000,12495600
450000.0,4,1.75,2190,11625,1.0,0,0,3,8,2020,170,1956,0.0,98146,47.4979,-122.363,1920,8855,9435,0.8116129032258065,4796100,135140625,130344525
300000.0,3,2.25,1780,10395,1.0,0,0,2,8,1780,0,1967,0.0,98058,47.4539,-122.15,2080,9360,8615,0.8287638287638288,3168400,108056025,104887625
216600.0,3,1.75,2200,7700,1.0,0,0,2,7,1240,960,1975,0.0,98031,47.4119,-122.181,1770,7360,5500,0.7142857142857143,4840000,59290000,54450000
525000.0,3,1.75,1600,6120,1.5,0,0,2,7,1600,0,1924,0.0,98115,47.6847,-122.291,1670,4590,4520,0.738562091503268,2560000,37454400,34894400
455000.0,4,2.25,2450,21000,1.0,0,2,3,8,1650,800,1954,0.0,98166,47.4559,-122.344,1820,12480,18550,0.8833333333333333,6002500,441000000,434997500
390000.0,4,2.25,2680,35218,2.0,0,0,2,8,2680,0,1986,0.0,98027,47.4613,-121.99700000000001,2980,35218,32538,0.923902549832472,7182400,1240307524,1233125124
450000.0,3,1.75,1850,8667,1.0,0,0,3,7,880,970,1982,0.0,98033,47.7025,-122.198,1450,10530,6817,0.7865466712818737,3422500,75116889,71694389
382000.0,4,1.0,1740,4400,1.5,0,0,2,7,1740,0,1924,0.0,98122,47.6058,-122.3,1590,4400,2660,0.6045454545454545,3027600,19360000,16332400
287000.0,3,2.25,1490,9600,1.0,0,0,3,7,1170,320,1987,0.0,98019,47.7378,-121.977,1590,10104,8110,0.8447916666666667,2220100,92160000,89939900
460000.0,4,2.0,1960,190357,1.0,0,3,1,8,1960,0,1971,0.0,98027,47.5538,-121.958,2560,189100,188397,0.9897035570007933,3841600,36235787449,36231945849
435000.0,3,2.25,1380,3015,2.0,0,0,2,7,1380,0,2009,0.0,98052,47.6783,-122.15700000000001,1930,3612,1635,0.5422885572139303,1904400,9090225,7185825
575000.0,2,1.0,1510,4032,1.5,0,0,2,8,1310,200,1935,0.0,98199,47.6371,-122.39299999999999,1700,4042,2522,0.6254960317460317,2280100,16257024,13976924
626700.0,3,1.5,1410,3600,1.0,0,0,2,7,1410,0,1906,0.0,98109,47.6402,-122.35700000000001,1370,3600,2190,0.6083333333333333,1988100,12960000,10971900
352000.0,4,1.5,1440,8680,1.5,0,0,2,7,1440,0,1922,0.0,98178,47.501999999999995,-122.228,1440,9000,7240,0.8341013824884793,2073600,75342400,73268800
650000.0,3,1.0,920,6750,1.0,0,0,3,7,920,0,1951,0.0,98004,47.6322,-122.212,1460,8933,5830,0.8637037037037038,846400,45562500,44716100
197000.0,3,1.0,1090,17630,1.0,0,0,3,7,1090,0,1962,0.0,98002,47.288000000000004,-122.196,1300,12000,16540,0.9381735677821894,1188100,310816900,309628800
340000.0,8,2.75,2790,6695,1.0,0,0,2,7,1470,1320,1977,0.0,98133,47.7565,-122.331,1760,7624,3905,0.5832710978342046,7784100,44823025,37038925
560000.0,3,2.0,1840,14985,1.0,0,0,2,7,1840,0,1968,0.0,98033,47.6916,-122.15799999999999,2300,16067,13145,0.8772105438772105,3385600,224550225,221164625
354000.0,3,1.75,1340,6300,1.0,0,0,2,7,1340,0,1972,0.0,98034,47.7186,-122.21799999999999,1780,7200,4960,0.7873015873015873,1795600,39690000,37894400
670000.0,4,2.5,2570,9086,2.0,0,0,2,9,2570,0,1999,0.0,98074,47.6373,-122.064,2760,6733,6516,0.7171472595201409,6604900,82555396,75950496
769000.0,4,3.5,3010,6202,2.0,0,0,2,9,3010,0,2005,0.0,98029,47.5533,-121.993,2520,5001,3192,0.5146726862302483,9060100,38464804,29404704
650000.0,4,2.5,2160,3139,1.0,0,0,2,7,1080,1080,1940,0.0,98103,47.6662,-122.338,1650,3740,979,0.31188276521185093,4665600,9853321,5187721
650000.0,3,1.75,2140,9484,1.0,0,0,2,7,1290,850,1953,0.0,98004,47.6234,-122.191,1960,9630,7344,0.7743568114719528,4579600,89946256,85366656
289950.0,4,1.75,2090,7416,1.0,0,0,3,7,1050,1040,1970,0.0,98031,47.4107,-122.179,1710,7527,5326,0.7181769147788565,4368100,54997056,50628956
300000.0,3,1.75,1810,21138,1.0,0,0,3,7,1240,570,1977,0.0,98058,47.4674,-122.178,1850,12200,19328,0.9143722206452833,3276100,446815044,443538944
471000.0,4,1.75,1760,5750,1.0,0,2,4,7,1070,690,1962,0.0,98126,47.5521,-122.37299999999999,1860,5750,3990,0.6939130434782609,3097600,33062500,29964900
639000.0,4,2.5,2500,8540,2.0,0,0,2,9,2500,0,1990,0.0,98029,47.5759,-121.994,2560,8475,6040,0.7072599531615925,6250000,72931600,66681600
287000.0,2,1.0,930,6900,1.0,0,2,2,7,930,0,1952,0.0,98178,47.506,-122.242,1910,7194,5970,0.8652173913043478,864900,47610000,46745100
740000.0,4,2.5,3030,8335,2.0,0,0,2,10,3030,0,1992,0.0,98075,47.578,-122.056,2850,8678,5305,0.6364727054589082,9180900,69472225,60291325
499922.0,3,2.0,1460,3000,1.0,0,0,3,7,940,520,1990,0.0,98117,47.681999999999995,-122.365,1460,3000,1540,0.5133333333333333,2131600,9000000,6868400
675000.0,4,2.5,2940,14071,2.0,0,0,2,9,2940,0,1986,0.0,98029,47.5627,-122.01799999999999,2670,10982,11131,0.791059626181508,8643600,197993041,189349441
738515.0,5,2.75,3360,9200,2.0,0,0,2,9,3360,0,2014,0.0,98011,47.7754,-122.17299999999999,3360,9713,5840,0.6347826086956522,11289600,84640000,73350400
445000.0,3,1.75,2110,4800,1.0,0,0,2,8,1210,900,1956,0.0,98108,47.567,-122.318,1660,4800,2690,0.5604166666666667,4452100,23040000,18587900
1040000.0,4,2.25,2740,11343,1.0,0,2,4,10,1980,760,1953,0.0,98125,47.7117,-122.27799999999999,2790,10027,8603,0.758441329454289,7507600,128663649,121156049
346000.0,2,1.0,1070,2196,1.0,0,0,3,7,880,190,1917,0.0,98144,47.5726,-122.30799999999999,1160,3600,1126,0.5127504553734062,1144900,4822416,3677516
450000.0,3,2.0,1680,4886,2.0,0,0,2,7,1180,500,1940,0.0,98118,47.5536,-122.286,1400,4900,3206,0.6561604584527221,2822400,23872996,21050596
350000.0,4,2.5,2260,13755,1.0,0,0,3,9,2260,0,1975,0.0,98042,47.3767,-122.161,2650,13650,11495,0.8356961105052708,5107600,189200025,184092425
2400000.0,4,3.5,5860,7200,2.0,0,0,4,10,3690,2170,1907,0.0,98112,47.6287,-122.287,4150,7200,1340,0.18611111111111112,34339600,51840000,17500400
594950.0,4,2.25,2380,35008,1.0,0,0,2,8,2380,0,1977,0.0,98075,47.5834,-122.001,2250,34794,32628,0.9320155393053017,5664400,1225560064,1219895664
1700000.0,5,3.0,3320,5354,2.0,0,0,2,9,3320,0,2004,0.0,98103,47.6542,-122.331,2330,4040,2034,0.3799028763541277,11022400,28665316,17642916
219000.0,2,1.0,1050,9000,1.5,0,0,3,7,1050,0,1984,0.0,98003,47.2887,-122.29899999999999,1550,9600,7950,0.8833333333333333,1102500,81000000,79897500
450000.0,4,2.5,2070,3982,2.0,0,0,2,7,2070,0,2004,0.0,98065,47.53100000000001,-121.854,2340,4067,1912,0.4801607232546459,4284900,15856324,11571424
402000.0,4,2.25,1790,7311,2.0,0,0,2,7,1790,0,1992,0.0,98056,47.5055,-122.189,1400,7203,5521,0.7551634523321024,3204100,53450721,50246621
275000.0,2,1.0,840,4000,1.0,0,0,2,6,840,0,1942,0.0,98108,47.5531,-122.307,1100,4000,3160,0.79,705600,16000000,15294400
421500.0,3,1.5,990,4500,1.0,0,0,4,7,990,0,1948,0.0,98122,47.6051,-122.29799999999999,1490,4000,3510,0.78,980100,20250000,19269900
560000.0,3,3.0,4120,60392,2.0,0,2,2,9,3180,940,1994,0.0,98014,47.6804,-121.913,2770,64033,56272,0.9317790435819314,16974400,3647193664,3630219264
314000.0,3,1.75,1620,9600,1.0,0,0,3,7,1620,0,1966,0.0,98059,47.4749,-122.155,1660,10200,7980,0.83125,2624400,92160000,89535600
287000.0,4,2.0,1340,8190,1.0,0,0,3,7,1340,0,1942,0.0,98146,47.4905,-122.34299999999999,1410,9721,6850,0.8363858363858364,1795600,67076100,65280500
277000.0,4,1.0,1500,5750,1.5,0,0,2,6,1500,0,1925,0.0,98055,47.4768,-122.206,1330,5750,4250,0.7391304347826086,2250000,33062500,30812500
337500.0,2,1.0,1300,6731,1.0,0,0,2,7,1300,0,1950,0.0,98116,47.5697,-122.395,1240,6731,5431,0.8068637646709256,1690000,45306361,43616361
792000.0,4,2.75,3100,10245,2.0,0,0,2,10,3100,0,1999,0.0,98052,47.6858,-122.10700000000001,3140,9028,7145,0.6974133723767691,9610000,104960025,95350025
435000.0,3,2.5,3380,7074,2.0,0,0,2,8,2200,1180,1999,0.0,98019,47.7462,-121.978,2060,6548,3694,0.5221939496748657,11424400,50041476,38617076
313100.0,4,2.5,2660,9030,1.0,0,0,3,7,1450,1210,1977,0.0,98055,47.4558,-122.212,1870,9030,6370,0.7054263565891473,7075600,81540900,74465300
575000.0,3,2.25,1700,3333,1.5,0,0,2,7,1100,600,1924,0.0,98117,47.6784,-122.361,1700,3750,1633,0.48994899489948995,2890000,11108889,8218889
510000.0,4,2.5,1840,7800,1.0,0,2,2,8,1240,600,1972,0.0,98177,47.7762,-122.384,2010,9100,5960,0.764102564102564,3385600,60840000,57454400
299950.0,2,1.0,890,5200,1.0,0,0,3,6,890,0,1941,0.0,98126,47.5311,-122.37299999999999,950,5200,4310,0.8288461538461539,792100,27040000,26247900
1030000.0,3,3.0,2800,5800,1.0,0,0,2,9,1580,1220,1953,2010.0,98199,47.6493,-122.413,2580,5800,3000,0.5172413793103449,7840000,33640000,25800000
364000.0,4,1.75,2010,8625,1.0,0,0,3,7,1340,670,1957,0.0,98133,47.7496,-122.355,1500,8400,6615,0.7669565217391304,4040100,74390625,70350525
335000.0,3,1.0,1380,7470,1.0,0,0,4,7,1380,0,1965,0.0,98133,47.7479,-122.34299999999999,1440,7473,6090,0.8152610441767069,1904400,55800900,53896500
219950.0,3,1.0,1210,8000,1.0,0,0,2,6,1210,0,1954,0.0,98198,47.4211,-122.314,1430,8000,6790,0.84875,1464100,64000000,62535900
215000.0,3,2.0,1280,6994,1.0,0,0,2,7,1280,0,1991,0.0,98038,47.3889,-122.04799999999999,1290,7514,5714,0.8169859879897055,1638400,48916036,47277636
640000.0,4,2.5,4090,215186,2.0,0,0,3,8,3670,420,1979,0.0,98092,47.2964,-122.116,2430,142005,211096,0.9809931872891359,16728100,46305014596,46288286496
535000.0,3,1.0,1580,6300,1.0,0,0,2,7,1180,400,1925,0.0,98199,47.6505,-122.384,1560,1601,4720,0.7492063492063492,2496400,39690000,37193600
253000.0,4,2.0,1910,7826,1.0,0,0,3,7,1140,770,1973,0.0,98003,47.3493,-122.306,1540,7826,5916,0.7559417326859187,3648100,61246276,57598176
650000.0,2,2.5,1740,2500,2.0,0,2,2,8,1210,530,1994,0.0,98112,47.622,-122.3,1640,2500,760,0.304,3027600,6250000,3222400
672000.0,3,2.25,1130,4445,1.5,0,0,3,8,1130,0,1930,0.0,98117,47.6845,-122.375,1330,4445,3315,0.7457817772778402,1276900,19758025,18481125
606000.0,3,1.75,1970,8540,1.0,0,3,3,8,1130,840,1950,0.0,98177,47.7213,-122.365,2280,8540,6570,0.7693208430913349,3880900,72931600,69050700
292000.0,3,2.25,1780,9720,1.0,0,0,2,8,1280,500,1981,0.0,98059,47.4762,-122.156,1710,9790,7940,0.8168724279835391,3168400,94478400,91310000
289950.0,3,2.0,1670,7757,1.0,0,0,2,8,1670,0,1992,0.0,98030,47.3802,-122.20700000000001,2290,7859,6087,0.7847105839886555,2788900,60171049,57382149
257500.0,4,1.5,1360,9323,1.0,0,0,3,7,1360,0,1968,0.0,98023,47.3168,-122.40100000000001,1180,9611,7963,0.8541242089456184,1849600,86918329,85068729
380000.0,3,2.5,1840,6985,1.0,0,0,2,7,1290,550,1971,0.0,98133,47.7586,-122.34200000000001,2160,7990,5145,0.7365783822476736,3385600,48790225,45404625
360000.0,3,1.75,1255,1113,3.0,0,0,2,8,1255,0,2010,0.0,98103,47.6958,-122.34299999999999,1010,1038,-142,-0.1275831087151842,1575025,1238769,-336256
269500.0,3,1.75,1840,7412,1.0,0,0,3,7,1240,600,1976,0.0,98031,47.3933,-122.18799999999999,1980,7350,5572,0.751753912574204,3385600,54937744,51552144
449000.0,4,2.5,2960,6031,2.0,0,0,2,9,2960,0,2005,0.0,98038,47.3596,-122.04,2570,5012,3071,0.50920245398773,8761600,36372961,27611361
375000.0,4,1.5,1430,7232,1.5,0,0,2,7,1430,0,1948,0.0,98125,47.7197,-122.32799999999999,1540,7232,5802,0.8022676991150443,2044900,52301824,50256924
2200000.0,5,4.75,5990,10450,2.0,1,4,2,11,4050,1940,2002,0.0,98027,47.5554,-122.07700000000001,3330,14810,4460,0.4267942583732057,35880100,109202500,73322400
810000.0,4,2.5,3480,59242,2.0,0,0,2,11,3480,0,1988,0.0,98072,47.7391,-122.102,2930,39400,55762,0.9412578913608588,12110400,3509614564,3497504164
994000.0,5,3.25,4260,7861,2.0,0,0,2,10,4260,0,2005,0.0,98074,47.611000000000004,-121.992,4020,7528,3601,0.45808421320442694,18147600,61795321,43647721
275000.0,5,2.25,1820,10500,1.0,0,0,3,7,1080,740,1979,0.0,98031,47.4058,-122.177,1820,7500,8680,0.8266666666666667,3312400,110250000,106937600
300000.0,2,1.0,1290,2482,2.0,0,0,2,7,1290,0,2008,0.0,98053,47.6972,-122.025,1290,2482,1192,0.4802578565672844,1664100,6160324,4496224
380000.0,5,2.5,2130,8428,2.0,0,0,2,7,2130,0,2013,0.0,98168,47.4726,-122.28200000000001,1500,11810,6298,0.7472710014238253,4536900,71031184,66494284
200000.0,3,2.0,1170,10051,1.0,0,0,3,7,1170,0,1957,0.0,98198,47.4229,-122.324,1440,9800,8881,0.8835936722714158,1368900,101022601,99653701
635000.0,3,3.5,1730,1349,3.0,0,0,2,9,1350,380,2009,0.0,98102,47.6224,-122.32600000000001,1830,3300,-381,-0.2824314306893996,2992900,1819801,-1173099
280000.0,2,1.0,880,5750,1.0,0,0,2,6,880,0,1939,0.0,98126,47.5642,-122.37899999999999,1190,5750,4870,0.8469565217391304,774400,33062500,32288100
574000.0,3,2.5,2380,6832,2.0,0,0,2,8,2380,0,2002,0.0,98065,47.5372,-121.876,2580,6832,4452,0.6516393442622951,5664400,46676224,41011824
1050000.0,4,1.0,1330,9729,1.0,0,0,2,6,1330,0,1952,0.0,98004,47.6223,-122.208,2920,10353,8399,0.8632953027032583,1768900,94653441,92884541
545000.0,3,2.25,1780,191228,2.0,0,2,2,8,1780,0,1988,0.0,98045,47.4575,-121.74799999999999,2440,87120,189448,0.9906917397033908,3168400,36568147984,36564979584
271950.0,3,1.5,1220,8400,1.0,0,0,3,7,1220,0,1962,0.0,98006,47.5467,-122.17299999999999,2110,9119,7180,0.8547619047619047,1488400,70560000,69071600
630000.0,5,1.75,2490,24969,1.0,0,2,3,8,1540,950,1959,0.0,98023,47.33600000000001,-122.35,2790,15600,22479,0.9002763426649045,6200100,623450961,617250861
400000.0,2,1.0,1180,10800,1.0,0,0,2,7,1180,0,1984,0.0,98011,47.7273,-122.236,1600,10800,9620,0.8907407407407407,1392400,116640000,115247600
334000.0,4,2.5,2310,6200,2.0,0,0,2,8,2310,0,1998,0.0,98092,47.3321,-122.17200000000001,2480,6200,3890,0.6274193548387097,5336100,38440000,33103900
332500.0,4,2.0,1440,4855,2.0,0,0,3,7,1440,0,1972,0.0,98144,47.5717,-122.287,1300,4080,3415,0.7033985581874357,2073600,23571025,21497425
525000.0,2,1.5,1620,1444,2.0,0,0,2,9,1080,540,2007,0.0,98144,47.5892,-122.309,1660,1642,-176,-0.12188365650969529,2624400,2085136,-539264
408000.0,3,2.5,2620,8403,2.0,0,0,2,8,2620,0,1991,0.0,98038,47.3675,-122.042,2190,7842,5783,0.688206592883494,6864400,70610409,63746009
846450.0,4,2.5,3710,7491,2.0,0,0,2,9,3710,0,2003,0.0,98029,47.5596,-122.016,3040,7491,3781,0.5047390201575224,13764100,56115081,42350981
411100.0,3,1.5,1040,10323,1.0,0,0,3,7,1040,0,1958,0.0,98005,47.5882,-122.155,1580,7200,9283,0.8992540928024799,1081600,106564329,105482729
409124.0,5,3.25,3320,11340,2.0,0,0,3,8,2480,840,1999,0.0,98042,47.3904,-122.154,2330,8339,8020,0.7072310405643739,11022400,128595600,117573200
335950.0,2,1.5,800,5192,1.0,0,0,4,7,800,0,1951,0.0,98146,47.5119,-122.38600000000001,1190,5320,4392,0.8459167950693375,640000,26956864,26316864
480000.0,5,2.5,2040,9597,1.0,0,0,3,7,1240,800,1963,0.0,98052,47.6544,-122.134,1800,8553,7557,0.7874335729915599,4161600,92102409,87940809
280000.0,2,1.75,1960,30144,1.0,0,0,2,7,980,980,1957,0.0,98031,47.4234,-122.212,1960,10140,28184,0.9349787685774947,3841600,908660736,904819136
668000.0,4,2.5,2670,4410,2.0,0,0,2,8,2670,0,1999,0.0,98075,47.5978,-122.038,2670,4410,1740,0.3945578231292517,7128900,19448100,12319200
750000.0,4,2.5,2930,8641,2.0,0,0,2,8,2930,0,2010,0.0,98034,47.7199,-122.24600000000001,2120,11175,5711,0.6609188751301933,8584900,74666881,66081981
394475.0,2,1.0,830,4000,1.0,0,0,2,6,830,0,1955,0.0,98117,47.6929,-122.37899999999999,950,4000,3170,0.7925,688900,16000000,15311100
848000.0,5,1.75,2290,4320,2.0,0,0,2,7,1980,310,1928,0.0,98105,47.663999999999994,-122.31,2870,4320,2030,0.4699074074074074,5244100,18662400,13418300
675000.0,3,1.5,2510,3600,2.5,0,0,3,8,2510,0,1907,0.0,98112,47.6195,-122.31299999999999,1740,1885,1090,0.30277777777777776,6300100,12960000,6659900
175000.0,3,1.0,1280,7572,1.0,0,0,3,6,1280,0,1958,0.0,98058,47.4491,-122.176,1170,7667,6292,0.8309561542525092,1638400,57335184,55696784
560000.0,4,1.5,1810,6000,1.0,0,1,2,8,1350,460,1952,0.0,98136,47.5233,-122.38600000000001,2020,6000,4190,0.6983333333333334,3276100,36000000,32723900
538888.0,5,2.75,2080,13189,2.0,0,0,2,8,2080,0,1987,0.0,98074,47.6288,-122.031,2030,11847,11109,0.8422928197740541,4326400,173949721,169623321
359000.0,4,1.75,1680,9244,2.0,0,0,2,8,1680,0,1991,0.0,98166,47.4612,-122.352,1840,9387,7564,0.8182604932929468,2822400,85451536,82629136
300000.0,3,2.25,1660,5128,2.0,0,0,2,7,1660,0,2001,0.0,98019,47.7362,-121.96700000000001,1680,4652,3468,0.6762870514820593,2755600,26296384,23540784
273000.0,3,2.5,1650,5994,2.0,0,0,3,7,1650,0,1989,0.0,98030,47.3603,-122.19,1930,6666,4344,0.7247247247247247,2722500,35928036,33205536
670000.0,3,2.5,1420,1438,2.0,0,0,2,9,1280,140,2003,0.0,98102,47.6265,-122.323,1490,1439,18,0.012517385257301807,2016400,2067844,51444
530000.0,4,2.25,2240,8376,1.0,0,0,2,8,1740,500,1984,0.0,98074,47.6323,-122.029,1890,7875,6136,0.7325692454632283,5017600,70157376,65139776
625000.0,3,1.5,1230,3060,1.0,0,0,2,7,910,320,1927,0.0,98103,47.667,-122.333,1260,4488,1830,0.5980392156862745,1512900,9363600,7850700
248000.0,3,1.0,1260,6000,1.0,0,0,3,6,1260,0,1954,0.0,98198,47.4187,-122.323,1520,6600,4740,0.79,1587600,36000000,34412400
533000.0,3,2.5,2060,4812,2.0,0,0,2,8,2060,0,1990,0.0,98029,47.5793,-122.00200000000001,1930,5264,2752,0.57190357439734,4243600,23155344,18911744
549950.0,4,3.5,3090,10510,1.0,0,0,2,8,2190,900,1991,0.0,98034,47.7176,-122.214,2200,7408,7420,0.7059942911512845,9548100,110460100,100912000
485000.0,4,1.75,3220,7392,1.0,0,0,3,8,2010,1210,1959,0.0,98177,47.7719,-122.361,1660,8363,4172,0.5643939393939394,10368400,54641664,44273264
353500.0,3,2.5,2020,4845,2.0,0,0,2,7,2020,0,2001,0.0,98038,47.3848,-122.03299999999999,1930,5134,2825,0.5830753353973168,4080400,23474025,19393625
435000.0,2,1.75,1910,12142,1.0,0,0,2,9,1910,0,1976,0.0,98074,47.6276,-122.053,2580,12326,10232,0.8426947784549498,3648100,147428164,143780064
241000.0,3,1.0,1150,10000,1.0,0,0,2,6,1000,150,1951,0.0,98178,47.5075,-122.262,1340,10000,8850,0.885,1322500,100000000,98677500
885000.0,4,2.75,2730,3560,1.5,0,0,2,8,1550,1180,1921,0.0,98115,47.6737,-122.304,1860,3560,830,0.23314606741573032,7452900,12673600,5220700
799200.0,6,3.0,2890,2370,2.5,0,0,2,7,2290,600,1906,0.0,98102,47.6227,-122.323,2180,2460,-520,-0.21940928270042195,8352100,5616900,-2735200
760000.0,3,2.5,2280,12746,1.0,0,0,3,8,1490,790,1973,0.0,98005,47.6362,-122.175,2100,12746,10466,0.8211203514828181,5198400,162460516,157262116
270000.0,2,1.0,1040,5700,1.0,0,0,2,6,1040,0,1922,0.0,98118,47.519,-122.26,1380,5700,4660,0.8175438596491228,1081600,32490000,31408400
675000.0,4,1.75,2440,7475,1.0,0,0,3,9,2040,400,1969,0.0,98052,47.6339,-122.096,2040,8480,5035,0.6735785953177258,5953600,55875625,49922025
499000.0,3,2.5,1720,5940,1.0,0,0,3,8,1000,720,1977,0.0,98052,47.6631,-122.12899999999999,1720,6136,4220,0.7104377104377104,2958400,35283600,32325200
1200000.0,3,2.5,3430,28718,1.5,0,0,2,10,3430,0,1984,0.0,98033,47.6477,-122.18299999999999,3440,35021,25288,0.8805627132808691,11764900,824723524,812958624
320000.0,4,2.5,2570,4865,2.0,0,0,2,8,2570,0,2005,0.0,98038,47.3588,-122.038,2570,4933,2295,0.47173689619732784,6604900,23668225,17063325
890000.0,4,3.25,4360,210254,1.0,0,0,2,10,2320,2040,2000,0.0,98038,47.4375,-122.008,2410,87120,205894,0.9792631769193452,19009600,44206744516,44187734916
275000.0,4,2.75,2060,7350,1.0,0,0,2,7,1210,850,1978,0.0,98001,47.3424,-122.275,1940,7420,5290,0.7197278911564626,4243600,54022500,49778900
490000.0,4,2.5,3020,8302,2.0,0,0,3,10,3020,0,1994,0.0,98042,47.363,-122.12700000000001,3020,8406,5282,0.6362322331968201,9120400,68923204,59802804
550000.0,3,2.5,2340,4200,1.5,0,0,2,7,1540,800,1906,0.0,98122,47.6033,-122.303,1590,4200,1860,0.44285714285714284,5475600,17640000,12164400
390000.0,5,2.0,2400,9537,1.0,0,0,4,7,1210,1190,1959,0.0,98056,47.5112,-122.186,1760,9533,7137,0.7483485372758729,5760000,90954369,85194369
277000.0,3,2.25,1610,11920,1.0,0,0,3,7,1110,500,1968,0.0,98032,47.3683,-122.279,1690,11839,10310,0.8649328859060402,2592100,142086400,139494300
236000.0,3,1.75,1090,7647,1.0,0,0,2,7,1090,0,1994,0.0,98003,47.2613,-122.302,1660,9219,6557,0.8574604420034,1188100,58476609,57288509
265953.0,3,1.75,1470,13068,1.0,0,0,3,7,1470,0,1975,0.0,98092,47.3096,-122.197,2090,16988,11598,0.8875114784205693,2160900,170772624,168611724
545000.0,3,2.25,1670,6240,1.0,0,0,3,8,1240,430,1974,0.0,98008,47.6413,-122.113,1910,7000,4570,0.7323717948717948,2788900,38937600,36148700
535000.0,3,2.5,1850,10109,2.0,0,0,2,8,1850,0,1991,0.0,98034,47.7163,-122.229,1780,9660,8259,0.8169947571470967,3422500,102191881,98769381
1450000.0,3,2.75,3940,9671,1.0,0,4,4,9,2140,1800,1967,0.0,98006,47.5654,-122.15799999999999,3390,9360,5731,0.5925964222934547,15523600,93528241,78004641
490000.0,4,3.0,2330,3497,2.0,0,0,2,9,1920,410,2003,0.0,98108,47.553999999999995,-122.30799999999999,2330,5242,1167,0.33371461252502144,5428900,12229009,6800109
319950.0,4,2.5,2020,7200,1.5,0,0,3,6,2020,0,1954,0.0,98065,47.5223,-121.818,1440,7200,5180,0.7194444444444444,4080400,51840000,47759600
625000.0,3,1.5,1300,7200,1.0,0,0,4,7,1300,0,1960,0.0,98033,47.6821,-122.196,2280,7200,5900,0.8194444444444444,1690000,51840000,50150000
248000.0,3,1.0,1180,6947,1.0,0,0,3,7,1180,0,1968,0.0,98031,47.4233,-122.177,1760,8657,5767,0.830142507557219,1392400,48260809,46868409
475000.0,3,1.75,1320,7840,1.0,0,0,2,8,1320,0,1966,0.0,98007,47.6024,-122.14299999999999,2050,7644,6520,0.8316326530612245,1742400,61465600,59723200
410000.0,6,2.75,2520,9324,1.0,0,0,3,7,1320,1200,1962,0.0,98155,47.7636,-122.294,1820,11000,6804,0.7297297297297297,6350400,86936976,80586576
670000.0,3,2.5,1680,2000,3.0,0,0,2,9,1680,0,1909,0.0,98105,47.6604,-122.29,1950,5000,320,0.16,2822400,4000000,1177600
430000.0,3,2.5,2000,35438,2.0,0,0,2,7,2000,0,1968,2005.0,98027,47.4733,-121.994,2000,51836,33438,0.9435634065127829,4000000,1255851844,1251851844
313000.0,2,1.0,1180,4900,1.0,0,0,4,6,1180,0,1954,0.0,98027,47.5321,-122.029,1650,7121,3720,0.7591836734693878,1392400,24010000,22617600
950000.0,3,3.25,3330,15093,2.5,0,0,2,9,3330,0,1988,0.0,98040,47.5395,-122.242,4340,20031,11763,0.7793679189028027,11088900,227798649,216709749
751750.0,2,2.0,1880,5400,1.5,0,0,2,8,1880,0,1902,0.0,98112,47.6238,-122.311,1590,5400,3520,0.6518518518518519,3534400,29160000,25625600
760000.0,4,2.5,2990,5280,2.0,0,0,2,9,2210,780,2003,0.0,98027,47.5353,-122.066,2990,6299,2290,0.4337121212121212,8940100,27878400,18938300
310650.0,3,1.75,1510,12408,1.0,0,0,3,7,1510,0,1969,0.0,98059,47.5069,-122.141,1480,17800,10898,0.8783043197936815,2280100,153958464,151678364
367500.0,4,3.0,3110,7231,2.0,0,0,2,8,3110,0,1997,0.0,98092,47.3279,-122.191,2820,7311,4121,0.569907343382658,9672100,52287361,42615261
580000.0,4,2.5,2150,5000,2.0,0,0,2,8,2150,0,2001,0.0,98115,47.6962,-122.314,2030,6380,2850,0.57,4622500,25000000,20377500
580000.0,3,2.25,1900,3960,1.5,0,0,2,8,1200,700,1905,0.0,98122,47.6122,-122.29799999999999,1310,3960,2060,0.5202020202020202,3610000,15681600,12071600
665000.0,4,2.5,2720,10000,2.0,0,0,2,10,2720,0,1987,0.0,98074,47.6293,-122.051,2720,10020,7280,0.728,7398400,100000000,92601600
239950.0,3,2.25,1560,8280,2.0,0,0,3,7,1560,0,1979,0.0,98001,47.3393,-122.259,1920,8120,6720,0.8115942028985508,2433600,68558400,66124800
470000.0,4,2.5,1990,30083,2.0,0,0,2,8,1990,0,1998,0.0,98155,47.7678,-122.272,2220,11627,28093,0.9338496825449589,3960100,904986889,901026789
733000.0,3,1.75,1740,3060,1.0,0,0,4,8,950,0,1930,2014.0,98115,47.6816,-122.31,1800,3960,1320,0.43137254901960786,3027600,9363600,6336000
250000.0,4,2.0,2130,8400,1.0,0,0,2,7,1350,780,1962,0.0,98031,47.4133,-122.209,1550,8596,6270,0.7464285714285714,4536900,70560000,66023100
402000.0,4,1.75,1510,9176,1.0,0,0,4,7,1510,0,1957,0.0,98133,47.7651,-122.339,1480,9176,7666,0.8354402789886661,2280100,84198976,81918876
295000.0,5,3.5,2100,5107,2.0,0,0,2,7,1410,690,1999,0.0,98178,47.5108,-122.257,1410,5650,3007,0.5887996867045232,4410000,26081449,21671449
355000.0,5,2.5,2344,8000,1.0,0,0,3,8,1560,784,1976,0.0,98023,47.3185,-122.37700000000001,2344,8000,5656,0.707,5494336,64000000,58505664
289000.0,3,1.5,1970,22486,1.0,0,0,3,6,1970,0,1968,0.0,98058,47.4511,-122.089,1850,20160,20516,0.9123899315129413,3880900,505620196,501739296
376000.0,3,2.25,1470,9140,2.0,0,2,2,7,1470,0,1982,0.0,98133,47.7162,-122.34899999999999,1400,8204,7670,0.8391684901531729,2160900,83539600,81378700
212700.0,2,1.0,940,5040,1.0,0,0,2,7,940,0,1926,0.0,98126,47.5375,-122.374,940,5040,4100,0.8134920634920635,883600,25401600,24518000
325000.0,3,1.75,1780,13095,1.0,0,0,3,9,1780,0,1983,0.0,98042,47.367,-122.152,2750,13095,11315,0.8640702558228331,3168400,171479025,168310625
415000.0,4,2.5,2230,5743,2.0,0,0,2,7,2230,0,2002,0.0,98019,47.7245,-121.95700000000001,2490,6300,3513,0.6117012014626502,4972900,32982049,28009149
935000.0,3,2.5,3570,15151,1.0,0,0,3,8,2400,1170,1981,0.0,98177,47.7475,-122.36399999999999,3140,14375,11581,0.764371988647614,12744900,229552801,216807901
372000.0,3,2.5,1920,15260,2.0,0,0,2,7,1920,0,1990,0.0,98019,47.7317,-121.964,2370,15235,13340,0.8741808650065531,3686400,232867600,229181200
240000.0,3,1.5,1290,8366,1.0,0,0,2,7,1020,270,1957,0.0,98168,47.4853,-122.318,1770,8400,7076,0.8458044465694478,1664100,69989956,68325856
334950.0,3,1.75,1880,16262,1.0,0,0,4,7,1880,0,1980,0.0,98059,47.5089,-122.155,1900,7972,14382,0.884393063583815,3534400,264452644,260918244
426500.0,4,2.5,2960,4640,2.0,0,0,2,9,2960,0,2005,0.0,98038,47.3597,-122.04,2750,4623,1680,0.3620689655172414,8761600,21529600,12768000
430000.0,2,1.75,1840,14874,1.0,0,2,2,8,1300,540,1952,0.0,98166,47.4382,-122.348,2920,15084,13034,0.8762942046524136,3385600,221235876,217850276
400000.0,3,1.5,1890,6183,1.0,0,0,2,7,1090,800,1967,0.0,98118,47.5396,-122.26899999999999,1750,6183,4293,0.6943231441048034,3572100,38229489,34657389
455850.0,3,2.25,1820,6000,1.0,0,0,3,7,1120,700,1964,0.0,98108,47.5684,-122.3,1970,6232,4180,0.6966666666666667,3312400,36000000,32687600
1970000.0,4,3.5,4370,8510,2.0,0,1,2,10,3610,760,2003,0.0,98004,47.5876,-122.204,2960,10347,4140,0.4864864864864865,19096900,72420100,53323200
400000.0,3,1.75,1530,10731,1.0,0,0,2,7,1530,0,1986,0.0,98028,47.7655,-122.244,2100,12593,9201,0.8574224210232038,2340900,115154361,112813461
397500.0,3,1.0,1030,10480,1.0,0,0,3,7,1030,0,1954,0.0,98006,47.5742,-122.139,1480,12200,9450,0.9017175572519084,1060900,109830400,108769500
755000.0,3,2.5,2000,1950,3.0,0,0,2,8,2000,0,2005,0.0,98109,47.6476,-122.35600000000001,1560,1340,-50,-0.02564102564102564,4000000,3802500,-197500
287000.0,5,1.5,1730,9230,1.0,0,0,2,7,1010,720,1962,0.0,98058,47.4646,-122.184,1730,9230,7500,0.8125677139761647,2992900,85192900,82200000
480000.0,4,2.5,3620,16000,2.0,0,0,2,9,3620,0,1976,0.0,98038,47.3711,-122.06,2590,16000,12380,0.77375,13104400,256000000,242895600
490000.0,3,2.5,2040,9622,2.0,0,0,2,8,2040,0,1995,0.0,98045,47.4833,-121.8,2390,9868,7582,0.7879858657243817,4161600,92582884,88421284
365000.0,3,2.5,2640,6715,2.0,0,0,2,8,1680,960,1991,0.0,98058,47.441,-122.125,2260,7373,4075,0.6068503350707372,6969600,45091225,38121625
260000.0,3,2.5,1600,2244,2.0,0,0,2,7,1600,0,2005,0.0,98056,47.4899,-122.164,1600,1700,644,0.28698752228163993,2560000,5035536,2475536
505000.0,4,1.0,1480,12675,1.5,0,0,3,7,1480,0,1929,0.0,98133,47.76300000000001,-122.34200000000001,1820,7995,11195,0.8832347140039448,2190400,160655625,158465225
260000.0,2,1.0,700,4800,1.0,0,0,2,7,700,0,1922,0.0,98122,47.6147,-122.3,1440,4800,4100,0.8541666666666666,490000,23040000,22550000
430000.0,2,1.0,700,4800,1.0,0,0,2,7,700,0,1922,0.0,98122,47.6147,-122.3,1440,4800,4100,0.8541666666666666,490000,23040000,22550000
905000.0,4,2.5,3520,12193,2.0,0,0,3,10,3520,0,1993,0.0,98027,47.5535,-122.095,3470,11318,8673,0.7113097678996145,12390400,148669249,136278849
440000.0,3,2.0,1650,6408,2.0,0,0,3,8,1650,0,1977,0.0,98052,47.6638,-122.12799999999999,1750,6402,4758,0.7425093632958801,2722500,41062464,38339964
439500.0,4,1.0,1360,5500,1.5,0,0,2,7,1360,0,1950,0.0,98115,47.6878,-122.285,1530,5790,4140,0.7527272727272727,1849600,30250000,28400400
270000.0,3,2.0,1350,6696,1.0,0,0,4,6,680,670,1944,0.0,98056,47.4919,-122.18700000000001,1350,6700,5346,0.7983870967741935,1822500,44836416,43013916
306500.0,3,2.5,1970,6291,2.0,0,0,3,7,1970,0,1998,0.0,98042,47.3627,-122.073,1980,8852,4321,0.6868542362104594,3880900,39576681,35695781
380000.0,3,2.0,1470,1656,2.0,0,0,2,8,1310,160,2003,0.0,98126,47.5653,-122.369,1470,2288,186,0.11231884057971014,2160900,2742336,581436
215000.0,4,1.75,1610,9652,1.0,0,0,4,7,1610,0,1969,0.0,98042,47.3281,-122.135,1220,9800,8042,0.8331951927061749,2592100,93161104,90569004
299900.0,2,1.0,810,6150,1.0,0,0,2,7,810,0,1950,0.0,98133,47.7289,-122.34,1080,7200,5340,0.8682926829268293,656100,37822500,37166400
1450000.0,4,3.5,2820,7809,2.0,0,0,2,10,2820,0,1995,0.0,98004,47.622,-122.195,2630,7904,4989,0.6388782174414137,7952400,60980481,53028081
239950.0,3,1.0,1900,33888,1.5,0,0,3,5,1900,0,1942,0.0,98001,47.2738,-122.271,1430,19200,31988,0.943932955618508,3610000,1148396544,1144786544
494000.0,4,2.5,1830,7345,1.0,0,0,3,8,1540,290,1973,0.0,98177,47.7741,-122.37299999999999,1990,7700,5515,0.7508509189925119,3348900,53949025,50600125
317500.0,4,1.5,1730,7700,1.0,0,0,3,7,1010,720,1963,0.0,98059,47.4996,-122.163,1650,8066,5970,0.7753246753246753,2992900,59290000,56297100
670000.0,4,2.5,2110,7291,2.0,0,0,3,7,2110,0,1977,0.0,98033,47.6888,-122.20100000000001,2350,8625,5181,0.7106021121931148,4452100,53158681,48706581
650000.0,3,2.5,3060,7831,2.0,0,2,2,9,3060,0,2004,0.0,98065,47.5401,-121.861,3140,7438,4771,0.609245307112757,9363600,61324561,51960961
852000.0,4,2.5,2620,7328,2.0,0,0,2,8,2620,0,1983,0.0,98118,47.5514,-122.26299999999999,1670,5080,4708,0.642467248908297,6864400,53699584,46835184
250000.0,2,1.5,1088,1360,2.0,0,0,2,7,1088,0,1983,0.0,98034,47.7094,-122.213,1098,1469,272,0.2,1183744,1849600,665856
264950.0,3,1.5,1400,10853,1.0,0,0,3,7,1400,0,1964,0.0,98055,47.4433,-122.194,1620,10849,9453,0.8710034091956141,1960000,117787609,115827609
582500.0,2,2.0,1540,6804,1.0,0,0,4,7,1020,520,1942,0.0,98177,47.7044,-122.37200000000001,1380,6930,5264,0.7736625514403292,2371600,46294416,43922816
384000.0,3,2.5,1540,1564,2.0,0,0,2,7,1300,240,1998,0.0,98144,47.58600000000001,-122.31299999999999,1540,2875,24,0.015345268542199489,2371600,2446096,74496
817000.0,3,1.5,2310,3360,1.5,0,0,2,8,1790,520,1926,0.0,98119,47.6431,-122.359,1930,4320,1050,0.3125,5336100,11289600,5953500
320000.0,4,1.75,1730,9520,1.0,0,0,3,7,1730,0,1971,0.0,98059,47.4756,-122.15700000000001,1550,11211,7790,0.8182773109243697,2992900,90630400,87637500
445800.0,4,2.25,2070,39446,1.0,0,0,2,8,1470,600,1977,0.0,98155,47.7765,-122.27600000000001,2140,12043,37376,0.9475231962683162,4284900,1555986916,1551702016
263300.0,2,1.0,900,4500,1.0,0,0,2,7,900,0,1951,0.0,98118,47.5273,-122.265,1175,5320,3600,0.8,810000,20250000,19440000
215000.0,3,1.0,860,6635,1.0,0,0,2,6,860,0,1952,0.0,98133,47.7508,-122.339,1170,8000,5775,0.8703843255463452,739600,44023225,43283625
842500.0,5,4.0,2980,4500,1.5,0,0,2,7,2070,910,1921,0.0,98115,47.6736,-122.323,1560,4225,1520,0.3377777777777778,8880400,20250000,11369600
850000.0,5,4.0,2980,4500,1.5,0,0,2,7,2070,910,1921,0.0,98115,47.6736,-122.323,1560,4225,1520,0.3377777777777778,8880400,20250000,11369600
386000.0,5,2.5,2740,12413,2.0,0,0,2,7,2740,0,1990,0.0,98031,47.4199,-122.18299999999999,1900,7416,9673,0.7792636751792476,7507600,154082569,146574969
251100.0,4,2.5,1790,5257,2.0,0,0,2,7,1790,0,1996,0.0,98030,47.3849,-122.204,1680,5320,3467,0.6595016168917633,3204100,27636049,24431949
435000.0,3,1.75,1750,16748,1.0,0,0,2,7,1330,420,1978,0.0,98072,47.7421,-122.089,1750,16050,14998,0.8955099116312395,3062500,280495504,277433004
870000.0,4,4.0,3610,12811,2.0,0,0,2,10,3610,0,2000,0.0,98075,47.5812,-121.993,3530,11783,9201,0.7182109124970728,13032100,164121721,151089621
800000.0,6,1.0,1430,20620,2.0,0,0,2,7,1430,0,1954,0.0,98004,47.6255,-122.209,2450,10080,19190,0.9306498545101843,2044900,425184400,423139500
555000.0,3,1.75,1570,15500,1.0,0,0,3,7,1570,0,1968,0.0,98052,47.6916,-122.12200000000001,1610,7500,13930,0.8987096774193548,2464900,240250000,237785100
280000.0,2,1.0,2280,37500,2.0,0,0,2,7,2280,0,1932,0.0,98136,47.525,-122.389,2360,6000,35220,0.9392,5198400,1406250000,1401051600
356000.0,3,1.0,940,2366,1.0,0,0,2,6,940,0,1916,0.0,98107,47.6744,-122.383,1500,5000,1426,0.6027049873203719,883600,5597956,4714356
675000.0,4,2.5,2920,6000,2.0,0,4,2,9,2920,0,2004,0.0,98065,47.5333,-121.859,3100,6001,3080,0.5133333333333333,8526400,36000000,27473600
605000.0,4,2.25,2260,11900,2.0,0,0,2,9,2260,0,1976,0.0,98074,47.6415,-122.057,2470,11900,9640,0.8100840336134454,5107600,141610000,136502400
690500.0,5,2.0,2000,4211,1.5,0,2,3,7,1280,720,1908,0.0,98112,47.6283,-122.301,1680,4000,2211,0.5250534314889574,4000000,17732521,13732521
437000.0,2,1.75,1440,4225,1.0,0,0,2,8,1440,0,2005,0.0,98053,47.7143,-122.03200000000001,1680,6200,2785,0.659171597633136,2073600,17850625,15777025
850000.0,5,2.0,2310,13430,1.5,0,0,3,8,2310,0,1966,0.0,98004,47.6395,-122.20299999999999,2810,13906,11120,0.8279970215934475,5336100,180364900,175028800
350000.0,4,2.25,2300,4600,1.5,0,0,3,7,1340,960,1904,0.0,98144,47.5895,-122.311,1540,3000,2300,0.5,5290000,21160000,15870000
480000.0,2,2.25,1490,6770,1.5,0,0,2,8,1490,0,1926,0.0,98108,47.5577,-122.29700000000001,1820,7875,5280,0.7799113737075333,2220100,45832900,43612800
379500.0,3,2.25,1830,25641,2.0,0,0,2,8,1830,0,1989,0.0,98059,47.4786,-122.11200000000001,1500,25641,23811,0.9286299286299287,3348900,657460881,654111981
600000.0,5,4.5,4440,9784,2.0,0,0,2,10,4440,0,2012,0.0,98168,47.4702,-122.275,2720,10080,5344,0.5461978740801309,19713600,95726656,76013056
1440000.0,4,3.5,4970,16582,2.0,0,3,3,11,3930,1040,1992,0.0,98006,47.5496,-122.12,3580,13335,11612,0.7002774092389338,24700900,274962724,250261824
303000.0,2,1.5,1000,1075,2.0,0,0,2,7,840,160,2007,0.0,98144,47.5708,-122.288,1000,1083,75,0.06976744186046512,1000000,1155625,155625
800000.0,4,2.5,4940,10037,1.0,0,4,2,9,3450,1490,1953,0.0,98178,47.5095,-122.24700000000001,2430,9272,5097,0.5078210620703397,24403600,100741369,76337769
549000.0,2,2.0,1980,6000,1.5,0,0,4,7,1220,760,1906,0.0,98103,47.6809,-122.351,1280,3900,4020,0.67,3920400,36000000,32079600
324950.0,3,2.5,1560,9600,1.0,0,0,2,7,1210,0,1964,0.0,98188,47.457,-122.27,2070,9600,8040,0.8375,2433600,92160000,89726400
170000.0,2,1.0,870,6537,1.0,0,0,2,6,870,0,1948,0.0,98168,47.4906,-122.306,1100,8701,5667,0.8669114272602111,756900,42732369,41975469
178000.0,3,1.0,840,6500,1.0,0,0,4,6,840,0,1969,0.0,98042,47.3704,-122.08,870,5200,5660,0.8707692307692307,705600,42250000,41544400
144000.0,3,1.0,1250,8314,1.0,0,0,2,6,1250,0,1958,0.0,98058,47.4522,-122.178,1188,7700,7064,0.8496511907625691,1562500,69122596,67560096
1580000.0,4,2.75,3120,20031,1.0,0,2,3,9,1980,1140,1954,0.0,98040,47.5389,-122.242,3330,18777,16911,0.8442414257900255,9734400,401240961,391506561
258000.0,2,1.0,750,7000,1.0,0,0,2,6,750,0,1932,0.0,98024,47.5655,-121.89,1100,8777,6250,0.8928571428571429,562500,49000000,48437500
345000.0,3,1.75,710,5050,1.0,0,0,3,6,710,0,1950,0.0,98126,47.5194,-122.375,900,5050,4340,0.8594059405940594,504100,25502500,24998400
470000.0,3,1.75,2290,14800,1.0,0,0,2,8,1620,670,1965,0.0,98155,47.7735,-122.273,2320,12474,12510,0.8452702702702702,5244100,219040000,213795900
2900000.0,5,2.5,3750,91681,2.0,1,4,2,10,3750,0,1925,0.0,98118,47.5379,-122.264,3540,24293,87931,0.9590973047850699,14062500,8405405761,8391343261
350000.0,3,1.5,980,7790,1.0,0,0,4,7,980,0,1969,0.0,98034,47.7141,-122.213,1390,7280,6810,0.8741976893453145,960400,60684100,59723700
225500.0,2,1.75,1590,11276,1.0,0,0,3,7,1590,0,1972,0.0,98002,47.3177,-122.21,1750,10687,9686,0.8589925505498404,2528100,127148176,124620076
473000.0,2,1.0,940,4000,1.0,0,0,2,6,720,220,1942,0.0,98199,47.6488,-122.385,1180,6000,3060,0.765,883600,16000000,15116400
279000.0,3,1.75,1750,9623,1.0,0,0,2,7,1150,600,1962,0.0,98198,47.3997,-122.31299999999999,1820,9623,7873,0.8181440299282968,3062500,92602129,89539629
470000.0,3,1.0,1460,8227,1.0,0,0,2,6,880,580,1948,0.0,98125,47.7009,-122.301,1530,8128,6767,0.8225355536647624,2131600,67683529,65551929
565000.0,3,1.75,1540,4800,1.0,0,0,3,6,770,770,1925,0.0,98105,47.67,-122.28399999999999,1510,4080,3260,0.6791666666666667,2371600,23040000,20668400
695000.0,3,2.0,2560,6800,1.0,0,1,3,8,1380,1180,1952,0.0,98136,47.5506,-122.395,1780,6800,4240,0.6235294117647059,6553600,46240000,39686400
315000.0,3,1.75,1660,37642,1.0,0,0,3,7,1660,0,1991,0.0,98022,47.2559,-122.007,2070,54450,35982,0.9559003241060517,2755600,1416920164,1414164564
529000.0,3,2.5,1880,4499,2.0,0,0,2,8,1880,0,1993,0.0,98029,47.5664,-121.999,2130,5114,2619,0.5821293620804623,3534400,20241001,16706601
750000.0,5,3.75,3500,101494,1.5,0,0,2,8,3500,0,1967,1990.0,98053,47.6745,-122.054,3250,38636,97994,0.9655152028691352,12250000,10301032036,10288782036
481500.0,3,2.25,1840,10500,2.0,0,0,2,7,1840,0,1993,0.0,98034,47.7326,-122.234,1840,7374,8660,0.8247619047619048,3385600,110250000,106864400
211000.0,3,2.0,1060,7412,1.0,0,0,2,7,1060,0,1987,0.0,98038,47.3897,-122.051,1080,7093,6352,0.8569886670264436,1123600,54937744,53814144
455000.0,3,2.25,1790,7500,1.0,0,0,2,7,1390,400,1973,0.0,98034,47.7321,-122.198,1940,7192,5710,0.7613333333333333,3204100,56250000,53045900
238950.0,2,1.0,810,4838,1.0,0,0,2,5,810,0,1938,0.0,98055,47.4909,-122.20299999999999,890,4838,4028,0.8325754443985118,656100,23406244,22750144
722500.0,4,3.5,2600,5100,2.0,0,0,2,8,1820,780,2003,0.0,98117,47.6948,-122.395,2000,6720,2500,0.49019607843137253,6760000,26010000,19250000
795000.0,4,2.5,3230,19193,1.0,0,3,3,8,2000,1230,1973,0.0,98075,47.5755,-122.07,3230,13420,15963,0.8317094774136404,10432900,368371249,357938349
327500.0,4,2.25,2240,9600,2.0,0,0,2,8,2240,0,1971,0.0,98032,47.361000000000004,-122.281,2050,9240,7360,0.7666666666666667,5017600,92160000,87142400
585000.0,4,3.0,3400,5100,2.0,0,0,2,9,3400,0,2006,0.0,98038,47.3548,-122.00200000000001,3400,5672,1700,0.3333333333333333,11560000,26010000,14450000
775000.0,4,2.0,3140,10875,1.0,0,1,2,7,1940,1200,1939,1969.0,98199,47.6656,-122.406,3300,10080,7735,0.7112643678160919,9859600,118265625,108406025
645000.0,4,2.5,2780,4200,2.0,0,0,2,8,2780,0,2001,0.0,98075,47.5989,-122.039,2510,4200,1420,0.3380952380952381,7728400,17640000,9911600
445000.0,4,2.75,2320,12368,1.0,0,0,2,8,1670,650,1968,0.0,98133,47.7373,-122.35,2070,9575,10048,0.8124191461836999,5382400,152967424,147585024
257950.0,3,1.75,1370,5858,1.0,0,0,2,7,1370,0,1987,0.0,98198,47.3815,-122.31299999999999,1400,7500,4488,0.7661317855923523,1876900,34316164,32439264
375000.0,5,1.75,2230,7560,1.0,0,0,2,7,1230,1000,1959,0.0,98178,47.5055,-122.26,1380,6570,5330,0.705026455026455,4972900,57153600,52180700
245000.0,3,2.5,1610,7223,2.0,0,0,2,7,1610,0,1994,0.0,98030,47.3661,-122.17299999999999,1610,7162,5613,0.7771009275924131,2592100,52171729,49579629
725000.0,3,2.5,3410,41022,2.0,0,0,2,11,3410,0,1990,0.0,98042,47.3228,-122.08,2150,21429,37612,0.9168738725561894,11628100,1682804484,1671176384
702000.0,4,2.5,2810,4922,2.0,0,0,2,9,2810,0,2005,0.0,98074,47.614,-122.041,2920,4922,2112,0.4290938642828119,7896100,24226084,16329984
330000.0,3,1.75,1850,14986,2.0,0,0,2,6,1850,0,1943,2005.0,98059,47.4837,-122.148,2660,10650,13136,0.8765514480181503,3422500,224580196,221157696
940000.0,3,1.5,1790,4800,1.5,0,0,2,8,1790,0,1912,0.0,98119,47.6332,-122.36200000000001,1780,3600,3010,0.6270833333333333,3204100,23040000,19835900
354500.0,3,1.0,1150,11396,1.5,0,0,3,7,1150,0,1950,0.0,98155,47.7435,-122.296,1600,8146,10246,0.8990873990873991,1322500,129868816,128546316
279950.0,4,2.75,2420,8700,1.5,0,0,3,7,2420,0,1914,0.0,98002,47.3109,-122.229,1070,4804,6280,0.7218390804597701,5856400,75690000,69833600
284000.0,3,2.25,1580,7034,1.0,0,0,3,7,1180,400,1989,0.0,98038,47.3564,-122.04,1470,7358,5454,0.7753767415410862,2496400,49477156,46980756
480000.0,5,2.0,1760,21562,1.0,0,1,2,8,1560,200,1959,0.0,98028,47.7597,-122.26299999999999,2150,12676,19802,0.9183749188386977,3097600,464919844,461822244
647500.0,5,2.0,1760,21562,1.0,0,1,2,8,1560,200,1959,0.0,98028,47.7597,-122.26299999999999,2150,12676,19802,0.9183749188386977,3097600,464919844,461822244
625000.0,3,2.5,2750,35000,2.0,0,0,2,9,2750,0,1993,0.0,98077,47.75,-122.024,2780,35862,32250,0.9214285714285714,7562500,1225000000,1217437500
152000.0,3,1.0,920,4875,1.0,0,0,3,7,920,0,1978,0.0,98042,47.3623,-122.09,1160,4875,3955,0.8112820512820513,846400,23765625,22919225
322000.0,3,1.0,960,10181,1.0,0,0,2,7,960,0,1961,0.0,98034,47.7231,-122.229,1740,10194,9221,0.9057067085747962,921600,103652761,102731161
445000.0,3,1.75,1120,4000,1.0,0,0,3,7,870,250,1916,0.0,98107,47.6684,-122.368,1470,4000,2880,0.72,1254400,16000000,14745600
595000.0,3,1.0,1560,3960,1.5,0,0,3,7,1560,0,1907,0.0,98144,47.5936,-122.301,1280,3960,2400,0.6060606060606061,2433600,15681600,13248000
165000.0,3,1.0,1380,7334,1.0,0,0,2,7,980,400,1981,0.0,98055,47.4339,-122.19200000000001,1910,7859,5954,0.8118352877011181,1904400,53787556,51883156
278500.0,4,2.5,1940,6206,2.0,0,0,2,7,1940,0,1990,0.0,98023,47.3063,-122.359,2060,7092,4266,0.6873992910087012,3763600,38514436,34750836
517500.0,3,1.75,1810,10625,1.0,0,0,2,8,1370,440,1973,0.0,98027,47.5322,-122.04899999999999,2140,10922,8815,0.8296470588235294,3276100,112890625,109614525
343566.0,2,1.0,1100,4200,1.0,0,0,2,7,1100,0,1954,0.0,98136,47.5312,-122.39200000000001,1240,4000,3100,0.7380952380952381,1210000,17640000,16430000
286285.0,4,2.25,1980,9714,1.0,0,0,2,7,1170,810,1977,0.0,98002,47.3207,-122.209,1610,9272,7734,0.7961704756022236,3920400,94361796,90441396
474905.0,4,1.5,1340,6200,1.0,0,0,4,6,1340,0,1959,0.0,98008,47.6214,-122.119,1210,7178,4860,0.7838709677419354,1795600,38440000,36644400
550000.0,3,1.75,1680,4800,1.0,0,0,3,7,1400,280,1960,0.0,98126,47.5535,-122.37700000000001,1540,5000,3120,0.65,2822400,23040000,20217600
286000.0,4,2.5,2060,16000,2.0,0,0,2,6,2060,0,1993,0.0,98001,47.2849,-122.251,1530,8000,13940,0.87125,4243600,256000000,251756400
900000.0,3,3.25,2620,7215,1.0,0,0,3,8,1770,850,1980,0.0,98004,47.5836,-122.2,2180,8931,4595,0.6368676368676369,6864400,52056225,45191825
449950.0,3,2.25,1610,5159,2.0,0,0,2,7,1610,0,1985,0.0,98029,47.5675,-122.01899999999999,1610,5210,3549,0.6879240162822252,2592100,26615281,24023181
259000.0,4,1.5,1490,7560,2.0,0,0,2,7,1490,0,1966,0.0,98198,47.3684,-122.318,1490,7689,6070,0.8029100529100529,2220100,57153600,54933500
340000.0,3,2.25,1900,8125,1.0,0,0,2,7,1540,360,1969,0.0,98058,47.4564,-122.162,1480,8284,6225,0.7661538461538462,3610000,66015625,62405625
785000.0,4,2.5,3440,56192,2.0,0,0,2,9,3440,0,1994,0.0,98053,47.6969,-122.046,3150,44431,52752,0.9387813211845103,11833600,3157540864,3145707264
490000.0,2,1.0,1840,3300,1.5,0,0,3,6,1130,710,1910,0.0,98107,47.6757,-122.36200000000001,1320,4000,1460,0.44242424242424244,3385600,10890000,7504400
344950.0,4,2.0,2330,6250,1.0,0,0,3,7,1400,930,1941,0.0,98030,47.3782,-122.228,2050,9000,3920,0.6272,5428900,39062500,33633600
950000.0,3,2.0,2250,2975,2.0,0,0,3,9,1880,370,1905,0.0,98112,47.6289,-122.309,2690,4800,725,0.24369747899159663,5062500,8850625,3788125
810000.0,4,1.75,2000,3988,1.0,0,4,3,7,1000,1000,1958,0.0,98116,47.5925,-122.391,1690,4144,1988,0.49849548645937813,4000000,15904144,11904144
998160.0,2,2.5,3010,16050,1.0,0,3,3,9,1260,1750,1976,0.0,98006,47.5643,-122.16,3010,11612,13040,0.8124610591900312,9060100,257602500,248542400
377000.0,3,1.75,1680,7389,1.0,0,0,2,8,1150,530,1979,0.0,98056,47.5199,-122.184,2100,10348,5709,0.7726349979699554,2822400,54597321,51774921
595000.0,3,2.0,1530,6773,1.0,0,0,3,8,1530,0,1984,0.0,98033,47.6653,-122.194,2240,7201,5243,0.7741030562527683,2340900,45873529,43532629
313300.0,2,1.0,970,4800,1.0,0,0,2,6,970,0,1911,1940.0,98116,47.5754,-122.414,1180,5900,3830,0.7979166666666667,940900,23040000,22099100
360000.0,5,1.75,1550,5225,1.5,0,0,3,7,1550,0,1941,0.0,98108,47.553999999999995,-122.306,1220,5225,3675,0.7033492822966507,2402500,27300625,24898125
188000.0,3,1.75,1660,7350,1.0,0,0,1,8,1660,0,1979,0.0,98023,47.3118,-122.337,1840,7673,5690,0.7741496598639456,2755600,54022500,51266900
755000.0,3,2.5,3680,203860,1.5,0,0,2,9,3680,0,1994,0.0,98014,47.6903,-121.929,2410,144183,200180,0.9819483959580104,13542400,41558899600,41545357200
1290000.0,5,3.5,3210,4060,2.0,0,2,2,10,2290,920,1917,2003.0,98117,47.6801,-122.35700000000001,1940,5000,850,0.20935960591133004,10304100,16483600,6179500
455000.0,3,1.0,1480,13280,2.5,0,0,2,6,1480,0,1940,0.0,98027,47.5378,-122.04299999999999,1510,8723,11800,0.8885542168674698,2190400,176358400,174168000
817500.0,5,3.5,3600,9312,2.0,0,3,2,10,2680,920,2005,0.0,98052,47.6582,-122.12200000000001,3420,9860,5712,0.6134020618556701,12960000,86713344,73753344
550000.0,3,2.25,1700,1481,3.0,0,0,2,8,1700,0,2002,0.0,98103,47.6598,-122.34899999999999,1560,1350,-219,-0.14787305874409182,2890000,2193361,-696639
260000.0,3,1.75,1680,8725,1.0,0,0,2,8,1240,440,1978,0.0,98023,47.3107,-122.397,2020,8352,7045,0.8074498567335243,2822400,76125625,73303225
320000.0,3,2.0,1550,34175,1.5,0,0,2,7,1550,0,1999,0.0,98045,47.4855,-121.698,2300,35174,32625,0.9546452084857352,2402500,1167930625,1165528125
1150000.0,3,3.25,3780,10623,1.0,0,1,2,11,2650,1130,1999,0.0,98006,47.5506,-122.101,3850,11170,6843,0.6441683140355832,14288400,112848129,98559729
362000.0,4,2.5,2360,7370,1.0,0,0,2,7,1460,900,1985,0.0,98125,47.7201,-122.30799999999999,1590,9906,5010,0.6797829036635007,5569600,54316900,48747300
503500.0,3,2.5,1810,1750,2.0,0,0,2,7,1350,460,1997,0.0,98199,47.6513,-122.38600000000001,1640,1563,-60,-0.03428571428571429,3276100,3062500,-213600
653000.0,3,2.5,2290,3475,2.0,0,0,2,9,2290,0,2006,0.0,98029,47.5551,-122.001,2340,3626,1185,0.3410071942446043,5244100,12075625,6831525
760000.0,4,2.75,3370,12447,2.0,0,0,2,10,3370,0,1991,0.0,98077,47.7309,-122.05799999999999,3700,13129,9077,0.7292520286012694,11356900,154927809,143570909
775000.0,4,1.75,2090,5050,1.0,0,0,3,7,1090,1000,1916,0.0,98117,47.6802,-122.35799999999999,1760,5000,2960,0.5861386138613861,4368100,25502500,21134400
1340000.0,4,3.75,2130,34689,1.5,1,4,2,9,2130,0,1955,0.0,98136,47.5489,-122.398,3030,28598,32559,0.9385972498486552,4536900,1203326721,1198789821
417500.0,5,1.75,2060,10911,1.0,0,0,3,7,1360,700,1954,0.0,98177,47.7767,-122.365,2060,9688,8851,0.811199706717991,4243600,119049921,114806321
525000.0,3,1.5,1560,9350,1.0,0,0,3,7,1220,340,1969,0.0,98052,47.6729,-122.148,1870,8671,7790,0.8331550802139037,2433600,87422500,84988900
217000.0,2,1.0,730,2400,1.0,0,1,2,4,730,0,1934,0.0,98198,47.35,-122.322,1220,4382,1670,0.6958333333333333,532900,5760000,5227100
525000.0,4,2.75,2910,6308,1.0,0,0,2,8,1640,1270,1985,0.0,98011,47.7352,-122.20100000000001,1970,7127,3398,0.5386810399492707,8468100,39790864,31322764
442500.0,4,2.25,2490,8700,1.0,0,0,2,7,1890,600,1976,0.0,98155,47.7397,-122.324,1470,7975,6210,0.7137931034482758,6200100,75690000,69489900
525000.0,4,1.75,1710,10440,1.0,0,0,3,7,1710,0,1955,0.0,98006,47.5756,-122.15799999999999,1480,10440,8730,0.8362068965517241,2924100,108993600,106069500
425500.0,4,1.75,1520,10630,1.0,0,0,3,7,1520,0,1967,0.0,98034,47.7347,-122.193,1550,8039,9110,0.8570084666039511,2310400,112996900,110686500
710000.0,3,2.75,2930,218235,2.0,0,2,2,8,2930,0,1990,0.0,98024,47.5481,-121.88600000000001,2450,218235,215305,0.9865741058950214,8584900,47626515225,47617930325
545000.0,4,3.0,3160,10948,1.0,0,3,2,8,1930,1230,1991,0.0,98070,47.3733,-122.42200000000001,2380,13623,7788,0.711362805991962,9985600,119858704,109873104
410000.0,5,2.75,2910,16410,1.5,0,0,3,8,2910,0,1967,0.0,98058,47.44,-122.145,1980,18000,13500,0.8226691042047533,8468100,269288100,260820000
245000.0,3,2.25,1700,8100,1.0,0,0,2,7,1200,500,1980,0.0,98038,47.3601,-122.046,1700,8100,6400,0.7901234567901234,2890000,65610000,62720000
194900.0,2,1.0,810,6697,1.0,0,0,3,6,810,0,1923,0.0,98002,47.3057,-122.21600000000001,1140,6695,5887,0.8790503210392713,656100,44849809,44193709
284000.0,4,2.5,2000,5390,2.0,0,0,2,7,2000,0,2003,0.0,98042,47.3732,-122.12899999999999,2330,5390,3390,0.6289424860853432,4000000,29052100,25052100
280000.0,2,1.75,1894,52769,1.5,0,0,3,6,1520,374,1936,0.0,98001,47.3088,-122.273,1820,50529,50875,0.96410771475677,3587236,2784567361,2780980125
280000.0,3,1.75,2080,87991,1.0,0,0,2,6,1040,1040,1970,0.0,98014,47.6724,-121.865,2080,84300,85911,0.9763612187610097,4326400,7742416081,7738089681
360000.0,4,2.0,1730,5500,1.0,0,0,4,7,1010,720,1943,0.0,98106,47.5304,-122.353,1080,4900,3770,0.6854545454545454,2992900,30250000,27257100
405000.0,2,1.0,720,4323,1.0,0,0,2,6,720,0,1942,0.0,98199,47.6604,-122.40100000000001,1460,3300,3603,0.8334489937543372,518400,18688329,18169929
865000.0,4,2.5,3560,13981,2.0,0,0,2,10,3560,0,2000,0.0,98075,47.6002,-121.98,3840,13624,10421,0.7453687146842143,12673600,195468361,182794761
483300.0,4,2.0,1210,11100,1.0,0,0,3,7,1210,0,1955,0.0,98006,47.5747,-122.145,1280,11100,9890,0.890990990990991,1464100,123210000,121745900
355000.0,4,2.5,2130,9268,2.0,0,0,3,8,2130,0,1985,0.0,98092,47.262,-122.22,2100,8400,7138,0.7701769529564092,4536900,85895824,81358924
274950.0,3,2.25,1570,8767,1.0,0,0,2,7,1180,390,1990,0.0,98038,47.3568,-122.038,1570,7434,7197,0.8209193566784533,2464900,76860289,74395389
1930000.0,3,4.5,3950,6134,2.0,0,3,2,11,2880,1070,1998,0.0,98199,47.6413,-122.405,3050,5281,2184,0.35604825562438863,15602500,37625956,22023456
755000.0,3,3.25,3450,15586,2.0,0,0,2,11,2690,760,1989,0.0,98166,47.4294,-122.34299999999999,3560,15046,12136,0.7786475041704093,11902500,242923396,231020896
1940000.0,4,5.75,7220,223462,2.0,0,4,2,12,6220,1000,2000,0.0,98053,47.7097,-122.01299999999999,2680,7593,216242,0.9676902560614332,52128400,49935265444,49883137044
309212.0,3,1.75,1150,9600,1.0,0,0,2,7,1150,0,1979,0.0,98045,47.4434,-121.774,1520,9976,8450,0.8802083333333334,1322500,92160000,90837500
219950.0,3,2.25,1500,7615,1.0,0,0,2,7,1150,350,1984,0.0,98023,47.3146,-122.351,1540,8649,6115,0.8030203545633617,2250000,57988225,55738225
690000.0,3,2.5,1300,5150,1.5,0,0,3,7,1300,0,1920,0.0,98117,47.6838,-122.36200000000001,1400,4017,3850,0.7475728155339806,1690000,26522500,24832500
250800.0,3,1.75,1290,4000,1.0,0,0,2,6,1170,120,1943,0.0,98106,47.5309,-122.354,1140,4000,2710,0.6775,1664100,16000000,14335900
557500.0,3,2.0,2510,35255,1.0,0,2,2,9,2510,0,1994,0.0,98038,47.4012,-122.025,3140,36450,32745,0.9288044249042688,6300100,1242915025,1236614925
941000.0,4,1.75,2320,3825,1.5,0,0,4,8,1820,500,1926,0.0,98105,47.6659,-122.32700000000001,1940,3825,1505,0.3934640522875817,5382400,14630625,9248225
3650000.0,6,4.75,5480,19401,1.5,1,4,4,11,3910,1570,1936,0.0,98105,47.6515,-122.277,3510,15810,13921,0.7175403329725272,30030400,376398801,346368401
305000.0,4,2.75,2030,8600,1.0,0,0,3,7,1230,800,1977,0.0,98042,47.3942,-122.16,1810,8600,6570,0.763953488372093,4120900,73960000,69839100
815000.0,4,1.5,2060,16110,1.0,0,0,3,8,2060,0,1949,0.0,98004,47.5983,-122.20200000000001,2060,16110,14050,0.8721291123525761,4243600,259532100,255288500
1020000.0,3,2.5,2920,34527,1.0,0,4,3,9,1800,1120,1954,1983.0,98116,47.5799,-122.4,2480,7933,31607,0.9154285052277927,8526400,1192113729,1183587329
1240000.0,4,3.0,3330,6990,1.5,0,3,4,9,2330,1000,1928,0.0,98144,47.5886,-122.287,2620,5310,3660,0.5236051502145923,11088900,48860100,37771200
535000.0,3,2.5,2110,8164,2.0,0,0,2,9,2110,0,1990,0.0,98056,47.5269,-122.171,2390,7499,6054,0.7415482606565409,4452100,66650896,62198796
775000.0,3,1.0,1175,10454,1.0,0,0,3,6,1175,0,1949,0.0,98004,47.6388,-122.21799999999999,2010,10800,9279,0.8876028314520757,1380625,109286116,107905491
255000.0,3,2.0,1590,8670,1.0,0,0,2,7,1590,0,1994,0.0,98042,47.3725,-122.073,1590,9253,7080,0.8166089965397924,2528100,75168900,72640800
327000.0,2,1.0,1070,9750,1.0,0,0,2,7,1070,0,1947,0.0,98155,47.7532,-122.318,1500,8775,8680,0.8902564102564102,1144900,95062500,93917600
560000.0,4,2.0,2720,8819,2.0,0,3,2,8,2240,480,1976,0.0,98003,47.338,-122.333,2960,9672,6099,0.6915750085043656,7398400,77774761,70376361
1340000.0,4,3.5,2980,6349,2.0,0,3,2,9,2980,0,1998,0.0,98033,47.6819,-122.208,2870,6349,3369,0.530634745629233,8880400,40309801,31429401
199500.0,3,1.75,1160,5200,1.0,0,0,3,7,1160,0,1977,0.0,98042,47.3643,-122.09,1470,5200,4040,0.7769230769230769,1345600,27040000,25694400
760000.0,4,2.5,3580,97574,2.0,0,0,2,9,3580,0,2004,0.0,98038,47.3901,-122.071,2510,27068,93994,0.9633098981285998,12816400,9520685476,9507869076
439000.0,3,2.25,3020,6000,3.0,0,2,2,8,1980,1040,1994,0.0,98108,47.5249,-122.319,1150,6000,2980,0.49666666666666665,9120400,36000000,26879600
527000.0,4,2.25,2380,5250,1.0,0,0,3,7,1410,970,1961,0.0,98008,47.6164,-122.115,2150,8560,2870,0.5466666666666666,5664400,27562500,21898100
199950.0,3,2.75,2270,13590,1.5,0,0,3,6,1300,970,1948,0.0,98022,47.2099,-122.001,1160,13545,11320,0.8329654157468727,5152900,184688100,179535200
254000.0,3,2.25,1660,8188,2.0,0,0,3,7,1660,0,1988,0.0,98042,47.3766,-122.115,1660,7000,6528,0.7972642892037127,2755600,67043344,64287744
393000.0,2,1.0,830,5000,1.0,0,0,3,7,830,0,1921,0.0,98103,47.6914,-122.352,1110,5000,4170,0.834,688900,25000000,24311100
585000.0,5,2.25,2480,12614,1.0,0,0,3,8,1860,620,1979,0.0,98011,47.7393,-122.2,2470,12392,10134,0.8033930553353417,6150400,159112996,152962596
450000.0,2,2.0,1900,7740,1.0,0,0,3,7,1150,750,1923,0.0,98126,47.5227,-122.37200000000001,1140,7740,5840,0.7545219638242894,3610000,59907600,56297600
565000.0,2,1.75,1670,4008,1.0,0,0,2,9,1670,0,2005,0.0,98029,47.5539,-122.001,2330,3752,2338,0.5833333333333334,2788900,16064064,13275164
330000.0,5,2.25,2000,7900,1.0,0,0,3,7,1300,700,1986,0.0,98188,47.4291,-122.292,2000,9132,5900,0.7468354430379747,4000000,62410000,58410000
870000.0,3,2.0,2320,65340,1.5,0,0,2,9,2320,0,1992,0.0,98074,47.6106,-122.055,3100,59603,63020,0.9644934190388735,5382400,4269315600,4263933200
585000.0,4,2.5,1860,8117,1.0,0,0,3,8,1460,400,1966,0.0,98008,47.6228,-122.104,2040,8199,6257,0.7708512997412837,3459600,65885689,62426089
500000.0,3,2.5,2110,208737,2.0,0,3,2,9,2110,0,1977,0.0,98092,47.2674,-122.072,2390,125017,206627,0.9898915860628447,4452100,43571135169,43566683069
225000.0,3,2.0,1400,7384,1.0,0,0,2,7,1150,250,1979,0.0,98058,47.4655,-122.17399999999999,1820,7992,5984,0.8104008667388949,1960000,54523456,52563456
295000.0,3,2.0,1400,7384,1.0,0,0,2,7,1150,250,1979,0.0,98058,47.4655,-122.17399999999999,1820,7992,5984,0.8104008667388949,1960000,54523456,52563456
775000.0,3,2.75,2850,14800,1.0,0,0,3,9,1920,930,1976,0.0,98006,47.559,-122.146,3300,10809,11950,0.8074324324324325,8122500,219040000,210917500
280000.0,3,1.0,1370,11050,1.0,0,0,2,7,1370,0,1981,0.0,98045,47.4485,-121.77600000000001,1520,10000,9680,0.8760180995475113,1876900,122102500,120225600
539000.0,3,2.5,2170,3200,1.5,0,0,4,7,1280,890,1923,0.0,98103,47.6543,-122.34700000000001,1180,1224,1030,0.321875,4708900,10240000,5531100
567500.0,3,1.75,2570,14033,1.0,0,2,3,8,2570,0,1953,0.0,98166,47.4335,-122.338,2550,16100,11463,0.816860257963372,6604900,196925089,190320189
442500.0,4,2.25,1970,7902,1.0,0,0,2,8,1310,660,1960,0.0,98125,47.7249,-122.29799999999999,1860,8021,5932,0.75069602632245,3880900,62441604,58560704
598200.0,5,3.75,2980,4635,3.0,0,0,2,8,2980,0,1997,0.0,98118,47.5508,-122.26799999999999,1100,5150,1655,0.35706580366774543,8880400,21483225,12602825
610000.0,4,2.5,2300,10843,2.0,0,0,4,8,2300,0,1955,0.0,98033,47.6988,-122.20200000000001,1780,10843,8543,0.7878815825878447,5290000,117570649,112280649
544900.0,3,2.5,1990,4936,2.0,0,0,2,8,1990,0,2004,0.0,98075,47.5911,-122.01799999999999,2250,4815,2946,0.596839546191248,3960100,24364096,20403996
557500.0,4,2.5,2390,38258,2.0,0,0,2,8,2390,0,2001,0.0,98072,47.7433,-122.094,1960,17113,35868,0.937529405614512,5712100,1463674564,1457962464
532500.0,3,2.5,2160,7500,1.0,0,1,2,7,1430,730,1979,0.0,98074,47.6188,-122.064,1560,7500,5340,0.712,4665600,56250000,51584400
1350000.0,4,3.25,3300,15907,2.0,0,0,4,10,3300,0,1985,0.0,98040,47.5413,-122.21600000000001,2740,11358,12607,0.7925441629471301,10890000,253032649,242142649
750000.0,3,2.0,1840,2825,1.0,0,0,2,7,1040,800,1920,0.0,98112,47.6428,-122.302,1820,3750,985,0.3486725663716814,3385600,7980625,4595025
530000.0,3,2.5,2030,10958,2.0,0,0,2,8,2030,0,1983,0.0,98052,47.7251,-122.11,1960,10282,8928,0.8147472166453732,4120900,120077764,115956864
346100.0,3,2.5,1400,2036,2.0,0,0,2,7,1400,0,2003,0.0,98136,47.5516,-122.382,1500,2036,636,0.31237721021611004,1960000,4145296,2185296
260000.0,4,2.25,2320,16800,2.0,0,0,3,9,2320,0,1977,0.0,98092,47.2959,-122.166,2700,15680,14480,0.861904761904762,5382400,282240000,276857600
365000.0,3,1.75,1410,9150,1.0,0,0,4,7,1410,0,1959,0.0,98006,47.5683,-122.178,1800,9940,7740,0.8459016393442623,1988100,83722500,81734400
615000.0,3,2.0,1860,42800,1.0,0,0,3,7,930,930,1983,0.0,98075,47.5898,-122.00399999999999,1980,11250,40940,0.9565420560747664,3459600,1831840000,1828380400
318400.0,4,2.5,1820,6916,2.0,0,0,2,7,1820,0,1994,0.0,98038,47.3862,-122.029,1680,6995,5096,0.7368421052631579,3312400,47831056,44518656
498500.0,4,2.5,1910,7172,2.0,0,0,2,8,1910,0,1993,0.0,98155,47.7615,-122.309,1630,10127,5262,0.7336865588399331,3648100,51437584,47789484
450000.0,3,1.75,1540,7490,1.0,0,0,4,7,1540,0,1971,0.0,98034,47.7222,-122.177,1270,7350,5950,0.794392523364486,2371600,56100100,53728500
200000.0,3,2.0,1430,7905,1.0,0,0,3,7,1430,0,1988,0.0,98092,47.2757,-122.145,1870,8400,6475,0.8191018342820999,2044900,62489025,60444125
234000.0,3,1.0,1010,8906,1.0,0,0,4,7,1010,0,1968,0.0,98042,47.3627,-122.10799999999999,1150,10414,7896,0.8865933078823265,1020100,79316836,78296736
121800.0,2,1.0,940,8384,1.0,0,0,2,5,940,0,1947,0.0,98146,47.5065,-122.36399999999999,1290,8384,7444,0.887881679389313,883600,70291456,69407856
805000.0,3,2.75,2600,5875,1.5,0,2,4,8,1600,1000,1929,0.0,98116,47.5773,-122.406,2260,5492,3275,0.5574468085106383,6760000,34515625,27755625
410000.0,4,2.25,2060,7283,1.0,0,0,2,8,1220,840,1963,2013.0,98155,47.7435,-122.31700000000001,1500,8134,5223,0.7171495262941096,4243600,53042089,48798489
475000.0,3,2.5,1920,4534,2.0,0,0,2,8,1920,0,1986,0.0,98034,47.7144,-122.204,1380,5100,2614,0.5765328628142921,3686400,20557156,16870756
1340000.0,4,2.5,2900,21074,2.0,0,0,2,11,2900,0,1986,0.0,98199,47.6696,-122.416,3390,20000,18174,0.8623896744804024,8410000,444113476,435703476
269000.0,1,1.0,1020,7920,1.0,0,0,2,7,1020,0,1947,1983.0,98106,47.5385,-122.355,1000,7168,6900,0.8712121212121212,1040400,62726400,61686000
573000.0,4,2.25,2150,9520,2.0,0,0,3,8,2150,0,1979,0.0,98052,47.6885,-122.113,2000,9520,7370,0.7741596638655462,4622500,90630400,86007900
330000.0,3,2.5,1660,2890,2.0,0,0,2,7,1660,0,2001,0.0,98108,47.5434,-122.29299999999999,1540,2890,1230,0.42560553633217996,2755600,8352100,5596500
252750.0,4,1.0,1230,7410,1.5,0,0,2,7,1230,0,1944,0.0,98166,47.4798,-122.344,1020,7648,6180,0.8340080971659919,1512900,54908100,53395200
745000.0,2,2.5,2170,7546,1.0,0,0,2,8,2170,0,2007,0.0,98053,47.7242,-122.03200000000001,2170,7083,5376,0.712430426716141,4708900,56942116,52233216
280000.0,3,2.0,1280,7633,1.0,0,0,2,7,1280,0,1991,0.0,98038,47.3883,-122.05,1450,6783,6353,0.8323070876457487,1638400,58262689,56624289
535000.0,4,2.5,2240,6920,1.0,0,0,4,8,1380,860,1974,0.0,98146,47.5011,-122.375,1540,7000,4680,0.6763005780346821,5017600,47886400,42868800
580000.0,4,1.5,1780,5100,1.0,0,0,2,7,1320,0,1953,0.0,98115,47.6944,-122.288,1880,5100,3320,0.6509803921568628,3168400,26010000,22841600
301000.0,3,1.75,1840,7200,1.0,0,0,3,7,1220,620,1968,0.0,98055,47.456,-122.209,1770,8075,5360,0.7444444444444445,3385600,51840000,48454400
600000.0,4,1.75,1740,7700,1.0,0,0,4,7,1740,0,1968,0.0,98008,47.6259,-122.111,1740,8120,5960,0.7740259740259741,3027600,59290000,56262400
538900.0,5,3.0,3040,6604,2.0,0,0,2,9,3040,0,2005,0.0,98106,47.548,-122.35600000000001,1650,6825,3564,0.5396729254996971,9241600,43612816,34371216
366000.0,3,2.5,2370,4375,2.0,0,0,2,8,2370,0,2006,0.0,98038,47.354,-121.999,2380,4606,2005,0.4582857142857143,5616900,19140625,13523725
303000.0,4,2.5,2100,6783,2.0,0,0,2,8,2100,0,2003,0.0,98042,47.3504,-122.141,2100,6192,4683,0.6904024767801857,4410000,46009089,41599089
432000.0,3,2.25,1470,1578,2.0,0,0,2,8,1090,380,2007,0.0,98136,47.5388,-122.387,1470,1668,108,0.06844106463878327,2160900,2490084,329184
300000.0,2,1.5,1300,6120,1.0,0,0,2,6,820,480,1945,0.0,98146,47.5088,-122.338,1250,6120,4820,0.7875816993464052,1690000,37454400,35764400
908800.0,3,3.0,3420,7826,2.0,0,0,3,8,2430,990,1939,0.0,98144,47.5873,-122.29,980,6300,4406,0.5629951443904933,11696400,61246276,49549876
500000.0,3,1.5,1190,4750,1.0,0,0,2,7,970,220,1940,0.0,98107,47.6726,-122.38600000000001,1460,4750,3560,0.7494736842105263,1416100,22562500,21146400
254000.0,5,2.0,2080,16117,1.0,0,0,4,7,1740,340,1959,0.0,98001,47.3424,-122.289,1510,13068,14037,0.8709437240181175,4326400,259757689,255431289
470000.0,5,1.5,2180,4268,1.5,0,0,3,7,1340,840,1924,0.0,98117,47.6848,-122.389,1530,3880,2088,0.48922211808809746,4752400,18215824,13463424
480000.0,3,2.0,1460,7860,1.0,0,0,4,7,1460,0,1967,0.0,98008,47.6233,-122.10799999999999,1850,8148,6400,0.8142493638676844,2131600,61779600,59648000
536000.0,3,1.75,1530,8503,1.0,0,0,3,7,1150,380,1983,0.0,98033,47.6872,-122.185,1610,8549,6973,0.8200635069975303,2340900,72301009,69960109
1350000.0,4,3.5,4740,8611,2.0,0,3,2,11,3640,1100,2006,0.0,98027,47.5375,-122.07,4042,8321,3871,0.44954128440366975,22467600,74149321,51681721
550000.0,3,2.25,1980,40887,1.0,0,0,3,8,1980,0,1980,0.0,98052,47.6478,-122.029,2460,35700,38907,0.9515738498789347,3920400,1671746769,1667826369
260000.0,3,1.75,1710,6400,1.0,0,0,3,7,1240,470,1976,0.0,98023,47.3036,-122.37700000000001,1600,6400,4690,0.7328125,2924100,40960000,38035900
284900.0,2,1.5,1160,982,2.0,0,0,2,7,890,0,2006,0.0,98155,47.7675,-122.315,1160,1008,-178,-0.18126272912423624,1345600,964324,-381276
740000.0,3,2.5,2200,3000,2.0,0,0,2,9,1530,670,2002,0.0,98109,47.6451,-122.35,2200,3300,800,0.26666666666666666,4840000,9000000,4160000
425000.0,2,1.0,1170,5000,1.0,0,0,3,7,1030,140,1920,0.0,98136,47.5449,-122.38799999999999,1170,5850,3830,0.766,1368900,25000000,23631100
230000.0,3,1.0,1120,7500,1.0,0,0,2,7,1120,0,1965,0.0,98146,47.5112,-122.359,1120,5000,6380,0.8506666666666667,1254400,56250000,54995600
675000.0,3,1.5,1710,4000,2.0,0,0,2,8,1710,0,1926,0.0,98116,47.5714,-122.385,1910,4000,2290,0.5725,2924100,16000000,13075900
267500.0,3,1.75,1650,7807,1.0,0,0,2,7,1650,0,1986,0.0,98030,47.3514,-122.167,1810,8475,6157,0.7886512104521584,2722500,60949249,58226749
814000.0,4,2.5,2840,8820,1.0,0,2,4,8,1420,1420,1952,0.0,98118,47.5542,-122.265,2310,8750,5980,0.6780045351473923,8065600,77792400,69726800
1250000.0,4,3.0,3310,217800,1.5,0,0,2,9,3310,0,1989,0.0,98053,47.6616,-121.999,2810,217800,214490,0.9848025711662075,10956100,47436840000,47425883900
460000.0,3,2.0,1860,7232,1.0,0,0,2,7,1320,540,1985,0.0,98125,47.7165,-122.319,1830,7220,5372,0.7428097345132744,3459600,52301824,48842224
445000.0,3,2.5,2250,9608,2.0,0,0,2,8,2250,0,1994,0.0,98045,47.4865,-121.802,2020,9834,7358,0.765820149875104,5062500,92313664,87251164
715000.0,3,2.5,2890,7027,2.0,0,0,2,8,2890,0,2004,0.0,98074,47.6111,-122.009,2890,7197,4137,0.5887291874199516,8352100,49378729,41026629
425000.0,3,1.75,2120,5992,1.0,0,0,2,7,1060,1060,1947,0.0,98125,47.7083,-122.30799999999999,1840,11000,3872,0.6461949265687583,4494400,35904064,31409664
370000.0,4,2.5,2130,4750,2.0,0,0,2,8,2130,0,2009,0.0,98058,47.4324,-122.184,2130,4071,2620,0.5515789473684211,4536900,22562500,18025600
302000.0,2,1.75,1170,8200,1.0,0,0,3,6,780,390,1937,0.0,98003,47.3263,-122.305,1780,9020,7030,0.8573170731707317,1368900,67240000,65871100
453000.0,4,1.75,2120,7420,1.0,0,0,3,7,1060,1060,1956,0.0,98008,47.6019,-122.13,1540,7420,5300,0.7142857142857143,4494400,55056400,50562000
290000.0,3,1.75,1280,10716,1.0,0,0,3,7,1280,0,1969,0.0,98059,47.4755,-122.145,1440,9870,9436,0.8805524449421426,1638400,114832656,113194256
1040000.0,4,2.5,3170,47502,2.0,0,0,2,10,3170,0,1988,0.0,98033,47.6495,-122.185,3190,35110,44332,0.9332659677487264,10048900,2256440004,2246391104
925000.0,4,2.25,2260,41984,1.0,0,0,3,9,2260,0,1967,0.0,98033,47.6622,-122.171,2650,37318,39724,0.9461699695121951,5107600,1762656256,1757548656
600000.0,3,1.75,2930,19876,1.0,0,0,2,9,2030,900,1993,0.0,98072,47.7443,-122.17,2740,11499,16946,0.8525860334071241,8584900,395055376,386470476
354000.0,3,1.5,1060,5750,1.0,0,2,3,7,1060,0,1981,0.0,98126,47.5512,-122.37100000000001,1060,5750,4690,0.8156521739130435,1123600,33062500,31938900
204950.0,4,1.75,1740,9344,1.0,0,0,2,7,1180,560,1978,0.0,98023,47.3196,-122.399,1440,12884,7604,0.8137842465753424,3027600,87310336,84282736
675000.0,4,2.5,2990,5400,2.0,0,0,2,8,2990,0,2005,0.0,98074,47.6122,-122.009,2890,6538,2410,0.4462962962962963,8940100,29160000,20219900
995000.0,4,3.25,3530,20012,2.0,0,0,2,11,3530,0,1986,0.0,98052,47.7193,-122.12700000000001,3850,20707,16482,0.8236058364981012,12460900,400480144,388019244
800000.0,5,2.0,2960,10960,1.0,0,0,3,7,1500,1460,1957,0.0,98005,47.6162,-122.17399999999999,2160,10960,8000,0.7299270072992701,8761600,120121600,111360000
472500.0,3,2.5,1650,3711,2.0,0,0,2,8,1650,0,1996,0.0,98052,47.6863,-122.09299999999999,1760,3762,2061,0.555375909458367,2722500,13771521,11049021
549950.0,4,2.5,2720,13500,1.0,0,0,2,8,1510,1210,1969,0.0,98007,47.6191,-122.145,2510,12350,10780,0.7985185185185185,7398400,182250000,174851600
575575.0,3,1.75,1516,2897,1.0,0,0,2,7,998,518,1925,0.0,98103,47.6842,-122.34100000000001,2100,3854,1381,0.4767000345184674,2298256,8392609,6094353
545000.0,4,3.25,4386,12275,1.0,0,0,2,10,2356,2030,2006,0.0,98092,47.3329,-122.2,3060,10925,7889,0.6426883910386966,19236996,150675625,131438629
340000.0,3,2.25,2580,7434,1.0,0,0,2,7,1630,950,1963,0.0,98133,47.7446,-122.33200000000001,1920,7737,4854,0.6529459241323649,6656400,55264356,48607956
225000.0,3,1.0,960,5512,1.0,0,0,3,6,960,0,1963,0.0,98056,47.4944,-122.165,1090,5837,4552,0.8258345428156749,921600,30382144,29460544
299950.0,2,1.75,1460,10506,1.0,0,0,2,7,1460,0,1983,0.0,98031,47.4048,-122.178,1460,8153,9046,0.8610317913573197,2131600,110376036,108244436
829900.0,4,3.5,3840,4000,2.0,0,0,2,8,2640,1200,2001,0.0,98105,47.6642,-122.291,1620,4000,160,0.04,14745600,16000000,1254400
340000.0,4,2.5,2090,4200,2.0,0,0,2,7,2090,0,2007,0.0,98038,47.3659,-122.01700000000001,2090,4200,2110,0.5023809523809524,4368100,17640000,13271900
515000.0,4,2.25,2470,7800,1.0,0,0,2,8,1470,1000,1975,0.0,98052,47.6913,-122.115,2050,8050,5330,0.6833333333333333,6100900,60840000,54739100
601000.0,4,2.5,2090,6906,2.0,0,0,3,8,2090,0,1992,0.0,98029,47.5718,-121.99600000000001,2090,6370,4816,0.6973646104836374,4368100,47692836,43324736
470000.0,3,2.5,2070,8581,2.0,0,0,2,8,2070,0,1994,0.0,98059,47.5101,-122.15100000000001,2440,7849,6511,0.7587693741988113,4284900,73633561,69348661
371500.0,3,1.0,1650,6400,1.0,0,0,3,7,980,670,1954,0.0,98106,47.52,-122.365,1230,6400,4750,0.7421875,2722500,40960000,38237500
550000.0,3,1.75,1880,45738,1.0,0,0,3,8,1410,470,1980,0.0,98072,47.7662,-122.11399999999999,2340,38556,43858,0.9588963225326862,3534400,2091964644,2088430244
242550.0,4,2.5,2060,7720,2.0,0,0,2,8,2060,0,1995,0.0,98023,47.2956,-122.374,1630,7720,5660,0.7331606217616581,4243600,59598400,55354800
367500.0,3,1.5,1410,9647,1.0,0,0,2,8,1410,0,1961,0.0,98177,47.7608,-122.361,2090,9272,8237,0.853840572198611,1988100,93064609,91076509
359000.0,4,3.5,2770,8763,2.0,0,0,2,8,2100,670,1996,0.0,98003,47.2625,-122.30799999999999,2030,7242,5993,0.6838982083761269,7672900,76790169,69117269
204900.0,3,2.0,1390,8245,1.0,0,0,1,7,1390,0,1984,0.0,98001,47.2669,-122.25399999999999,1260,8245,6855,0.8314129775621589,1932100,67980025,66047925
850000.0,4,2.75,5440,239580,1.0,0,0,1,9,2720,2720,1969,0.0,98001,47.354,-122.29299999999999,1970,40392,234140,0.9772935971283079,29593600,57398576400,57368982800
187000.0,3,1.5,1280,4452,2.0,0,0,2,6,1280,0,1985,0.0,98002,47.3344,-122.21600000000001,1070,4366,3172,0.7124887690925427,1638400,19820304,18181904
326000.0,3,2.75,1720,28000,1.0,0,0,3,7,1720,0,1958,0.0,98058,47.4375,-122.176,2000,41817,26280,0.9385714285714286,2958400,784000000,781041600
340000.0,3,2.75,1720,28000,1.0,0,0,3,7,1720,0,1958,0.0,98058,47.4375,-122.176,2000,41817,26280,0.9385714285714286,2958400,784000000,781041600
330000.0,6,2.25,3040,28535,1.0,0,0,2,8,1890,1150,1951,0.0,98030,47.3864,-122.223,1360,8250,25495,0.8934641668126861,9241600,814246225,805004625
782000.0,4,3.5,3780,7769,2.0,0,0,2,9,3110,670,2001,0.0,98052,47.691,-122.12899999999999,3310,7945,3989,0.5134508945810271,14288400,60357361,46068961
612000.0,4,2.5,2670,5974,2.0,0,0,2,8,2670,0,1999,0.0,98034,47.7122,-122.23100000000001,2140,5729,3304,0.5530632741881486,7128900,35688676,28559776
400000.0,3,2.0,1350,7216,1.0,0,0,2,7,1350,0,1964,0.0,98177,47.7616,-122.365,1920,7600,5866,0.8129157427937915,1822500,52070656,50248156
941500.0,5,3.5,3490,9680,2.0,0,4,2,9,2460,1030,1980,0.0,98177,47.7757,-122.391,3080,13489,6190,0.6394628099173554,12180100,93702400,81522300
313000.0,2,1.5,870,747,2.0,0,0,2,8,800,0,2004,0.0,98103,47.6967,-122.34200000000001,1710,1280,-123,-0.1646586345381526,756900,558009,-198891
735000.0,4,2.25,2410,4250,1.5,0,0,4,7,1460,950,1929,0.0,98117,47.6849,-122.376,1360,5074,1840,0.4329411764705882,5808100,18062500,12254400
471000.0,3,1.75,1640,10123,1.0,0,0,2,8,1340,300,1977,0.0,98011,47.7698,-122.167,2210,10852,8483,0.8379926899140571,2689600,102475129,99785529
350000.0,3,1.0,1540,9800,1.0,0,0,3,7,1540,0,1950,0.0,98155,47.7604,-122.329,1560,9450,8260,0.8428571428571429,2371600,96040000,93668400
530000.0,4,2.5,2370,9601,1.0,0,0,2,8,1570,800,1976,0.0,98027,47.5327,-122.054,2550,10500,7231,0.7531507134673472,5616900,92179201,86562301
415000.0,4,3.0,1830,9548,2.0,0,0,2,7,1830,0,1991,0.0,98028,47.7379,-122.22399999999999,1740,9750,7718,0.8083368244658568,3348900,91164304,87815404
639500.0,4,2.25,2330,8994,2.0,0,0,2,8,2330,0,1986,0.0,98052,47.7264,-122.104,2330,8396,6664,0.7409384033800311,5428900,80892036,75463136
580379.0,4,2.75,2240,27820,1.5,0,0,3,8,2240,0,1976,0.0,98075,47.5936,-122.054,2330,20000,25580,0.9194823867721064,5017600,773952400,768934800
378000.0,2,2.5,1700,2513,2.0,0,0,2,8,1700,0,2009,0.0,98065,47.5163,-121.87799999999999,1760,2891,813,0.3235177079188221,2890000,6315169,3425169
265000.0,3,2.25,1750,9298,1.0,0,0,3,7,1410,340,1969,0.0,98058,47.4579,-122.164,1720,7875,7548,0.8117874811787481,3062500,86452804,83390304
212000.0,3,1.75,1100,9750,1.0,0,0,3,6,1100,0,1967,0.0,98023,47.2955,-122.36200000000001,1100,9900,8650,0.8871794871794871,1210000,95062500,93852500
400000.0,4,3.0,2320,13068,2.0,0,2,2,8,2320,0,1998,0.0,98198,47.3497,-122.31700000000001,2220,25265,10748,0.8224670951943679,5382400,170772624,165390224
750000.0,4,2.5,2540,6491,2.0,0,0,2,8,2540,0,1997,0.0,98008,47.6363,-122.117,1990,8447,3951,0.6086889539362194,6451600,42133081,35681481
384900.0,5,2.5,3090,12750,1.0,0,0,2,8,1750,1340,1968,0.0,98023,47.3408,-122.335,1760,25919,9660,0.7576470588235295,9548100,162562500,153014400
176000.0,2,1.0,770,5200,1.0,0,0,4,6,770,0,1969,0.0,98042,47.3627,-122.087,1150,5330,4430,0.8519230769230769,592900,27040000,26447100
350000.0,3,2.75,2370,4632,2.0,0,0,2,7,2370,0,2002,0.0,98038,47.3794,-122.022,2290,5012,2262,0.4883419689119171,5616900,21455424,15838524
168000.0,3,1.0,1200,7210,1.0,0,0,3,6,1200,0,1977,0.0,98030,47.3729,-122.18299999999999,1200,7650,6010,0.8335644937586685,1440000,51984100,50544100
358000.0,4,2.0,2200,3060,1.0,0,0,2,7,1100,1100,1908,0.0,98118,47.565,-122.28399999999999,1410,5100,860,0.28104575163398693,4840000,9363600,4523600
580000.0,3,2.75,2660,32757,1.0,0,0,3,8,2660,0,1975,0.0,98077,47.7649,-122.098,2720,35191,30097,0.9187959825380835,7075600,1073021049,1065945449
442500.0,3,1.75,1600,10280,1.0,0,0,2,7,1050,550,1977,0.0,98034,47.725,-122.17399999999999,1590,8100,8680,0.8443579766536965,2560000,105678400,103118400
515000.0,2,2.5,1330,1249,3.0,0,0,2,8,1330,0,2004,0.0,98105,47.6668,-122.285,1430,1328,-81,-0.06485188150520416,1768900,1560001,-208899
554000.0,5,2.5,3440,12900,1.0,0,2,3,8,1720,1720,1958,0.0,98166,47.4426,-122.34200000000001,2100,10751,9460,0.7333333333333333,11833600,166410000,154576400
659000.0,3,2.5,2510,6320,2.0,0,0,2,9,2510,0,1996,0.0,98075,47.5868,-122.03299999999999,2518,5819,3810,0.6028481012658228,6300100,39942400,33642300
414999.0,4,2.5,2150,10098,1.0,0,0,2,7,1090,1060,1963,0.0,98034,47.7166,-122.20100000000001,1880,10000,7948,0.7870865517924341,4622500,101969604,97347104
275000.0,3,1.5,1180,10277,1.0,0,0,2,6,1180,0,1983,0.0,98045,47.488,-121.787,1680,11104,9097,0.885180500145957,1392400,105616729,104224329
193000.0,2,1.0,680,8640,1.0,0,0,3,5,680,0,1951,0.0,98188,47.4559,-122.289,1320,13140,7960,0.9212962962962963,462400,74649600,74187200
525000.0,4,2.5,2840,4750,2.0,0,0,2,9,2840,0,2002,0.0,98058,47.4511,-122.12100000000001,2460,4750,1910,0.40210526315789474,8065600,22562500,14496900
424000.0,3,2.5,1820,7500,2.0,0,0,2,8,1820,0,1985,0.0,98052,47.7155,-122.104,2040,8304,5680,0.7573333333333333,3312400,56250000,52937600
455000.0,2,1.0,1070,5150,1.0,0,0,3,6,870,200,1908,0.0,98117,47.6853,-122.366,1520,3860,4080,0.7922330097087379,1144900,26522500,25377600
463000.0,2,1.0,1250,5650,2.0,0,1,3,7,1250,0,1943,0.0,98126,47.5495,-122.37700000000001,1210,5650,4400,0.7787610619469026,1562500,31922500,30360000
1100000.0,4,2.5,2190,6300,1.0,0,3,2,7,1240,950,1960,0.0,98033,47.6918,-122.21600000000001,2730,14659,4110,0.6523809523809524,4796100,39690000,34893900
523000.0,3,1.75,3000,5413,2.0,0,0,3,8,1900,1100,1963,0.0,98115,47.6962,-122.31200000000001,1550,5413,2413,0.4457786809532607,9000000,29300569,20300569
615000.0,4,1.75,2270,9830,1.0,0,0,3,8,2270,0,1959,0.0,98005,47.5999,-122.176,2540,11990,7560,0.7690742624618515,5152900,96628900,91476000
1520000.0,4,4.0,4500,11795,2.0,0,0,2,12,4500,0,1991,0.0,98027,47.5533,-122.098,3930,11576,7295,0.6184824077999153,20250000,139122025,118872025
870000.0,5,4.0,3400,5000,2.0,0,0,2,8,2320,1080,1900,2013.0,98107,47.6655,-122.363,1910,5000,1600,0.32,11560000,25000000,13440000
710000.0,3,2.5,2830,9680,2.0,0,0,2,10,2830,0,1991,0.0,98074,47.6249,-122.024,2970,8691,6850,0.7076446280991735,8008900,93702400,85693500
215000.0,3,1.0,960,9563,1.0,0,0,4,7,960,0,1967,0.0,98023,47.2864,-122.35700000000001,1280,9600,8603,0.8996130921259019,921600,91450969,90529369
590000.0,2,1.0,1530,6450,1.0,0,0,3,7,1530,0,1920,0.0,98117,47.6833,-122.398,1530,5000,4920,0.7627906976744186,2340900,41602500,39261600
323000.0,5,2.5,2500,13034,1.0,0,0,2,7,1300,1200,1962,0.0,98092,47.3343,-122.194,2440,13300,10534,0.8081939542734387,6250000,169885156,163635156
279000.0,4,2.0,1560,7569,1.5,0,0,3,7,1560,0,1966,0.0,98058,47.4496,-122.155,1480,8755,6009,0.7938961553705906,2433600,57289761,54856161
535100.0,3,2.25,2070,7207,1.0,0,0,2,8,1720,350,1973,0.0,98177,47.7735,-122.37100000000001,2350,7980,5137,0.7127792424032191,4284900,51940849,47655949
830000.0,5,2.25,2710,19800,1.0,0,0,4,9,1910,800,1959,0.0,98005,47.5958,-122.175,2120,16400,17090,0.8631313131313131,7344100,392040000,384695900
815000.0,4,2.5,3150,4203,2.0,0,0,2,9,3150,0,2002,0.0,98033,47.688,-122.164,3150,5169,1053,0.2505353319057816,9922500,17665209,7742709
535900.0,3,2.25,1880,10880,1.0,0,0,2,8,1480,400,1975,0.0,98008,47.5937,-122.116,2120,10240,9000,0.8272058823529411,3534400,118374400,114840000
230000.0,3,1.0,1250,8800,1.0,0,0,2,7,1250,0,1955,0.0,98146,47.497,-122.35700000000001,1480,8200,7550,0.8579545454545454,1562500,77440000,75877500
325500.0,4,1.75,2290,8142,1.0,0,0,3,7,1490,800,1969,0.0,98055,47.4564,-122.211,1840,8142,5852,0.7187423237533775,5244100,66292164,61048064
359000.0,3,2.25,1990,4331,2.0,0,0,2,7,1990,0,1997,0.0,98056,47.4917,-122.167,1690,3688,2341,0.5405218194412376,3960100,18757561,14797461
505000.0,3,2.5,2100,5824,2.0,0,2,2,8,2100,0,1999,0.0,98065,47.5334,-121.867,1890,4140,3724,0.6394230769230769,4410000,33918976,29508976
253905.0,3,1.0,940,8400,1.0,0,0,4,7,940,0,1958,0.0,98056,47.5112,-122.167,950,8400,7460,0.888095238095238,883600,70560000,69676400
369950.0,3,1.75,1640,4860,1.0,0,0,2,8,1200,440,1965,0.0,98125,47.7125,-122.32,1480,7200,3220,0.6625514403292181,2689600,23619600,20930000
350000.0,3,2.25,1860,8378,2.0,0,0,2,7,1860,0,1995,0.0,98038,47.3875,-122.03200000000001,1870,8378,6518,0.7779899737407496,3459600,70190884,66731284
650000.0,4,2.25,2100,2500,3.0,0,0,2,8,2100,0,2001,0.0,98115,47.6726,-122.29799999999999,1660,4000,400,0.16,4410000,6250000,1840000
295000.0,3,1.75,1500,15246,1.0,0,0,2,6,1500,0,1925,0.0,98070,47.4367,-122.463,1500,16988,13746,0.9016135379771744,2250000,232440516,230190516
620000.0,3,1.75,1680,28046,1.0,0,3,2,8,1180,500,1948,0.0,98177,47.7648,-122.37,2190,26308,26366,0.9400984097554018,2822400,786578116,783755716
2000000.0,2,2.5,3900,920423,2.0,0,0,2,12,3900,0,2009,0.0,98065,47.5371,-121.756,2720,411962,916523,0.9957628177479267,15210000,847178498929,847163288929
246000.0,3,1.0,1400,7410,1.0,0,0,2,6,1400,0,1944,0.0,98166,47.4798,-122.34299999999999,1070,7410,6010,0.8110661268556005,1960000,54908100,52948100
430000.0,3,2.75,2600,12860,1.0,0,0,2,7,1350,1250,1965,0.0,98014,47.695,-121.91799999999999,2260,12954,10260,0.7978227060653188,6760000,165379600,158619600
509990.0,3,2.0,1440,4859,2.0,0,0,1,6,1440,0,1921,0.0,98118,47.5503,-122.285,1360,4558,3419,0.7036427248405022,2073600,23609881,21536281
490000.0,4,1.75,1870,9500,1.0,0,0,3,7,1090,780,1962,0.0,98033,47.7012,-122.18700000000001,2010,10000,7630,0.8031578947368421,3496900,90250000,86753100
385000.0,4,2.75,2960,10454,1.0,0,1,2,8,2360,600,1979,0.0,98198,47.4006,-122.322,1870,10500,7494,0.7168547924239526,8761600,109286116,100524516
769000.0,4,2.5,2440,6733,2.0,0,0,2,9,2440,0,1999,0.0,98074,47.6374,-122.064,2570,6496,4293,0.6376058220703995,5953600,45333289,39379689
185000.0,2,1.0,1122,9100,1.0,0,0,3,6,1122,0,1960,0.0,98023,47.328,-122.34100000000001,840,9344,7978,0.8767032967032967,1258884,82810000,81551116
303500.0,3,1.5,1060,10464,1.0,0,0,3,7,1060,0,1973,0.0,98034,47.7313,-122.229,1420,10464,9404,0.8987003058103975,1123600,109495296,108371696
468000.0,4,2.5,2150,8165,1.0,0,0,2,8,1430,720,1957,0.0,98177,47.773,-122.37100000000001,2360,7980,6015,0.7366809552969994,4622500,66667225,62044725
449950.0,4,2.5,3100,10000,2.0,0,0,2,9,3100,0,1978,0.0,98042,47.3741,-122.15,1850,9438,6900,0.69,9610000,100000000,90390000
235000.0,2,1.5,880,1805,2.0,0,0,2,7,880,0,1999,0.0,98133,47.7064,-122.34200000000001,880,5060,925,0.5124653739612188,774400,3258025,2483625
520000.0,4,2.5,2490,34947,2.0,0,0,2,9,2150,340,1985,0.0,98027,47.4823,-122.031,2490,39639,32457,0.9287492488625633,6200100,1221292809,1215092709
203000.0,2,1.0,1080,9067,1.0,0,0,2,6,1080,0,1951,0.0,98168,47.4815,-122.331,1080,6647,7987,0.8808867321054373,1166400,82210489,81044089
657000.0,5,2.5,2530,10190,1.0,0,0,3,7,1290,1240,1960,0.0,98008,47.61600000000001,-122.115,2040,8560,7660,0.7517173699705594,6400900,103836100,97435200
275000.0,3,1.0,1200,7800,1.0,0,0,3,7,1200,0,1954,0.0,98126,47.5196,-122.37100000000001,1230,7070,6600,0.8461538461538461,1440000,60840000,59400000
540000.0,4,2.25,2850,7453,2.0,0,0,2,9,2850,0,1991,0.0,98072,47.7439,-122.17399999999999,2700,8468,4603,0.6176036495370991,8122500,55547209,47424709
455000.0,4,2.5,2950,4502,2.0,0,0,2,7,2950,0,2005,0.0,98059,47.5002,-122.15100000000001,2360,4502,1552,0.34473567303420705,8702500,20268004,11565504
458500.0,2,1.75,1160,6828,1.0,0,0,2,7,860,300,1941,0.0,98115,47.6937,-122.29799999999999,1250,6828,5668,0.8301113063854716,1345600,46621584,45275984
549900.0,4,3.5,3420,4751,2.0,0,0,2,10,3420,0,2003,0.0,98055,47.4734,-122.193,3490,5700,1331,0.2801515470427278,11696400,22572001,10875601
750000.0,3,1.75,2240,10578,2.0,0,0,4,8,1550,690,1923,0.0,98115,47.6954,-122.292,1570,10578,8338,0.788239742862545,5017600,111894084,106876484
235000.0,4,1.75,1450,8891,1.5,0,0,2,7,1180,270,1962,0.0,98168,47.478,-122.27799999999999,1450,9013,7441,0.8369137329884152,2102500,79049881,76947381
286000.0,4,2.5,1820,7930,2.0,0,0,4,7,1820,0,1989,0.0,98038,47.358999999999995,-122.05,1490,7930,6110,0.7704918032786885,3312400,62884900,59572500
2650000.0,4,3.5,4700,13730,2.0,0,3,2,11,3500,1200,1958,1995.0,98033,47.6899,-122.21700000000001,3210,15306,9030,0.6576839038601602,22090000,188512900,166422900
602000.0,4,1.75,2430,14000,1.0,0,0,3,7,1580,850,1963,0.0,98052,47.6554,-122.134,1910,8285,11570,0.8264285714285714,5904900,196000000,190095100
640000.0,3,1.5,1960,4080,1.5,0,0,2,7,1960,0,1915,0.0,98115,47.6768,-122.31,1880,4080,2120,0.5196078431372549,3841600,16646400,12804800
267000.0,3,1.75,1440,10920,1.0,0,0,3,8,1440,0,1977,0.0,98030,47.3812,-122.16799999999999,1720,8260,9480,0.8681318681318682,2073600,119246400,117172800
712000.0,4,2.5,2730,4385,2.0,0,0,2,8,2730,0,2001,0.0,98075,47.5975,-122.038,2670,4644,1655,0.3774230330672748,7452900,19228225,11775325
244500.0,2,1.0,910,9000,1.0,0,0,2,5,910,0,1923,0.0,98065,47.526,-121.81,1290,9000,8090,0.8988888888888888,828100,81000000,80171900
301000.0,2,1.0,910,9000,1.0,0,0,2,5,910,0,1923,0.0,98065,47.526,-121.81,1290,9000,8090,0.8988888888888888,828100,81000000,80171900
990000.0,4,2.5,2430,6325,2.0,0,0,3,8,2020,410,1919,0.0,98109,47.6413,-122.354,2340,4375,3895,0.6158102766798419,5904900,40005625,34100725
739999.0,4,2.75,3350,6500,2.0,0,0,2,10,3350,0,1999,0.0,98075,47.5838,-122.027,2960,6970,3150,0.4846153846153846,11222500,42250000,31027500
480000.0,4,1.75,2320,4322,1.0,0,0,2,7,1140,1180,1910,0.0,98144,47.5755,-122.289,1820,4322,2002,0.46321147616844055,5382400,18679684,13297284
305000.0,3,2.5,1260,1622,3.0,0,0,2,8,1260,0,2009,0.0,98133,47.7325,-122.34299999999999,1340,1188,362,0.22318125770653513,1587600,2630884,1043284
703300.0,3,2.0,1980,3525,1.5,0,0,3,8,1590,390,1932,0.0,98117,47.6847,-122.368,1760,3760,1545,0.43829787234042555,3920400,12425625,8505225
265000.0,4,1.5,1580,8468,2.0,0,0,3,7,1580,0,1971,0.0,98001,47.3336,-122.281,1580,8260,6888,0.8134152102031176,2496400,71707024,69210624
600000.0,4,2.5,2710,35009,2.0,0,2,2,9,2710,0,1992,0.0,98045,47.4815,-121.714,2330,35040,32299,0.9225913336570596,7344100,1225630081,1218285981
253000.0,3,1.0,1400,9750,1.0,0,0,2,7,1400,0,1968,1998.0,98198,47.3862,-122.304,1640,8050,8350,0.8564102564102564,1960000,95062500,93102500
617950.0,4,2.5,2410,7950,2.0,0,0,2,8,2410,0,1997,0.0,98034,47.7185,-122.226,1920,7713,5540,0.6968553459119496,5808100,63202500,57394400
385000.0,4,3.25,1790,2460,2.0,0,0,3,7,1100,690,2000,0.0,98106,47.534,-122.346,1260,4040,670,0.27235772357723576,3204100,6051600,2847500
319000.0,3,2.0,1640,9234,1.0,0,0,4,7,1060,580,1967,0.0,98118,47.5162,-122.274,2230,10354,7594,0.8223954949101148,2689600,85266756,82577156
696000.0,3,2.5,1670,8023,1.0,0,0,4,7,1170,500,1960,0.0,98008,47.615,-122.117,1960,8964,6353,0.7918484357472267,2788900,64368529,61579629
345000.0,2,1.0,970,5750,1.0,0,0,3,6,970,0,1932,0.0,98126,47.5518,-122.37,1650,8625,4780,0.831304347826087,940900,33062500,32121600
380000.0,3,2.5,1610,1778,3.0,0,0,2,7,1610,0,2002,0.0,98115,47.6902,-122.306,1120,2187,168,0.09448818897637795,2592100,3161284,569184
647500.0,4,1.75,2060,26036,1.0,0,0,3,8,1160,900,1947,0.0,98166,47.4444,-122.351,2590,21891,23976,0.9208787832232294,4243600,677873296,673629696
725000.0,3,2.5,3570,35271,2.0,0,0,2,9,3570,0,1997,0.0,98027,47.4782,-122.035,3510,37194,31701,0.8987837033256784,12744900,1244043441,1231298541
269950.0,3,1.75,1400,7735,1.0,0,0,3,7,1400,0,1989,0.0,98038,47.357,-122.04,1530,7754,6335,0.8190045248868778,1960000,59830225,57870225
875000.0,4,2.5,3470,32109,2.0,0,0,2,10,3470,0,1995,0.0,98077,47.7311,-122.036,3800,35181,28639,0.8919306113550718,12040900,1030987881,1018946981
299950.0,3,1.0,1210,9525,1.0,0,0,2,7,1210,0,1955,0.0,98106,47.5274,-122.345,1680,7620,8315,0.8729658792650918,1464100,90725625,89261525
1880000.0,4,3.25,3930,10929,2.0,0,0,2,10,3930,0,2006,0.0,98004,47.6259,-122.194,1780,9999,6999,0.640406258578095,15444900,119443041,103998141
430000.0,2,1.0,990,4802,1.0,0,0,2,7,990,0,1947,0.0,98117,47.6876,-122.395,1180,5000,3812,0.7938359017076219,980100,23059204,22079104
495000.0,5,2.5,2200,4942,2.0,0,0,2,8,2200,0,1989,0.0,98029,47.5772,-122.001,2200,5924,2742,0.5548360987454471,4840000,24423364,19583364
275000.0,3,1.5,1510,16200,1.0,0,0,2,7,1510,0,1970,0.0,98031,47.3926,-122.167,1650,13950,14690,0.9067901234567901,2280100,262440000,260159900
333000.0,3,1.0,1620,5040,1.0,0,0,2,7,1120,500,1964,0.0,98118,47.5263,-122.286,1790,6178,3420,0.6785714285714286,2624400,25401600,22777200
247000.0,3,2.25,1580,7941,2.0,0,0,3,7,1580,0,1986,0.0,98023,47.2843,-122.35700000000001,1730,8051,6361,0.8010326155396046,2496400,63059481,60563081
204555.0,3,1.75,1260,15000,1.5,0,0,3,7,1260,0,1983,0.0,98092,47.2737,-122.15299999999999,2400,21715,13740,0.916,1587600,225000000,223412400
432000.0,3,2.0,2190,13673,1.0,0,0,3,9,2190,0,1994,0.0,98042,47.3542,-122.098,2770,13804,11483,0.8398303225334601,4796100,186950929,182154829
175000.0,3,1.75,1230,13056,1.0,0,0,3,7,1230,0,1962,0.0,98001,47.3171,-122.279,1690,15750,11826,0.9057904411764706,1512900,170459136,168946236
556300.0,4,2.5,2030,7140,1.0,0,0,3,7,1400,630,1968,0.0,98008,47.6244,-122.109,1800,7565,5110,0.7156862745098039,4120900,50979600,46858700
286000.0,2,1.0,780,3475,1.0,0,0,3,5,780,0,1930,0.0,98045,47.4944,-121.789,1210,6769,2695,0.7755395683453238,608400,12075625,11467225
320000.0,2,1.5,1110,1200,3.0,0,0,2,8,1110,0,2000,0.0,98103,47.6931,-122.34200000000001,1110,1363,90,0.075,1232100,1440000,207900
815000.0,3,2.5,2790,53143,2.0,0,0,3,9,2790,0,1991,0.0,98077,47.7687,-122.036,2740,47916,50353,0.9475001411286529,7784100,2824178449,2816394349
385000.0,4,1.75,1660,10757,1.0,0,0,2,7,1000,0,1980,0.0,98056,47.5071,-122.194,1880,8319,9097,0.8456818815654923,2755600,115713049,112957449
1040000.0,4,1.0,3410,5000,2.0,0,0,4,8,2190,1220,1910,0.0,98144,47.5807,-122.291,2550,5000,1590,0.318,11628100,25000000,13371900
350000.0,4,2.25,2390,13002,2.0,0,0,2,8,2390,0,1987,0.0,98023,47.3111,-122.35,2450,11200,10612,0.8161821258267958,5712100,169052004,163339904
277000.0,4,2.5,1850,5880,2.0,0,0,2,8,1850,0,1998,0.0,98092,47.3322,-122.17299999999999,2370,6500,4030,0.685374149659864,3422500,34574400,31151900
415000.0,6,2.0,2500,5200,1.0,0,0,2,8,1250,1250,1966,0.0,98118,47.5517,-122.26799999999999,1800,5200,2700,0.5192307692307693,6250000,27040000,20790000
295000.0,3,1.0,1000,8320,1.0,0,0,4,6,1000,0,1951,0.0,98155,47.7548,-122.316,1090,8450,7320,0.8798076923076923,1000000,69222400,68222400
969000.0,4,2.0,2450,5000,2.0,0,4,4,8,2200,250,1919,0.0,98116,47.5619,-122.405,2360,6090,2550,0.51,6002500,25000000,18997500
339888.0,4,1.75,1440,6144,1.0,0,0,4,6,720,720,1947,0.0,98106,47.5257,-122.35700000000001,960,5160,4704,0.765625,2073600,37748736,35675136
269950.0,3,2.25,1660,7003,2.0,0,0,2,7,1660,0,1996,0.0,98030,47.3599,-122.18799999999999,1840,6680,5343,0.762958731972012,2755600,49042009,46286409
1190000.0,3,2.5,2510,4600,2.0,0,2,2,10,2510,0,2006,0.0,98034,47.7051,-122.223,2560,7500,2090,0.4543478260869565,6300100,21160000,14859900
780000.0,4,2.5,3090,12511,2.0,0,0,3,10,3090,0,1998,0.0,98075,47.5932,-121.98299999999999,3100,10882,9421,0.7530173447366317,9548100,156525121,146977021
198000.0,3,1.0,860,5185,1.0,0,0,3,6,860,0,1968,0.0,98042,47.3634,-122.086,1120,5494,4325,0.8341369334619093,739600,26884225,26144625
350000.0,2,1.0,1220,28703,1.0,0,0,3,7,1220,0,1953,0.0,98056,47.4952,-122.17200000000001,2740,6720,27483,0.9574957321534334,1488400,823862209,822373809
350000.0,3,1.0,1010,7680,1.0,0,0,3,7,1010,0,1967,0.0,98034,47.732,-122.23100000000001,1320,7373,6670,0.8684895833333334,1020100,58982400,57962300
319000.0,4,2.25,2390,7350,2.0,0,0,2,8,2390,0,1990,0.0,98023,47.2938,-122.348,2390,7350,4960,0.6748299319727891,5712100,54022500,48310400
311000.0,4,2.25,3340,8000,2.0,0,0,3,8,3340,0,1973,0.0,98023,47.317,-122.385,2230,8000,4660,0.5825,11155600,64000000,52844400
394000.0,5,3.25,3620,4650,2.0,0,0,2,8,2790,0,2004,0.0,98038,47.3552,-122.02600000000001,2850,4650,1030,0.221505376344086,13104400,21622500,8518100
1340000.0,5,2.25,4200,5800,2.5,0,0,3,9,2910,1290,1906,0.0,98112,47.6284,-122.31200000000001,3060,5800,1600,0.27586206896551724,17640000,33640000,16000000
2700000.0,5,2.75,3831,13800,2.0,1,4,2,9,3831,0,1959,1980.0,98040,47.5919,-122.251,3850,36563,9969,0.7223913043478261,14676561,190440000,175763439
396000.0,3,1.0,1980,9540,1.0,0,0,2,7,1080,900,1949,0.0,98133,47.7551,-122.353,1680,9529,7560,0.7924528301886793,3920400,91011600,87091200
809000.0,4,1.75,1790,8372,1.0,0,0,3,8,1340,450,1976,0.0,98033,47.6605,-122.189,2180,10500,6582,0.7861920688007644,3204100,70090384,66886284
480000.0,3,2.0,1580,7400,1.0,0,0,2,7,1050,530,1977,0.0,98052,47.6715,-122.162,1560,7458,5820,0.7864864864864864,2496400,54760000,52263600
535000.0,6,1.75,2460,6000,1.0,0,0,3,7,1230,1230,1913,0.0,98115,47.6721,-122.323,1560,4275,3540,0.59,6051600,36000000,29948400
425000.0,5,2.75,2110,5120,2.0,0,0,2,7,1870,240,1947,1983.0,98106,47.5294,-122.35700000000001,1580,5120,3010,0.587890625,4452100,26214400,21762300
408000.0,3,2.5,1470,1204,3.0,0,0,2,8,1470,0,2006,0.0,98117,47.6998,-122.366,1460,1245,-266,-0.22093023255813954,2160900,1449616,-711284
1260000.0,4,2.5,3510,13100,2.0,0,0,3,10,3510,0,1966,0.0,98040,47.5306,-122.227,3230,12745,9590,0.73206106870229,12320100,171610000,159289900
310000.0,1,0.75,520,2885,1.0,0,0,3,6,520,0,1947,0.0,98117,47.6886,-122.37799999999999,980,4241,2365,0.8197573656845754,270400,8323225,8052825
292000.0,3,2.5,1950,7421,2.0,0,0,2,8,1950,0,1996,0.0,98038,47.3842,-122.036,2200,4668,5471,0.7372321789516237,3802500,55071241,51268741
217000.0,2,1.0,770,9715,1.0,0,0,3,6,770,0,1942,0.0,98168,47.4924,-122.31200000000001,1140,9715,8945,0.9207411219763253,592900,94381225,93788325
398500.0,4,2.5,2250,6064,2.0,0,0,2,8,2250,0,2005,0.0,98056,47.4956,-122.17399999999999,1520,7840,3814,0.628957783641161,5062500,36772096,31709596
2250000.0,3,3.0,4040,7200,1.5,0,2,3,9,3340,700,1930,0.0,98112,47.6288,-122.28399999999999,3450,10800,3160,0.4388888888888889,16321600,51840000,35518400
700000.0,4,1.75,2360,6000,1.0,0,0,2,7,1280,1080,1955,0.0,98109,47.6465,-122.35700000000001,1700,3460,3640,0.6066666666666667,5569600,36000000,30430400
585000.0,4,2.5,2330,45860,2.0,0,0,2,9,2330,0,1989,0.0,98075,47.5842,-121.992,2930,5020,43530,0.9491931966855648,5428900,2103139600,2097710700
399950.0,3,1.0,1720,8910,1.0,0,0,3,7,1720,0,1954,0.0,98155,47.7736,-122.296,1870,8640,7190,0.8069584736251403,2958400,79388100,76429700
235000.0,3,1.75,1900,8540,1.0,0,0,2,6,950,950,1980,0.0,98168,47.4868,-122.303,1370,10204,6640,0.7775175644028103,3610000,72931600,69321600
212000.0,3,1.0,1040,6800,1.0,0,0,4,6,1040,0,1951,0.0,98178,47.492,-122.22399999999999,1430,6080,5760,0.8470588235294118,1081600,46240000,45158400
310000.0,3,2.0,2070,9195,1.0,0,0,2,8,1220,850,1982,0.0,98074,47.6491,-122.061,2080,9551,7125,0.7748776508972267,4284900,84548025,80263125
539000.0,3,2.0,2070,9195,1.0,0,0,2,8,1220,850,1982,0.0,98074,47.6491,-122.061,2080,9551,7125,0.7748776508972267,4284900,84548025,80263125
390000.0,3,3.0,1550,1608,2.0,0,0,2,8,1280,270,2001,0.0,98122,47.6042,-122.303,1940,1883,58,0.036069651741293535,2402500,2585664,183164
560000.0,3,2.5,2020,11935,1.0,0,0,3,9,2020,0,1976,0.0,98052,47.632,-122.09200000000001,2410,12350,9915,0.8307498952660243,4080400,142444225,138363825
800000.0,5,2.5,3320,9024,2.0,0,0,2,9,3320,0,1999,0.0,98075,47.5865,-122.056,3320,7665,5704,0.6320921985815603,11022400,81432576,70410176
1900000.0,4,3.25,4130,112521,2.0,0,0,2,11,4130,0,1978,0.0,98005,47.6392,-122.165,3140,26147,108391,0.9632957403506901,17056900,12660975441,12643918541
472000.0,5,2.0,2030,9804,1.0,0,0,2,7,1110,920,1963,0.0,98008,47.6297,-122.11399999999999,1930,7990,7774,0.7929416564667483,4120900,96118416,91997516
502550.0,3,1.75,1770,7875,1.0,0,0,3,7,1170,600,1958,0.0,98008,47.606,-122.125,1670,8000,6105,0.7752380952380953,3132900,62015625,58882725
830000.0,4,3.25,3330,7809,2.0,0,0,2,9,3330,0,2004,0.0,98075,47.5977,-121.976,3100,6465,4479,0.5735689588935843,11088900,60980481,49891581
224950.0,4,2.5,2260,9686,1.0,0,0,3,7,1520,740,1965,0.0,98002,47.286,-122.21799999999999,1750,9916,7426,0.7666735494528185,5107600,93818596,88710996
375000.0,3,2.5,1950,6871,2.0,0,0,2,8,1950,0,1997,0.0,98155,47.7603,-122.307,1950,7663,4921,0.7161985154999272,3802500,47210641,43408141
645000.0,3,2.5,2930,19900,1.5,0,0,2,9,2930,0,1983,0.0,98077,47.7234,-122.066,3160,20492,16970,0.8527638190954774,8584900,396010000,387425100
599000.0,3,2.75,1960,2500,1.5,0,0,4,7,1410,550,1926,0.0,98103,47.6744,-122.353,2040,5000,540,0.216,3841600,6250000,2408400
515000.0,4,2.5,2980,12534,2.0,0,0,2,9,2980,0,1996,0.0,98031,47.3999,-122.211,2630,12534,9554,0.762246689005904,8880400,157101156,148220756
135000.0,2,1.0,780,6685,1.0,0,0,3,5,780,0,1948,0.0,98002,47.305,-122.215,880,6695,5905,0.8833208676140614,608400,44689225,44080825
485000.0,3,2.5,1650,4218,2.0,0,0,2,8,1650,0,2000,0.0,98075,47.5998,-122.016,1650,4559,2568,0.6088193456614509,2722500,17791524,15069024
890000.0,3,3.25,4030,12765,2.0,0,0,3,9,2800,1230,1975,0.0,98005,47.6331,-122.166,2670,13447,8735,0.6842929886408148,16240900,162945225,146704325
215000.0,3,1.0,1010,10125,1.0,0,0,3,7,1010,0,1972,0.0,98042,47.3423,-122.088,1230,10125,9115,0.9002469135802469,1020100,102515625,101495525
299500.0,3,1.0,1190,9600,1.0,0,0,2,7,1190,0,1981,0.0,98045,47.4805,-121.762,1360,10140,8410,0.8760416666666667,1416100,92160000,90743900
800000.0,2,1.0,1050,8750,1.0,0,0,3,7,1050,0,1951,0.0,98004,47.6294,-122.215,3360,20115,7700,0.88,1102500,76562500,75460000
275000.0,3,2.5,1560,4244,2.0,0,0,2,7,1560,0,2002,0.0,98038,47.3834,-122.027,1670,4251,2684,0.6324222431668237,2433600,18011536,15577936
256400.0,3,1.5,1490,7800,1.0,0,0,2,7,1010,480,1963,0.0,98003,47.3431,-122.304,1570,7800,6310,0.808974358974359,2220100,60840000,58619900
310000.0,2,1.0,770,8149,1.0,0,0,3,6,770,0,1948,0.0,98155,47.7439,-122.301,820,8149,7379,0.9055098785127009,592900,66406201,65813301
385000.0,1,1.0,620,5100,1.0,0,0,2,6,620,0,1954,0.0,98144,47.5699,-122.287,1540,2676,4480,0.8784313725490196,384400,26010000,25625600
203000.0,3,1.5,1200,9120,1.0,0,0,2,7,1000,200,1963,0.0,98055,47.4545,-122.18700000000001,1640,9200,7920,0.868421052631579,1440000,83174400,81734400
285000.0,4,2.0,2120,6865,1.0,0,0,2,7,1060,1060,1954,0.0,98133,47.7775,-122.337,1460,7780,4745,0.6911871813546977,4494400,47128225,42633825
473975.0,3,2.5,2330,3610,2.0,0,0,2,8,2330,0,1999,0.0,98074,47.6022,-122.021,1830,2948,1280,0.3545706371191136,5428900,13032100,7603200
320000.0,3,1.75,2000,9760,1.0,0,0,3,8,1400,600,1978,0.0,98058,47.4417,-122.134,1890,8089,7760,0.7950819672131147,4000000,95257600,91257600
599000.0,5,2.75,2820,4608,1.0,0,0,2,7,1450,1370,1967,0.0,98117,47.6886,-122.361,1620,3840,1788,0.3880208333333333,7952400,21233664,13281264
580000.0,3,2.0,2040,4800,1.0,0,0,3,7,1020,1020,1925,0.0,98126,47.5561,-122.37700000000001,1640,4800,2760,0.575,4161600,23040000,18878400
269500.0,4,2.25,1700,7056,2.0,0,0,2,7,1700,0,1999,0.0,98001,47.3385,-122.262,1650,6025,5356,0.7590702947845805,2890000,49787136,46897136
274000.0,2,1.0,820,6200,1.0,0,0,3,6,820,0,1954,0.0,98166,47.4163,-122.34,1410,14000,5380,0.867741935483871,672400,38440000,37767600
347000.0,2,1.75,1315,2162,2.0,0,0,3,8,1315,0,1974,0.0,98028,47.751999999999995,-122.25299999999999,1640,2128,847,0.39176688251618874,1729225,4674244,2945019
270000.0,3,1.75,1390,10905,1.0,0,0,2,6,860,530,1957,0.0,98106,47.5517,-122.36,1390,10839,9515,0.8725355341586428,1932100,118919025,116986925
1430000.0,3,2.0,1890,12017,1.0,0,2,2,8,1890,0,1949,0.0,98004,47.6203,-122.21,2000,12210,10127,0.842722809353416,3572100,144408289,140836189
220000.0,3,1.75,1460,7226,1.0,0,0,2,7,1460,0,1993,0.0,98198,47.3839,-122.321,1760,7226,5766,0.7979518405756989,2131600,52215076,50083476
243000.0,3,1.0,1480,15416,1.0,0,2,3,8,1480,0,1955,0.0,98022,47.2142,-121.98700000000001,1190,10758,13936,0.903995848469123,2190400,237653056,235462656
457500.0,3,1.75,1840,4030,1.0,0,0,4,7,1050,790,1925,0.0,98108,47.5549,-122.311,1840,5040,2190,0.543424317617866,3385600,16240900,12855300
340000.0,2,1.75,1880,7208,1.0,0,0,2,7,940,940,1951,0.0,98115,47.6946,-122.32799999999999,1880,8051,5328,0.7391786903440621,3534400,51955264,48420864
657500.0,4,1.5,1910,5000,1.5,0,0,2,7,1610,300,1912,0.0,98105,47.6597,-122.29,2170,5000,3090,0.618,3648100,25000000,21351900
332500.0,4,2.5,2220,4720,2.0,0,0,2,7,2220,0,1998,0.0,98038,47.3541,-122.024,2090,4717,2500,0.5296610169491526,4928400,22278400,17350000
340000.0,3,2.0,1410,10015,1.0,0,3,2,6,1410,0,1993,0.0,98045,47.4948,-121.77600000000001,1570,10485,8605,0.8592111832251622,1988100,100300225,98312125
350000.0,4,3.0,3380,16133,1.0,0,1,2,8,2330,1050,1959,0.0,98118,47.5501,-122.26100000000001,2500,11100,12753,0.790491539081386,11424400,260273689,248849289
428000.0,4,2.5,1950,5602,1.0,0,0,4,7,1120,830,1966,0.0,98118,47.5437,-122.291,2000,6050,3652,0.6519100321313817,3802500,31382404,27579904
515055.0,4,2.5,2400,8320,2.0,0,0,2,8,2400,0,1999,0.0,98045,47.4808,-121.781,2430,9258,5920,0.7115384615384616,5760000,69222400,63462400
450000.0,3,1.75,1560,8968,1.0,0,0,3,8,1560,0,1972,0.0,98008,47.6243,-122.1,1990,8034,7408,0.8260481712756468,2433600,80425024,77991424
190000.0,3,1.0,1040,8910,1.0,0,0,2,6,1040,0,1943,0.0,98168,47.5024,-122.32,1330,9720,7870,0.8832772166105499,1081600,79388100,78306500
1000000.0,4,2.75,3090,16538,3.0,0,0,3,8,2590,500,1919,0.0,98116,47.5803,-122.40299999999999,1500,5130,13448,0.8131575764905067,9548100,273505444,263957344
299000.0,3,2.5,1850,4600,2.0,0,0,2,7,1850,0,2005,0.0,98058,47.4661,-122.145,2160,4751,2750,0.5978260869565217,3422500,21160000,17737500
508000.0,2,1.0,1200,2500,2.0,0,2,2,7,1090,110,1927,0.0,98112,47.6304,-122.301,2690,4800,1300,0.52,1440000,6250000,4810000
294000.0,4,2.25,2190,3746,2.0,0,0,2,8,2190,0,2005,0.0,98038,47.3896,-122.03399999999999,2200,3591,1556,0.41537640149492794,4796100,14032516,9236416
320000.0,2,1.0,1380,5820,1.0,0,0,2,7,1380,0,1918,1976.0,98117,47.6875,-122.39200000000001,1540,4076,4440,0.7628865979381443,1904400,33872400,31968000
641000.0,5,2.75,3710,8674,2.0,0,0,2,9,3710,0,1996,0.0,98056,47.513999999999996,-122.176,3250,8678,4964,0.5722849896241642,13764100,75238276,61474176
675000.0,3,2.5,2320,98445,1.0,0,0,3,8,1380,940,1978,0.0,98072,47.7323,-122.116,2830,54014,96125,0.9764335415714358,5382400,9691418025,9686035625
255000.0,3,1.5,1110,10296,1.0,0,0,4,7,1110,0,1964,0.0,98042,47.422,-122.15299999999999,1330,10296,9186,0.8921911421911422,1232100,106007616,104775516
286651.0,3,2.5,1830,4997,2.0,0,0,2,7,1830,0,2004,0.0,98001,47.3035,-122.28299999999999,2488,4998,3167,0.6337802681608965,3348900,24970009,21621109
607500.0,4,2.5,2460,45738,1.0,0,0,3,8,1650,810,1969,0.0,98075,47.5952,-122.056,2550,32040,43278,0.9462154007608553,6051600,2091964644,2085913044
765000.0,3,1.0,1270,6500,1.0,0,0,3,7,1270,0,1956,0.0,98033,47.6874,-122.214,2260,7200,5230,0.8046153846153846,1612900,42250000,40637100
334950.0,4,1.75,1700,40973,1.0,0,0,2,8,1700,0,1961,0.0,98031,47.3439,-122.198,2760,40973,39273,0.9585092621970566,2890000,1678786729,1675896729
426000.0,3,1.0,1130,9147,1.0,0,0,4,7,1130,0,1952,0.0,98033,47.7006,-122.197,1930,9906,8017,0.8764622280529135,1276900,83667609,82390709
775000.0,3,1.75,1640,18730,1.5,0,0,3,7,1640,0,1946,0.0,98004,47.5975,-122.196,1670,12154,17090,0.9124399359316604,2689600,350812900,348123300
343000.0,2,1.5,1040,8526,1.0,0,0,4,6,1040,0,1953,0.0,98155,47.7349,-122.295,1310,8504,7486,0.8780201735866761,1081600,72692676,71611076
470101.0,4,2.5,2320,7800,2.0,0,0,2,8,2320,0,1986,0.0,98028,47.7738,-122.266,2090,5721,5480,0.7025641025641025,5382400,60840000,55457600
195000.0,3,1.5,1200,7800,1.0,0,0,3,7,1200,0,1958,0.0,98002,47.3137,-122.212,1390,8415,6600,0.8461538461538461,1440000,60840000,59400000
772500.0,4,1.0,1720,4410,1.5,0,2,2,7,1720,0,1928,0.0,98117,47.6791,-122.402,2140,4500,2690,0.6099773242630385,2958400,19448100,16489700
450000.0,3,1.5,2330,11740,1.0,0,0,2,8,1330,1000,1954,0.0,98155,47.7481,-122.292,2630,11740,9410,0.8015332197614992,5428900,137827600,132398700
1440000.0,4,3.75,4410,9231,3.0,0,3,2,11,4410,0,2001,0.0,98118,47.5427,-122.265,2160,6600,4821,0.5222619434514137,19448100,85211361,65763261
525000.0,4,1.75,1650,8560,1.0,0,0,2,8,1650,0,1970,0.0,98052,47.6652,-122.146,1700,8560,6910,0.8072429906542056,2722500,73273600,70551100
280000.0,3,1.5,1370,11400,2.0,0,0,2,7,1370,0,1980,0.0,98045,47.4477,-121.77,1390,9600,10030,0.8798245614035087,1876900,129960000,128083100
270000.0,3,2.5,1770,8640,1.0,0,0,2,7,1420,350,1986,0.0,98001,47.326,-122.273,1894,7974,6870,0.7951388888888888,3132900,74649600,71516700
406100.0,3,2.25,1410,1332,3.0,0,0,2,8,1410,0,2005,0.0,98103,47.6916,-122.34,1430,1448,-78,-0.05855855855855856,1988100,1774224,-213876
332544.0,2,1.75,1710,4187,1.0,0,0,2,7,1710,0,1987,0.0,98055,47.4732,-122.18799999999999,1760,4084,2477,0.5915930260329592,2924100,17530969,14606869
110000.0,2,1.0,790,8250,1.0,0,0,2,6,790,0,1947,0.0,98188,47.4523,-122.286,900,8250,7460,0.9042424242424243,624100,68062500,67438400
685000.0,6,2.25,2770,5854,1.5,0,0,2,8,2120,650,1921,0.0,98112,47.6466,-122.304,2300,5450,3084,0.5268192688759822,7672900,34269316,26596416
461000.0,4,1.0,1260,8505,1.5,0,0,4,7,1260,0,1951,0.0,98177,47.7181,-122.37100000000001,1480,8100,7245,0.8518518518518519,1587600,72335025,70747425
615000.0,3,2.25,2300,8067,1.0,0,0,3,8,1300,1000,1979,0.0,98034,47.7091,-122.198,2120,9524,5767,0.7148878145531177,5290000,65076489,59786489
550000.0,2,1.0,1070,3000,1.0,0,0,3,7,870,200,1926,0.0,98103,47.6828,-122.353,1890,3300,1930,0.6433333333333333,1144900,9000000,7855100
1060000.0,4,3.5,3850,8100,2.0,0,1,2,11,2430,1420,1995,0.0,98033,47.6855,-122.19,2620,9346,4250,0.5246913580246914,14822500,65610000,50787500
685000.0,3,2.5,2320,219978,2.0,0,0,3,8,2320,0,1993,0.0,98053,47.6847,-122.064,2340,88862,217658,0.9894534908036258,5382400,48390320484,48384938084
1560000.0,5,2.5,2870,16238,2.0,0,0,3,8,2870,0,1962,0.0,98039,47.6308,-122.238,2870,16238,13368,0.8232540953319374,8236900,263672644,255435744
312000.0,4,2.5,1830,5175,2.0,0,0,2,7,1830,0,2003,0.0,98038,47.3565,-122.016,1830,5175,3345,0.6463768115942029,3348900,26780625,23431725
507500.0,3,1.75,1990,9594,1.0,0,0,2,8,1190,800,1977,0.0,98052,47.6617,-122.137,1930,9765,7604,0.7925786950177194,3960100,92044836,88084736
217000.0,3,1.0,1110,9827,1.0,0,0,2,7,1110,0,1966,0.0,98198,47.369,-122.311,1540,10187,8717,0.887045893965605,1232100,96569929,95337829
439000.0,3,2.25,1830,13477,1.0,0,3,3,7,1170,660,1981,0.0,98034,47.7243,-122.21,1960,11344,11647,0.8642131038064851,3348900,181629529,178280629
620000.0,6,3.5,3600,6875,2.0,0,0,2,8,2740,860,2004,0.0,98065,47.5401,-121.87899999999999,3150,6663,3275,0.4763636363636364,12960000,47265625,34305625
915000.0,4,2.5,3210,8532,2.0,0,0,2,10,3210,0,1998,0.0,98007,47.625,-122.14399999999999,2950,6753,5322,0.6237693389592124,10304100,72795024,62490924
425000.0,4,2.0,1490,5300,1.0,0,0,2,7,1110,380,1977,0.0,98144,47.5949,-122.296,1330,1499,3810,0.7188679245283018,2220100,28090000,25869900
435000.0,2,1.0,990,5643,1.0,0,0,2,7,870,120,1947,0.0,98115,47.6802,-122.29799999999999,1280,5700,4653,0.8245614035087719,980100,31843449,30863349
305000.0,3,2.25,1646,12414,2.0,0,0,2,7,1646,0,1996,0.0,98038,47.363,-122.035,1654,8734,10768,0.8674077654261317,2709316,154107396,151398080
276000.0,2,1.0,720,4000,1.0,0,0,2,6,720,0,1918,0.0,98106,47.5346,-122.353,1630,4000,3280,0.82,518400,16000000,15481600
327500.0,3,2.25,2310,7200,2.0,0,0,2,8,2310,0,1990,0.0,98031,47.4051,-122.193,1960,7201,4890,0.6791666666666667,5336100,51840000,46503900
810000.0,3,2.5,2670,10481,2.0,0,0,2,9,2670,0,2003,0.0,98033,47.6673,-122.176,2620,8895,7811,0.745253315523328,7128900,109851361,102722461
715000.0,3,3.25,3060,9055,2.0,0,0,2,10,2460,600,1994,0.0,98052,47.6971,-122.101,2990,9598,5995,0.6620651573716179,9363600,81993025,72629425
272000.0,3,1.5,1380,11760,1.0,0,0,3,7,1380,0,1963,0.0,98055,47.4243,-122.20200000000001,1650,9855,10380,0.8826530612244898,1904400,138297600,136393200
266000.0,2,1.0,700,5559,1.0,0,0,4,6,700,0,1949,0.0,98155,47.7492,-122.311,1230,8100,4859,0.8740780715956107,490000,30902481,30412481
543000.0,3,1.5,1710,8364,2.0,0,2,2,7,1710,0,1944,0.0,98136,47.5175,-122.39299999999999,2430,9040,6654,0.7955523672883787,2924100,69956496,67032396
400000.0,3,2.5,1450,8064,1.0,0,0,2,8,1450,0,1984,0.0,98074,47.6256,-122.037,1710,9554,6614,0.8201884920634921,2102500,65028096,62925596
509500.0,5,2.25,2060,9000,1.0,0,0,3,7,1320,740,1961,0.0,98007,47.6122,-122.137,2050,8800,6940,0.7711111111111111,4243600,81000000,76756400
495000.0,3,3.5,2380,6250,2.0,0,3,2,8,1670,710,1997,0.0,98118,47.5137,-122.25200000000001,2540,4010,3870,0.6192,5664400,39062500,33398100
424950.0,4,2.5,2760,5564,2.0,0,0,2,7,2760,0,2001,0.0,98056,47.4814,-122.189,2670,5626,2804,0.5039539899352984,7617600,30958096,23340496
230000.0,3,1.0,940,10875,1.0,0,0,2,7,940,0,1957,0.0,98056,47.5121,-122.16799999999999,1250,11200,9935,0.9135632183908046,883600,118265625,117382025
235000.0,4,1.5,1760,6150,1.5,0,0,2,7,1760,0,1951,0.0,98031,47.3871,-122.22399999999999,1760,8276,4390,0.7138211382113822,3097600,37822500,34724900
763000.0,3,2.0,1360,8752,1.0,0,2,3,6,1360,0,1942,0.0,98033,47.6879,-122.208,2530,7680,7392,0.8446069469835467,1849600,76597504,74747904
350000.0,3,1.75,2010,6150,2.0,0,0,4,7,2010,0,1939,0.0,98178,47.4975,-122.23100000000001,1770,7380,4140,0.6731707317073171,4040100,37822500,33782400
900000.0,3,1.5,2160,2260,2.0,0,2,4,8,1620,540,1917,0.0,98119,47.6321,-122.37100000000001,2570,2400,100,0.04424778761061947,4665600,5107600,442000
250000.0,3,1.0,930,6060,1.0,0,0,3,6,930,0,1973,0.0,98118,47.5289,-122.28,1640,6364,5130,0.8465346534653465,864900,36723600,35858700
225000.0,3,2.5,1020,2040,2.0,0,0,2,7,720,300,2004,0.0,98106,47.5294,-122.361,1060,1478,1020,0.5,1040400,4161600,3121200
255000.0,2,2.0,1360,5433,1.0,0,0,2,8,1360,0,1974,2003.0,98198,47.3804,-122.32,1160,5264,4073,0.7496778943493466,1849600,29517489,27667889
161700.0,4,1.75,1720,7200,1.0,0,0,2,7,1220,500,1974,0.0,98023,47.306000000000004,-122.375,1790,7200,5480,0.7611111111111111,2958400,51840000,48881600
336000.0,3,3.0,1790,13350,1.0,0,0,2,7,1190,600,1988,0.0,98178,47.4958,-122.262,1740,10624,11560,0.8659176029962546,3204100,178222500,175018400
410500.0,3,1.0,1150,6800,1.0,0,0,2,7,1150,0,1954,0.0,98133,47.727,-122.339,1210,6800,5650,0.8308823529411765,1322500,46240000,44917500
502700.0,4,3.5,2710,14016,2.0,0,0,3,8,2710,0,1968,0.0,98155,47.7601,-122.286,1590,27903,11306,0.8066495433789954,7344100,196448256,189104156
505000.0,3,2.5,2400,9601,1.0,0,0,4,7,1390,1010,1977,0.0,98034,47.7256,-122.211,2010,9943,7201,0.7500260389542756,5760000,92179201,86419201
250000.0,3,1.0,1660,7650,1.5,0,0,2,7,1350,310,1910,0.0,98118,47.5576,-122.277,1750,5760,5990,0.7830065359477124,2755600,58522500,55766900
570000.0,3,1.0,1660,7650,1.5,0,0,2,7,1350,310,1910,0.0,98118,47.5576,-122.277,1750,5760,5990,0.7830065359477124,2755600,58522500,55766900
349900.0,4,2.5,2290,8796,2.0,0,0,2,8,2290,0,1994,0.0,98198,47.3762,-122.318,2130,8796,6506,0.7396543883583447,5244100,77369616,72125516
465000.0,3,2.5,2870,25663,2.0,0,0,2,10,2870,0,1988,0.0,98003,47.2769,-122.333,2950,24347,22793,0.8881658418735144,8236900,658589569,650352669
625000.0,4,3.25,4240,25639,2.0,0,3,2,10,3550,690,1989,0.0,98023,47.3241,-122.37799999999999,3590,24967,21399,0.8346269355279067,17977600,657358321,639380721
655000.0,3,1.75,1800,5102,1.0,0,0,2,7,1170,630,1952,0.0,98199,47.6514,-122.40700000000001,1720,5102,3302,0.6471971775774206,3240000,26030404,22790404
469000.0,4,1.75,2960,11347,1.0,0,0,3,8,1570,1390,1946,0.0,98166,47.4738,-122.353,1660,8911,8387,0.7391380981757293,8761600,128754409,119992809
355000.0,3,2.25,1980,7200,1.0,0,0,2,8,1300,680,1964,0.0,98177,47.7625,-122.36,1820,8250,5220,0.725,3920400,51840000,47919600
596000.0,3,2.5,1730,2631,2.0,0,0,2,8,1730,0,2001,0.0,98005,47.5878,-122.165,1730,2751,901,0.3424553401748385,2992900,6922161,3929261
790000.0,4,2.5,3020,36893,2.0,0,0,2,9,3020,0,1986,2007.0,98077,47.768,-122.09200000000001,3020,36444,33873,0.9181416528880818,9120400,1361093449,1351973049
885000.0,4,2.25,4470,86225,2.0,0,0,2,10,4470,0,1991,0.0,98053,47.6377,-121.985,3850,97049,81755,0.9481588866338069,19980900,7434750625,7414769725
1030000.0,4,3.25,2830,4000,2.0,0,0,2,9,1910,920,1912,0.0,98144,47.5845,-122.291,2740,4000,1170,0.2925,8008900,16000000,7991100
710000.0,4,1.75,2120,5400,1.0,0,0,3,8,1060,1060,1941,0.0,98199,47.6501,-122.395,2052,6000,3280,0.6074074074074074,4494400,29160000,24665600
428040.0,3,2.5,2150,9266,2.0,0,0,2,8,2150,0,1988,0.0,98028,47.7445,-122.24799999999999,2150,12550,7116,0.7679689186272394,4622500,85858756,81236256
1370000.0,5,2.25,3510,13843,1.0,0,2,2,8,1850,1660,1959,0.0,98040,47.5817,-122.24600000000001,2680,8750,10333,0.7464422451780683,12320100,191628649,179308549
546000.0,2,1.0,970,3400,1.0,0,0,2,7,970,0,1924,0.0,98109,47.6444,-122.35700000000001,1180,3600,2430,0.7147058823529412,940900,11560000,10619100
540000.0,4,1.0,1360,5766,1.5,0,0,4,7,1360,0,1951,0.0,98115,47.6827,-122.289,1500,5704,4406,0.764134582032605,1849600,33246756,31397156
435000.0,3,2.5,1470,3000,1.0,0,0,2,7,930,540,1985,0.0,98115,47.6832,-122.286,1470,5588,1530,0.51,2160900,9000000,6839100
540000.0,4,2.25,3040,10283,1.0,0,0,3,8,1430,1610,1984,0.0,98074,47.6268,-122.038,1870,11074,7243,0.7043664300301469,9241600,105740089,96498489
284000.0,2,1.0,860,7204,1.0,0,0,2,7,860,0,1918,0.0,98106,47.5361,-122.351,1200,7500,6344,0.8806218767351471,739600,51897616,51158016
208000.0,2,1.0,820,5700,1.0,0,0,4,5,820,0,1942,0.0,98056,47.4915,-122.184,1000,5700,4880,0.856140350877193,672400,32490000,31817600
315000.0,3,1.75,1900,7076,1.0,0,0,2,7,1130,770,1977,0.0,98155,47.7569,-122.32600000000001,1540,10113,5176,0.7314867156585642,3610000,50069776,46459776
417500.0,2,1.0,1330,5510,1.0,0,0,2,6,850,480,1910,0.0,98117,47.6901,-122.36200000000001,1200,4150,4180,0.7586206896551724,1768900,30360100,28591200
345000.0,3,1.75,1240,38095,1.0,0,0,2,7,1240,0,1978,0.0,98053,47.6522,-121.97,2060,38552,36855,0.9674497965612285,1537600,1451229025,1449691425
375000.0,3,2.5,1330,1064,3.0,0,0,2,8,1330,0,2004,0.0,98117,47.6835,-122.387,1330,1113,-266,-0.25,1768900,1132096,-636804
389800.0,3,1.75,1880,12821,1.0,0,0,2,7,1880,0,1959,0.0,98155,47.7681,-122.305,1540,12868,10941,0.8533655721082599,3534400,164378041,160843641
475000.0,3,1.75,1890,7560,1.0,0,0,2,8,1430,460,1973,0.0,98034,47.7322,-122.185,1890,9095,5670,0.75,3572100,57153600,53581500
569000.0,4,2.25,2250,41688,2.0,0,0,2,8,2250,0,1980,0.0,98053,47.6695,-122.05,2350,37920,39438,0.946027633851468,5062500,1737889344,1732826844
985000.0,5,4.25,4650,108464,2.0,0,0,2,10,3260,1390,1999,0.0,98024,47.5669,-121.956,2810,155509,103814,0.9571286325416728,21622500,11764439296,11742816796
532000.0,3,2.5,1830,8022,2.0,0,0,2,8,1830,0,1987,0.0,98074,47.6198,-122.044,2030,7736,6192,0.7718773373223635,3348900,64352484,61003584
280000.0,2,1.0,720,5000,1.0,0,0,4,6,720,0,1951,0.0,98126,47.5195,-122.374,810,5000,4280,0.856,518400,25000000,24481600
435000.0,4,2.0,1960,50112,1.0,0,0,3,7,1050,910,1963,0.0,98058,47.4353,-122.084,2340,44967,48152,0.9608876117496807,3841600,2511212544,2507370944
223000.0,3,1.0,1220,71191,1.0,0,0,2,6,1220,0,1952,0.0,98023,47.3261,-122.353,1960,15378,69971,0.9828630023458022,1488400,5068158481,5066670081
390000.0,2,1.0,1800,119790,1.0,0,0,3,7,1200,600,1947,0.0,98027,47.4617,-122.012,2320,79208,117990,0.9849737039819685,3240000,14349644100,14346404100
315000.0,3,1.75,1340,12800,1.0,0,0,2,7,880,460,1981,0.0,98058,47.4437,-122.137,1500,7875,11460,0.8953125,1795600,163840000,162044400
612000.0,3,3.0,1740,3700,1.0,0,0,2,7,1740,0,1982,0.0,98122,47.6102,-122.309,1830,2480,1960,0.5297297297297298,3027600,13690000,10662400
591000.0,3,1.75,1680,2400,1.0,0,0,4,7,870,810,1922,0.0,98122,47.6155,-122.3,1440,3600,720,0.3,2822400,5760000,2937600
800000.0,4,2.25,3220,8436,2.0,0,0,2,8,3220,0,1968,0.0,98008,47.6381,-122.116,2500,7632,5216,0.6183025130393551,10368400,71166096,60797696
225000.0,3,2.0,1610,8400,1.0,0,0,2,8,1610,0,1990,0.0,98022,47.1958,-122.009,1930,8459,6790,0.8083333333333333,2592100,70560000,67967900
589900.0,2,3.0,3160,66646,2.0,0,0,2,7,3160,0,1993,0.0,98077,47.7479,-122.03399999999999,3140,38790,63486,0.9525853014434474,9985600,4441689316,4431703716
565000.0,4,2.5,2520,13156,1.0,0,0,2,8,1520,1000,1979,0.0,98052,47.6558,-122.135,2050,10940,10636,0.8084524171480694,6350400,173080336,166729936
650000.0,3,1.5,2120,8448,1.0,0,0,2,7,1060,1060,1940,0.0,98199,47.6438,-122.40299999999999,1620,7920,6328,0.7490530303030303,4494400,71368704,66874304
499000.0,3,2.5,2090,8505,2.0,0,0,2,8,2090,0,1951,1977.0,98177,47.7195,-122.37100000000001,1640,8100,6415,0.7542621987066431,4368100,72335025,67966925
280000.0,3,1.0,1330,20562,1.5,0,0,2,5,1330,0,1959,0.0,98045,47.4807,-121.775,1350,20562,19232,0.9353175761112732,1768900,422795844,421026944
649950.0,3,2.5,2420,7500,1.0,0,2,3,8,1210,1210,1944,0.0,98117,47.6949,-122.389,2340,7500,5080,0.6773333333333333,5856400,56250000,50393600
420000.0,3,1.75,1510,6360,1.0,0,0,3,7,1510,0,1954,0.0,98133,47.7321,-122.353,1480,7260,4850,0.7625786163522013,2280100,40449600,38169500
319990.0,4,2.5,2120,5293,2.0,0,0,2,7,2120,0,2003,0.0,98031,47.4217,-122.20100000000001,1990,5313,3173,0.5994709994332137,4494400,28015849,23521449
265000.0,3,2.0,1850,16535,1.0,0,0,2,7,1850,0,1992,0.0,98014,47.6565,-121.912,1528,13295,14685,0.8881161173268823,3422500,273406225,269983725
482000.0,3,1.75,2300,16474,1.0,0,0,2,7,1220,1080,1984,0.0,98072,47.7609,-122.14399999999999,1940,15601,14174,0.8603860628869734,5290000,271392676,266102676
452000.0,3,2.25,2600,14810,1.0,0,2,3,8,1490,1110,1956,0.0,98166,47.4326,-122.34100000000001,2450,16715,12210,0.824442943956786,6760000,219336100,212576100
1490000.0,4,4.25,5180,13077,2.0,0,3,2,12,4280,900,1998,0.0,98006,47.5513,-122.109,5030,15069,7897,0.6038846830312763,26832400,171007929,144175529
375000.0,2,1.0,1810,8527,1.5,0,0,3,7,1810,0,1943,0.0,98133,47.7275,-122.336,1490,6800,6717,0.7877330831476487,3276100,72709729,69433629
588000.0,5,3.0,2190,4900,2.0,0,0,4,7,1490,700,1940,0.0,98117,47.6892,-122.38600000000001,1370,4606,2710,0.5530612244897959,4796100,24010000,19213900
635000.0,4,2.5,2500,10215,2.0,0,0,2,9,2500,0,1998,0.0,98075,47.5912,-121.986,2890,10240,7715,0.7552618697993148,6250000,104346225,98096225
280500.0,4,2.5,1890,6962,2.0,0,0,2,8,1890,0,1997,0.0,98092,47.3328,-122.18700000000001,2170,6803,5072,0.7285262855501293,3572100,48469444,44897344
210500.0,2,1.75,2040,8600,1.0,0,0,3,6,1430,610,1985,0.0,98003,47.2755,-122.30799999999999,1310,7859,6560,0.7627906976744186,4161600,73960000,69798400
196500.0,3,2.0,1310,7000,1.0,0,0,3,7,1310,0,1979,0.0,98023,47.303000000000004,-122.383,1390,7500,5690,0.8128571428571428,1716100,49000000,47283900
1400000.0,5,3.5,4010,8510,2.0,0,1,4,9,2850,1160,1971,0.0,98105,47.6578,-122.286,2610,6128,4500,0.5287896592244419,16080100,72420100,56340000
475000.0,3,1.75,1780,8033,1.0,0,0,1,7,1210,570,1977,0.0,98034,47.7275,-122.219,1630,7508,6253,0.7784140420764347,3168400,64529089,61360689
550000.0,3,2.5,1980,9061,2.0,0,0,3,8,1980,0,1987,0.0,98074,47.6366,-122.029,1930,8869,7081,0.7814810727292794,3920400,82101721,78181321
1580000.0,3,3.25,3690,7200,2.0,0,0,2,11,3690,0,2007,0.0,98033,47.6815,-122.2,1880,7200,3510,0.4875,13616100,51840000,38223900
240000.0,3,1.75,1540,6687,1.0,0,0,2,7,1200,340,1991,0.0,98022,47.1938,-121.98100000000001,1540,7242,5147,0.7697024076566472,2371600,44715969,42344369
272000.0,3,1.0,1130,8100,1.5,0,0,2,6,1130,0,1934,0.0,98168,47.4935,-122.306,1080,8100,6970,0.8604938271604938,1276900,65610000,64333100
408506.0,3,2.75,2480,209199,1.5,0,0,2,8,1870,610,2000,0.0,98010,47.3085,-121.88799999999999,2040,219229,206719,0.9881452588205488,6150400,43764221601,43758071201
640000.0,3,2.5,2580,7500,2.0,0,0,2,9,2580,0,1991,0.0,98116,47.5577,-122.396,910,6500,4920,0.656,6656400,56250000,49593600
316000.0,4,2.5,2010,7226,2.0,0,0,2,8,2010,0,1995,0.0,98092,47.2588,-122.21,2160,7696,5216,0.7218378079158594,4040100,52215076,48174976
299000.0,4,2.0,2320,12000,1.0,0,0,2,7,1720,600,1943,2014.0,98108,47.5246,-122.325,1390,6000,9680,0.8066666666666666,5382400,144000000,138617600
447500.0,2,2.25,1180,2090,2.0,0,0,2,7,1180,0,2004,0.0,98122,47.6032,-122.31,1550,2812,910,0.4354066985645933,1392400,4368100,2975700
736500.0,4,2.5,3180,21904,2.0,0,3,2,9,3180,0,2000,0.0,98059,47.515,-122.117,3715,29170,18724,0.8548210372534697,10112400,479785216,469672816
665000.0,4,2.0,2970,52567,2.0,0,0,2,8,2970,0,1924,1985.0,98072,47.7333,-122.12799999999999,3280,46676,49597,0.9435006753286282,8820900,2763289489,2754468589
707000.0,5,2.5,3050,13212,1.0,0,0,3,8,1590,0,1975,0.0,98006,47.5596,-122.14200000000001,2550,10826,10162,0.7691492582500757,9302500,174556944,165254444
215000.0,4,1.75,1630,8000,1.0,0,0,2,7,1630,0,1959,0.0,98031,47.3948,-122.20100000000001,1630,7700,6370,0.79625,2656900,64000000,61343100
275000.0,3,2.25,1620,6415,2.0,0,0,3,7,1620,0,1989,0.0,98038,47.3577,-122.038,1640,7253,4795,0.7474668745128605,2624400,41152225,38527825
648000.0,4,2.25,2170,8240,2.0,0,1,3,8,2170,0,1983,0.0,98006,47.5634,-122.12799999999999,2600,9898,6070,0.7366504854368932,4708900,67897600,63188700
415000.0,4,2.5,2150,8173,2.0,0,0,2,8,2150,0,1987,0.0,98059,47.511,-122.15299999999999,2080,7620,6023,0.736938700599535,4622500,66797929,62175429
690000.0,3,2.0,1770,1800,3.0,0,0,2,8,1770,0,1999,0.0,98122,47.6102,-122.314,1890,3200,30,0.016666666666666666,3132900,3240000,107100
320000.0,4,2.75,2110,13260,1.0,0,0,3,7,1290,820,1979,0.0,98058,47.4513,-122.16,1980,11016,11150,0.8408748114630468,4452100,175827600,171375500
750000.0,3,1.75,1590,8285,1.0,0,0,3,8,1590,0,1956,0.0,98004,47.5855,-122.194,1970,8970,6695,0.8080869040434521,2528100,68641225,66113125
355000.0,3,2.25,1370,1524,3.0,0,0,2,8,1370,0,2005,0.0,98103,47.6982,-122.34700000000001,1370,1418,154,0.1010498687664042,1876900,2322576,445676
246000.0,3,1.75,1390,7399,1.0,0,0,3,7,1390,0,1975,0.0,98031,47.4183,-122.182,1460,7800,6009,0.8121367752398972,1932100,54745201,52813101
1160000.0,3,1.75,1640,10464,1.0,0,2,3,8,1640,0,1968,0.0,98004,47.5873,-122.205,2630,18872,8824,0.8432721712538226,2689600,109495296,106805696
744000.0,3,2.5,2670,12187,2.0,0,0,2,8,2670,0,1986,0.0,98052,47.6677,-122.15,2400,8999,9517,0.7809140887831295,7128900,148522969,141394069
1210000.0,3,3.75,5400,24740,2.0,0,0,2,11,5400,0,1997,0.0,98053,47.6426,-121.955,1690,20000,19340,0.7817299919159256,29160000,612067600,582907600
217000.0,3,2.0,1690,6750,1.0,0,0,2,7,1210,480,1977,0.0,98023,47.3021,-122.375,1930,7350,5060,0.7496296296296296,2856100,45562500,42706400
583000.0,3,2.5,2600,5100,2.0,0,1,2,8,2600,0,1998,0.0,98056,47.5175,-122.205,2270,5400,2500,0.49019607843137253,6760000,26010000,19250000
515000.0,2,1.5,1400,5000,1.0,0,0,3,7,1150,250,1904,0.0,98107,47.6681,-122.36200000000001,1530,4200,3600,0.72,1960000,25000000,23040000
594000.0,4,1.75,2140,8000,1.0,0,0,3,8,1410,730,1965,0.0,98007,47.622,-122.139,2080,8000,5860,0.7325,4579600,64000000,59420400
303100.0,3,1.5,1640,5650,1.0,0,0,2,8,1640,0,1952,0.0,98178,47.50899999999999,-122.251,1640,5650,4010,0.7097345132743362,2689600,31922500,29232900
430000.0,3,1.75,1720,15225,1.0,0,0,3,7,1020,0,1970,0.0,98075,47.57899999999999,-122.051,1860,13588,13505,0.8870279146141216,2958400,231800625,228842225
708000.0,5,3.25,3060,11778,2.0,0,0,2,8,3060,0,2004,0.0,98034,47.7212,-122.22200000000001,1840,10403,8718,0.7401935812531839,9363600,138721284,129357684
221000.0,3,1.0,1150,7260,1.0,0,0,2,7,1150,0,1959,0.0,98133,47.7344,-122.333,1200,7888,6110,0.8415977961432507,1322500,52707600,51385100
325000.0,3,2.5,2000,7205,2.0,0,0,2,8,2000,0,1998,0.0,98003,47.3499,-122.302,2180,7611,5205,0.7224149895905622,4000000,51912025,47912025
385000.0,3,1.75,1560,5950,1.0,0,0,3,6,780,780,1944,0.0,98125,47.718999999999994,-122.307,1320,7830,4390,0.7378151260504202,2433600,35402500,32968900
359500.0,3,2.5,2070,4689,2.0,0,0,2,8,2070,0,2013,0.0,98038,47.3545,-122.056,1880,4593,2619,0.5585412667946257,4284900,21986721,17701821
433000.0,3,2.0,1920,7200,1.0,0,0,2,7,1300,620,1984,0.0,98028,47.7703,-122.265,2010,7200,5280,0.7333333333333333,3686400,51840000,48153600
525000.0,2,1.0,1000,4950,1.0,0,0,2,7,800,200,1948,0.0,98116,47.5671,-122.39399999999999,1060,5500,3950,0.797979797979798,1000000,24502500,23502500
356200.0,3,2.0,1690,10062,1.0,0,2,4,7,940,750,1928,0.0,98178,47.5102,-122.241,2390,6650,8372,0.8320413436692506,2856100,101243844,98387744
595000.0,4,2.0,3090,87120,1.0,0,0,3,7,1590,1500,1974,0.0,98072,47.7275,-122.12200000000001,2560,88426,84030,0.9645316804407713,9548100,7589894400,7580346300
560000.0,4,1.5,1790,3420,1.0,0,0,3,7,1020,770,1923,0.0,98103,47.6489,-122.337,1680,3420,1630,0.4766081871345029,3204100,11696400,8492300
2180000.0,4,3.0,4750,21701,1.5,0,0,4,11,4750,0,1976,0.0,98004,47.6454,-122.21799999999999,3120,18551,16951,0.7811160776001106,22562500,470933401,448370901
513000.0,4,2.0,2090,4000,1.0,0,0,2,7,1480,610,1951,0.0,98107,47.6751,-122.37899999999999,1510,5000,1910,0.4775,4368100,16000000,11631900
365000.0,2,1.0,680,2550,1.0,0,0,3,5,680,0,1901,0.0,98117,47.6767,-122.38799999999999,1120,5100,1870,0.7333333333333333,462400,6502500,6040100
368000.0,4,1.75,2100,11942,1.0,0,0,2,7,1030,1070,1964,0.0,98106,47.55,-122.35600000000001,1170,6986,9842,0.8241500586166471,4410000,142611364,138201364
870000.0,4,2.75,2840,4000,1.5,0,0,4,8,1960,880,1912,0.0,98144,47.5846,-122.291,2750,4000,1160,0.29,8065600,16000000,7934400
225000.0,3,2.25,1470,6808,1.0,0,0,2,7,1160,310,1984,0.0,98023,47.2884,-122.365,1570,7881,5338,0.7840775558166863,2160900,46348864,44187964
1390000.0,4,4.5,4490,24767,2.0,0,2,2,11,3800,690,1998,0.0,98006,47.5544,-122.147,3370,32700,20277,0.8187103807485767,20160100,613404289,593244189
177000.0,3,1.75,1150,8079,1.0,0,0,3,7,1150,0,1983,0.0,98030,47.3766,-122.18,1540,7399,6929,0.8576556504517886,1322500,65270241,63947741
465000.0,3,1.5,1460,9879,1.0,0,0,2,7,1460,0,1956,0.0,98008,47.6346,-122.12700000000001,1610,10050,8419,0.8522117623241219,2131600,97594641,95463041
750000.0,4,2.75,3150,6343,1.0,0,3,2,8,1810,1340,1976,0.0,98126,47.5424,-122.381,2250,6343,3193,0.5033895632981239,9922500,40233649,30311149
149000.0,3,1.0,1090,2800,1.0,0,0,2,6,1090,0,1969,0.0,98092,47.3162,-122.18299999999999,1040,2960,1710,0.6107142857142858,1188100,7840000,6651900
605000.0,3,2.5,2670,47480,2.0,0,3,2,9,2670,0,1981,0.0,98072,47.7443,-122.11399999999999,2760,42800,44810,0.943765796124684,7128900,2254350400,2247221500
725000.0,3,2.0,2110,5800,1.5,0,0,3,7,1990,120,1927,0.0,98103,47.6645,-122.34200000000001,1620,4300,3690,0.6362068965517241,4452100,33640000,29187900
413900.0,4,2.25,1770,5236,2.0,0,0,2,7,1770,0,2007,0.0,98056,47.5137,-122.189,2470,5064,3466,0.661955691367456,3132900,27415696,24282796
199950.0,3,1.5,1510,6600,1.0,0,0,2,6,1510,0,1938,0.0,98168,47.4821,-122.331,990,6600,5090,0.7712121212121212,2280100,43560000,41279900
400000.0,1,1.0,530,13679,1.0,0,0,3,6,530,0,1949,0.0,98053,47.6422,-121.954,1930,20624,13149,0.9612544776664961,280900,187115041,186834141
870000.0,3,1.5,2420,5000,2.0,0,0,3,8,2200,220,1925,0.0,98103,47.6744,-122.353,2070,5000,2580,0.516,5856400,25000000,19143600
292000.0,5,2.5,2490,7666,1.0,0,0,3,7,1490,1000,1989,0.0,98031,47.4022,-122.171,1930,7415,5176,0.6751891468823376,6200100,58767556,52567456
225000.0,3,1.0,990,8012,1.0,0,0,3,7,990,0,1966,0.0,98058,47.4557,-122.181,1260,9060,7022,0.8764353469795307,980100,64192144,63212044
466750.0,4,2.0,1730,9139,2.0,0,0,2,8,1730,0,1957,0.0,98125,47.7181,-122.316,1410,7311,7409,0.810701389648758,2992900,83521321,80528421
330000.0,2,1.5,1440,11954,1.0,0,0,3,8,1440,0,1978,0.0,98002,47.2909,-122.219,1460,9730,10514,0.8795382298812113,2073600,142898116,140824516
770000.0,7,2.25,3260,8145,2.0,0,0,4,8,3260,0,1967,0.0,98008,47.6336,-122.115,2340,8145,4885,0.5997544505831799,10627600,66341025,55713425
802500.0,4,2.25,1950,7000,1.0,0,1,2,8,1450,500,1957,0.0,98118,47.5426,-122.262,1840,6440,5050,0.7214285714285714,3802500,49000000,45197500
378800.0,5,2.5,2740,5400,2.0,0,0,2,8,2740,0,2005,0.0,98031,47.4036,-122.205,2900,5476,2660,0.4925925925925926,7507600,29160000,21652400
795000.0,3,2.75,2940,12487,2.0,0,0,2,10,2940,0,1997,0.0,98075,47.5879,-121.973,3110,10837,9547,0.7645551373428365,8643600,155925169,147281569
460000.0,3,2.0,1200,7320,1.0,0,0,2,7,1200,0,1955,0.0,98115,47.6986,-122.286,1750,8220,6120,0.8360655737704918,1440000,53582400,52142400
567000.0,3,2.5,2070,10908,2.0,0,0,2,8,2070,0,1986,0.0,98029,47.5665,-122.023,2220,10975,8838,0.8102310231023102,4284900,118984464,114699564
209950.0,3,1.75,1570,15570,1.0,0,0,2,7,1570,0,1981,0.0,98023,47.3207,-122.36200000000001,2000,28200,14000,0.899165061014772,2464900,242424900,239960000
415000.0,2,1.0,1050,60113,1.0,0,0,3,7,1050,0,1943,0.0,98001,47.3226,-122.287,1380,27442,59063,0.9825328963784872,1102500,3613572769,3612470269
424500.0,4,1.5,1830,6985,1.0,0,0,2,7,1080,750,1967,0.0,98028,47.7494,-122.236,1650,9501,5155,0.7380100214745884,3348900,48790225,45441325
261000.0,2,1.0,970,12500,1.0,0,0,2,6,970,0,1941,0.0,98168,47.5102,-122.33,1280,6250,11530,0.9224,940900,156250000,155309100
365000.0,3,2.5,2200,9696,2.0,0,0,2,8,2200,0,1987,0.0,98031,47.4197,-122.205,2200,9915,7496,0.773102310231023,4840000,94012416,89172416
631000.0,4,2.0,1930,3240,1.5,0,0,3,7,1930,0,1911,0.0,98122,47.6156,-122.29899999999999,1480,3600,1310,0.404320987654321,3724900,10497600,6772700
3800000.0,5,5.5,7050,42840,1.0,0,2,3,13,4320,2730,1978,0.0,98004,47.6229,-122.22,5070,20570,35790,0.8354341736694678,49702500,1835265600,1785563100
584000.0,3,2.5,1790,3962,2.0,0,0,2,8,1790,0,1992,0.0,98117,47.6894,-122.391,1340,3960,2172,0.5482079757698132,3204100,15697444,12493344
310000.0,3,1.75,1560,82328,1.0,0,0,2,7,1560,0,1974,0.0,98070,47.3674,-122.50299999999999,2100,205603,80768,0.9810514041395394,2433600,6777899584,6775465984
717000.0,4,2.5,2780,7985,2.0,0,0,3,10,2780,0,1992,0.0,98029,47.5608,-122.016,2650,8094,5205,0.65184721352536,7728400,63760225,56031825
667000.0,3,1.5,1720,8100,2.0,0,0,2,8,1720,0,1907,0.0,98107,47.6746,-122.4,2210,8100,6380,0.7876543209876543,2958400,65610000,62651600
190000.0,3,1.0,1640,8100,1.0,0,0,2,6,1040,600,1939,0.0,98146,47.482,-122.34,1600,8100,6460,0.7975308641975308,2689600,65610000,62920400
430000.0,3,2.0,1730,9000,1.0,0,0,2,8,1370,360,1978,0.0,98027,47.5202,-122.04700000000001,2390,10000,7270,0.8077777777777778,2992900,81000000,78007100
213000.0,2,1.0,740,7380,1.0,0,0,3,6,740,0,1951,0.0,98188,47.4481,-122.27799999999999,1500,10075,6640,0.8997289972899729,547600,54464400,53916800
475000.0,3,2.5,2280,3710,1.0,0,0,2,8,1550,730,1990,0.0,98072,47.735,-122.15899999999999,2030,3710,1430,0.38544474393531,5198400,13764100,8565700
649000.0,2,2.75,2090,23962,2.0,0,3,3,8,2090,0,1988,0.0,98070,47.4145,-122.44,1820,32340,21872,0.912778566062933,4368100,574177444,569809344
715000.0,3,2.5,2550,13458,2.0,0,0,2,9,2550,0,1990,0.0,98006,47.5586,-122.12100000000001,3180,13458,10908,0.8105216228265716,6502500,181117764,174615264
845000.0,4,3.5,3350,19487,1.0,0,0,2,11,2460,890,1992,0.0,98075,47.5796,-121.99799999999999,3360,19460,16137,0.8280905218863858,11222500,379743169,368520669
390000.0,3,2.5,2770,8820,1.0,0,0,2,7,1900,870,1980,2004.0,98038,47.3685,-122.04799999999999,1850,10920,6050,0.6859410430839002,7672900,77792400,70119500
390000.0,4,3.0,2860,5724,1.0,0,0,2,7,1730,1130,1983,0.0,98108,47.5427,-122.302,2340,7200,2864,0.5003494060097834,8179600,32764176,24584576
328000.0,4,1.75,1990,7194,1.0,0,0,3,8,1400,590,1978,0.0,98058,47.4417,-122.135,1820,7400,5204,0.723380594940228,3960100,51753636,47793536
239999.0,3,2.75,1740,8436,1.0,0,0,2,7,1140,600,1967,0.0,98003,47.3456,-122.305,1550,8436,6696,0.7937411095305832,3027600,71166096,68138496
225000.0,3,2.0,1460,7740,1.0,0,0,2,7,1460,0,1968,0.0,98003,47.3467,-122.306,1540,7644,6280,0.8113695090439277,2131600,59907600,57776000
920000.0,3,1.75,3670,11884,1.0,0,2,3,9,1950,1720,1979,0.0,98006,47.5604,-122.133,3020,9747,8214,0.6911814203971727,13468900,141229456,127760556
940000.0,4,2.75,3270,9231,2.0,0,0,2,10,3270,0,1995,0.0,98052,47.6539,-122.12100000000001,3380,10154,5961,0.6457588560285993,10692900,85211361,74518461
465000.0,3,1.0,1210,4872,1.0,0,0,3,6,1210,0,1949,0.0,98118,47.5551,-122.273,1070,4872,3662,0.7516420361247947,1464100,23736384,22272284
241000.0,3,2.0,1770,7000,1.0,0,0,2,7,1770,0,1986,0.0,98001,47.3321,-122.26100000000001,1510,10462,5230,0.7471428571428571,3132900,49000000,45867100
307550.0,4,2.5,1980,5909,2.0,0,0,2,8,1980,0,2003,0.0,98031,47.3913,-122.185,2550,5487,3929,0.6649179218141817,3920400,34916281,30995881
490000.0,4,2.5,2650,9627,1.0,0,3,3,8,1610,1040,1976,0.0,98028,47.7684,-122.25399999999999,2650,9221,6977,0.7247325231120806,7022500,92679129,85656629
647000.0,4,2.5,3040,6887,2.0,0,0,2,8,3040,0,1999,0.0,98074,47.6073,-122.015,2790,7196,3847,0.5585886452737041,9241600,47430769,38189169
780000.0,4,2.75,3640,231739,1.5,0,0,2,10,3640,0,1999,0.0,98027,47.5078,-122.01799999999999,2670,91040,228099,0.9842926740859329,13249600,53702964121,53689714521
517500.0,3,2.5,1810,4332,2.0,0,0,2,8,1810,0,1992,0.0,98029,47.5776,-121.99600000000001,1740,4332,2522,0.5821791320406279,3276100,18766224,15490124
295000.0,3,2.0,1380,8682,1.0,0,0,3,7,1380,0,1966,0.0,98148,47.4238,-122.322,1410,10594,7302,0.8410504492052523,1904400,75377124,73472724
560000.0,4,1.5,1810,3400,2.0,0,0,2,8,1810,0,1926,0.0,98112,47.6264,-122.302,1770,3600,1590,0.4676470588235294,3276100,11560000,8283900
319450.0,5,2.0,2250,5472,1.5,0,0,4,7,1750,500,1930,0.0,98002,47.3065,-122.219,1540,5472,3222,0.5888157894736842,5062500,29942784,24880284
1500000.0,4,3.25,3860,7199,2.0,0,1,2,9,2870,990,2005,0.0,98115,47.6855,-122.26899999999999,2940,9600,3339,0.4638144186692596,14899600,51825601,36926001
340000.0,4,3.0,2380,20277,1.0,0,0,2,8,1500,880,1999,0.0,98023,47.3046,-122.39200000000001,2370,15440,17897,0.8826256349558613,5664400,411156729,405492329
249950.0,3,1.0,1370,11658,1.0,0,0,3,6,1370,0,1958,0.0,98058,47.4576,-122.182,1080,9198,10288,0.882484131068794,1876900,135908964,134032064
499950.0,3,1.0,1830,3000,1.5,0,0,2,7,1430,400,1926,0.0,98103,47.6619,-122.351,1510,2500,1170,0.39,3348900,9000000,5651100
1040000.0,4,1.75,1440,13296,1.0,0,0,3,8,1440,0,1967,0.0,98004,47.63399999999999,-122.204,3520,10802,11856,0.8916967509025271,2073600,176783616,174710016
750000.0,4,2.5,2510,17200,1.0,0,2,3,9,1540,970,1977,0.0,98052,47.6287,-122.089,2370,14621,14690,0.8540697674418605,6300100,295840000,289539900
875000.0,4,2.5,3230,256132,2.0,0,0,2,9,3230,0,2006,0.0,98053,47.6544,-121.99799999999999,3080,217800,252902,0.9873893148845126,10432900,65603601424,65593168524
678000.0,3,1.75,1670,7210,1.0,0,0,4,8,1670,0,1967,0.0,98008,47.6344,-122.116,2200,7210,5540,0.768377253814147,2788900,51984100,49195200
360000.0,2,1.0,780,4200,1.0,0,0,2,6,780,0,1920,0.0,98118,47.5381,-122.26700000000001,1620,6000,3420,0.8142857142857143,608400,17640000,17031600
354900.0,3,1.0,1720,16552,1.0,0,0,3,7,1720,0,1971,0.0,98059,47.4772,-122.15299999999999,1550,15457,14832,0.8960850652489125,2958400,273968704,271010304
632000.0,5,2.5,2260,10087,1.0,0,0,2,8,1520,740,1967,0.0,98008,47.5982,-122.12799999999999,2500,9440,7827,0.7759492415980965,5107600,101747569,96639969
350000.0,3,1.75,1480,9375,1.0,0,0,3,7,1480,0,1957,0.0,98146,47.5076,-122.366,1370,9000,7895,0.8421333333333333,2190400,87890625,85700225
990000.0,3,4.0,2550,3900,2.0,0,2,2,8,2050,500,1940,2003.0,98199,47.6415,-122.39200000000001,2340,6400,1350,0.34615384615384615,6502500,15210000,8707500
1650000.0,4,3.25,3920,881654,3.0,0,3,2,11,3920,0,2002,0.0,98024,47.5385,-121.896,2970,112384,877734,0.9955538113591046,15366400,777313775716,777298409316
481000.0,4,2.5,2286,8269,2.0,0,0,2,8,2286,0,2002,0.0,98056,47.5174,-122.194,2110,4711,5983,0.7235457733704196,5225796,68376361,63150565
485000.0,3,2.5,1500,5412,1.0,0,0,4,7,900,600,1920,0.0,98136,47.5499,-122.39399999999999,1090,5412,3912,0.7228381374722838,2250000,29289744,27039744
477000.0,3,2.5,1740,4960,2.0,0,0,2,8,1740,0,1992,0.0,98029,47.5772,-121.99799999999999,1740,5021,3220,0.6491935483870968,3027600,24601600,21574000
560000.0,5,2.5,2880,9000,1.0,0,0,4,8,1440,1440,1966,0.0,98006,47.5456,-122.179,2010,9000,6120,0.68,8294400,81000000,72705600
600000.0,6,3.0,2600,9350,1.0,0,0,3,8,1340,1260,1963,0.0,98008,47.6198,-122.105,2090,9102,6750,0.7219251336898396,6760000,87422500,80662500
622500.0,5,2.75,3320,23760,2.0,0,0,3,8,2190,1130,1975,0.0,98072,47.7498,-122.146,2520,36720,20440,0.8602693602693603,11022400,564537600,553515200
410000.0,2,2.25,1660,2128,2.0,0,0,3,8,1660,0,1974,0.0,98028,47.7528,-122.25200000000001,1640,2128,468,0.2199248120300752,2755600,4528384,1772784
318200.0,3,2.5,1990,3644,2.0,0,0,2,7,1990,0,2010,0.0,98038,47.3531,-122.01700000000001,2580,3800,1654,0.45389681668496157,3960100,13278736,9318636
289000.0,3,2.0,1680,8424,1.0,0,0,2,7,1680,0,1993,0.0,98022,47.1969,-122.01100000000001,1990,8545,6744,0.8005698005698005,2822400,70963776,68141376
263000.0,3,1.75,1570,7775,2.0,0,0,2,7,1570,0,1982,0.0,98031,47.3876,-122.21600000000001,1580,8622,6205,0.7980707395498392,2464900,60450625,57985725
240000.0,3,1.0,1150,4825,1.0,0,0,3,6,1150,0,1957,0.0,98027,47.5321,-122.029,1760,7121,3675,0.7616580310880829,1322500,23280625,21958125
281500.0,3,1.0,1270,7500,1.0,0,0,2,7,1270,0,1953,0.0,98146,47.4921,-122.339,1340,3000,6230,0.8306666666666667,1612900,56250000,54637100
587206.0,3,3.5,1890,1710,2.0,0,0,2,8,1640,250,1999,0.0,98103,47.6592,-122.34899999999999,1680,1562,-180,-0.10526315789473684,3572100,2924100,-648000
482000.0,2,2.25,1350,1248,2.0,0,0,2,7,1180,170,2000,0.0,98102,47.6399,-122.32,1760,3360,-102,-0.08173076923076923,1822500,1557504,-264996
485000.0,3,1.75,1650,9500,1.0,0,0,2,8,1650,0,1967,0.0,98052,47.631,-122.098,1880,9375,7850,0.8263157894736842,2722500,90250000,87527500
309000.0,3,2.5,1450,11480,2.0,0,0,2,7,1450,0,1990,0.0,98014,47.672,-121.86399999999999,2080,87991,10030,0.8736933797909407,2102500,131790400,129687900
221000.0,3,2.25,1640,7350,1.0,0,0,2,7,1140,500,1984,0.0,98003,47.2625,-122.3,1480,8041,5710,0.7768707482993197,2689600,54022500,51332900
700000.0,3,2.5,2030,8398,2.0,0,0,3,9,2030,0,1975,0.0,98008,47.6272,-122.095,2450,8104,6368,0.7582757799476065,4120900,70526404,66405504
411500.0,5,3.0,2420,7740,1.0,0,0,4,7,1360,1060,1929,1969.0,98106,47.536,-122.35799999999999,1840,6780,5320,0.6873385012919897,5856400,59907600,54051200
285000.0,4,3.5,2770,10505,2.0,0,0,2,8,2770,0,1940,2015.0,98133,47.7412,-122.355,1760,10505,7735,0.7363160399809614,7672900,110355025,102682125
395000.0,4,3.0,1980,7931,1.0,0,0,3,7,1160,820,1983,0.0,98133,47.7513,-122.334,1910,7931,5951,0.7503467406380028,3920400,62900761,58980361
237950.0,2,1.75,1460,7926,1.0,0,0,3,7,1460,0,1987,0.0,98042,47.3665,-122.09200000000001,1680,8206,6466,0.8157961140550088,2131600,62821476,60689876
680000.0,3,2.5,1610,8064,1.0,0,2,3,7,1160,450,1981,0.0,98033,47.6818,-122.189,2260,8328,6454,0.8003472222222222,2592100,65028096,62435996
199950.0,2,1.0,1010,10057,1.0,0,0,2,6,1010,0,1961,0.0,98023,47.3286,-122.336,1040,8591,9047,0.8995724371084817,1020100,101143249,100123149
765000.0,4,3.5,2760,4000,2.0,0,2,2,8,2000,760,1926,2014.0,98126,47.5687,-122.374,1690,4000,1240,0.31,7617600,16000000,8382400
515000.0,2,1.0,1060,4960,1.0,0,0,2,7,1060,0,1926,0.0,98103,47.6896,-122.331,1420,4960,3900,0.7862903225806451,1123600,24601600,23478000
470000.0,3,1.5,1510,8000,1.0,0,0,3,7,1510,0,1956,0.0,98007,47.5865,-122.135,1430,8000,6490,0.81125,2280100,64000000,61719900
330000.0,2,1.0,880,4000,1.0,0,0,2,6,780,100,1937,0.0,98117,47.6931,-122.37899999999999,950,4000,3120,0.78,774400,16000000,15225600
284000.0,3,2.5,2150,9375,1.0,0,0,2,8,1550,600,1968,0.0,98188,47.4578,-122.274,1950,9100,7225,0.7706666666666667,4622500,87890625,83268125
295000.0,3,2.5,1660,8125,1.0,0,0,2,7,1150,510,1999,0.0,98148,47.4373,-122.333,1250,8125,6465,0.7956923076923077,2755600,66015625,63260025
555000.0,4,2.5,2160,10987,1.0,0,0,3,8,1440,720,1981,0.0,98074,47.6333,-122.03399999999999,1280,11617,8827,0.8034040229361973,4665600,120714169,116048569
350000.0,3,1.0,1370,8162,1.5,0,0,2,6,1370,0,1949,0.0,98125,47.7263,-122.289,1560,8250,6792,0.8321489830923793,1876900,66618244,64741344
240000.0,3,2.25,1460,5818,1.0,0,0,2,7,1140,320,1986,0.0,98023,47.3113,-122.35799999999999,1490,6031,4358,0.7490546579580611,2131600,33849124,31717524
419900.0,3,1.5,1450,7000,1.0,0,0,2,7,1450,0,1955,0.0,98007,47.5983,-122.15,1490,7245,5550,0.7928571428571428,2102500,49000000,46897500
528000.0,3,2.0,1560,6300,1.0,0,0,2,7,1560,0,1924,0.0,98126,47.5407,-122.37899999999999,1620,6300,4740,0.7523809523809524,2433600,39690000,37256400
481000.0,4,2.5,2480,9869,1.0,0,0,3,8,1240,1240,1963,0.0,98028,47.7612,-122.229,2230,10310,7389,0.7487080757928868,6150400,97397161,91246761
304700.0,2,1.0,740,5995,1.0,0,0,3,7,740,0,1949,0.0,98133,47.7291,-122.337,1140,5995,5255,0.8765638031693077,547600,35940025,35392425
715000.0,4,2.5,2927,12171,2.0,0,0,2,10,2927,0,1998,0.0,98075,47.5948,-121.98299999999999,2967,12166,9244,0.7595103113959412,8567329,148133241,139565912
738950.0,4,2.75,2260,12005,1.0,0,0,3,8,2260,0,1956,1989.0,98005,47.6342,-122.171,1870,10800,9745,0.8117451062057476,5107600,144120025,139012425
215000.0,3,1.5,1240,9405,1.0,0,0,3,7,1240,0,1966,0.0,98042,47.3727,-122.162,2260,7611,8165,0.8681552365762892,1537600,88454025,86916425
300000.0,6,2.0,2040,10812,1.0,0,0,3,5,2040,0,1943,0.0,98056,47.4919,-122.181,1440,10200,8772,0.8113207547169812,4161600,116899344,112737744
346000.0,3,1.75,1270,8100,1.0,0,0,2,6,880,390,1950,0.0,98146,47.4828,-122.344,1650,8173,6830,0.8432098765432099,1612900,65610000,63997100
473000.0,4,3.5,4370,37193,2.0,0,3,2,8,2780,1590,1996,0.0,98022,47.24100000000001,-121.979,2860,39356,32823,0.8825047724034093,19096900,1383319249,1364222349
500000.0,3,1.75,1700,6120,1.0,0,0,2,7,1700,0,1952,0.0,98116,47.5807,-122.397,1330,6120,4420,0.7222222222222222,2890000,37454400,34564400
750000.0,2,1.5,1300,7632,1.0,0,2,2,7,1300,0,1943,0.0,98122,47.6134,-122.30799999999999,1420,1676,6332,0.8296645702306079,1690000,58247424,56557424
519900.0,4,2.0,1820,9350,1.0,0,0,3,8,1820,0,1967,0.0,98052,47.6288,-122.098,2260,9299,7530,0.8053475935828877,3312400,87422500,84110100
378500.0,2,1.0,880,6171,1.0,0,0,3,7,880,0,1949,0.0,98125,47.7262,-122.285,2260,12769,5291,0.857397504456328,774400,38081241,37306841
314500.0,3,1.75,1870,12381,1.0,0,0,3,8,1870,0,1957,0.0,98003,47.3358,-122.32,1950,12667,10511,0.8489621193764639,3496900,153289161,149792261
499950.0,3,1.5,1350,9315,1.0,0,0,2,7,1350,0,1968,0.0,98052,47.6587,-122.124,1840,9920,7965,0.855072463768116,1822500,86769225,84946725
1740000.0,5,3.5,4870,7700,2.5,0,3,4,10,3650,1220,1929,0.0,98144,47.5832,-122.29,3220,7700,2830,0.36753246753246754,23716900,59290000,35573100
630000.0,3,2.5,2460,38794,2.0,0,0,2,9,2460,0,1999,0.0,98077,47.7602,-122.022,2470,51400,36334,0.9365881321853895,6051600,1504974436,1498922836
360000.0,4,1.5,1720,6417,1.0,0,0,2,7,1720,0,1953,0.0,98125,47.7268,-122.311,1430,6240,4697,0.7319619760012467,2958400,41177889,38219489
460000.0,2,1.5,2730,19877,1.0,0,0,3,8,1570,1160,1976,0.0,98019,47.7698,-121.898,1450,19509,17147,0.8626553302812295,7452900,395095129,387642229
361000.0,3,1.0,1100,4046,1.5,0,4,3,6,1100,0,1922,0.0,98198,47.343999999999994,-122.331,2550,7847,2946,0.7281265447355413,1210000,16370116,15160116
713400.0,3,2.25,1810,9845,1.0,0,0,3,8,1810,0,1959,1991.0,98040,47.5505,-122.221,1900,10083,8035,0.8161503301168106,3276100,96924025,93647925
445000.0,2,1.0,930,3150,1.0,0,0,4,6,930,0,1918,0.0,98115,47.6783,-122.29799999999999,1900,5000,2220,0.7047619047619048,864900,9922500,9057600
305000.0,4,1.5,1590,131551,1.0,0,3,3,7,1590,0,1966,0.0,98022,47.2558,-122.024,2280,108028,129961,0.9879134328131295,2528100,17305665601,17303137501
1430000.0,3,2.75,2710,9204,1.5,0,4,2,9,1480,1230,1975,0.0,98177,47.7039,-122.385,2960,10080,6494,0.7055627987831378,7344100,84713616,77369516
222000.0,3,1.0,1460,8400,1.0,0,0,3,6,1460,0,1962,0.0,98023,47.3086,-122.365,1060,8563,6940,0.8261904761904761,2131600,70560000,68428400
510000.0,5,3.25,3400,4499,2.0,0,0,2,8,2740,660,2005,0.0,98065,47.5385,-121.88,3400,6163,1099,0.2442765058901978,11560000,20241001,8681001
500000.0,5,3.0,2920,11440,2.0,0,0,2,8,2920,0,2003,0.0,98133,47.7607,-122.354,1720,9348,8520,0.7447552447552448,8526400,130873600,122347200
605000.0,2,1.0,910,3600,1.0,0,0,3,7,910,0,1909,0.0,98119,47.6341,-122.361,1720,3600,2690,0.7472222222222222,828100,12960000,12131900
393000.0,3,2.0,1320,10720,2.0,0,0,2,8,1320,0,1981,0.0,98074,47.6203,-122.037,1910,13639,9400,0.8768656716417911,1742400,114918400,113176000
725000.0,4,2.5,2490,5170,2.0,0,0,3,9,2490,0,2000,0.0,98052,47.6836,-122.162,2490,5170,2680,0.5183752417794971,6200100,26728900,20528800
320000.0,3,1.75,2220,11646,1.0,0,0,2,7,1270,950,1950,0.0,98028,47.7762,-122.27,1490,10003,9426,0.8093766099948481,4928400,135629316,130700916
210000.0,4,1.5,1130,7840,1.0,0,0,3,7,1130,0,1970,0.0,98023,47.2986,-122.37700000000001,1690,7840,6710,0.8558673469387755,1276900,61465600,60188700
419900.0,4,2.5,2750,5767,2.0,0,0,2,9,2750,0,2005,0.0,98038,47.3595,-122.038,2800,5376,3017,0.5231489509276921,7562500,33258289,25695789
410000.0,4,2.5,2240,4447,2.0,0,0,2,7,2240,0,2006,0.0,98059,47.4868,-122.15899999999999,2000,3800,2207,0.49628963346076005,5017600,19775809,14758209
721000.0,3,2.25,2680,10440,1.0,0,1,2,8,1540,1140,1963,0.0,98116,47.56100000000001,-122.398,2140,7560,7760,0.7432950191570882,7182400,108993600,101811200
605000.0,2,2.0,1270,5500,1.5,0,0,3,8,1270,0,1921,0.0,98122,47.6121,-122.294,1870,4400,4230,0.769090909090909,1612900,30250000,28637100
738000.0,3,1.75,1520,5500,1.5,0,0,4,7,1520,0,1936,0.0,98116,47.5839,-122.383,2310,5500,3980,0.7236363636363636,2310400,30250000,27939600
725000.0,6,3.0,2480,12000,2.0,0,0,2,8,2480,0,1972,0.0,98007,47.6131,-122.145,2220,8580,9520,0.7933333333333333,6150400,144000000,137849600
255000.0,2,1.0,960,20954,1.0,0,0,2,7,960,0,1977,0.0,98045,47.4485,-121.774,1240,9752,19994,0.9541853584041233,921600,439070116,438148516
303000.0,3,2.25,1340,873,3.0,0,0,2,8,1340,0,2009,0.0,98133,47.7325,-122.34299999999999,1340,1186,-467,-0.5349369988545246,1795600,762129,-1033471
394950.0,3,2.5,1090,7700,1.0,0,0,3,7,1090,0,1957,0.0,98008,47.607,-122.12,1740,7700,6610,0.8584415584415584,1188100,59290000,58101900
530000.0,4,3.0,2240,5580,2.0,0,0,4,7,1830,410,1949,0.0,98118,47.5598,-122.27,1530,4800,3340,0.5985663082437276,5017600,31136400,26118800
475000.0,4,2.5,3740,8700,1.0,0,0,2,10,2260,1480,2004,0.0,98058,47.4587,-122.117,2650,6333,4960,0.5701149425287356,13987600,75690000,61702400
250000.0,4,2.5,1800,8100,2.0,0,0,2,7,1800,0,1998,0.0,98038,47.3611,-122.04700000000001,1590,8100,6300,0.7777777777777778,3240000,65610000,62370000
180000.0,3,1.0,780,3540,1.0,0,0,1,6,780,0,1920,0.0,98118,47.565,-122.291,1260,3540,2760,0.7796610169491526,608400,12531600,11923200
443500.0,2,1.0,1330,4140,1.0,0,0,3,7,930,400,1919,1940.0,98115,47.6802,-122.306,1410,5100,2810,0.678743961352657,1768900,17139600,15370700
390000.0,4,2.0,1900,76877,1.0,0,0,2,8,1900,0,2004,0.0,98042,47.3491,-122.113,1740,34848,74977,0.9752851958323036,3610000,5910073129,5906463129
430000.0,4,1.75,1570,7650,1.0,0,0,2,7,1100,470,1975,0.0,98052,47.6801,-122.10600000000001,1580,7650,6080,0.7947712418300653,2464900,58522500,56057600
460000.0,5,4.5,3100,7260,2.0,0,0,2,8,3100,0,1963,2000.0,98059,47.5004,-122.162,1650,7700,4160,0.5730027548209367,9610000,52707600,43097600
660000.0,3,3.5,2740,3785,2.0,0,0,2,9,2190,550,2001,0.0,98034,47.7195,-122.182,2060,3457,1045,0.2760898282694848,7507600,14326225,6818625
515000.0,3,1.75,1570,10939,1.0,0,0,2,8,1200,370,1974,0.0,98052,47.6389,-122.102,1760,10200,9369,0.8564768260352866,2464900,119661721,117196821
482500.0,3,2.0,1330,6490,1.0,0,0,3,7,1330,0,1954,0.0,98125,47.7181,-122.30799999999999,1580,7202,5160,0.7950693374422187,1768900,42120100,40351200
305000.0,2,1.5,1140,2980,2.0,0,0,2,7,1140,0,1988,0.0,98029,47.5707,-122.01799999999999,1150,2981,1840,0.6174496644295302,1299600,8880400,7580800
835000.0,4,2.75,1550,4000,1.5,0,0,2,9,1550,0,1930,0.0,98105,47.6596,-122.28,2120,4000,2450,0.6125,2402500,16000000,13597500
237000.0,3,2.0,1290,7952,1.0,0,0,2,7,1290,0,1998,0.0,98030,47.3867,-122.19,1670,7280,6662,0.8377766599597586,1664100,63234304,61570204
445000.0,2,1.5,1510,2001,2.0,0,0,3,8,1510,0,1985,0.0,98007,47.6211,-122.15299999999999,1510,2055,491,0.24537731134432783,2280100,4004001,1723901
710000.0,4,2.5,2720,8000,1.0,0,0,3,7,1360,1360,1955,0.0,98136,47.5237,-122.391,1790,8000,5280,0.66,7398400,64000000,56601600
180000.0,3,1.0,840,5700,1.0,0,0,3,5,840,0,1945,0.0,98038,47.3948,-122.02799999999999,1430,12600,4860,0.8526315789473684,705600,32490000,31784400
280017.0,3,2.5,1850,8770,2.0,0,0,2,8,1850,0,1996,0.0,98022,47.2091,-122.009,2350,8606,6920,0.7890535917901939,3422500,76912900,73490400
436500.0,4,2.5,2290,11173,2.0,0,0,3,8,2290,0,1988,0.0,98058,47.4314,-122.164,2290,10404,8883,0.7950416181867,5244100,124835929,119591829
1260000.0,4,2.5,3200,7535,2.0,0,0,2,9,3200,0,2006,0.0,98105,47.666000000000004,-122.27600000000001,1650,6850,4335,0.5753151957531519,10240000,56776225,46536225
420000.0,3,2.25,1800,9800,1.0,0,0,3,7,1300,500,1959,0.0,98028,47.7393,-122.244,1680,9545,8000,0.8163265306122449,3240000,96040000,92800000
205000.0,3,1.0,860,7467,1.0,0,0,2,6,860,0,1944,0.0,98178,47.4947,-122.23700000000001,1280,7467,6607,0.8848265702423999,739600,55756089,55016489
570000.0,3,1.5,1980,10203,1.0,0,0,3,7,1680,300,1946,0.0,98010,47.3402,-122.046,1980,13664,8223,0.8059394295795355,3920400,104101209,100180809
565000.0,4,1.75,2140,7102,1.0,0,0,3,7,1070,1070,1948,0.0,98177,47.7042,-122.37,1950,7102,4962,0.6986764291748803,4579600,50438404,45858804
287000.0,2,2.5,2410,7500,1.0,0,0,2,7,1550,860,1978,0.0,98023,47.3078,-122.374,1840,8800,5090,0.6786666666666666,5808100,56250000,50441900
260000.0,4,1.75,1650,7276,1.0,0,0,2,7,1010,640,1977,0.0,98011,47.7721,-122.206,1840,8550,5626,0.7732270478284772,2722500,52940176,50217676
470000.0,4,1.75,1650,7276,1.0,0,0,2,7,1010,640,1977,0.0,98011,47.7721,-122.206,1840,8550,5626,0.7732270478284772,2722500,52940176,50217676
700000.0,3,2.5,2410,9916,2.0,0,0,3,10,2410,0,1989,0.0,98052,47.6911,-122.103,2310,8212,7506,0.7569584509883017,5808100,98327056,92518956
249000.0,3,1.75,1520,7500,1.0,0,0,2,8,1520,0,1985,0.0,98092,47.2646,-122.219,2180,7506,5980,0.7973333333333333,2310400,56250000,53939600
568000.0,3,1.75,2050,3520,1.0,0,0,3,7,1070,980,1977,0.0,98136,47.5536,-122.399,2050,16083,1470,0.41761363636363635,4202500,12390400,8187900
500000.0,4,1.0,1720,4011,1.5,0,0,3,7,1720,0,1904,0.0,98107,47.6719,-122.396,1580,3784,2291,0.5711792570431314,2958400,16088121,13129721
358000.0,5,2.5,2390,8775,1.0,0,0,3,7,1270,1120,1980,0.0,98058,47.4639,-122.17,1800,8000,6385,0.7276353276353277,5712100,77000625,71288525
225000.0,3,2.5,1680,6755,2.0,0,0,2,8,1680,0,1994,0.0,98092,47.3293,-122.17,1860,7257,5075,0.7512953367875648,2822400,45630025,42807625
275500.0,3,1.0,1060,7246,1.0,0,0,3,6,1060,0,1981,0.0,98056,47.4936,-122.165,1090,6694,6186,0.8537123930444384,1123600,52504516,51380916
495000.0,3,2.5,1860,3150,2.0,0,0,2,8,1860,0,2001,0.0,98034,47.718999999999994,-122.182,2050,3375,1290,0.4095238095238095,3459600,9922500,6462900
758800.0,5,2.25,1750,5000,1.0,0,0,2,8,960,790,1940,0.0,98105,47.6589,-122.27600000000001,2580,5000,3250,0.65,3062500,25000000,21937500
280000.0,3,1.75,1480,8165,1.0,0,0,3,7,1480,0,1985,0.0,98042,47.3624,-122.079,1450,7939,6685,0.8187385180649112,2190400,66667225,64476825
380500.0,3,2.5,1900,7361,2.0,0,0,2,8,1900,0,1994,0.0,98055,47.4324,-122.191,2100,7361,5461,0.7418828963456052,3610000,54184321,50574321
3200000.0,7,4.5,6210,8856,2.5,0,2,4,11,4760,1450,1910,0.0,98109,47.6307,-122.354,2940,5400,2646,0.29878048780487804,38564100,78428736,39864636
260000.0,3,1.75,1440,12888,1.0,0,2,2,7,1090,350,1958,0.0,98168,47.471000000000004,-122.262,1710,12888,11448,0.888268156424581,2073600,166100544,164026944
630000.0,4,2.5,1910,1502,3.0,0,0,2,8,1910,0,2014,0.0,98107,47.6747,-122.39299999999999,1520,3888,-408,-0.27163781624500666,3648100,2256004,-1392096
875000.0,3,2.0,2010,4000,1.0,0,0,4,7,1210,800,1915,0.0,98103,47.6638,-122.329,1770,4000,1990,0.4975,4040100,16000000,11959900
457500.0,3,1.0,960,4600,1.5,0,0,3,6,960,0,1927,0.0,98118,47.5553,-122.286,1380,5175,3640,0.7913043478260869,921600,21160000,20238400
900000.0,2,1.0,1240,5500,1.0,0,0,2,7,1240,0,1954,0.0,98102,47.6461,-122.31700000000001,2080,4400,4260,0.7745454545454545,1537600,30250000,28712400
235000.0,2,2.0,870,6450,1.0,0,0,3,6,740,130,1954,0.0,98118,47.5354,-122.27799999999999,1640,5775,5580,0.8651162790697674,756900,41602500,40845600
410000.0,3,2.0,1400,45738,2.0,0,0,3,8,1400,0,1981,0.0,98070,47.3624,-122.455,2390,56628,44338,0.9693908784817876,1960000,2091964644,2090004644
355000.0,3,3.0,1850,9600,1.0,0,0,2,7,1230,620,1981,0.0,98028,47.7717,-122.25,1970,10000,7750,0.8072916666666666,3422500,92160000,88737500
1300000.0,4,4.0,4270,6002,2.0,0,3,2,10,3180,1090,2004,0.0,98029,47.5443,-121.994,4280,5942,1732,0.28857047650783074,18232900,36024004,17791104
467500.0,3,1.75,2260,8512,1.0,0,0,2,7,1130,1130,1948,0.0,98125,47.7129,-122.304,2240,8040,6252,0.7344924812030075,5107600,72454144,67346544
500000.0,4,4.5,2690,7350,1.5,0,0,4,7,2690,0,1949,0.0,98125,47.7062,-122.311,1660,9000,4660,0.6340136054421769,7236100,54022500,46786400
995000.0,4,3.5,2780,9550,2.0,0,4,4,10,2530,250,1978,0.0,98166,47.45399999999999,-122.37299999999999,2724,10634,6770,0.7089005235602094,7728400,91202500,83474100
277000.0,3,1.0,1140,8144,1.0,0,0,2,7,1140,0,1956,0.0,98155,47.7464,-122.31700000000001,1150,8144,7004,0.8600196463654224,1299600,66324736,65025136
630000.0,4,2.25,2900,9680,2.0,0,0,2,7,1990,910,1947,0.0,98125,47.7037,-122.30799999999999,1850,7540,6780,0.7004132231404959,8410000,93702400,85292400
628000.0,5,2.75,2830,11795,1.0,0,0,3,7,1710,1120,1960,0.0,98008,47.5828,-122.118,2460,10880,8965,0.7600678253497245,8008900,139122025,131113125
655000.0,5,2.5,2560,46786,2.0,0,0,2,8,2560,0,1995,0.0,98019,47.7125,-121.915,2430,46929,44226,0.9452827768990724,6553600,2188929796,2182376196
170000.0,2,1.0,1240,9900,1.0,0,0,2,7,940,300,1950,0.0,98168,47.4862,-122.32600000000001,1050,9375,8660,0.8747474747474747,1537600,98010000,96472400
352500.0,4,2.5,2100,10750,1.0,0,2,3,8,2100,0,1967,0.0,98023,47.3338,-122.337,2310,10425,8650,0.8046511627906977,4410000,115562500,111152500
615000.0,4,2.75,3120,34040,2.0,0,0,2,9,3120,0,1997,0.0,98010,47.3431,-122.03,2420,25201,30920,0.9083431257344301,9734400,1158721600,1148987200
165000.0,3,1.0,970,6600,1.0,0,0,2,7,970,0,1965,0.0,98168,47.4836,-122.33200000000001,1200,6600,5630,0.853030303030303,940900,43560000,42619100
243500.0,4,2.5,2300,15188,2.0,0,0,3,7,2300,0,1966,0.0,98042,47.3683,-122.164,1820,10125,12888,0.8485646563076112,5290000,230675344,225385344
304000.0,2,1.5,950,676,2.0,0,0,2,7,850,100,2003,0.0,98144,47.6005,-122.306,950,1280,-274,-0.40532544378698226,902500,456976,-445524
369000.0,3,1.5,2110,5195,1.0,0,0,2,7,1210,900,1959,0.0,98118,47.5283,-122.286,1950,5195,3085,0.5938402309913379,4452100,26988025,22535925
779950.0,4,2.75,2990,4298,2.0,0,0,2,9,2990,0,2014,0.0,98052,47.7101,-122.10799999999999,2990,4837,1308,0.3043275942298744,8940100,18472804,9532704
605000.0,4,2.25,2940,48788,1.0,0,0,4,7,1520,1420,1961,0.0,98028,47.7422,-122.245,2470,14900,45848,0.9397392801508567,8643600,2380268944,2371625344
292500.0,4,2.5,1860,8709,2.0,0,0,2,8,1860,0,1994,0.0,98092,47.3289,-122.17,1990,6825,6849,0.7864278332759215,3459600,75846681,72387081
500007.0,2,1.75,1820,6050,1.0,0,0,2,7,910,910,1950,0.0,98115,47.6928,-122.323,1730,6050,4230,0.6991735537190082,3312400,36602500,33290100
449999.0,4,2.5,1950,4947,2.0,0,0,2,8,1950,0,2000,0.0,98056,47.5042,-122.193,1760,5611,2997,0.6058217101273499,3802500,24472809,20670309
355000.0,4,2.5,1890,7867,2.0,0,0,2,8,1890,0,1996,0.0,98038,47.3788,-122.031,2250,7867,5977,0.7597559425448074,3572100,61889689,58317589
258000.0,4,3.0,2710,7199,1.0,0,0,3,7,1710,1000,1967,0.0,98030,47.3789,-122.213,2070,9271,4489,0.6235588276149465,7344100,51825601,44481501
380000.0,4,2.25,2150,20181,1.0,0,0,2,7,1090,1060,1963,0.0,98028,47.7627,-122.245,2150,10480,18031,0.8934641494475001,4622500,407272761,402650261
650000.0,4,3.0,3720,57499,1.0,0,0,2,9,1880,1840,2003,0.0,98014,47.6469,-121.897,2560,26372,53779,0.935303222664742,13838400,3306135001,3292296601
456500.0,4,2.5,2580,11780,2.0,0,0,2,9,2580,0,2003,0.0,98038,47.3658,-122.04,2410,8403,9200,0.7809847198641766,6656400,138768400,132112000
259950.0,4,2.0,1540,10212,1.5,0,0,4,7,1540,0,1948,0.0,98022,47.2056,-121.999,1480,10212,8672,0.8491970231100666,2371600,104284944,101913344
123000.0,2,1.0,1050,6600,1.5,0,0,2,6,1050,0,1964,0.0,98168,47.4828,-122.324,1330,6600,5550,0.8409090909090909,1102500,43560000,42457500
520000.0,3,2.25,1210,1250,3.0,0,0,2,8,1210,0,2014,0.0,98107,47.6722,-122.384,1780,5000,40,0.032,1464100,1562500,98400
506000.0,4,2.25,2040,12000,1.0,0,0,3,7,1300,740,1963,0.0,98028,47.7362,-122.241,1930,12000,9960,0.83,4161600,144000000,139838400
425000.0,3,1.0,980,4800,1.5,0,0,2,7,980,0,1926,0.0,98118,47.5663,-122.274,2030,7200,3820,0.7958333333333333,960400,23040000,22079600
438000.0,5,2.5,1990,6840,2.0,0,0,3,7,1990,0,1974,0.0,98034,47.7162,-122.166,1990,7150,4850,0.7090643274853801,3960100,46785600,42825500
1490000.0,4,2.5,2420,18480,1.0,0,0,3,9,2420,0,1967,0.0,98004,47.6214,-122.227,3330,19910,16060,0.8690476190476191,5856400,341510400,335654000
375000.0,4,2.0,1240,3000,1.0,0,0,2,7,1040,200,1908,0.0,98122,47.6076,-122.29799999999999,1480,3500,1760,0.5866666666666667,1537600,9000000,7462400
337500.0,3,2.25,1530,6600,1.0,0,0,3,7,1240,290,1968,0.0,98055,47.461999999999996,-122.18799999999999,1500,7700,5070,0.7681818181818182,2340900,43560000,41219100
300000.0,4,2.25,2080,7700,1.0,0,0,2,7,1450,630,1968,0.0,98058,47.4349,-122.17,1900,7980,5620,0.7298701298701299,4326400,59290000,54963600
627000.0,5,3.25,3570,5425,2.0,0,0,2,7,3570,0,2005,0.0,98075,47.5933,-122.007,2690,5347,1855,0.3419354838709677,12744900,29430625,16685725
1400000.0,5,4.25,4230,6907,2.0,0,0,2,10,3450,780,2008,0.0,98033,47.6866,-122.205,2650,8076,2677,0.387577819603301,17892900,47706649,29813749
674725.0,4,2.5,2700,10160,2.0,0,0,2,9,2700,0,1988,0.0,98029,47.5685,-122.012,2760,9219,7460,0.734251968503937,7290000,103225600,95935600
325000.0,3,2.75,2200,7000,1.0,0,0,3,7,1280,920,1977,0.0,98058,47.4574,-122.169,1670,7000,4800,0.6857142857142857,4840000,49000000,44160000
230000.0,5,2.0,1210,12538,2.0,0,0,2,7,1210,0,1982,0.0,98023,47.2848,-122.361,1510,7700,11328,0.9034933801244217,1464100,157201444,155737344
485000.0,5,1.75,2140,43124,1.0,0,2,3,7,1220,920,1962,0.0,98027,47.5516,-122.085,2520,14677,40984,0.9503756608848901,4579600,1859679376,1855099776
315000.0,4,2.5,2740,8400,1.5,0,2,2,8,2740,0,1993,0.0,98022,47.1947,-122.008,2030,8638,5660,0.6738095238095239,7507600,70560000,63052400
560000.0,3,2.75,1370,1193,3.0,0,0,2,8,1370,0,2003,0.0,98107,47.67,-122.39200000000001,1320,1180,-177,-0.14836546521374686,1876900,1423249,-453651
444000.0,4,3.0,2800,7198,2.0,0,0,2,8,2800,0,2002,0.0,98038,47.3538,-122.01299999999999,3610,7845,4398,0.6110030564045569,7840000,51811204,43971204
325000.0,3,1.5,1060,7488,1.0,0,0,4,7,1060,0,1977,0.0,98106,47.5549,-122.35600000000001,1300,6780,6428,0.8584401709401709,1123600,56070144,54946544
118125.0,2,1.0,790,7153,1.0,0,0,3,6,790,0,1944,0.0,98168,47.4869,-122.324,810,7128,6363,0.8895568293023906,624100,51165409,50541309
212000.0,2,1.0,790,7153,1.0,0,0,3,6,790,0,1944,0.0,98168,47.4869,-122.324,810,7128,6363,0.8895568293023906,624100,51165409,50541309
428900.0,4,2.5,2820,5056,2.0,0,0,2,9,2820,0,2006,0.0,98038,47.3591,-122.038,2820,5150,2236,0.442246835443038,7952400,25563136,17610736
510000.0,3,2.0,1850,9600,1.0,0,0,2,7,1850,0,1968,1998.0,98011,47.7671,-122.225,1770,9600,7750,0.8072916666666666,3422500,92160000,88737500
416000.0,3,1.5,1110,9762,1.0,0,0,3,7,1110,0,1963,0.0,98052,47.676,-122.15,1900,9720,8652,0.8862937922556853,1232100,95296644,94064544
950000.0,4,3.0,3230,438213,2.0,0,0,2,9,3230,0,1999,0.0,98070,47.4141,-122.47,1600,144619,434983,0.9926291552281653,10432900,192030633369,192020200469
204000.0,3,1.5,1460,7140,1.0,0,0,3,7,980,480,1980,0.0,98031,47.3954,-122.191,1400,8572,5680,0.7955182072829131,2131600,50979600,48848000
7700000.0,6,8.0,12050,27600,2.5,0,3,3,13,8570,3480,1910,1987.0,98102,47.6298,-122.323,3940,8800,15550,0.5634057971014492,145202500,761760000,616557500
878000.0,4,2.5,3480,13421,2.0,0,0,2,11,3480,0,1995,0.0,98027,47.5504,-122.09700000000001,3290,9642,9941,0.7407048655092765,12110400,180123241,168012841
1050000.0,4,3.0,3560,4000,3.0,0,2,2,9,2970,590,1996,0.0,98112,47.6265,-122.3,1190,4000,440,0.11,12673600,16000000,3326400
350000.0,2,1.0,840,5551,1.0,0,0,2,6,840,0,1952,0.0,98118,47.5354,-122.28,1270,4652,4711,0.8486759142496847,705600,30813601,30108001
659500.0,3,1.75,1820,5500,1.0,0,0,3,8,1620,200,1957,0.0,98115,47.6737,-122.28299999999999,2330,6050,3680,0.6690909090909091,3312400,30250000,26937600
395000.0,3,2.5,1630,15200,1.0,0,0,2,7,1120,510,1988,0.0,98072,47.7454,-122.103,2050,15200,13570,0.8927631578947368,2656900,231040000,228383100
308950.0,4,2.5,1920,8562,2.0,0,2,3,7,1920,0,1994,0.0,98022,47.1932,-122.008,1820,8628,6642,0.7757533286615277,3686400,73307844,69621444
410000.0,3,2.0,1750,2550,1.0,0,0,2,7,1750,0,1955,0.0,98133,47.7329,-122.34299999999999,1370,1533,800,0.3137254901960784,3062500,6502500,3440000
710000.0,4,3.0,2750,7500,1.0,0,0,4,8,1630,1120,1966,0.0,98177,47.7134,-122.361,2440,7500,4750,0.6333333333333333,7562500,56250000,48687500
175000.0,1,1.0,620,8685,1.0,0,0,3,5,620,0,1976,0.0,98198,47.4095,-122.29,1300,12150,8065,0.9286125503742084,384400,75429225,75044825
508800.0,3,2.0,1720,10098,1.0,0,0,3,8,1140,580,1981,0.0,98074,47.6231,-122.04299999999999,1840,10098,8378,0.8296692414339473,2958400,101969604,99011204
606400.0,3,3.0,1800,5000,1.5,0,2,2,8,1500,300,1929,0.0,98119,47.6475,-122.37100000000001,1670,5000,3200,0.64,3240000,25000000,21760000
245100.0,3,1.75,1300,7958,1.0,0,0,2,7,1300,0,1996,0.0,98092,47.3162,-122.194,1640,8698,6658,0.8366423724553907,1690000,63329764,61639764
540000.0,3,2.5,1970,14876,1.0,0,0,2,7,1320,650,1981,0.0,98146,47.5031,-122.37200000000001,2030,8008,12906,0.8675719279376176,3880900,221295376,217414476
415000.0,3,1.5,1740,9046,1.0,0,0,2,7,1740,0,1956,0.0,98028,47.7402,-122.255,1830,9513,7306,0.8076497899624143,3027600,81830116,78802516
469500.0,4,2.75,1930,13041,1.0,0,0,3,8,1180,750,1980,0.0,98072,47.7502,-122.085,1880,10234,11111,0.8520052143240548,3724900,170067681,166342781
195000.0,3,1.75,1190,14777,1.0,0,0,3,7,1190,0,1965,0.0,98023,47.2933,-122.37700000000001,2240,8325,13587,0.9194694457603032,1416100,218359729,216943629
1620000.0,4,3.25,4250,12281,2.0,0,4,2,12,3020,1230,1996,0.0,98006,47.5507,-122.113,4940,12941,8031,0.6539369758163016,18062500,150822961,132760461
1450000.0,4,3.5,4360,24603,2.0,0,0,2,12,4360,0,1998,0.0,98074,47.6035,-122.005,4770,27521,20243,0.8227858391253099,19009600,605307609,586298009
1200000.0,3,2.5,3420,16622,1.0,0,4,2,10,2410,1010,1991,0.0,98006,47.5638,-122.105,3460,14566,13202,0.7942485862110455,11696400,276290884,264594484
1070000.0,4,3.75,4260,9800,2.0,0,0,2,10,4260,0,2008,0.0,98033,47.6739,-122.17200000000001,1950,8970,5540,0.5653061224489796,18147600,96040000,77892400
555500.0,2,1.0,920,10000,1.0,0,0,3,7,920,0,1981,0.0,98033,47.6938,-122.21,1340,10000,9080,0.908,846400,100000000,99153600
440000.0,3,1.0,1040,4000,1.0,0,0,2,7,1040,0,1950,0.0,98122,47.6178,-122.292,1170,4000,2960,0.74,1081600,16000000,14918400
485000.0,3,1.0,1260,7250,1.0,0,2,2,7,960,300,1940,0.0,98115,47.6947,-122.311,1540,7250,5990,0.8262068965517242,1587600,52562500,50974900
693000.0,3,2.5,2460,12028,2.0,0,0,2,9,2460,0,1996,0.0,98052,47.691,-122.095,2540,12229,9568,0.795477219820419,6051600,144672784,138621184
295000.0,3,1.0,830,3386,1.0,0,0,2,6,830,0,1942,0.0,98133,47.7027,-122.355,1300,3844,2556,0.754873006497342,688900,11464996,10776096
700000.0,3,2.5,2060,10650,1.0,0,0,4,8,1050,1010,1976,0.0,98006,47.5627,-122.137,2690,8850,8590,0.8065727699530516,4243600,113422500,109178900
767500.0,2,1.75,2210,9374,1.0,0,3,3,8,1560,650,1951,0.0,98107,47.6634,-122.359,2140,5640,7164,0.7642415190953702,4884100,87871876,82987776
800000.0,6,4.25,5480,189050,2.0,0,0,3,10,5140,340,1991,0.0,98031,47.412,-122.16799999999999,2470,10429,183570,0.9710129595345147,30030400,35739902500,35709872100
440000.0,3,2.0,1860,217800,2.0,0,2,2,8,1860,0,1998,0.0,98059,47.5157,-122.10700000000001,2500,217800,215940,0.9914600550964188,3459600,47436840000,47433380400
600000.0,3,2.5,1350,187313,1.0,0,0,3,7,1350,0,1997,0.0,98077,47.7369,-122.04899999999999,2310,49222,185963,0.9927928120311991,1822500,35086159969,35084337469
1160000.0,4,2.5,2790,5450,2.0,0,0,2,10,1930,860,1925,0.0,98112,47.6453,-122.303,2320,5450,2660,0.48807339449541287,7784100,29702500,21918400
506000.0,2,1.0,1570,8210,1.0,0,0,3,8,1150,420,1952,0.0,98177,47.7221,-122.37100000000001,1680,8196,6640,0.8087697929354446,2464900,67404100,64939200
474950.0,4,1.75,2030,15400,1.0,0,1,2,9,1130,900,1975,0.0,98166,47.4603,-122.365,2040,12425,13370,0.8681818181818182,4120900,237160000,233039100
654000.0,3,2.5,2570,5500,1.0,0,0,3,7,1320,1250,1961,0.0,98199,47.6417,-122.397,1460,6250,2930,0.5327272727272727,6604900,30250000,23645100
710000.0,2,1.0,1210,6000,1.0,0,0,3,7,1000,210,1942,0.0,98199,47.6482,-122.402,1840,6000,4790,0.7983333333333333,1464100,36000000,34535900
620000.0,4,2.25,1530,7845,1.0,0,0,3,7,1030,500,1981,0.0,98027,47.5589,-122.08200000000001,1710,7627,6315,0.8049713193116634,2340900,61544025,59203125
390000.0,3,2.0,1510,10827,2.0,0,0,2,7,1510,0,1984,0.0,98052,47.653999999999996,-122.12700000000001,1900,10908,9317,0.8605338505587882,2280100,117223929,114943829
550000.0,3,2.25,1720,9600,1.0,0,0,3,7,1220,500,1967,0.0,98052,47.6581,-122.126,1720,9600,7880,0.8208333333333333,2958400,92160000,89201600
353000.0,3,1.75,2190,7021,1.0,0,2,3,7,1390,800,1953,0.0,98178,47.5033,-122.23200000000001,2180,7155,4831,0.6880786212790201,4796100,49294441,44498341
465000.0,4,2.5,3030,47958,1.0,0,0,2,8,1660,1370,1980,0.0,98027,47.4598,-122.00399999999999,2740,36017,44928,0.936819717252596,9180900,2299969764,2290788864
279900.0,3,2.0,1410,6600,1.0,0,0,3,7,1410,0,1990,0.0,98042,47.3596,-122.089,1750,7150,5190,0.7863636363636364,1988100,43560000,41571900
700000.0,2,1.75,1679,577605,2.0,0,0,2,9,1679,0,2001,0.0,98070,47.463,-122.475,1850,358934,575926,0.9970931692073303,2819041,333627536025,333624716984
395000.0,4,1.0,1980,10350,1.0,0,0,3,7,1430,550,1968,0.0,98027,47.5226,-122.045,1890,13140,8370,0.808695652173913,3920400,107122500,103202100
375000.0,4,2.5,1900,9428,2.0,0,0,2,8,1900,0,1978,0.0,98028,47.7628,-122.244,1830,10480,7528,0.7984726347051336,3610000,88887184,85277184
547000.0,4,1.0,1720,2800,1.5,0,0,3,7,1200,520,1926,0.0,98115,47.6743,-122.29899999999999,1530,3500,1080,0.38571428571428573,2958400,7840000,4881600
525000.0,5,3.25,2480,10277,2.0,0,0,4,8,1640,840,1993,0.0,98155,47.7726,-122.286,2270,10277,7797,0.7586844409847232,6150400,105616729,99466329
285000.0,3,1.0,1210,4731,1.5,0,0,2,7,1210,0,1901,0.0,98117,47.6865,-122.397,1450,5264,3521,0.7442401183682097,1464100,22382361,20918261
570000.0,2,1.75,1540,4025,1.0,0,0,3,7,1190,350,1908,0.0,98116,47.5876,-122.391,1950,4420,2485,0.6173913043478261,2371600,16200625,13829025
409000.0,3,2.5,2740,9168,2.0,0,0,2,9,2740,0,1991,0.0,98042,47.3835,-122.148,2690,10554,6428,0.7011343804537522,7507600,84052224,76544624
260000.0,4,2.5,1811,4381,2.0,0,0,2,8,1811,0,2007,0.0,98055,47.45399999999999,-122.19,1811,4150,2570,0.5866240584341474,3279721,19193161,15913440
348000.0,4,2.5,2720,7697,1.0,0,0,3,8,2120,600,1987,0.0,98058,47.4391,-122.161,2340,7700,4977,0.6466155645056516,7398400,59243809,51845409
389000.0,4,1.0,1520,9800,1.5,0,0,3,7,1520,0,1971,0.0,98034,47.7303,-122.236,1540,7700,8280,0.8448979591836735,2310400,96040000,93729600
445000.0,4,2.75,2160,7200,1.0,0,0,3,7,1220,940,1976,0.0,98034,47.7177,-122.22399999999999,1790,7614,5040,0.7,4665600,51840000,47174400
400000.0,3,1.75,1390,4602,1.0,0,0,2,7,930,460,1981,0.0,98117,47.6944,-122.366,1230,4800,3212,0.6979574098218166,1932100,21178404,19246304
302000.0,4,2.5,1740,7895,2.0,0,0,2,7,1740,0,1999,0.0,98001,47.3401,-122.28200000000001,1720,6813,6155,0.779607346421786,3027600,62331025,59303425
798000.0,3,2.5,2849,9588,2.0,0,0,2,10,2849,0,2001,0.0,98074,47.6487,-122.079,3190,8897,6739,0.702857738840217,8116801,91929744,83812943
335000.0,2,1.0,1440,8842,1.0,0,0,2,7,840,600,1950,0.0,98155,47.7443,-122.325,1650,8461,7402,0.837140918344266,2073600,78180964,76107364
585000.0,4,2.5,3000,6892,2.0,0,0,2,8,3000,0,2005,0.0,98072,47.7623,-122.165,3000,6589,3892,0.5647127103888566,9000000,47499664,38499664
2500000.0,4,4.0,3330,24354,1.0,0,0,3,10,3330,0,1961,0.0,98006,47.5708,-122.19200000000001,3880,25493,21024,0.8632668144863267,11088900,593117316,582028416
555000.0,4,2.25,1720,2300,1.0,0,0,2,7,860,860,1940,2014.0,98116,47.5762,-122.412,1720,4680,580,0.25217391304347825,2958400,5290000,2331600
3100000.0,3,3.0,3920,13085,2.0,1,4,3,11,3920,0,1996,0.0,98040,47.5716,-122.204,3450,13287,9165,0.7004203286205579,15366400,171217225,155850825
295000.0,3,2.5,1500,3060,2.0,0,0,2,7,1500,0,1994,0.0,98006,47.5605,-122.117,2700,7734,1560,0.5098039215686274,2250000,9363600,7113600
265000.0,4,1.5,2050,7100,1.0,0,0,2,7,1050,1000,1963,0.0,98001,47.3395,-122.28,1950,7350,5050,0.7112676056338029,4202500,50410000,46207500
330000.0,4,2.0,1180,7275,1.0,0,0,2,7,1180,0,1965,0.0,98034,47.7301,-122.2,1210,7275,6095,0.8378006872852234,1392400,52925625,51533225
286000.0,4,1.5,1600,5750,2.0,0,0,3,6,1600,0,1902,0.0,98118,47.5437,-122.28,1690,5750,4150,0.7217391304347827,2560000,33062500,30502500
305000.0,3,2.5,1260,895,3.0,0,0,2,7,1160,0,2009,0.0,98133,47.7072,-122.336,1190,1095,-365,-0.40782122905027934,1587600,801025,-786575
970000.0,2,1.0,1290,5376,1.0,0,0,2,6,1290,0,1945,0.0,98115,47.6966,-122.315,1180,5376,4086,0.7600446428571429,1664100,28901376,27237276
525000.0,4,2.0,2680,14157,1.0,0,0,2,8,1460,1220,1966,0.0,98188,47.4286,-122.292,2100,9199,11477,0.8106943561489016,7182400,200420649,193238249
355000.0,3,1.75,2370,9750,1.0,0,0,3,7,1280,1090,1979,0.0,98045,47.4459,-121.773,1230,9775,7380,0.7569230769230769,5616900,95062500,89445600
469950.0,5,2.5,2310,8303,1.0,0,0,2,7,1300,1010,1975,0.0,98034,47.7212,-122.211,1930,8303,5993,0.7217873057930868,5336100,68939809,63603709
435000.0,4,1.0,1450,8800,1.0,0,0,3,7,1450,0,1954,0.0,98006,47.5746,-122.135,1260,8942,7350,0.8352272727272727,2102500,77440000,75337500
363500.0,4,2.5,2680,7700,2.0,0,0,3,8,2680,0,1990,0.0,98031,47.4094,-122.17,2400,7700,5020,0.6519480519480519,7182400,59290000,52107600
595000.0,2,1.5,1030,4500,1.0,0,0,2,7,830,200,1924,0.0,98109,47.6455,-122.352,1250,4000,3470,0.7711111111111111,1060900,20250000,19189100
275000.0,3,1.0,1320,11090,1.0,0,0,2,7,1320,0,1955,0.0,98155,47.7748,-122.304,1320,8319,9770,0.8809738503155996,1742400,122988100,121245700
295000.0,2,1.0,670,7952,1.0,0,0,3,6,670,0,1942,0.0,98146,47.5124,-122.37200000000001,1080,9525,7282,0.9157444668008048,448900,63234304,62785404
345000.0,3,2.25,2670,37089,2.0,0,0,2,9,2670,0,1990,0.0,98042,47.3347,-122.07700000000001,2290,36284,34419,0.9280110005662057,7128900,1375593921,1368465021
485000.0,3,2.25,2440,47916,2.0,0,0,2,8,2090,350,1991,0.0,98053,47.6347,-121.958,2150,24000,45476,0.9490775523833375,5953600,2295943056,2289989456
1250000.0,5,2.5,3370,8113,2.0,0,0,2,9,3370,0,2005,0.0,98004,47.5812,-122.196,2470,8113,4743,0.584617280907186,11356900,65820769,54463869
340500.0,2,1.0,940,5413,1.0,0,0,2,7,940,0,1923,0.0,98115,47.6956,-122.304,1340,5296,4473,0.8263439866986884,883600,29300569,28416969
280000.0,3,1.0,1100,5132,1.0,0,0,2,6,840,0,1948,0.0,98103,47.7011,-122.336,1280,5132,4032,0.7856586126266563,1210000,26337424,25127424
449888.0,3,2.25,2520,78408,2.0,0,0,2,9,2520,0,1988,0.0,98001,47.3514,-122.279,1490,29972,75888,0.967860422405877,6350400,6147814464,6141464064
483000.0,2,1.75,1400,4720,1.0,0,0,3,7,820,580,1927,0.0,98116,47.5705,-122.39200000000001,1330,6786,3320,0.7033898305084746,1960000,22278400,20318400
445500.0,3,1.75,1880,9360,1.0,0,0,3,7,940,940,1941,0.0,98125,47.7131,-122.28299999999999,1390,7200,7480,0.7991452991452992,3534400,87609600,84075200
379900.0,5,3.5,2800,7350,2.0,0,0,2,7,2800,0,1995,0.0,98106,47.5273,-122.345,2190,7620,4550,0.6190476190476191,7840000,54022500,46182500
599950.0,4,3.5,2500,3080,2.0,0,0,2,8,1810,690,2008,0.0,98052,47.6749,-122.14,2060,3295,580,0.18831168831168832,6250000,9486400,3236400
215000.0,3,1.0,810,5240,1.0,0,0,2,6,810,0,1942,0.0,98166,47.4734,-122.35,1700,5245,4430,0.8454198473282443,656100,27457600,26801500
263000.0,3,2.5,1720,6847,2.0,0,0,2,7,1720,0,1987,0.0,98001,47.3266,-122.272,1610,7790,5127,0.7487950927413466,2958400,46881409,43923009
565000.0,4,1.0,2170,12100,1.0,0,0,4,7,2170,0,1961,0.0,98033,47.6893,-122.164,1270,12844,9930,0.8206611570247934,4708900,146410000,141701100
950000.0,5,3.0,4530,258746,1.5,0,0,3,9,3200,1330,2003,0.0,98077,47.7702,-122.066,3430,83199,254216,0.9824924829755822,20520900,66949492516,66928971616
395000.0,4,1.0,1440,8320,1.5,0,0,2,7,1440,0,1946,0.0,98155,47.7529,-122.318,1440,9230,6880,0.8269230769230769,2073600,69222400,67148800
1540000.0,4,3.25,2850,4100,2.0,0,3,2,10,1820,1030,1908,0.0,98122,47.6147,-122.285,2130,4200,1250,0.3048780487804878,8122500,16810000,8687500
922000.0,4,2.5,2620,14126,1.0,0,4,3,8,1620,1000,1941,0.0,98117,47.6983,-122.397,2620,8905,11506,0.8145264052102505,6864400,199543876,192679476
330000.0,3,2.5,1676,18778,2.0,0,0,2,7,1676,0,1997,0.0,98014,47.6521,-121.905,1410,18778,17102,0.9107466183832144,2808976,352613284,349804308
1530000.0,4,3.75,5850,35070,2.0,0,0,3,12,4410,1440,1990,0.0,98006,47.5485,-122.124,4830,36200,29220,0.8331907613344739,34222500,1229904900,1195682400
323000.0,3,1.75,1910,8329,1.0,0,0,2,8,1910,0,2004,0.0,98022,47.19,-122.016,2510,9259,6419,0.7706807539920759,3648100,69372241,65724141
554000.0,2,2.0,1670,4996,1.0,0,0,2,8,1670,0,2004,0.0,98053,47.7141,-122.031,1670,4996,3326,0.6657325860688551,2788900,24960016,22171116
500000.0,3,2.0,2050,11454,1.0,0,0,2,8,2050,0,1987,0.0,98052,47.6389,-122.11,1980,11424,9404,0.821023223328095,4202500,131194116,126991616
775000.0,5,3.5,3730,16679,1.0,0,0,2,10,2760,970,1990,0.0,98075,47.5987,-122.029,3280,16679,12949,0.7763654895377421,13912900,278189041,264276141
340000.0,4,1.75,1800,5210,1.0,0,0,4,7,1080,720,1979,0.0,98118,47.5298,-122.28,1870,5365,3410,0.654510556621881,3240000,27144100,23904100
560000.0,4,1.75,2230,6838,1.0,0,0,2,7,1320,910,1985,0.0,98008,47.5742,-122.118,1580,7500,4608,0.6738812518280198,4972900,46758244,41785344
304000.0,3,2.5,1670,5298,2.0,0,0,2,8,1670,0,2002,0.0,98042,47.3925,-122.165,1920,5298,3628,0.6847867119667799,2788900,28068804,25279904
279900.0,3,1.0,1400,10800,1.0,0,0,2,6,1400,0,1962,0.0,98034,47.718999999999994,-122.20200000000001,1430,10000,9400,0.8703703703703703,1960000,116640000,114680000
315000.0,5,3.0,2110,10766,2.0,0,0,2,7,2110,0,2005,0.0,98030,47.3599,-122.176,1460,10400,8656,0.804012632361137,4452100,115906756,111454656
849000.0,4,2.0,2160,6300,1.5,0,1,3,8,2160,0,1928,0.0,98116,47.5662,-122.404,1980,5152,4140,0.6571428571428571,4665600,39690000,35024400
325000.0,3,1.75,2420,14862,1.0,0,0,2,8,1380,1040,1977,0.0,98023,47.3301,-122.365,2550,14675,12442,0.8371686179518234,5856400,220879044,215022644
786000.0,4,3.5,3320,8808,2.0,0,0,2,9,3320,0,2005,0.0,98075,47.592,-121.98899999999999,3160,9226,5488,0.623069936421435,11022400,77580864,66558464
384000.0,5,2.75,3220,8160,2.0,0,0,2,9,3220,0,1999,0.0,98001,47.3154,-122.25399999999999,2876,11521,4940,0.6053921568627451,10368400,66585600,56217200
907000.0,3,1.5,1340,6000,1.5,0,1,2,9,1340,0,1927,0.0,98105,47.66,-122.28200000000001,2600,6000,4660,0.7766666666666666,1795600,36000000,34204400
700000.0,3,2.5,2490,23891,2.0,0,0,2,9,2490,0,1993,0.0,98053,47.6716,-122.029,2900,34705,21401,0.8957766522958436,6200100,570779881,564579781
269500.0,3,2.0,1640,8395,1.0,0,0,3,7,1640,0,1991,0.0,98038,47.348,-122.035,1510,7180,6755,0.8046456223942823,2689600,70476025,67786425
269000.0,3,2.25,1420,7297,1.0,0,0,2,7,1130,0,1984,0.0,98031,47.4046,-122.194,1730,7419,5877,0.805399479238043,2016400,53246209,51229809
749950.0,4,2.5,3340,123600,2.0,0,0,2,10,3340,0,2005,0.0,98053,47.6101,-121.955,3730,123600,120260,0.9729773462783171,11155600,15276960000,15265804400
325000.0,3,2.75,1580,4007,2.0,0,0,2,7,1580,0,2001,0.0,98019,47.7367,-121.969,1770,3799,2427,0.605690042425755,2496400,16056049,13559649
1150000.0,3,1.5,2170,16600,1.0,1,2,2,10,1130,1040,1979,0.0,98052,47.6307,-122.088,3130,13875,14430,0.869277108433735,4708900,275560000,270851100
406000.0,3,1.5,1370,7853,1.0,0,0,3,7,1370,0,1962,0.0,98056,47.5409,-122.18,1730,9465,6483,0.8255443779447345,1876900,61669609,59792709
650000.0,4,2.5,2840,9354,2.0,0,0,2,10,2840,0,1990,0.0,98074,47.6274,-122.04,2540,10200,6514,0.6963865725892666,8065600,87497316,79431716
295000.0,3,1.75,1940,7500,1.5,0,0,3,8,1940,0,1918,1985.0,98022,47.2062,-121.993,1650,7500,5560,0.7413333333333333,3763600,56250000,52486400
375000.0,4,2.0,1757,19370,1.0,0,2,4,7,1757,0,1955,0.0,98198,47.3974,-122.31200000000001,1850,11125,17613,0.9092927207021166,3087049,375196900,372109851
395000.0,2,1.0,980,5100,1.0,0,0,3,6,980,0,1907,0.0,98117,47.6824,-122.38,1190,5100,4120,0.807843137254902,960400,26010000,25049600
609000.0,6,3.0,2470,9267,2.0,0,0,2,8,2470,0,1982,0.0,98007,47.6025,-122.152,2470,9151,6797,0.7334628250782346,6100900,85877289,79776389
510000.0,3,1.75,1610,11950,1.0,0,2,2,7,1210,400,1984,0.0,98052,47.6705,-122.13799999999999,1610,9363,10340,0.8652719665271966,2592100,142802500,140210400
190000.0,3,2.25,1590,11745,1.0,0,0,2,7,1090,500,1978,0.0,98001,47.3553,-122.28,1540,12530,10155,0.8646232439335888,2528100,137945025,135416925
250000.0,1,1.0,780,1033,1.0,0,0,2,7,780,0,1922,1985.0,98122,47.6155,-122.306,1040,1319,253,0.24491771539206195,608400,1067089,458689
295000.0,3,1.5,720,7450,1.0,0,1,0,5,720,0,1924,0.0,98126,47.583999999999996,-122.375,2600,7360,6730,0.9033557046979865,518400,55502500,54984100
740000.0,3,1.5,1630,4080,1.5,0,0,3,8,1630,0,1927,0.0,98115,47.6756,-122.30799999999999,1950,4080,2450,0.6004901960784313,2656900,16646400,13989500
323000.0,3,1.0,1590,7759,2.0,0,0,3,7,1590,0,1912,1984.0,98065,47.5217,-121.819,1600,7200,6169,0.7950766851398376,2528100,60202081,57673981
713000.0,3,2.75,2310,1850,2.0,0,0,2,10,2020,290,2011,0.0,98027,47.5304,-122.073,2340,2155,-460,-0.24864864864864866,5336100,3422500,-1913600
1070000.0,3,1.75,2320,6090,2.0,0,3,2,8,2040,280,1939,0.0,98199,47.643,-122.412,3110,7052,3770,0.6190476190476191,5382400,37088100,31705700
460000.0,3,1.75,1660,9900,2.0,0,0,2,8,1660,0,1978,0.0,98033,47.6704,-122.184,1720,6600,8240,0.8323232323232324,2755600,98010000,95254400
880000.0,3,1.75,2070,5000,1.5,0,0,2,8,2070,0,1920,0.0,98144,47.5828,-122.291,2630,5000,2930,0.586,4284900,25000000,20715100
585000.0,4,1.75,2500,7000,1.0,0,0,2,7,1250,1250,1947,0.0,98199,47.648,-122.38600000000001,1680,7000,4500,0.6428571428571429,6250000,49000000,42750000
249950.0,2,1.0,940,8532,1.0,0,0,3,7,940,0,1959,0.0,98166,47.4814,-122.34299999999999,1050,8100,7592,0.8898265353961556,883600,72795024,71911424
450000.0,3,2.5,1990,3478,2.0,0,0,2,10,1520,470,1990,0.0,98199,47.6361,-122.399,1710,6157,1488,0.4278320874065555,3960100,12096484,8136384
450000.0,3,2.5,2620,14096,2.0,0,0,3,9,2620,0,1989,0.0,98042,47.3513,-122.1,3010,14096,11476,0.8141316685584563,6864400,198697216,191832816
1780000.0,4,3.25,3730,7071,3.0,0,2,2,11,3730,0,1985,0.0,98109,47.6292,-122.355,3730,7680,3341,0.47249328242115685,13912900,49999041,36086141
350000.0,3,3.25,1600,1298,3.0,0,0,2,8,1600,0,1999,0.0,98117,47.6954,-122.375,1600,1348,-302,-0.23266563944530047,2560000,1684804,-875196
292500.0,3,2.5,2095,3438,2.0,0,0,2,7,2095,0,2008,0.0,98002,47.3523,-122.213,1805,3402,1343,0.39063408958696916,4389025,11819844,7430819
879000.0,4,2.75,4230,31747,2.0,0,0,3,10,4230,0,1985,0.0,98072,47.731,-122.132,4080,35576,27517,0.8667590638485526,17892900,1007872009,989979109
1180000.0,4,2.5,3200,7500,1.5,0,1,4,8,1860,1340,1948,0.0,98115,47.6826,-122.274,2500,6500,4300,0.5733333333333334,10240000,56250000,46010000
584999.0,4,2.75,2050,17859,1.0,0,0,3,7,1300,750,1967,0.0,98075,47.5945,-122.056,2960,20908,15809,0.8852119379584523,4202500,318943881,314741381
366000.0,4,2.75,2020,8093,1.0,0,0,4,7,1300,720,1961,0.0,98133,47.7685,-122.33200000000001,1920,8089,6073,0.7504015816137403,4080400,65496649,61416249
987500.0,4,2.25,3270,15760,1.0,0,0,3,10,2000,1270,1974,0.0,98040,47.5295,-122.229,4100,15760,12490,0.7925126903553299,10692900,248377600,237684700
300000.0,3,1.0,1320,7200,1.0,0,0,3,7,1320,0,1959,0.0,98056,47.5048,-122.19,1720,7249,5880,0.8166666666666667,1742400,51840000,50097600
299000.0,2,1.75,1270,7800,1.0,0,0,3,7,890,380,1981,0.0,98058,47.4438,-122.134,2020,8025,6530,0.8371794871794872,1612900,60840000,59227100
560000.0,4,1.75,1980,2700,1.5,0,0,2,8,1210,770,1931,0.0,98115,47.6865,-122.32,1720,2910,720,0.26666666666666666,3920400,7290000,3369600
695000.0,3,2.5,2620,51354,2.0,0,0,2,9,2620,0,1998,0.0,98077,47.7211,-122.02799999999999,2620,37042,48734,0.9489815788448807,6864400,2637233316,2630368916
360000.0,4,1.75,1750,18810,1.0,0,0,2,7,1220,530,1977,0.0,98059,47.4719,-122.074,1840,17424,17060,0.9069643806485912,3062500,353816100,350753600
183500.0,3,1.0,1040,8892,1.0,0,0,3,6,800,240,1958,0.0,98023,47.3273,-122.34899999999999,820,9000,7852,0.8830409356725146,1081600,79067664,77986064
311000.0,3,1.75,1900,3000,1.5,0,0,4,7,1070,830,1903,0.0,98118,47.5255,-122.265,1130,6000,1100,0.36666666666666664,3610000,9000000,5390000
263000.0,3,1.75,1660,7210,1.0,0,0,3,7,1660,0,1977,0.0,98032,47.3609,-122.274,2150,7350,5550,0.7697642163661581,2755600,51984100,49228500
269000.0,3,1.75,1530,7930,1.0,0,0,4,7,1530,0,1986,0.0,98038,47.3609,-122.05,1610,7930,6400,0.807061790668348,2340900,62884900,60544000
1600000.0,4,3.5,4280,9583,2.0,0,0,2,11,4280,0,2005,0.0,98004,47.5979,-122.197,2360,10031,5303,0.5533757695919858,18318400,91833889,73515489
564000.0,4,2.5,2870,6658,2.0,0,0,2,8,2870,0,2004,0.0,98065,47.5394,-121.87799999999999,2770,6658,3788,0.5689396215079604,8236900,44328964,36092064
425000.0,3,2.5,2540,5612,2.0,0,0,2,9,2540,0,1999,0.0,98059,47.4965,-122.15700000000001,2380,6303,3072,0.5473984319315752,6451600,31494544,25042944
679000.0,4,2.75,2100,4480,1.5,0,0,3,7,1780,320,1928,0.0,98105,47.6691,-122.294,2050,4480,2380,0.53125,4410000,20070400,15660400
410000.0,3,2.0,1740,9300,1.0,0,0,3,7,1740,0,1952,0.0,98166,47.4526,-122.35700000000001,1540,9638,7560,0.8129032258064516,3027600,86490000,83462400
340000.0,4,2.5,2441,7316,2.0,0,0,2,8,2441,0,2007,0.0,98023,47.3237,-122.337,2724,7357,4875,0.6663477310005468,5958481,53523856,47565375
360000.0,3,1.75,1810,7200,1.0,0,0,4,7,1030,780,1959,0.0,98146,47.4993,-122.36399999999999,1950,8384,5390,0.7486111111111111,3276100,51840000,48563900
450000.0,3,1.5,2060,44866,1.0,0,0,2,8,2060,0,1953,0.0,98077,47.7503,-122.051,2320,43995,42806,0.9540854990415906,4243600,2012957956,2008714356
552000.0,4,2.75,3160,8429,1.0,0,3,3,7,1620,1540,1982,0.0,98178,47.511,-122.251,1760,6780,5269,0.6251038082809348,9985600,71048041,61062441
294000.0,4,2.0,2930,12840,1.5,0,0,3,8,2930,0,1965,0.0,98092,47.2957,-122.18700000000001,1960,10920,9910,0.7718068535825545,8584900,164865600,156280700
663500.0,2,1.0,1310,5200,1.0,0,0,2,7,910,400,1946,0.0,98115,47.6784,-122.304,1320,4794,3890,0.7480769230769231,1716100,27040000,25323900
1980000.0,6,4.5,4800,9097,2.0,0,0,2,10,3580,1220,2007,0.0,98112,47.6259,-122.291,2180,6037,4297,0.4723535231394965,23040000,82755409,59715409
175409.0,4,1.5,1450,5530,1.0,0,0,3,6,1450,0,1969,0.0,98042,47.3613,-122.087,1060,5200,4080,0.7377938517179023,2102500,30580900,28478400
459000.0,4,3.0,1900,9077,2.0,0,0,2,7,1900,0,1954,2015.0,98155,47.7684,-122.304,1900,12868,7177,0.7906797400022034,3610000,82391929,78781929
339950.0,3,1.0,1050,5402,1.5,0,0,3,7,1050,0,1906,0.0,98144,47.5867,-122.311,1510,4685,4352,0.8056275453535727,1102500,29181604,28079104
393000.0,5,1.75,1610,15246,1.0,0,0,2,6,1610,0,1936,0.0,98024,47.5654,-121.89399999999999,1410,10500,13636,0.8943985307621671,2592100,232440516,229848416
275500.0,2,1.0,720,11400,1.0,0,0,4,6,720,0,1951,0.0,98133,47.7641,-122.34100000000001,1690,8075,10680,0.9368421052631579,518400,129960000,129441600
485000.0,3,1.0,1020,9835,1.0,0,0,4,7,1020,0,1955,0.0,98006,47.5728,-122.179,1210,9622,8815,0.8962887646161668,1040400,96727225,95686825
250000.0,3,1.0,1250,7920,1.0,0,0,3,7,1250,0,1960,0.0,98059,47.4853,-122.126,1440,9648,6670,0.8421717171717171,1562500,62726400,61163900
935100.0,4,3.5,3200,8049,1.0,0,0,2,8,2700,500,1980,0.0,98005,47.5841,-122.17200000000001,1640,8506,4849,0.6024350851037396,10240000,64786401,54546401
245000.0,3,1.0,990,9599,1.0,0,0,3,6,990,0,1959,0.0,98002,47.2934,-122.215,1216,10364,8609,0.8968642566934055,980100,92140801,91160701
670000.0,4,2.5,2850,25993,2.0,0,0,3,9,2850,0,1989,0.0,98056,47.5318,-122.17,2480,12672,23143,0.8903550956026622,8122500,675636049,667513549
1390000.0,3,3.5,4240,21578,2.0,0,0,2,10,3500,740,1994,0.0,98040,47.5614,-122.215,3120,16440,17338,0.8035035684493466,17977600,465610084,447632484
440000.0,4,1.75,2800,49149,1.0,0,0,3,7,1400,1400,1978,0.0,98027,47.4649,-122.03399999999999,2560,61419,46349,0.9430303770168263,7840000,2415624201,2407784201
1250000.0,2,2.5,2310,3313,2.0,0,0,2,9,2310,0,2006,0.0,98119,47.6318,-122.365,2700,5670,1003,0.30274675520676125,5336100,10975969,5639869
203000.0,3,1.75,1490,8000,1.0,0,0,3,7,1200,290,1978,0.0,98092,47.3187,-122.18,1540,8000,6510,0.81375,2220100,64000000,61779900
583000.0,4,2.5,1840,4011,2.0,0,0,2,9,1840,0,2005,0.0,98052,47.6662,-122.083,2120,4011,2171,0.5412615307903266,3385600,16088121,12702521
575000.0,3,1.0,1740,9163,1.0,0,0,2,7,1740,0,1954,0.0,98125,47.705,-122.29899999999999,1490,6509,7423,0.8101058605260286,3027600,83960569,80932969
2580000.0,4,3.5,3280,3800,2.0,0,0,2,11,2880,400,2011,0.0,98112,47.6299,-122.28,2050,3800,520,0.1368421052631579,10758400,14440000,3681600
1600000.0,5,3.5,4050,20925,2.0,0,3,2,10,3020,1030,1973,2005.0,98040,47.5348,-122.241,3880,18321,16875,0.8064516129032258,16402500,437855625,421453125
312500.0,4,2.5,2160,8755,2.0,0,0,2,7,2160,0,1993,0.0,98030,47.3585,-122.195,1990,7971,6595,0.7532838378069674,4665600,76650025,71984425
455000.0,3,2.75,2720,31314,3.0,0,2,2,8,2720,0,1986,0.0,98042,47.3689,-122.163,2290,15188,28594,0.9131378935939196,7398400,980566596,973168196
1310000.0,5,3.0,3650,16600,1.0,0,3,3,9,1860,1790,1978,0.0,98006,47.56,-122.14399999999999,3150,10400,12950,0.7801204819277109,13322500,275560000,262237500
605000.0,4,2.25,1750,6120,1.0,0,0,2,7,1150,0,1962,0.0,98115,47.6958,-122.29,1350,6120,4370,0.7140522875816994,3062500,37454400,34391900
325000.0,3,2.25,2450,49658,1.0,0,0,2,7,1770,680,1978,0.0,98045,47.486000000000004,-121.726,1340,121097,47208,0.9506625317169439,6002500,2465916964,2459914464
630000.0,3,1.75,1940,7306,1.0,0,0,2,8,1470,470,1982,0.0,98052,47.6632,-122.15299999999999,2360,8865,5366,0.734464823432795,3763600,53377636,49614036
928950.0,4,3.75,3280,6000,2.0,0,0,2,9,3280,0,2014,0.0,98006,47.553999999999995,-122.19,2900,10108,2720,0.4533333333333333,10758400,36000000,25241600
489950.0,3,1.75,2480,10804,1.0,0,0,2,8,1800,680,1976,0.0,98177,47.7721,-122.367,2480,10400,8324,0.770455386893743,6150400,116726416,110576016
550000.0,3,2.25,2120,18255,1.0,0,0,2,8,1590,530,1984,0.0,98074,47.6279,-122.037,2120,12997,16135,0.8838674335798411,4494400,333245025,328750625
237000.0,3,2.0,1710,7920,1.0,0,0,2,8,1260,450,1968,0.0,98003,47.3473,-122.305,1760,8120,6210,0.7840909090909091,2924100,62726400,59802300
390000.0,3,2.5,1690,10113,1.0,0,0,2,7,1310,380,1991,0.0,98028,47.7381,-122.223,1690,10113,8423,0.8328883615148819,2856100,102272769,99416669
665000.0,3,2.5,2190,10370,2.0,0,0,2,9,2190,0,1987,0.0,98074,47.6218,-122.03,2470,10472,8180,0.7888138862102217,4796100,107536900,102740800
277000.0,4,3.0,1960,5160,1.0,0,0,2,7,1170,790,2001,0.0,98106,47.5313,-122.36,1960,5160,3200,0.6201550387596899,3841600,26625600,22784000
545000.0,3,1.0,1510,5000,1.5,0,0,2,7,1510,0,1909,0.0,98105,47.6708,-122.29700000000001,1680,4000,3490,0.698,2280100,25000000,22719900
615000.0,3,2.5,1490,1410,2.0,0,0,2,10,1300,190,2008,0.0,98199,47.6478,-122.383,1490,1715,-80,-0.05673758865248227,2220100,1988100,-232000
343000.0,3,1.75,2210,7920,1.0,0,0,2,7,1400,810,1966,0.0,98178,47.4968,-122.23700000000001,2220,7920,5710,0.7209595959595959,4884100,62726400,57842300
597000.0,4,2.5,2340,7877,2.0,0,0,2,9,2340,0,2004,0.0,98125,47.73,-122.315,1920,9116,5537,0.7029325885489399,5475600,62047129,56571529
600000.0,3,1.0,940,19000,1.0,0,0,2,6,940,0,1945,0.0,98004,47.5828,-122.19,2280,19000,18060,0.9505263157894737,883600,361000000,360116400
479000.0,3,1.75,1470,6018,1.0,0,0,2,8,1470,0,1987,0.0,98074,47.6171,-122.044,1720,6584,4548,0.7557328015952144,2160900,36216324,34055424
292000.0,3,1.75,1650,14633,1.0,0,0,3,7,1650,0,1958,0.0,98056,47.4984,-122.176,1370,12495,12983,0.887241167224766,2722500,214124689,211402189
265000.0,3,1.5,1400,6527,1.0,0,0,2,7,1110,290,1957,0.0,98166,47.4535,-122.35799999999999,1690,7597,5127,0.7855063582043817,1960000,42601729,40641729
623000.0,4,2.5,2710,49044,2.0,0,0,2,9,2710,0,1988,0.0,98077,47.773999999999994,-122.08,2560,38190,46334,0.9447434956365712,7344100,2405313936,2397969836
486000.0,4,2.5,2150,39449,1.0,0,0,2,7,1420,730,1978,0.0,98024,47.5531,-121.89200000000001,2010,35717,37299,0.9454992521990419,4622500,1556223601,1551601101
520500.0,3,2.0,1900,8100,1.0,0,0,3,7,950,950,1940,0.0,98115,47.6997,-122.319,1400,6380,6200,0.7654320987654321,3610000,65610000,62000000
1300000.0,4,3.5,4380,74052,1.0,0,0,2,11,4380,0,2001,0.0,98053,47.6587,-122.009,5170,62291,69672,0.9408523740074543,19184400,5483698704,5464514304
825000.0,4,1.0,2290,6300,1.5,0,4,3,7,2150,140,1921,0.0,98144,47.5917,-122.29,2390,6300,4010,0.6365079365079365,5244100,39690000,34445900
259900.0,3,1.75,1690,7953,1.0,0,0,2,7,1690,0,1986,0.0,98030,47.3556,-122.175,1680,7425,6263,0.7875015717339369,2856100,63250209,60394109
1170000.0,5,2.75,3090,12031,1.0,0,0,4,9,1600,1490,1968,0.0,98040,47.5342,-122.226,2280,10800,8941,0.7431634943063752,9548100,144744961,135196861
245000.0,2,1.0,1120,5650,1.0,0,1,2,6,720,400,1904,0.0,98118,47.5155,-122.255,2160,6480,4530,0.8017699115044248,1254400,31922500,30668100
830200.0,3,2.5,2680,4990,1.0,0,0,4,8,1440,1240,1951,0.0,98199,47.6538,-122.39299999999999,2320,6000,2310,0.46292585170340683,7182400,24900100,17717700
650000.0,4,2.5,2400,7351,2.0,0,0,2,9,2400,0,1990,0.0,98029,47.5707,-122.022,2330,7756,4951,0.6735138076452183,5760000,54037201,48277201
305000.0,4,2.0,1610,6250,1.0,0,0,3,7,1610,0,1952,0.0,98118,47.5293,-122.271,1310,6000,4640,0.7424,2592100,39062500,36470400
599000.0,5,2.5,3470,12003,2.0,0,0,2,8,3470,0,1978,0.0,98074,47.623999999999995,-122.04799999999999,2220,12283,8533,0.7109056069316004,12040900,144072009,132031109
272000.0,4,2.5,2070,6175,2.0,0,0,2,8,2070,0,1993,0.0,98092,47.3262,-122.17399999999999,1940,6175,4105,0.6647773279352227,4284900,38130625,33845725
415000.0,3,2.5,2420,10733,2.0,0,0,2,8,2420,0,1996,0.0,98038,47.3835,-122.035,1950,8534,8313,0.7745271592285474,5856400,115197289,109340889
319000.0,4,2.25,2380,7400,1.0,0,0,3,8,1760,620,1979,0.0,98042,47.3555,-122.149,1940,7400,5020,0.6783783783783783,5664400,54760000,49095600
425000.0,4,1.75,2120,15920,1.0,0,0,3,7,1060,1060,1960,0.0,98028,47.771,-122.258,2200,12580,13800,0.8668341708542714,4494400,253446400,248952000
297500.0,4,2.5,2190,8100,1.0,0,0,3,8,1250,940,1978,0.0,98023,47.3131,-122.39200000000001,2100,8840,5910,0.7296296296296296,4796100,65610000,60813900
725000.0,4,2.5,2740,12899,2.0,0,0,3,10,2740,0,1990,0.0,98075,47.5811,-122.02799999999999,2830,9453,10159,0.7875804325916738,7507600,166384201,158876601
325000.0,3,2.5,1830,7585,2.0,0,0,3,8,1830,0,1995,0.0,98042,47.3893,-122.154,2070,7585,5755,0.7587343441001978,3348900,57532225,54183325
460000.0,3,1.75,1370,8467,1.0,0,0,3,7,970,400,1972,0.0,98052,47.6644,-122.145,1650,8472,7097,0.838195346639896,1876900,71690089,69813189
396480.0,3,1.0,1000,10800,1.0,0,0,2,7,1000,0,1959,0.0,98027,47.52,-122.03,1140,16846,9800,0.9074074074074074,1000000,116640000,115640000
1030000.0,3,1.0,2050,4800,2.0,0,0,2,8,1950,100,1922,0.0,98112,47.6315,-122.311,2220,4800,2750,0.5729166666666666,4202500,23040000,18837500
370000.0,3,2.75,1750,9166,1.0,0,0,3,7,1170,580,1979,0.0,98155,47.7696,-122.325,1810,8760,7416,0.8090770237835478,3062500,84015556,80953056
260656.0,3,1.0,1620,13803,1.0,0,0,3,6,1620,0,1969,0.0,98038,47.3631,-122.02799999999999,1260,10370,12183,0.8826342099543577,2624400,190522809,187898409
431000.0,3,2.5,1710,12677,2.0,0,0,2,8,1710,0,1996,0.0,98028,47.75,-122.234,1610,12160,10967,0.8651100418079988,2924100,160706329,157782229
320000.0,3,1.0,1060,5000,1.0,0,0,2,7,1060,0,1958,0.0,98106,47.5294,-122.354,1220,4600,3940,0.788,1123600,25000000,23876400
296500.0,3,2.75,2170,7900,1.0,0,0,3,8,1380,790,1978,0.0,98032,47.361999999999995,-122.277,2170,7700,5730,0.7253164556962025,4708900,62410000,57701100
679000.0,4,2.5,3080,8451,1.0,0,0,2,7,1540,1540,1969,0.0,98052,47.674,-122.154,1550,8125,5371,0.6355460892202106,9486400,71419401,61933001
359000.0,3,3.0,1320,1071,2.0,0,0,2,7,1080,240,2003,0.0,98144,47.5942,-122.296,1780,7715,-249,-0.23249299719887956,1742400,1147041,-595359
330000.0,4,3.0,1920,12040,1.0,0,0,2,7,1920,0,1962,0.0,98168,47.4805,-122.301,1530,10230,10120,0.840531561461794,3686400,144961600,141275200
350000.0,4,2.5,2440,4000,2.0,0,0,2,7,2440,0,2009,0.0,98038,47.3841,-122.036,2410,4502,1560,0.39,5953600,16000000,10046400
242000.0,3,1.5,1640,8922,1.0,0,0,3,7,1640,0,1963,0.0,98146,47.495,-122.34200000000001,1540,9040,7282,0.8161847119479937,2689600,79602084,76912484
692500.0,3,2.5,2420,198198,2.0,0,0,2,9,2420,0,1997,0.0,98077,47.772,-122.022,2780,179467,195778,0.9877899877899878,5856400,39282447204,39276590804
441000.0,2,1.5,1190,3400,1.0,0,0,2,7,990,200,1919,0.0,98115,47.6726,-122.32,1410,3150,2210,0.65,1416100,11560000,10143900
765000.0,4,2.5,2910,15016,2.0,0,0,2,10,2910,0,1990,0.0,98052,47.69,-122.09700000000001,2870,13992,12106,0.8062067128396377,8468100,225480256,217012156
375000.0,2,1.0,1010,4050,1.0,0,0,2,7,1010,0,1950,0.0,98116,47.5838,-122.382,2310,5000,3040,0.7506172839506173,1020100,16402500,15382400
365000.0,3,1.75,2080,7800,1.0,0,0,4,7,1220,860,1955,0.0,98166,47.4536,-122.355,1770,7860,5720,0.7333333333333333,4326400,60840000,56513600
580000.0,2,1.5,1990,6000,1.0,0,0,2,6,1430,560,1944,0.0,98199,47.6521,-122.398,1350,6000,4010,0.6683333333333333,3960100,36000000,32039900
1610000.0,4,3.5,3920,19088,1.0,0,1,2,10,2240,1680,2005,0.0,98040,47.576,-122.214,3800,13749,15168,0.7946353730092205,15366400,364351744,348985344
841000.0,4,2.5,3080,13870,2.0,0,0,3,9,3080,0,1981,0.0,98007,47.6197,-122.149,2920,12221,10790,0.7779379956741168,9486400,192376900,182890500
515000.0,5,3.0,2670,11761,1.0,0,0,2,7,1370,1300,1981,0.0,98052,47.6895,-122.12899999999999,2580,10703,9091,0.7729784882237904,7128900,138321121,131192221
565000.0,5,2.5,4320,107157,1.0,0,0,3,8,2160,2160,1967,0.0,98038,47.4009,-122.059,2480,107157,102837,0.959685321537557,18662400,11482622649,11463960249
365000.0,2,1.5,1200,6380,1.0,0,0,2,7,1200,0,1929,0.0,98115,47.696999999999996,-122.319,1290,6598,5180,0.8119122257053292,1440000,40704400,39264400
295000.0,3,1.5,1640,7222,2.0,0,0,3,7,1640,0,1908,0.0,98108,47.5215,-122.33,1240,5100,5582,0.7729160897258377,2689600,52157284,49467684
406500.0,2,1.0,870,5750,1.0,0,0,3,7,870,0,1947,0.0,98116,47.5637,-122.395,1100,5750,4880,0.8486956521739131,756900,33062500,32305600
614905.0,3,2.5,2410,7225,2.0,0,0,2,8,2410,0,1991,0.0,98125,47.7211,-122.31,1940,8347,4815,0.6664359861591695,5808100,52200625,46392525
1400000.0,5,2.25,2640,14959,1.0,0,0,3,7,1770,870,1929,0.0,98039,47.6191,-122.234,3240,17904,12319,0.8235176148138245,6969600,223771681,216802081
250000.0,2,1.0,990,10556,2.0,0,0,2,7,990,0,1981,0.0,98056,47.5118,-122.18799999999999,1350,7295,9566,0.9062144751799924,980100,111429136,110449036
549000.0,5,1.0,1500,3978,2.0,0,0,2,7,1500,0,1929,0.0,98117,47.6811,-122.383,1350,4080,2478,0.6229260935143288,2250000,15824484,13574484
397000.0,4,2.5,1790,6590,2.0,0,0,2,7,1790,0,2005,0.0,98059,47.4829,-122.12799999999999,1950,5180,4800,0.7283763277693475,3204100,43428100,40224000
184000.0,3,1.75,1490,10125,1.0,0,0,3,7,1490,0,1962,0.0,98001,47.3075,-122.28399999999999,2488,4981,8635,0.8528395061728395,2220100,102515625,100295525
2500000.0,4,3.25,3960,16224,2.0,0,2,2,12,3100,860,1938,0.0,98105,47.6701,-122.259,3960,15050,12264,0.7559171597633136,15681600,263218176,247536576
499100.0,3,1.5,1620,5108,1.0,0,0,2,7,1620,0,1954,0.0,98115,47.6978,-122.316,1380,6130,3488,0.682850430696946,2624400,26091664,23467264
676101.0,4,1.5,2270,6010,1.0,0,0,2,8,1290,980,1954,0.0,98115,47.6743,-122.26899999999999,2120,5987,3740,0.6222961730449251,5152900,36120100,30967200
290000.0,3,1.0,1150,8145,1.0,0,0,3,6,990,160,1932,0.0,98155,47.7471,-122.31700000000001,1200,8145,6995,0.8588090853284224,1322500,66341025,65018525
390000.0,4,1.75,2180,7560,1.0,0,0,3,7,1560,620,1962,0.0,98133,47.757,-122.336,1810,7352,5380,0.7116402116402116,4752400,57153600,52401200
465000.0,3,1.0,910,4500,1.0,0,0,2,7,910,0,1948,0.0,98117,47.6828,-122.395,1370,5000,3590,0.7977777777777778,828100,20250000,19421900
470000.0,3,2.75,2770,54707,1.5,0,0,2,8,2370,400,1938,0.0,98155,47.7555,-122.289,1640,54707,51937,0.9493666258431279,7672900,2992855849,2985182949
435000.0,3,1.0,940,7590,1.0,0,0,3,6,940,0,1959,0.0,98008,47.6231,-122.12,1250,7590,6650,0.8761528326745718,883600,57608100,56724500
415000.0,3,1.75,2410,8944,1.0,0,0,3,8,1860,550,1967,0.0,98058,47.4494,-122.139,2750,9600,6534,0.7305456171735242,5808100,79995136,74187036
450000.0,3,2.0,1010,2820,1.5,0,0,2,7,1010,0,1905,0.0,98122,47.6066,-122.304,1330,3000,1810,0.6418439716312057,1020100,7952400,6932300
645000.0,3,2.5,2120,196995,1.0,0,1,2,9,2120,0,1997,0.0,98070,47.4089,-122.459,1304,92423,194875,0.9892383055407498,4494400,38807030025,38802535625
231000.0,4,2.0,1530,6375,2.0,0,0,2,7,1530,0,1942,1983.0,98058,47.4692,-122.162,1500,8712,4845,0.76,2340900,40640625,38299725
358000.0,3,1.5,1810,100188,1.0,0,0,4,7,1810,0,1969,0.0,98022,47.2175,-121.995,1540,40415,98378,0.9819339641474029,3276100,10037635344,10034359244
330000.0,3,1.0,1040,11900,1.0,0,0,4,6,1040,0,1972,0.0,98070,47.4332,-122.446,1250,9600,10860,0.9126050420168067,1081600,141610000,140528400
229950.0,2,1.5,1160,1848,2.0,0,0,2,7,1160,0,1972,0.0,98034,47.7366,-122.176,1160,1566,688,0.3722943722943723,1345600,3415104,2069504
403250.0,2,1.5,1430,8137,1.0,0,0,2,7,1130,300,1934,0.0,98125,47.7307,-122.29,1430,8137,6707,0.8242595551185941,2044900,66210769,64165869
470000.0,3,2.5,2280,6134,2.0,0,0,2,8,2280,0,2004,0.0,98065,47.5335,-121.854,2640,6167,3854,0.628301271600913,5198400,37625956,32427556
239000.0,3,1.0,1200,7810,1.0,0,0,3,7,1200,0,1967,0.0,98038,47.3631,-122.05,1590,7800,6610,0.8463508322663252,1440000,60996100,59556100
579000.0,4,1.5,2480,6000,1.0,0,0,2,8,1520,960,1955,0.0,98136,47.5233,-122.38600000000001,1810,6000,3520,0.5866666666666667,6150400,36000000,29849600
380500.0,3,2.0,1270,1348,3.0,0,0,2,8,1270,0,2003,0.0,98103,47.6929,-122.34200000000001,1180,1360,78,0.057863501483679525,1612900,1817104,204204
614285.0,5,2.75,2730,6401,2.0,0,0,2,8,2730,0,2015,0.0,98072,47.7685,-122.16,2520,6126,3671,0.5735041399781284,7452900,40972801,33519901
376000.0,2,2.0,1340,1635,2.0,0,0,2,8,1340,0,2003,0.0,98029,47.5476,-122.005,1410,1375,295,0.18042813455657492,1795600,2673225,877625
290000.0,3,1.0,1240,9300,1.0,0,0,2,7,1240,0,1954,0.0,98148,47.4363,-122.333,1250,9300,8060,0.8666666666666667,1537600,86490000,84952400
487000.0,4,2.25,2400,7000,1.0,0,0,3,8,1800,600,1965,0.0,98034,47.7207,-122.184,2210,7210,4600,0.6571428571428571,5760000,49000000,43240000
935000.0,4,2.0,1220,7489,2.0,0,0,2,7,1220,0,1903,0.0,98122,47.6133,-122.306,1220,3750,6269,0.8370944051275203,1488400,56085121,54596721
255000.0,4,2.5,2163,5882,2.0,0,0,2,7,2163,0,2006,0.0,98001,47.2736,-122.251,1760,9600,3719,0.6322679360761646,4678569,34597924,29919355
380000.0,2,2.5,1860,3504,2.0,0,0,2,7,1860,0,2000,0.0,98028,47.776,-122.23899999999999,1860,4246,1644,0.4691780821917808,3459600,12278016,8818416
450000.0,2,1.0,810,4368,1.0,0,0,2,6,810,0,1958,0.0,98115,47.6915,-122.31200000000001,1890,5253,3558,0.8145604395604396,656100,19079424,18423324
622000.0,3,2.5,1950,7481,2.0,0,0,2,8,1950,0,1987,0.0,98027,47.56399999999999,-122.09100000000001,1980,8479,5531,0.7393396604731988,3802500,55965361,52162861
292500.0,3,2.25,1390,6004,2.0,0,0,2,8,1390,0,1993,0.0,98038,47.3536,-122.04700000000001,1630,6397,4614,0.7684876748834111,1932100,36048016,34115916
1320000.0,4,3.0,2120,3600,2.0,0,3,3,8,1830,290,1908,1996.0,98119,47.6344,-122.369,2120,3600,1480,0.4111111111111111,4494400,12960000,8465600
410000.0,4,2.0,1510,3240,1.0,0,0,4,7,870,640,1901,0.0,98144,47.5972,-122.296,1420,5160,1730,0.5339506172839507,2280100,10497600,8217500
160000.0,3,1.75,1010,5355,1.0,0,0,2,6,1010,0,1950,0.0,98106,47.5202,-122.351,750,4515,4345,0.811391223155929,1020100,28676025,27655925
809000.0,4,1.5,1840,4337,2.0,0,0,3,8,1840,0,1917,0.0,98112,47.6312,-122.307,2250,4337,2497,0.575743601567904,3385600,18809569,15423969
183750.0,5,2.75,1650,5453,1.0,0,0,2,7,1650,0,1970,0.0,98118,47.5293,-122.285,1670,5885,3803,0.6974142673757565,2722500,29735209,27012709
411000.0,5,1.75,2860,12293,1.0,0,0,3,8,1430,1430,1947,0.0,98133,47.7385,-122.348,1920,18110,9433,0.7673472708045229,8179600,151117849,142938249
1050000.0,3,1.75,2650,5512,2.0,0,0,2,9,2250,400,1984,0.0,98112,47.6265,-122.295,1440,5100,2862,0.5192307692307693,7022500,30382144,23359644
625000.0,2,1.0,1100,4160,1.0,0,0,2,7,1100,0,1919,0.0,98109,47.6352,-122.352,1900,4000,3060,0.7355769230769231,1210000,17305600,16095600
305000.0,3,2.25,1646,9519,2.0,0,0,2,7,1646,0,1994,0.0,98038,47.3646,-122.036,1975,8889,7873,0.8270826767517596,2709316,90611361,87902045
915000.0,4,4.5,5250,48352,2.0,0,0,2,10,5250,0,1998,0.0,98059,47.4858,-122.111,2500,48352,43102,0.891421244209133,27562500,2337915904,2310353404
317000.0,3,1.5,1390,8300,1.0,0,0,3,7,1390,0,1974,0.0,98019,47.7383,-121.98299999999999,1470,7500,6910,0.8325301204819278,1932100,68890000,66957900
165000.0,2,1.0,780,6380,1.0,0,0,2,6,780,0,1947,0.0,98106,47.5423,-122.351,1270,6960,5600,0.877742946708464,608400,40704400,40096000
575000.0,2,1.0,1490,6000,1.0,0,0,2,7,1090,400,1946,0.0,98112,47.6296,-122.3,1590,6000,4510,0.7516666666666667,2220100,36000000,33779900
219900.0,3,1.0,970,7742,1.0,0,0,3,6,970,0,1967,0.0,98003,47.3173,-122.32700000000001,970,7650,6772,0.8747093774218548,940900,59938564,58997664
1490000.0,4,3.25,3730,7200,2.0,0,0,2,10,2810,920,2006,0.0,98033,47.6824,-122.199,2490,7200,3470,0.48194444444444445,13912900,51840000,37927100
300000.0,3,1.0,1090,9900,1.0,0,0,3,7,1090,0,1955,0.0,98052,47.6755,-122.16,1720,10419,8810,0.8898989898989899,1188100,98010000,96821900
520000.0,3,1.75,1940,219527,1.0,0,0,2,7,1940,0,1991,0.0,98038,47.4214,-122.02,2060,108900,217587,0.9911628182410364,3763600,48192103729,48188340129
310000.0,4,2.25,1780,8820,1.0,0,0,3,8,1480,300,1966,0.0,98032,47.3618,-122.289,1780,8625,7040,0.7981859410430839,3168400,77792400,74624000
322500.0,3,2.0,1190,6445,1.0,0,0,2,7,1190,0,1996,0.0,98056,47.5057,-122.17200000000001,1920,8195,5255,0.8153607447633825,1416100,41538025,40121925
320000.0,4,2.25,2000,10374,2.0,0,1,3,7,2000,0,1967,0.0,98023,47.3342,-122.34,2170,10374,8374,0.807210333526123,4000000,107619876,103619876
440000.0,3,2.5,1390,4997,2.0,0,0,2,7,1390,0,2004,0.0,98065,47.5303,-121.855,2340,4125,3607,0.721833099859916,1932100,24970009,23037909
578000.0,3,1.0,1500,4500,1.0,0,0,2,7,1120,380,1938,0.0,98117,47.6873,-122.385,1440,4500,3000,0.6666666666666666,2250000,20250000,18000000
382000.0,2,1.5,1070,877,3.0,0,0,2,8,1070,0,2005,0.0,98107,47.6699,-122.39299999999999,1320,1193,-193,-0.22006841505131128,1144900,769129,-375771
535000.0,3,2.5,1720,4006,2.0,0,0,2,8,1720,0,1994,0.0,98029,47.568999999999996,-122.007,1780,3974,2286,0.5706440339490764,2958400,16048036,13089636
679000.0,4,2.5,3680,7236,2.0,0,0,2,10,3680,0,2006,0.0,98038,47.3543,-122.005,3310,7180,3556,0.49143173023770037,13542400,52359696,38817296
258900.0,3,2.25,1400,10436,1.0,0,0,3,7,1040,360,1985,0.0,98058,47.4261,-122.14399999999999,1860,9318,9036,0.8658489842851668,1960000,108910096,106950096
563000.0,3,1.5,1730,9509,2.0,0,0,2,8,1270,460,1955,0.0,98125,47.7067,-122.28200000000001,1810,8795,7779,0.8180670943316858,2992900,90421081,87428181
562000.0,5,3.0,2795,15101,2.0,0,0,2,8,2795,0,1996,0.0,98019,47.7301,-121.97200000000001,2750,14567,12306,0.8149129196741938,7812025,228040201,220228176
725000.0,4,1.75,2000,3750,1.0,0,0,4,8,1120,880,1950,0.0,98117,47.6816,-122.374,1370,5000,1750,0.4666666666666667,4000000,14062500,10062500
236775.0,3,2.5,1830,8372,2.0,0,0,2,8,1830,0,1987,0.0,98023,47.3116,-122.4,1770,8372,6542,0.7814142379359771,3348900,70090384,66741484
860000.0,4,3.5,3380,8098,1.0,0,1,4,9,1690,1690,1952,0.0,98033,47.6839,-122.19,1890,8400,4718,0.5826129908619412,11424400,65577604,54153204
270000.0,3,1.5,1500,6337,1.0,0,0,4,7,1500,0,1953,0.0,98125,47.7276,-122.31200000000001,1420,6337,4837,0.7632949345115986,2250000,40157569,37907569
621000.0,4,2.75,1950,6930,1.0,0,2,3,7,1250,700,1960,0.0,98008,47.61600000000001,-122.113,1950,8560,4980,0.7186147186147186,3802500,48024900,44222400
527900.0,3,2.5,2490,5928,2.0,0,2,2,8,2490,0,1998,0.0,98065,47.5385,-121.87,2420,6381,3438,0.5799595141700404,6200100,35141184,28941084
395000.0,4,2.25,1780,10748,2.0,0,0,3,8,1780,0,1964,0.0,98072,47.762,-122.11,2070,37680,8968,0.8343877930777819,3168400,115519504,112351104
320000.0,3,2.0,1110,10500,1.0,0,0,4,7,1110,0,1978,0.0,98045,47.4456,-121.773,1230,10395,9390,0.8942857142857142,1232100,110250000,109017900
300000.0,4,2.5,2500,4750,2.0,0,0,2,8,2500,0,2003,0.0,98042,47.3666,-122.12200000000001,2690,4750,2250,0.47368421052631576,6250000,22562500,16312500
320000.0,3,1.75,1480,7225,1.0,0,0,3,7,1480,0,1965,0.0,98056,47.51300000000001,-122.185,1430,7201,5745,0.7951557093425605,2190400,52200625,50010225
625000.0,3,2.25,2570,47480,1.0,0,0,2,9,2570,0,1979,0.0,98053,47.6854,-122.079,2570,106722,44910,0.9458719460825611,6604900,2254350400,2247745500
505000.0,2,1.0,810,5060,1.0,0,0,2,6,810,0,1941,0.0,98116,47.5635,-122.39399999999999,900,5060,4250,0.8399209486166008,656100,25603600,24947500
300000.0,4,2.5,2700,10814,1.0,0,0,3,8,1560,1140,1966,0.0,98030,47.369,-122.177,2460,6310,8114,0.7503236545219161,7290000,116942596,109652596
363000.0,4,2.5,2180,9281,2.0,0,0,2,8,2180,0,2004,0.0,98042,47.3673,-122.072,2520,9520,7101,0.7651115181553712,4752400,86136961,81384561
1700000.0,4,3.5,4330,15335,2.0,0,0,3,11,3230,1100,1988,0.0,98040,47.5315,-122.23100000000001,3840,14311,11005,0.7176393870231497,18748900,235162225,216413325
1150000.0,4,3.5,4210,10308,2.0,0,0,2,10,4210,0,2006,0.0,98008,47.5905,-122.117,3860,10200,6098,0.5915793558401242,17724100,106254864,88530764
680000.0,4,2.5,2880,9202,1.0,0,0,2,8,1780,1100,1977,0.0,98052,47.6658,-122.139,2500,10265,6322,0.6870245598782874,8294400,84676804,76382404
678940.0,5,2.25,2610,4080,2.0,0,0,4,7,1750,860,1909,0.0,98115,47.6757,-122.309,2160,4080,1470,0.3602941176470588,6812100,16646400,9834300
299000.0,3,1.75,2010,8065,1.0,0,0,3,7,1090,920,1984,0.0,98031,47.4171,-122.20200000000001,1560,8065,6055,0.7507749535027899,4040100,65044225,61004125
379900.0,4,1.75,1500,11600,1.0,0,0,3,7,1000,500,1955,0.0,98028,47.7373,-122.241,1740,11600,10100,0.8706896551724138,2250000,134560000,132310000
205000.0,3,1.0,1290,6566,1.0,0,0,4,7,1290,0,1976,0.0,98023,47.3004,-122.37700000000001,1690,6860,5276,0.8035333536399635,1664100,43112356,41448256
387500.0,4,1.0,1320,4440,1.5,0,0,2,7,1320,0,1929,0.0,98122,47.6145,-122.295,1260,4440,3120,0.7027027027027027,1742400,19713600,17971200
256000.0,3,1.0,1290,4720,1.0,0,0,2,6,790,500,1948,0.0,98106,47.5186,-122.35799999999999,1110,4720,3430,0.7266949152542372,1664100,22278400,20614300
548000.0,4,2.5,2440,11005,2.0,0,0,2,9,2440,0,1994,0.0,98056,47.5318,-122.176,2590,14754,8565,0.7782825988187188,5953600,121110025,115156425
163000.0,3,1.75,1290,4811,1.0,0,0,2,7,1290,0,1996,0.0,98032,47.3912,-122.234,1310,4811,3521,0.7318644772396591,1664100,23145721,21481621
367500.0,2,2.0,1030,600,2.0,0,0,2,8,680,350,2004,0.0,98116,47.5788,-122.41,1120,1267,-430,-0.7166666666666667,1060900,360000,-700900
390000.0,3,2.25,1640,2875,2.0,0,0,2,6,1240,400,1983,0.0,98118,47.5686,-122.286,1500,3960,1235,0.4295652173913043,2689600,8265625,5576025
415000.0,4,2.5,1160,16008,1.0,0,0,3,7,1160,0,1989,0.0,98155,47.7643,-122.295,1570,12645,14848,0.927536231884058,1345600,256256064,254910464
449000.0,4,2.25,2230,8440,2.0,0,0,3,8,2230,0,1968,0.0,98011,47.7558,-122.21700000000001,2160,9412,6210,0.735781990521327,4972900,71233600,66260700
460000.0,5,2.0,1910,12264,1.0,0,0,3,7,1010,900,1963,0.0,98007,47.601000000000006,-122.134,1700,9179,10354,0.844259621656882,3648100,150405696,146757596
395000.0,4,2.0,1980,15354,1.0,0,0,2,7,1980,0,1977,0.0,98053,47.63800000000001,-121.96799999999999,1420,12300,13374,0.8710433763188745,3920400,235745316,231824916
300000.0,3,2.0,1470,16500,1.0,0,0,2,7,1470,0,1961,0.0,98042,47.3617,-122.061,1720,14406,15030,0.9109090909090909,2160900,272250000,270089100
345000.0,3,1.75,1520,7439,1.0,0,0,3,7,1520,0,1969,0.0,98055,47.457,-122.208,1650,7500,5919,0.7956714612179057,2310400,55338721,53028321
825000.0,3,1.75,1930,8442,1.0,0,0,3,7,1930,0,1953,0.0,98004,47.6313,-122.204,1790,8442,6512,0.771381189291637,3724900,71267364,67542464
539950.0,3,2.5,1330,2180,3.0,0,0,2,8,1330,0,2014,0.0,98117,47.6987,-122.365,1330,5000,850,0.38990825688073394,1768900,4752400,2983500
410000.0,4,2.0,1580,9581,1.0,0,0,2,7,1580,0,1953,0.0,98033,47.692,-122.165,1580,10552,8001,0.8350902828514769,2496400,91795561,89299161
245000.0,3,1.0,1370,6000,1.0,0,0,2,7,1370,0,1955,0.0,98146,47.4879,-122.339,1370,9520,4630,0.7716666666666666,1876900,36000000,34123100
482000.0,4,2.75,3010,15750,1.0,0,0,3,8,1560,1450,1973,0.0,98034,47.7336,-122.18299999999999,2110,9450,12740,0.8088888888888889,9060100,248062500,239002400
270000.0,3,1.75,1390,9000,1.0,0,0,3,7,1390,0,1978,0.0,98045,47.4469,-121.772,1400,9697,7610,0.8455555555555555,1932100,81000000,79067900
475000.0,3,1.75,1330,14560,1.0,0,0,2,7,1330,0,1983,0.0,98052,47.6599,-122.135,1510,9890,13230,0.9086538461538461,1768900,211993600,210224700
445800.0,3,2.0,1320,6500,1.0,0,0,2,7,1320,0,1947,0.0,98125,47.7119,-122.319,1110,6592,5180,0.796923076923077,1742400,42250000,40507600
518000.0,4,3.0,2430,11670,1.0,0,0,3,7,1330,1100,1978,0.0,98034,47.7307,-122.228,1580,10464,9240,0.7917737789203085,5904900,136188900,130284000
785000.0,2,0.75,1260,4800,1.5,0,2,3,6,1080,180,1942,0.0,98033,47.6843,-122.212,2660,7200,3540,0.7375,1587600,23040000,21452400
430000.0,3,2.5,1690,1310,2.0,0,0,2,8,1140,550,2004,0.0,98136,47.5404,-122.387,1640,1321,-380,-0.2900763358778626,2856100,1716100,-1140000
715000.0,4,1.75,3420,7200,1.0,0,3,4,8,1770,1650,1947,0.0,98125,47.7081,-122.277,2450,6200,3780,0.525,11696400,51840000,40143600
560000.0,3,1.5,2790,6900,1.0,0,2,2,8,1700,1090,1955,0.0,98125,47.7328,-122.288,2410,8100,4110,0.5956521739130435,7784100,47610000,39825900
449000.0,3,1.75,1270,6600,1.5,0,0,4,7,1270,0,1903,0.0,98144,47.5976,-122.295,1490,3600,5330,0.8075757575757576,1612900,43560000,41947100
805000.0,4,2.5,2910,9000,2.0,0,0,2,9,2910,0,1989,0.0,98006,47.5451,-122.14200000000001,2530,9000,6090,0.6766666666666666,8468100,81000000,72531900
296000.0,3,2.5,1560,5845,2.0,0,0,2,7,1560,0,2003,0.0,98038,47.3851,-122.029,1860,5752,4285,0.7331052181351583,2433600,34164025,31730425
275000.0,2,1.0,770,4840,1.0,0,0,3,7,770,0,1927,0.0,98126,47.551,-122.376,930,4840,4070,0.8409090909090909,592900,23425600,22832700
419950.0,3,1.75,1770,16909,1.0,0,0,4,8,1770,0,1977,0.0,98058,47.4458,-122.134,1960,9100,15139,0.8953220178603111,3132900,285914281,282781381
285000.0,3,1.75,1100,1307,2.0,0,0,2,7,780,320,2008,0.0,98106,47.5601,-122.363,1170,4800,207,0.15837796480489671,1210000,1708249,498249
775000.0,3,2.5,2890,8470,2.0,0,0,2,10,2890,0,1996,0.0,98075,47.5785,-122.054,3000,8879,5580,0.6587957497048406,8352100,71740900,63388800
288250.0,3,1.75,2110,15400,1.0,0,0,2,7,1380,730,1963,0.0,98178,47.4861,-122.226,2110,9800,13290,0.862987012987013,4452100,237160000,232707900
257000.0,2,1.75,1220,2268,1.0,0,0,3,6,610,610,1909,0.0,98144,47.592,-122.295,1240,1675,1048,0.4620811287477954,1488400,5143824,3655424
377000.0,1,1.0,950,10585,1.5,0,0,2,6,950,0,1929,0.0,98115,47.6968,-122.29700000000001,1400,7056,9635,0.9102503542749173,902500,112042225,111139725
550000.0,2,1.0,1420,3100,1.0,0,0,2,7,820,600,1924,0.0,98107,47.6737,-122.365,1420,3915,1680,0.5419354838709678,2016400,9610000,7593600
339000.0,3,1.0,1100,4128,1.0,0,0,3,7,720,380,1942,0.0,98126,47.5296,-122.37899999999999,1510,4538,3028,0.7335271317829457,1210000,17040384,15830384
481500.0,3,1.75,2140,6000,1.0,0,0,2,7,1070,1070,1948,0.0,98117,47.6913,-122.366,1240,4650,3860,0.6433333333333333,4579600,36000000,31420400
224500.0,3,1.75,1300,7735,1.0,0,0,3,7,1300,0,1980,0.0,98022,47.1983,-122.0,1300,8941,6435,0.8319327731092437,1690000,59830225,58140225
260000.0,3,1.0,1790,11884,1.0,0,0,2,7,1790,0,1951,0.0,98031,47.3887,-122.22,1660,11513,10094,0.8493773140356782,3204100,141229456,138025356
865000.0,2,1.0,1470,5400,1.5,0,0,2,8,1470,0,1912,0.0,98119,47.6391,-122.36,1760,3573,3930,0.7277777777777777,2160900,29160000,26999100
730000.0,5,3.0,2500,11779,1.0,0,0,3,8,1550,950,1971,0.0,98006,47.5696,-122.12700000000001,2580,12055,9279,0.7877578741828678,6250000,138744841,132494841
550000.0,2,1.0,980,3080,1.5,0,0,2,7,980,0,1910,1946.0,98103,47.6646,-122.339,1450,3333,2100,0.6818181818181818,960400,9486400,8526000
645000.0,3,2.0,2130,4000,2.0,0,0,2,7,2130,0,1908,0.0,98115,47.6741,-122.323,2010,4000,1870,0.4675,4536900,16000000,11463100
250000.0,3,1.75,1360,16000,1.0,0,0,2,7,1360,0,1978,0.0,98155,47.7583,-122.306,1360,12939,14640,0.915,1849600,256000000,254150400
507200.0,3,3.5,1630,1329,2.0,0,0,2,9,1360,270,2000,0.0,98122,47.6159,-122.306,1580,1319,-301,-0.22648607975921745,2656900,1766241,-890659
380000.0,4,2.5,2500,11070,1.0,0,2,3,8,1300,1200,1964,0.0,98003,47.33600000000001,-122.334,2500,11070,8570,0.7741644083107497,6250000,122544900,116294900
540000.0,4,1.75,2260,19500,1.0,0,2,2,8,1450,810,1971,0.0,98074,47.6555,-122.086,2980,19500,17240,0.884102564102564,5107600,380250000,375142400
738500.0,3,2.5,2300,6009,1.0,0,0,2,8,2300,0,2005,0.0,98053,47.7067,-122.01299999999999,1640,5931,3709,0.6172408054584789,5290000,36108081,30818081
206000.0,3,1.0,1060,10350,1.0,0,0,3,7,1060,0,1980,0.0,98038,47.365,-122.02799999999999,1500,9660,9290,0.8975845410628019,1123600,107122500,105998900
265000.0,2,1.0,940,9458,1.0,0,0,2,6,940,0,1948,0.0,98155,47.7523,-122.311,1450,9458,8518,0.900613237470924,883600,89453764,88570164
190000.0,1,0.75,780,77603,1.0,0,0,0,5,780,0,1945,0.0,98058,47.4396,-122.104,1750,30847,76823,0.9899488421839362,608400,6022225609,6021617209
339900.0,3,1.0,1200,9087,1.0,0,0,4,7,1200,0,1969,0.0,98056,47.5234,-122.177,1250,11826,7887,0.8679432155827006,1440000,82573569,81133569
250000.0,6,2.5,2590,10890,1.0,0,0,3,7,1340,1250,1970,0.0,98042,47.4126,-122.165,2474,10454,8300,0.7621671258034894,6708100,118592100,111884000
416500.0,3,1.0,1100,4184,1.0,0,0,3,7,1100,0,1965,0.0,98136,47.5309,-122.382,1630,4366,3084,0.737093690248566,1210000,17505856,16295856
575000.0,4,2.5,2890,9775,2.0,0,2,2,8,2890,0,2004,0.0,98065,47.5339,-121.854,2640,7184,6885,0.7043478260869566,8352100,95550625,87198525
385000.0,3,1.75,1230,7500,1.0,0,0,2,7,1230,0,1987,0.0,98034,47.7316,-122.22399999999999,1930,8747,6270,0.836,1512900,56250000,54737100
253000.0,3,1.0,1030,6250,1.0,0,0,2,7,1030,0,1960,1997.0,98056,47.4988,-122.16799999999999,1160,7250,5220,0.8352,1060900,39062500,38001600
460000.0,3,1.0,1140,4600,1.0,0,0,2,7,1140,0,1942,0.0,98103,47.6897,-122.337,1370,5000,3460,0.7521739130434782,1299600,21160000,19860400
1450000.0,4,2.5,3200,3600,3.0,0,3,3,9,2600,600,1997,0.0,98119,47.632,-122.369,2490,4080,400,0.1111111111111111,10240000,12960000,2720000
492000.0,2,1.0,950,6000,1.0,0,0,2,7,950,0,1942,0.0,98115,47.6897,-122.294,1440,6000,5050,0.8416666666666667,902500,36000000,35097500
275000.0,4,2.0,1960,30480,1.0,0,2,3,7,1060,900,1972,0.0,98022,47.1924,-121.988,1460,8914,28520,0.9356955380577427,3841600,929030400,925188800
542500.0,5,3.25,3010,1074218,1.5,0,0,4,8,2010,1000,1931,0.0,98027,47.4564,-122.00399999999999,2450,68825,1071208,0.9971979616800314,9060100,1153944311524,1153935251424
345000.0,2,1.0,1080,7775,1.0,0,0,2,6,1080,0,1955,0.0,98136,47.5447,-122.39399999999999,1730,7350,6695,0.8610932475884244,1166400,60450625,59284225
575000.0,4,2.75,2730,35075,1.0,0,0,2,8,1530,1200,1979,0.0,98072,47.7726,-122.139,2310,35000,32345,0.9221667854597292,7452900,1230255625,1222802725
275000.0,5,2.5,2570,17234,1.0,0,0,2,7,1300,1270,1959,0.0,98133,47.7753,-122.355,1760,7969,14664,0.8508761750029012,6604900,297010756,290405856
510000.0,6,4.5,3300,7561,2.0,0,0,2,8,3300,0,1980,0.0,98052,47.6795,-122.104,2470,7561,4261,0.5635497950006613,10890000,57168721,46278721
2540000.0,4,3.5,4350,6000,2.0,0,0,4,10,2970,1380,1908,0.0,98112,47.6277,-122.286,4190,7200,1650,0.275,18922500,36000000,17077500
830000.0,3,3.5,3820,145054,2.0,0,3,2,9,2870,950,1999,0.0,98045,47.4419,-121.736,2500,95950,141234,0.9736649799385056,14592400,21040662916,21026070516
640000.0,4,2.5,2260,5172,2.0,0,0,2,9,2260,0,2004,0.0,98052,47.7047,-122.12799999999999,2680,5172,2912,0.563031709203403,5107600,26749584,21641984
702000.0,4,2.75,3880,15025,2.0,0,0,2,7,3880,0,2004,0.0,98053,47.6777,-122.035,2620,5300,11145,0.7417637271214642,15054400,225750625,210696225
960000.0,3,2.5,2010,6857,1.0,0,0,3,9,1450,560,1955,0.0,98102,47.6402,-122.314,2380,6370,4847,0.7068688931019397,4040100,47018449,42978349
190000.0,3,1.0,950,7610,1.0,0,0,2,7,950,0,1983,0.0,98092,47.3188,-122.17399999999999,1360,7938,6660,0.8751642575558476,902500,57912100,57009600
500000.0,3,2.25,1730,13040,1.0,0,0,3,8,1290,440,1988,0.0,98052,47.6809,-122.119,1730,11016,11310,0.8673312883435583,2992900,170041600,167048700
529000.0,3,2.5,3070,22098,2.0,0,0,2,9,3070,0,1995,0.0,98059,47.4724,-122.147,3070,21803,19028,0.8610734003077202,9424900,488321604,478896704
435000.0,3,1.75,1500,8173,1.0,0,0,2,7,1500,0,1997,0.0,98034,47.7293,-122.227,1970,8173,6673,0.8164688608833965,2250000,66797929,64547929
670000.0,3,1.75,2160,5760,1.0,0,0,3,8,1260,900,1954,0.0,98136,47.5346,-122.391,2090,5760,3600,0.625,4665600,33177600,28512000
365000.0,3,2.25,1960,1985,2.0,0,0,2,7,1750,210,2003,0.0,98118,47.5419,-122.289,1760,1985,25,0.012594458438287154,3841600,3940225,98625
1270000.0,5,3.0,3950,9520,1.0,0,0,2,9,2250,1700,1953,2002.0,98004,47.6363,-122.20700000000001,1890,9520,5570,0.5850840336134454,15602500,90630400,75027900
465000.0,3,1.0,1100,145490,1.5,0,0,3,6,1100,0,1915,0.0,98024,47.5697,-121.898,1100,11610,144390,0.9924393429101657,1210000,21167340100,21166130100
285000.0,3,1.5,1400,7582,1.0,0,0,2,7,1400,0,1956,0.0,98148,47.4536,-122.33,1280,7872,6182,0.8153521498285413,1960000,57486724,55526724
219950.0,3,1.0,1020,4960,1.5,0,0,2,6,920,100,1926,0.0,98118,47.5328,-122.275,1230,7335,3940,0.7943548387096774,1040400,24601600,23561200
220000.0,3,1.5,1600,10548,1.0,0,0,3,7,1600,0,1962,0.0,98001,47.2925,-122.28399999999999,2880,13609,8948,0.8483124762988244,2560000,111260304,108700304
1470000.0,6,4.5,4230,6420,2.0,0,3,3,8,2360,1870,1916,0.0,98119,47.6301,-122.369,3450,4085,2190,0.3411214953271028,17892900,41216400,23323500
1110000.0,5,3.5,3090,3600,2.0,0,0,2,9,2060,1030,2000,0.0,98112,47.6217,-122.309,2240,3904,510,0.14166666666666666,9548100,12960000,3411900
694000.0,2,2.5,2320,9311,1.0,0,0,2,8,2320,0,2007,0.0,98053,47.7226,-122.03,1680,4765,6991,0.7508323488347116,5382400,86694721,81312321
620000.0,3,2.5,2440,10363,2.0,0,0,2,9,2440,0,1988,0.0,98029,47.5634,-122.016,2500,10728,7923,0.764546945865097,5953600,107391769,101438169
415000.0,3,1.0,2020,19210,1.0,0,0,2,6,1760,260,1949,0.0,98028,47.7552,-122.229,1780,14469,17190,0.8948464341488808,4080400,369024100,364943700
765000.0,3,3.0,3270,38088,2.0,0,0,2,10,3270,0,1992,0.0,98053,47.6692,-122.02799999999999,1870,37457,34818,0.9141461877756774,10692900,1450695744,1440002844
864000.0,4,1.75,2260,6600,1.0,0,0,4,8,1220,1040,1948,0.0,98115,47.6753,-122.27799999999999,2240,6600,4340,0.6575757575757576,5107600,43560000,38452400
385000.0,5,2.0,2020,4000,2.0,0,0,2,7,2020,0,1950,0.0,98144,47.5799,-122.305,1960,4000,1980,0.495,4080400,16000000,11919600
725000.0,3,1.0,1000,19969,1.0,0,0,2,7,1000,0,1951,0.0,98033,47.6745,-122.197,1370,7962,18969,0.9499223796885172,1000000,398760961,397760961
545000.0,4,2.25,2030,11585,1.0,0,0,3,7,1590,440,1967,0.0,98052,47.6561,-122.13,1960,8977,9555,0.824773413897281,4120900,134212225,130091325
299900.0,3,1.75,1730,9893,1.0,0,0,3,9,1730,0,1988,0.0,98042,47.3747,-122.164,2120,9108,8163,0.8251288790053574,2992900,97871449,94878549
639500.0,3,1.75,2010,8072,1.0,0,0,3,8,2010,0,1974,0.0,98052,47.6327,-122.09700000000001,2030,8055,6062,0.7509910802775025,4040100,65157184,61117084
345000.0,4,1.5,1540,7168,1.0,0,0,2,7,1160,380,1964,0.0,98055,47.455,-122.198,1540,7176,5628,0.78515625,2371600,51380224,49008624
1130000.0,6,4.0,5330,18116,2.0,0,0,2,11,3950,1380,2000,0.0,98006,47.5503,-122.137,4590,16900,12786,0.7057849414881873,28408900,328189456,299780556
345000.0,2,1.0,960,2700,1.0,0,0,2,6,780,180,1904,0.0,98144,47.6013,-122.29899999999999,1400,3000,1740,0.6444444444444445,921600,7290000,6368400
600000.0,3,2.0,1460,2800,1.0,0,0,3,7,730,730,1921,0.0,98105,47.67,-122.295,1780,4560,1340,0.4785714285714286,2131600,7840000,5708400
355000.0,4,1.75,2160,7417,1.0,0,0,3,7,1360,800,1983,0.0,98056,47.5122,-122.181,1880,8022,5257,0.7087771336119725,4665600,55011889,50346289
698000.0,3,2.75,2640,11957,1.5,0,0,2,9,2260,380,1978,0.0,98052,47.6491,-122.12,2640,12641,9317,0.7792088316467342,6969600,142969849,136000249
566000.0,4,2.25,2170,7737,2.0,0,0,2,8,2170,0,1987,0.0,98074,47.637,-122.029,1850,8869,5567,0.7195295334108828,4708900,59861169,55152269
449950.0,3,2.5,1530,3840,2.0,0,0,2,8,1530,0,1994,0.0,98029,47.5691,-122.007,1720,3985,2310,0.6015625,2340900,14745600,12404700
404600.0,3,1.0,1570,7727,1.0,0,2,3,8,1270,300,1958,0.0,98056,47.4821,-122.19200000000001,2440,7727,6157,0.7968163582244079,2464900,59706529,57241629
258000.0,3,1.0,1490,7435,1.0,0,0,2,7,1120,370,1969,0.0,98198,47.368,-122.314,1490,7530,5945,0.7995965030262273,2220100,55279225,53059125
415000.0,4,2.0,1960,10559,2.0,0,0,3,7,1960,0,1955,0.0,98133,47.7494,-122.337,1580,7769,8599,0.8143763613978596,3841600,111492481,107650881
320000.0,4,2.25,2190,9020,2.0,0,0,2,8,2190,0,1978,0.0,98032,47.3742,-122.28399999999999,2170,8400,6830,0.7572062084257206,4796100,81360400,76564300
295000.0,3,2.5,1690,4102,2.0,0,0,2,7,1690,0,2003,0.0,98038,47.3552,-122.015,1830,4733,2412,0.5880058508044856,2856100,16826404,13970304
389000.0,5,2.0,2330,10750,1.0,0,0,3,7,1190,1140,1962,0.0,98028,47.7325,-122.245,1830,10180,8420,0.7832558139534884,5428900,115562500,110133600
299900.0,3,1.75,1470,27000,1.0,0,0,2,7,1470,0,1958,0.0,98198,47.3943,-122.311,2230,14186,25530,0.9455555555555556,2160900,729000000,726839100
394000.0,3,2.5,2550,5349,2.0,0,0,2,7,2550,0,2004,0.0,98038,47.3504,-122.02600000000001,2640,5400,2799,0.5232753785754347,6502500,28611801,22109301
762000.0,4,2.0,2130,5500,1.5,0,0,4,7,2130,0,1939,0.0,98033,47.6807,-122.199,1490,6000,3370,0.6127272727272727,4536900,30250000,25713100
697000.0,4,2.75,3650,48351,1.5,0,0,3,8,3650,0,1978,0.0,98077,47.7632,-122.089,2820,53143,44701,0.9245103513888027,13322500,2337819201,2324496701
485000.0,3,2.5,3340,70131,2.0,0,0,2,9,2420,920,1994,0.0,98022,47.2666,-122.015,2760,116740,66791,0.9523748413682964,11155600,4918357161,4907201561
189900.0,2,1.0,800,5600,1.0,0,0,4,6,800,0,1955,0.0,98056,47.4959,-122.17200000000001,1100,6000,4800,0.8571428571428571,640000,31360000,30720000
2150000.0,3,2.75,3470,9610,3.0,0,4,2,11,3470,0,1989,0.0,98034,47.7205,-122.26,4130,11875,6140,0.6389177939646202,12040900,92352100,80311200
345000.0,3,1.5,1030,6969,1.0,0,0,3,6,1030,0,1921,0.0,98108,47.5492,-122.3,1420,6000,5939,0.8522026115655044,1060900,48566961,47506061
376500.0,3,2.0,1630,7800,1.0,0,0,4,7,1630,0,1950,0.0,98125,47.7326,-122.307,1470,7800,6170,0.791025641025641,2656900,60840000,58183100
775000.0,3,2.0,2010,7017,2.0,0,3,2,7,2010,0,1951,1988.0,98115,47.6828,-122.26700000000001,2450,6045,5007,0.7135528003420265,4040100,49238289,45198189
450000.0,3,1.0,1360,3737,1.5,0,0,3,6,1360,0,1910,0.0,98107,47.6751,-122.36200000000001,1820,4500,2377,0.636071715279636,1849600,13965169,12115569
760000.0,4,2.25,2040,8315,1.0,0,0,3,8,1480,560,1958,0.0,98177,47.7077,-122.37100000000001,2330,8940,6275,0.7546602525556224,4161600,69139225,64977625
569000.0,4,2.5,2830,10954,2.0,0,0,2,8,2830,0,2003,0.0,98065,47.5396,-121.882,2470,10443,8124,0.7416468869819244,8008900,119990116,111981216
500000.0,3,1.5,2040,6750,1.0,0,0,2,7,1280,760,1950,0.0,98117,47.7013,-122.369,1970,6750,4710,0.6977777777777778,4161600,45562500,41400900
592500.0,2,2.0,1340,5350,1.5,0,0,2,8,1340,0,1941,0.0,98199,47.6384,-122.40299999999999,2210,5350,4010,0.7495327102803738,1795600,28622500,26826900
620000.0,4,2.5,2130,9139,2.0,0,0,2,9,2130,0,1988,0.0,98029,47.5648,-122.01,2150,8178,7009,0.7669329248276616,4536900,83521321,78984421
1000000.0,5,4.25,3920,16258,2.0,0,0,2,9,2900,1020,1990,0.0,98004,47.5871,-122.19200000000001,2540,12131,12338,0.7588879320949686,15366400,264322564,248956164
815000.0,3,2.5,2415,2186,2.0,0,1,2,9,2415,0,1981,0.0,98033,47.6506,-122.20200000000001,2660,2165,-229,-0.10475754803293687,5832225,4778596,-1053629
775000.0,5,2.75,3750,12077,2.0,0,4,2,10,3750,0,2005,0.0,98038,47.3525,-122.00200000000001,3120,7255,8327,0.6894924236151362,14062500,145853929,131791429
340000.0,3,1.0,1010,7500,1.0,0,0,3,7,1010,0,1975,0.0,98074,47.6169,-122.06200000000001,1230,7500,6490,0.8653333333333333,1020100,56250000,55229900
458000.0,2,1.75,990,5850,1.0,0,0,3,6,990,0,1942,0.0,98125,47.7132,-122.321,840,6110,4860,0.8307692307692308,980100,34222500,33242400
250000.0,2,1.5,1200,5773,2.0,0,0,2,7,1200,0,1985,0.0,98055,47.4723,-122.19,1530,4576,4573,0.7921358046076563,1440000,33327529,31887529
151600.0,2,1.0,1060,16988,1.0,0,0,2,6,1060,0,1954,0.0,98058,47.4305,-122.15700000000001,2320,10580,15928,0.9376030138921592,1123600,288592144,287468544
515000.0,4,2.5,3200,6473,2.0,0,0,2,7,3200,0,2005,0.0,98059,47.5012,-122.15,2480,6140,3273,0.5056388073536228,10240000,41899729,31659729
216000.0,2,1.0,1810,10360,1.0,0,0,2,6,1010,800,1946,0.0,98178,47.5039,-122.266,1810,10360,8550,0.8252895752895753,3276100,107329600,104053500
245000.0,3,1.75,1670,24650,1.0,0,0,3,7,1670,0,1974,0.0,98022,47.1764,-122.02600000000001,1810,19465,22980,0.9322515212981745,2788900,607622500,604833600
645000.0,3,2.75,1850,16960,1.0,0,2,3,8,1850,0,1953,0.0,98177,47.7128,-122.365,2470,13761,15110,0.8909198113207547,3422500,287641600,284219100
249900.0,3,1.0,1100,5000,1.0,0,0,2,7,1100,0,1960,0.0,98118,47.5433,-122.28299999999999,1020,5000,3900,0.78,1210000,25000000,23790000
410000.0,3,1.75,1660,6250,1.0,0,0,2,7,830,830,1980,0.0,98116,47.5859,-122.385,1660,5750,4590,0.7344,2755600,39062500,36306900
499000.0,6,1.75,2400,7500,1.5,0,0,2,7,1400,1000,1975,0.0,98155,47.7661,-122.31299999999999,1980,7500,5100,0.68,5760000,56250000,50490000
790000.0,5,3.25,2900,12160,1.0,0,0,3,8,1890,1010,1967,0.0,98005,47.6154,-122.16799999999999,2590,12160,9260,0.7615131578947368,8410000,147865600,139455600
458000.0,1,2.25,2140,10350,1.0,0,0,2,7,1470,670,1976,0.0,98072,47.7352,-122.17,1980,8400,8210,0.7932367149758454,4579600,107122500,102542900
925000.0,4,2.5,2670,5100,2.0,0,0,2,8,1940,730,1929,2010.0,98117,47.6768,-122.39,1470,4080,2430,0.4764705882352941,7128900,26010000,18881100
152000.0,3,1.0,1090,3264,1.0,0,0,3,6,1090,0,1969,0.0,98092,47.3155,-122.182,1090,3330,2174,0.6660539215686274,1188100,10653696,9465596
402000.0,3,2.5,1970,12205,2.0,0,0,3,8,1970,0,1990,0.0,98011,47.7397,-122.209,2640,9636,10235,0.8385907414993855,3880900,148962025,145081125
340000.0,2,2.0,1250,1178,2.0,0,0,2,7,980,270,1996,0.0,98136,47.5426,-122.387,1270,1242,-72,-0.06112054329371817,1562500,1387684,-174816
1250000.0,4,2.5,4040,11350,2.0,0,2,3,10,3690,350,1984,0.0,98006,47.559,-122.162,3770,12382,7310,0.6440528634361233,16321600,128822500,112500900
775000.0,4,2.5,3220,38448,2.0,0,0,2,10,3220,0,1993,0.0,98053,47.6854,-122.053,3090,38448,35228,0.9162505201831045,10368400,1478248704,1467880304
299800.0,2,1.0,1310,2814,1.0,0,0,2,6,810,500,1944,0.0,98126,47.5185,-122.376,1300,1344,1504,0.5344705046197583,1716100,7918596,6202496
340000.0,4,2.25,2060,8400,1.0,0,0,2,7,1300,760,1960,0.0,98178,47.4984,-122.23,1990,7383,6340,0.7547619047619047,4243600,70560000,66316400
626000.0,3,2.25,1750,1572,2.5,0,0,2,9,1470,280,2005,0.0,98102,47.6498,-122.321,2410,3050,-178,-0.11323155216284987,3062500,2471184,-591316
324950.0,2,1.0,1150,9186,1.0,0,0,2,7,1150,0,1946,0.0,98168,47.5081,-122.33,1390,10690,8036,0.8748094927062922,1322500,84382596,83060096
535500.0,3,2.5,2050,4976,2.0,0,0,2,8,2050,0,1994,0.0,98029,47.5689,-121.995,2050,5153,2926,0.5880225080385852,4202500,24760576,20558076
817500.0,3,3.25,3230,7639,2.0,0,0,2,10,3230,0,1999,0.0,98074,47.6338,-122.06299999999999,3230,7772,4409,0.5771697866212855,10432900,58354321,47921421
810000.0,4,3.5,4170,4322,2.0,0,0,2,9,2940,1230,2005,0.0,98074,47.6136,-122.041,2970,4922,152,0.035168903285515966,17388900,18679684,1290784
565000.0,5,1.5,1940,3430,1.5,0,0,3,6,1220,720,1926,0.0,98117,47.6853,-122.36200000000001,1830,4120,1490,0.43440233236151604,3763600,11764900,8001300
978000.0,3,1.5,2390,4000,1.5,0,0,2,9,1690,700,1936,0.0,98105,47.6604,-122.28,2350,4000,1610,0.4025,5712100,16000000,10287900
530000.0,3,1.0,1440,27505,1.0,0,0,2,8,1440,0,1951,0.0,98177,47.7553,-122.37,2430,16400,26065,0.947645882566806,2073600,756525025,754451425
305000.0,4,2.5,2230,6487,2.0,0,0,2,7,2230,0,2003,0.0,98092,47.3287,-122.169,2230,6882,4257,0.6562355480191151,4972900,42081169,37108269
345000.0,3,2.5,1210,1420,3.0,0,0,2,8,1210,0,2008,0.0,98103,47.6977,-122.34899999999999,1190,1407,210,0.14788732394366197,1464100,2016400,552300
258000.0,2,2.0,750,6553,1.5,0,2,2,7,750,0,1945,0.0,98178,47.4982,-122.221,1140,7500,5803,0.8855486036929651,562500,42941809,42379309
275000.0,4,1.0,1770,7345,1.5,0,0,2,7,1770,0,1966,0.0,98106,47.5393,-122.351,1580,7345,5575,0.7590197413206263,3132900,53949025,50816125
310000.0,3,1.0,1020,55756,1.0,0,0,2,7,1020,0,1961,0.0,98042,47.3836,-122.08200000000001,1490,12745,54736,0.9817060047349164,1040400,3108731536,3107691136
713250.0,3,2.0,2050,9000,1.0,0,0,3,7,2050,0,1951,0.0,98040,47.5885,-122.245,2910,8856,6950,0.7722222222222223,4202500,81000000,76797500
500000.0,3,1.0,2000,21780,1.0,0,0,2,8,1480,520,1978,0.0,98074,47.6064,-122.039,2000,45738,19780,0.9081726354453628,4000000,474368400,470368400
472000.0,3,1.75,2180,7200,1.0,0,3,3,8,1090,1090,1954,0.0,98178,47.5044,-122.235,2180,7140,5020,0.6972222222222222,4752400,51840000,47087600
250000.0,3,1.0,920,4429,1.0,0,0,2,7,920,0,1952,0.0,98118,47.5369,-122.291,1320,7860,3509,0.7922781666290359,846400,19616041,18769641
725000.0,4,2.25,3440,14237,2.0,0,0,2,9,3440,0,1982,0.0,98077,47.7241,-122.065,3250,18365,10797,0.7583760623726908,11833600,202692169,190858569
345000.0,3,2.0,1610,15005,1.0,0,0,3,7,1610,0,1986,0.0,98014,47.6886,-121.911,1610,15479,13395,0.8927024325224925,2592100,225150025,222557925
460000.0,3,1.5,1870,15685,1.0,0,0,2,7,1470,400,1936,0.0,98133,47.723,-122.353,1340,7620,13815,0.8807778131973223,3496900,246019225,242522325
440150.0,2,1.0,1110,6800,1.0,0,0,4,7,1000,110,1947,0.0,98133,47.7184,-122.355,1410,6963,5690,0.836764705882353,1232100,46240000,45007900
390000.0,3,1.75,2200,8036,1.0,0,0,2,7,1270,930,1978,0.0,98011,47.7763,-122.209,1850,7563,5836,0.726231956197113,4840000,64577296,59737296
375000.0,2,1.0,790,5120,1.0,0,0,2,6,790,0,1950,0.0,98136,47.556999999999995,-122.395,1250,5120,4330,0.845703125,624100,26214400,25590300
224950.0,3,1.5,1630,9282,1.0,0,0,3,7,1630,0,1963,0.0,98022,47.2021,-122.00200000000001,1420,9282,7652,0.8243912949795302,2656900,86155524,83498624
480000.0,3,1.5,2100,67269,1.0,0,0,3,7,1220,880,1949,0.0,98028,47.7592,-122.23,1610,15999,65169,0.9687820541408375,4410000,4525118361,4520708361
721000.0,4,2.75,2690,5400,2.0,0,0,2,7,2210,480,1940,2009.0,98117,47.6963,-122.367,1620,5400,2710,0.5018518518518519,7236100,29160000,21923900
174000.0,2,1.0,600,4854,1.0,0,0,4,6,600,0,1922,0.0,98168,47.4927,-122.28,1470,5000,4254,0.8763906056860321,360000,23561316,23201316
170000.0,2,1.0,810,9882,1.0,0,0,2,6,810,0,1944,0.0,98178,47.4925,-122.23899999999999,950,7200,9072,0.9180327868852459,656100,97653924,96997824
658000.0,3,1.5,1660,3190,1.5,0,0,2,7,1660,0,1919,0.0,98109,47.6368,-122.351,2200,3240,1530,0.47962382445141066,2755600,10176100,7420500
860000.0,3,2.0,1880,8494,1.0,0,0,3,7,1200,680,1968,0.0,98004,47.6217,-122.19200000000001,1290,9128,6614,0.7786672945608665,3534400,72148036,68613636
407450.0,4,1.5,2310,68824,2.0,0,0,3,7,2310,0,1968,0.0,98010,47.3354,-122.031,2020,39900,66514,0.9664361269324654,5336100,4736742976,4731406876
615000.0,4,1.5,2650,34000,2.0,0,0,3,7,2650,0,1930,0.0,98028,47.7516,-122.23700000000001,1960,34000,31350,0.9220588235294118,7022500,1156000000,1148977500
920000.0,4,3.0,3130,12381,2.0,0,0,2,9,3130,0,1995,0.0,98006,47.5599,-122.118,3250,10049,9251,0.7471932800258461,9796900,153289161,143492261
195000.0,2,1.0,860,10400,1.0,0,0,3,6,860,0,1983,0.0,98042,47.3682,-122.096,1390,9086,9540,0.9173076923076923,739600,108160000,107420400
269950.0,3,1.0,990,9950,1.0,0,0,4,7,990,0,1961,0.0,98056,47.5104,-122.171,1370,9260,8960,0.9005025125628141,980100,99002500,98022400
855000.0,4,3.5,4030,1024068,2.0,0,0,2,10,4030,0,2006,0.0,98045,47.4619,-121.744,1830,11700,1020038,0.9960647144525558,16240900,1048715268624,1048699027724
620000.0,3,2.25,1780,1429,3.0,0,0,2,8,1570,210,2007,0.0,98109,47.6413,-122.346,1470,1799,-351,-0.2456263121063681,3168400,2042041,-1126359
276000.0,2,2.0,1480,6075,1.0,0,0,4,7,740,740,1919,0.0,98118,47.5317,-122.27600000000001,1230,6053,4595,0.7563786008230453,2190400,36905625,34715225
329000.0,3,1.0,1140,5258,1.5,0,0,2,6,1140,0,1911,0.0,98146,47.5122,-122.383,1140,5280,4118,0.7831875237732978,1299600,27646564,26346964
270000.0,3,1.5,1230,7500,1.0,0,0,2,7,1230,0,1962,0.0,98198,47.4202,-122.331,1260,7800,6270,0.836,1512900,56250000,54737100
440000.0,4,2.5,3080,10646,2.0,0,0,2,9,3080,0,1993,0.0,98042,47.3828,-122.148,2740,9994,7566,0.7106894608303588,9486400,113337316,103850916
639000.0,4,2.5,1990,8034,2.0,0,0,3,10,1990,0,1989,0.0,98029,47.56100000000001,-122.01799999999999,2580,8034,6044,0.752302713467762,3960100,64545156,60585056
403500.0,1,1.0,700,5621,1.0,0,0,3,6,700,0,1945,0.0,98133,47.733999999999995,-122.353,1020,5621,4921,0.8754669987546699,490000,31595641,31105641
585000.0,3,2.5,1700,1156,2.0,0,2,2,9,1320,380,2002,0.0,98119,47.6373,-122.369,1710,1686,-544,-0.47058823529411764,2890000,1336336,-1553664
216000.0,2,1.0,860,9000,1.0,0,0,3,6,860,0,1942,0.0,98168,47.4801,-122.315,990,9975,8140,0.9044444444444445,739600,81000000,80260400
1150000.0,3,2.5,3160,24437,1.0,0,3,2,11,2160,1000,1991,0.0,98006,47.5531,-122.131,3990,11977,21277,0.8706878913123542,9985600,597166969,587181369
575000.0,3,2.0,2500,30056,1.0,0,0,4,8,1840,660,1954,0.0,98166,47.4468,-122.337,2500,30000,27556,0.9168219323928667,6250000,903363136,897113136
430000.0,4,2.5,3000,9460,2.0,0,0,2,9,3000,0,2001,0.0,98031,47.3959,-122.211,3000,8450,6460,0.6828752642706131,9000000,89491600,80491600
660000.0,2,1.0,1670,8195,1.0,0,0,2,7,1670,0,1954,1975.0,98033,47.6627,-122.19200000000001,1980,7500,6525,0.7962172056131788,2788900,67158025,64369125
338000.0,2,1.0,690,6400,1.0,0,0,2,6,690,0,1943,0.0,98126,47.5287,-122.367,1000,6400,5710,0.8921875,476100,40960000,40483900
400000.0,4,2.75,1240,3867,1.0,0,0,2,7,800,440,1987,0.0,98125,47.7157,-122.28399999999999,1150,7733,2627,0.6793379881044738,1537600,14953689,13416089
210000.0,2,1.0,900,5000,1.0,0,0,4,6,900,0,1930,1990.0,98022,47.2008,-121.995,1150,5000,4100,0.82,810000,25000000,24190000
305000.0,4,1.75,2200,8100,1.5,0,0,4,6,1400,800,1942,0.0,98168,47.4945,-122.303,1520,8100,5900,0.7283950617283951,4840000,65610000,60770000
365000.0,2,1.0,960,223898,1.0,0,0,2,6,960,0,1985,0.0,98014,47.6668,-121.89200000000001,1830,230868,222938,0.9957123332946253,921600,50130314404,50129392804
325000.0,5,2.75,2130,6222,1.0,0,0,2,7,1300,830,1991,0.0,98118,47.5272,-122.27600000000001,2130,6222,4092,0.6576663452266153,4536900,38713284,34176384
245000.0,4,1.75,2020,8800,1.0,0,0,3,8,2020,0,1969,0.0,98023,47.3202,-122.384,2320,8000,6780,0.7704545454545455,4080400,77440000,73359600
182000.0,3,1.0,1060,7350,1.0,0,0,3,7,1060,0,1959,0.0,98032,47.3809,-122.287,1060,7350,6290,0.85578231292517,1123600,54022500,52898900
440000.0,2,1.0,1230,6600,1.0,0,0,2,7,1130,100,1906,0.0,98118,47.5573,-122.28200000000001,1260,5060,5370,0.8136363636363636,1512900,43560000,42047100
225000.0,3,2.25,2510,12013,2.0,0,0,2,8,2510,0,1988,0.0,98003,47.3473,-122.314,1870,8017,9503,0.7910596853408807,6300100,144312169,138012069
358000.0,3,2.25,2510,12013,2.0,0,0,2,8,2510,0,1988,0.0,98003,47.3473,-122.314,1870,8017,9503,0.7910596853408807,6300100,144312169,138012069
580000.0,5,2.5,2720,5000,1.5,0,0,3,7,1530,1190,1939,0.0,98117,47.6827,-122.376,1210,5000,2280,0.456,7398400,25000000,17601600
240000.0,3,1.5,1070,8886,1.0,0,0,3,7,1070,0,1984,0.0,98030,47.3516,-122.166,1730,9461,7816,0.879585865406257,1144900,78960996,77816096
700000.0,4,3.25,3580,43093,1.0,0,0,3,8,3580,0,1990,0.0,98024,47.5595,-121.90100000000001,2070,43093,39513,0.9169238623442323,12816400,1857006649,1844190249
325000.0,4,2.5,2230,8500,2.0,0,0,2,8,2230,0,1994,0.0,98022,47.2082,-122.009,2270,8770,6270,0.7376470588235294,4972900,72250000,67277100
488000.0,4,2.25,2500,10890,1.0,0,0,4,7,1800,700,1978,0.0,98034,47.7318,-122.23899999999999,2500,7467,8390,0.7704315886134068,6250000,118592100,112342100
875000.0,4,1.0,1670,4600,1.5,0,0,4,8,1670,0,1906,0.0,98103,47.6838,-122.33200000000001,1820,4600,2930,0.6369565217391304,2788900,21160000,18371100
615000.0,4,2.5,2150,9070,2.0,0,0,3,8,2150,0,1985,0.0,98052,47.7279,-122.10700000000001,2230,8995,6920,0.762954796030871,4622500,82264900,77642400
321000.0,3,2.5,2020,4183,2.0,0,0,2,7,2020,0,2012,0.0,98038,47.3658,-122.01700000000001,2030,4140,2163,0.5170929954578054,4080400,17497489,13417089
1040000.0,3,2.5,2230,5750,2.0,0,0,2,9,2230,0,2003,0.0,98033,47.6938,-122.213,1900,8238,3520,0.6121739130434782,4972900,33062500,28089600
299500.0,2,1.0,740,6300,1.0,0,0,2,6,740,0,1942,0.0,98126,47.5158,-122.376,740,6300,5560,0.8825396825396825,547600,39690000,39142400
459000.0,4,1.5,2020,9583,2.0,0,0,3,7,2020,0,1963,0.0,98034,47.7283,-122.238,1770,8625,7563,0.7892100594803297,4080400,91833889,87753489
435000.0,3,2.5,1730,4065,2.0,0,0,2,8,1730,0,1996,0.0,98029,47.5668,-122.005,1730,4094,2335,0.5744157441574416,2992900,16524225,13531325
222000.0,3,1.75,1370,8280,1.0,0,0,3,7,1370,0,1980,0.0,98031,47.4096,-122.17200000000001,1850,7820,6910,0.8345410628019324,1876900,68558400,66681500
485000.0,4,1.0,1210,6380,1.5,0,0,2,7,1210,0,1936,0.0,98115,47.6924,-122.321,1340,6380,5170,0.8103448275862069,1464100,40704400,39240300
750000.0,5,3.5,2160,2323,3.0,0,0,2,9,2160,0,2007,0.0,98107,47.6726,-122.39,1750,4650,163,0.07016788635385278,4665600,5396329,730729
266000.0,3,2.25,1550,6022,2.0,0,0,2,8,1550,0,1989,0.0,98003,47.3525,-122.304,1650,5627,4472,0.7426104284290933,2402500,36264484,33861984
455000.0,2,1.0,1170,6000,1.0,0,0,3,7,970,200,1941,0.0,98103,47.6994,-122.354,2130,6002,4830,0.805,1368900,36000000,34631100
490000.0,3,1.75,2020,215622,2.0,0,0,3,7,2020,0,1975,0.0,98070,47.4189,-122.499,1810,215622,213602,0.9906317537171532,4080400,46492846884,46488766484
280000.0,3,1.75,1740,8625,1.0,0,0,3,7,1240,500,1978,0.0,98023,47.3054,-122.38,1980,8625,6885,0.7982608695652174,3027600,74390625,71363025
1450000.0,4,3.25,3100,3900,2.0,0,2,4,9,2090,0,1923,0.0,98109,47.6385,-122.348,2110,3900,800,0.20512820512820512,9610000,15210000,5600000
291000.0,4,1.0,1590,24330,1.5,0,0,2,6,1140,450,1942,0.0,98168,47.4906,-122.309,1000,16228,22740,0.9346485819975339,2528100,591948900,589420800
745000.0,5,3.0,2400,10126,2.0,0,3,2,8,2400,0,1981,0.0,98126,47.5726,-122.37299999999999,2250,3946,7726,0.7629863717163737,5760000,102535876,96775876
685900.0,3,2.5,2290,9142,1.0,0,0,2,8,2290,0,1972,0.0,98117,47.691,-122.387,1770,8035,6852,0.7495077663530956,5244100,83576164,78332064
160000.0,3,1.75,1610,7392,1.0,0,0,3,7,1610,0,1964,0.0,98001,47.3413,-122.28,1450,7392,5782,0.7821969696969697,2592100,54641664,52049564
650000.0,4,2.5,2240,9934,1.0,0,0,3,8,1490,750,1968,0.0,98005,47.6147,-122.166,2640,11622,7694,0.774511777733038,5017600,98684356,93666756
250000.0,2,1.0,850,6370,1.0,0,0,2,6,850,0,1951,0.0,98126,47.5198,-122.37299999999999,850,5170,5520,0.8665620094191523,722500,40576900,39854400
265000.0,2,1.5,920,1458,2.0,0,0,2,7,920,0,1995,0.0,98133,47.7081,-122.34200000000001,1110,1598,538,0.36899862825788754,846400,2125764,1279364
599000.0,5,3.25,2590,6180,1.0,0,0,2,7,1330,1260,1960,0.0,98118,47.551,-122.272,1560,6180,3590,0.580906148867314,6708100,38192400,31484300
199950.0,3,1.0,1340,7260,1.5,0,0,2,6,1340,0,1944,0.0,98178,47.4934,-122.23700000000001,1210,7260,5920,0.8154269972451791,1795600,52707600,50912000
712500.0,4,2.75,2420,11201,1.0,0,1,2,8,1420,1000,1948,1999.0,98118,47.5459,-122.265,3170,9385,8781,0.7839478617980538,5856400,125462401,119606001
490000.0,2,1.0,1420,4305,1.0,0,0,3,7,920,500,1941,0.0,98115,47.6864,-122.311,1420,4305,2885,0.670150987224158,2016400,18533025,16516625
511500.0,4,1.0,1360,6000,1.5,0,0,2,7,1360,0,1917,0.0,98115,47.6854,-122.288,1710,6000,4640,0.7733333333333333,1849600,36000000,34150400
299000.0,3,1.0,1510,6200,1.0,0,0,2,6,1010,500,1955,0.0,98118,47.5293,-122.274,1710,8623,4690,0.7564516129032258,2280100,38440000,36159900
685000.0,4,2.5,2650,25248,1.0,0,2,2,9,2330,320,1954,0.0,98177,47.7537,-122.37299999999999,3020,23135,22598,0.8950411913814955,7022500,637461504,630439004
597000.0,4,2.0,2120,4000,1.5,0,0,3,7,1720,400,1927,0.0,98117,47.688,-122.383,1760,4000,1880,0.47,4494400,16000000,11505600
210000.0,3,1.0,1200,7200,1.0,0,0,2,6,1200,0,1977,0.0,98030,47.3746,-122.18299999999999,1200,7420,6000,0.8333333333333334,1440000,51840000,50400000
659000.0,4,2.5,3190,11375,1.0,0,0,4,8,2210,980,1946,0.0,98125,47.70399999999999,-122.3,1100,8500,8185,0.7195604395604396,10176100,129390625,119214525
540000.0,3,1.0,1050,4160,1.0,0,0,3,7,1050,0,1925,0.0,98115,47.6756,-122.3,1580,3680,3110,0.7475961538461539,1102500,17305600,16203100
469000.0,3,2.0,1300,22605,1.0,0,0,2,7,1300,0,1998,0.0,98056,47.5337,-122.18700000000001,2250,10215,21305,0.942490599424906,1690000,510986025,509296025
1070000.0,3,2.5,3970,263538,1.5,0,0,2,9,3970,0,1991,0.0,98024,47.6067,-121.95200000000001,3970,194676,259568,0.9849357587900037,15760900,69452277444,69436516544
575000.0,5,2.5,2990,7500,1.0,0,2,2,9,1800,1190,1972,0.0,98177,47.7707,-122.369,2800,9860,4510,0.6013333333333334,8940100,56250000,47309900
725000.0,4,2.75,2440,7042,1.5,0,2,3,7,1640,0,1941,0.0,98116,47.5731,-122.40799999999999,2170,7900,4602,0.6535075262709458,5953600,49589764,43636164
299950.0,4,1.0,1170,5400,1.0,0,0,4,6,1170,0,1953,0.0,98056,47.492,-122.17200000000001,1100,5400,4230,0.7833333333333333,1368900,29160000,27791100
375000.0,4,2.0,2270,18450,1.0,0,0,2,7,2270,0,1961,0.0,98001,47.3264,-122.262,2150,18450,16180,0.8769647696476964,5152900,340402500,335249600
342450.0,3,1.5,1280,5525,1.0,0,0,2,7,1280,0,1962,0.0,98133,47.7339,-122.336,1330,5286,4245,0.7683257918552037,1638400,30525625,28887225
315000.0,4,2.5,1950,3225,2.0,0,0,2,7,1950,0,2002,0.0,98178,47.5014,-122.226,1980,3225,1275,0.3953488372093023,3802500,10400625,6598125
328000.0,4,2.75,1930,3840,1.0,0,0,2,7,1170,760,1997,0.0,98106,47.5303,-122.346,1610,3840,1910,0.4973958333333333,3724900,14745600,11020700
323000.0,4,2.75,1970,7213,1.0,0,0,2,8,1170,800,1977,0.0,98058,47.4424,-122.126,1980,7045,5243,0.7268820185775683,3880900,52027369,48146469
320000.0,4,3.0,1820,3120,1.0,0,0,2,7,1000,820,1997,0.0,98118,47.5468,-122.274,1600,5001,1300,0.4166666666666667,3312400,9734400,6422000
550000.0,2,1.0,950,4080,1.0,0,0,3,7,950,0,1924,0.0,98117,47.6765,-122.384,1120,4080,3130,0.7671568627450981,902500,16646400,15743900
1650000.0,6,3.5,4010,16200,1.0,0,0,2,8,2090,1920,1955,1990.0,98004,47.6322,-122.21600000000001,3560,16200,12190,0.7524691358024691,16080100,262440000,246359900
1210000.0,4,3.5,4560,16643,1.0,0,3,2,12,2230,2330,1995,0.0,98006,47.5521,-122.115,4060,15177,12083,0.7260109355284504,20793600,276989449,256195849
1200000.0,4,3.5,4560,16643,1.0,0,3,2,12,2230,2330,1995,0.0,98006,47.5521,-122.115,4060,15177,12083,0.7260109355284504,20793600,276989449,256195849
120000.0,3,1.0,1150,8924,1.0,0,0,2,6,1150,0,1943,0.0,98030,47.3865,-122.21700000000001,1492,8924,7774,0.8711340206185567,1322500,79637776,78315276
175000.0,3,1.0,1150,8924,1.0,0,0,2,6,1150,0,1943,0.0,98030,47.3865,-122.21700000000001,1492,8924,7774,0.8711340206185567,1322500,79637776,78315276
169900.0,3,1.0,910,5800,1.5,0,0,3,5,910,0,1900,0.0,98022,47.2068,-121.992,1400,6766,4890,0.843103448275862,828100,33640000,32811900
508000.0,6,2.75,2890,7500,1.0,0,0,3,8,1830,1060,1976,0.0,98034,47.7099,-122.23,1880,7500,4610,0.6146666666666667,8352100,56250000,47897900
335000.0,2,1.0,1070,6678,1.0,0,0,3,7,1070,0,1951,0.0,98133,47.7315,-122.35700000000001,1680,7788,5608,0.8397723869421982,1144900,44595684,43450784
613200.0,3,2.75,2050,3320,1.5,0,0,3,7,1580,470,1927,0.0,98105,47.6719,-122.301,1760,4150,1270,0.3825301204819277,4202500,11022400,6819900
420000.0,2,1.5,1040,3500,1.5,0,0,3,6,1040,0,1904,0.0,98144,47.588,-122.304,1340,1213,2460,0.7028571428571428,1081600,12250000,11168400
1000000.0,4,3.25,3320,8587,3.0,0,0,2,11,2950,370,2008,0.0,98103,47.691,-122.337,1860,5668,5267,0.6133690462326773,11022400,73736569,62714169
342000.0,2,1.0,740,6180,1.0,0,0,2,6,740,0,1948,0.0,98118,47.5517,-122.272,1330,4635,5440,0.8802588996763754,547600,38192400,37644800
850000.0,4,2.0,3380,90968,1.0,0,0,3,9,1690,1690,1979,0.0,98075,47.5936,-122.07700000000001,3380,42740,87588,0.9628440770380793,11424400,8275177024,8263752624
582000.0,2,1.75,1210,4141,1.0,0,0,3,7,910,300,1942,0.0,98117,47.68600000000001,-122.382,1310,4141,2931,0.7078000482975126,1464100,17147881,15683781
475000.0,3,2.5,2480,6031,2.0,0,0,2,8,2480,0,2001,0.0,98155,47.772,-122.29700000000001,1850,7704,3551,0.588791245232963,6150400,36372961,30222561
570000.0,3,2.25,2010,6000,1.0,0,0,2,8,1330,680,1975,0.0,98052,47.6912,-122.115,2080,8260,3990,0.665,4040100,36000000,31959900
826600.0,4,3.25,3230,5000,1.5,0,0,3,7,1750,1480,1916,0.0,98105,47.6702,-122.3,1730,4000,1770,0.354,10432900,25000000,14567100
387000.0,2,2.5,1170,1394,2.0,0,0,2,8,1170,0,2001,0.0,98122,47.6131,-122.29700000000001,1250,3136,224,0.1606886657101865,1368900,1943236,574336
330000.0,3,1.0,1250,9126,1.0,0,0,2,7,1250,0,1969,0.0,98077,47.7554,-122.07600000000001,1440,10620,7876,0.8630287091825554,1562500,83283876,81721376
653450.0,3,2.5,2070,49658,1.0,0,0,3,8,1540,530,1980,0.0,98075,47.5936,-122.01299999999999,2620,35160,47588,0.9583148737363567,4284900,2465916964,2461632064
285000.0,2,1.0,1050,3088,1.0,0,0,2,7,1050,0,2005,0.0,98029,47.5471,-121.99600000000001,1890,2772,2038,0.6599740932642487,1102500,9535744,8433244
217000.0,3,1.0,1400,7800,1.0,0,0,2,7,1400,0,1962,0.0,98059,47.4789,-122.15899999999999,1400,7800,6400,0.8205128205128205,1960000,60840000,58880000
615000.0,3,1.0,1120,12500,1.0,0,0,3,7,1120,0,1977,0.0,98033,47.6842,-122.2,2380,10000,11380,0.9104,1254400,156250000,154995600
580135.0,4,2.5,3150,5886,2.0,0,0,2,8,3150,0,2014,0.0,98059,47.4787,-122.12200000000001,2650,5886,2736,0.4648318042813456,9922500,34644996,24722496
1150000.0,4,3.5,4540,19767,2.0,0,0,2,11,4200,340,1998,0.0,98006,47.5445,-122.137,3990,12881,15227,0.7703242778367987,20611600,390734289,370122689
231200.0,3,2.0,1400,8821,1.0,0,0,2,7,1400,0,1991,0.0,98022,47.1949,-121.98899999999999,1450,8721,7421,0.841287835846276,1960000,77810041,75850041
680000.0,4,2.75,2500,4950,2.0,0,0,2,8,2500,0,2010,0.0,98053,47.6964,-122.01700000000001,2500,4950,2450,0.494949494949495,6250000,24502500,18252500
267500.0,3,1.5,1390,2153,2.0,0,0,2,7,1390,0,2001,0.0,98118,47.5506,-122.29,1100,2617,763,0.35438922433813286,1932100,4635409,2703309
942000.0,4,2.75,3160,37200,2.0,0,3,2,8,2310,850,1939,0.0,98125,47.7214,-122.285,3130,20000,34040,0.9150537634408602,9985600,1383840000,1373854400
435000.0,3,1.75,1310,8065,1.0,0,0,3,6,1310,0,1948,0.0,98117,47.701,-122.368,1420,8100,6755,0.8375697458152511,1716100,65044225,63328125
315000.0,2,1.0,1740,3622,1.0,0,0,3,7,950,790,1924,0.0,98118,47.5541,-122.29,1270,3800,1882,0.5196024295969078,3027600,13118884,10091284
354901.0,3,2.5,1490,1709,3.0,0,0,2,8,1490,0,2004,0.0,98125,47.7173,-122.29899999999999,1364,1709,219,0.12814511410181392,2220100,2920681,700581
439888.0,2,2.0,1300,6515,1.0,0,0,2,8,1300,0,2005,0.0,98053,47.7078,-122.01299999999999,1640,6009,5215,0.8004604758250192,1690000,42445225,40755225
360000.0,4,1.0,1460,3840,1.5,0,0,2,8,1340,120,1928,0.0,98106,47.533,-122.34700000000001,990,4200,2380,0.6197916666666666,2131600,14745600,12614000
205000.0,4,1.0,1030,6621,1.0,0,0,3,6,1030,0,1955,0.0,98055,47.4857,-122.221,1420,6631,5591,0.8444343754719831,1060900,43837641,42776741
299995.0,3,2.5,1970,7500,2.0,0,0,2,8,1970,0,1988,0.0,98092,47.2658,-122.21799999999999,1950,8220,5530,0.7373333333333333,3880900,56250000,52369100
150000.0,2,1.0,790,7275,1.0,0,0,3,6,790,0,1944,0.0,98058,47.4771,-122.17399999999999,850,7399,6485,0.8914089347079038,624100,52925625,52301525
575000.0,3,2.25,3800,33825,1.0,0,0,3,10,3330,470,1976,0.0,98042,47.3797,-122.152,3470,14484,30025,0.8876570583887657,14440000,1144130625,1129690625
625000.0,3,2.0,2168,12616,2.0,0,1,3,7,2168,0,1950,0.0,98146,47.4933,-122.367,2168,9750,10448,0.8281547241597971,4700224,159163456,154463232
950000.0,4,3.5,4140,13392,2.0,0,0,2,11,4140,0,2000,0.0,98059,47.5261,-122.14399999999999,4140,11529,9252,0.6908602150537635,17139600,179345664,162206064
278800.0,4,2.5,2440,7797,1.0,0,0,2,8,1560,880,1965,0.0,98031,47.3895,-122.22200000000001,2090,8100,5357,0.6870591253046043,5953600,60793209,54839609
713500.0,3,2.0,1720,4200,2.0,0,0,2,8,1720,0,1908,0.0,98112,47.6285,-122.301,1720,4200,2480,0.5904761904761905,2958400,17640000,14681600
1900000.0,4,2.25,3020,11489,1.5,1,3,4,10,2110,910,1916,0.0,98040,47.5395,-122.21,3890,11489,8469,0.7371398729219253,9120400,131997121,122876721
439000.0,5,2.0,2610,5009,1.0,0,0,2,7,1710,900,1988,0.0,98117,47.6969,-122.366,1600,5040,2399,0.4789379117588341,6812100,25090081,18277981
425000.0,3,2.0,1500,8086,1.0,0,0,2,7,1060,440,1981,0.0,98027,47.5584,-122.081,1550,8086,6586,0.8144941874845412,2250000,65383396,63133396
252500.0,4,2.5,2600,11280,1.5,0,0,2,7,1570,1030,1961,0.0,98003,47.33600000000001,-122.304,1660,11200,8680,0.7695035460992907,6760000,127238400,120478400
185000.0,3,1.5,1370,8470,1.0,0,0,3,7,1370,0,1961,0.0,98092,47.2874,-122.19200000000001,1710,8800,7100,0.8382526564344747,1876900,71740900,69864000
406550.0,5,2.75,2400,15781,1.0,0,0,3,7,1200,1200,1974,0.0,98074,47.622,-122.059,2390,7500,13381,0.8479183828654712,5760000,249039961,243279961
243000.0,2,1.5,1068,1758,2.0,0,0,2,7,1068,0,1990,0.0,98028,47.7527,-122.244,1078,1315,690,0.3924914675767918,1140624,3090564,1949940
500000.0,3,1.5,2220,8994,1.0,0,0,3,8,1110,1110,1962,0.0,98006,47.5473,-122.17200000000001,2220,8994,6774,0.7531687791861241,4928400,80892036,75963636
204750.0,2,1.0,880,7575,1.0,0,0,3,7,880,0,1942,0.0,98198,47.3757,-122.304,1800,7575,6695,0.8838283828382838,774400,57380625,56606225
222000.0,3,1.5,1310,9273,1.0,0,0,3,7,1310,0,1968,0.0,98042,47.3683,-122.147,1710,9600,7963,0.8587296452065135,1716100,85988529,84272429
200000.0,4,1.0,1350,11507,1.0,0,0,2,7,1350,0,1966,0.0,98055,47.4269,-122.197,1320,25675,10157,0.8826801077604937,1822500,132411049,130588549
367000.0,3,2.25,1400,1320,3.0,0,2,2,8,1400,0,2006,0.0,98133,47.7147,-122.35600000000001,1490,1449,-80,-0.06060606060606061,1960000,1742400,-217600
183000.0,3,1.0,1170,7320,1.0,0,0,2,7,1170,0,1962,0.0,98188,47.4685,-122.28200000000001,2040,7320,6150,0.8401639344262295,1368900,53582400,52213500
300000.0,3,2.5,1020,1570,2.0,0,0,2,7,720,300,2004,0.0,98144,47.5871,-122.31700000000001,1470,1249,550,0.3503184713375796,1040400,2464900,1424500
369000.0,3,1.75,1300,3844,1.0,0,0,2,7,1300,0,1985,0.0,98133,47.7024,-122.355,1290,3844,2544,0.6618106139438086,1690000,14776336,13086336
380000.0,3,2.0,2010,16736,2.0,0,0,3,6,2010,0,1929,0.0,98133,47.7643,-122.352,1890,11477,14726,0.8798996175908221,4040100,280093696,276053596
463000.0,3,2.0,1590,5009,2.0,0,0,3,6,1590,0,1985,0.0,98125,47.7012,-122.322,1730,6380,3419,0.6825713715312438,2528100,25090081,22561981
475000.0,3,1.0,1470,9750,1.0,0,0,2,7,1470,0,1963,0.0,98034,47.7155,-122.194,1300,9750,8280,0.8492307692307692,2160900,95062500,92901600
225000.0,3,1.75,1580,14400,1.0,0,0,3,7,1580,0,1981,0.0,98001,47.2598,-122.281,1480,9600,12820,0.8902777777777777,2496400,207360000,204863600
371000.0,3,1.75,1970,9512,1.0,0,0,2,8,1970,0,1968,0.0,98058,47.4545,-122.146,2250,10573,7542,0.7928931875525652,3880900,90478144,86597244
625000.0,3,2.5,2330,3141,2.0,0,0,2,8,2330,0,2003,0.0,98116,47.5622,-122.39200000000001,1980,5265,811,0.2581980261063356,5428900,9865881,4436981
3200000.0,6,5.0,7100,18200,2.5,0,0,2,13,5240,1860,1933,2002.0,98199,47.6427,-122.40799999999999,3130,6477,11100,0.6098901098901099,50410000,331240000,280830000
329000.0,3,1.75,1230,10725,1.0,0,0,2,7,1230,0,1980,0.0,98045,47.4431,-121.772,1250,10170,9495,0.8853146853146853,1512900,115025625,113512725
634000.0,3,1.75,2570,13000,2.0,0,0,3,7,2570,0,1962,0.0,98177,47.7705,-122.37100000000001,2570,8521,10430,0.8023076923076923,6604900,169000000,162395100
616000.0,4,2.5,3440,6915,2.0,0,0,2,10,3440,0,2006,0.0,98038,47.3538,-122.00399999999999,3200,6915,3475,0.502530730296457,11833600,47817225,35983625
1820000.0,3,2.25,3330,20053,2.0,0,0,2,9,3330,0,1968,0.0,98004,47.6395,-122.214,2870,20053,16723,0.8339400588440632,11088900,402122809,391033909
435000.0,4,2.25,1780,2684,2.0,0,0,2,7,1780,0,2002,0.0,98072,47.7642,-122.149,1670,2426,904,0.33681073025335323,3168400,7203856,4035456
320000.0,4,2.5,2110,6295,2.0,0,0,2,8,2110,0,2000,0.0,98030,47.3641,-122.193,2720,6311,4185,0.664813343923749,4452100,39627025,35174925
820000.0,4,3.5,2770,8049,2.0,0,0,2,9,2770,0,2002,0.0,98074,47.6469,-122.081,3410,7447,5279,0.6558578705429245,7672900,64786401,57113501
310000.0,3,2.5,1590,3359,2.0,0,0,2,7,1590,0,2000,0.0,98019,47.7349,-121.986,1820,3383,1769,0.5266448347722537,2528100,11282881,8754781
443750.0,3,2.25,1460,968,2.0,0,0,2,7,1140,320,2003,0.0,98199,47.6601,-122.4,1460,1531,-492,-0.5082644628099173,2131600,937024,-1194576
795000.0,4,2.25,2070,13084,1.0,0,0,3,8,1700,370,1967,0.0,98040,47.5606,-122.22200000000001,2520,10180,11014,0.8417915010700092,4284900,171191056,166906156
475000.0,3,2.5,2420,36862,1.0,0,0,3,8,1530,890,1957,0.0,98003,47.3264,-122.30799999999999,1670,9046,34442,0.9343497368563832,5856400,1358807044,1352950644
585000.0,5,1.75,2000,3750,2.0,0,0,3,7,2000,0,1921,0.0,98103,47.6618,-122.355,1520,3750,1750,0.4666666666666667,4000000,14062500,10062500
315000.0,2,1.0,1010,7338,2.0,0,0,3,7,1010,0,1981,0.0,98056,47.5123,-122.19,1220,7719,6328,0.8623603161624421,1020100,53846244,52826144
635000.0,4,2.5,3050,7238,2.0,0,0,2,8,3050,0,1989,0.0,98029,47.5772,-122.01299999999999,2580,7228,4188,0.5786128764852169,9302500,52388644,43086144
305000.0,3,1.0,1160,11776,1.0,0,0,2,7,1160,0,1968,0.0,98077,47.7427,-122.074,1160,10050,10616,0.9014945652173914,1345600,138674176,137328576
785000.0,3,2.0,2180,5440,1.0,0,0,4,7,1100,1080,1904,0.0,98103,47.657,-122.345,1470,4109,3260,0.5992647058823529,4752400,29593600,24841200
525000.0,3,1.75,1560,6000,1.0,0,0,2,6,780,780,1944,0.0,98199,47.6501,-122.384,1560,1734,4440,0.74,2433600,36000000,33566400
537000.0,4,1.75,1580,3635,1.0,0,0,3,7,790,790,1910,0.0,98117,47.6795,-122.37100000000001,1190,3638,2055,0.5653370013755158,2496400,13213225,10716825
279950.0,3,1.75,1660,8303,1.0,0,0,2,7,1380,280,1974,0.0,98058,47.4366,-122.171,1740,8320,6643,0.8000722630374564,2755600,68939809,66184209
659000.0,4,2.0,2350,9329,2.0,0,0,2,8,2350,0,1977,0.0,98005,47.583,-122.17,1640,9403,6979,0.7480973309036338,5522500,87030241,81507741
203000.0,2,1.0,1440,6650,1.0,0,0,2,7,970,0,1980,0.0,98023,47.2896,-122.369,1600,6847,5210,0.7834586466165413,2073600,44222500,42148900
782500.0,4,2.5,2930,7806,2.0,0,0,2,9,2930,0,2005,0.0,98074,47.6219,-122.024,2600,6051,4876,0.6246477068921342,8584900,60933636,52348736
250000.0,3,1.75,1590,7560,1.0,0,0,2,7,1130,460,1984,0.0,98031,47.4016,-122.18,1500,7560,5970,0.7896825396825397,2528100,57153600,54625500
279000.0,3,1.0,1400,9450,1.0,0,0,3,7,1060,340,1955,0.0,98056,47.5051,-122.194,1400,8108,8050,0.8518518518518519,1960000,89302500,87342500
664000.0,6,2.5,3190,12196,2.0,0,0,3,8,3190,0,1979,0.0,98052,47.6309,-122.103,2790,13068,9006,0.7384388324040669,10176100,148742416,138566316
2900000.0,4,3.25,4580,4838,2.0,0,3,3,11,3080,1500,1991,0.0,98109,47.6305,-122.354,3540,6483,258,0.05332782141380736,20976400,23406244,2429844
378500.0,4,2.0,1830,6000,1.0,0,0,4,7,1070,760,1953,0.0,98118,47.5453,-122.279,1830,5500,4170,0.695,3348900,36000000,32651100
535000.0,3,1.75,2720,149410,1.5,0,0,2,9,2720,0,1988,0.0,98014,47.7092,-121.89200000000001,2560,149410,146690,0.9817950605715815,7398400,22323348100,22315949700
520000.0,2,1.0,1360,22508,1.0,0,0,2,7,1360,0,1932,0.0,98034,47.7101,-122.226,2830,12600,21148,0.9395770392749244,1849600,506610064,504760464
369950.0,3,2.0,1520,4000,1.0,0,0,4,6,800,720,1943,0.0,98106,47.53100000000001,-122.351,1430,4000,2480,0.62,2310400,16000000,13689600
545000.0,3,2.25,2290,14585,2.0,0,0,2,8,2290,0,1981,0.0,98075,47.5874,-122.074,1660,36961,12295,0.8429893726431265,5244100,212722225,207478125
360000.0,3,2.5,2150,14092,2.0,0,0,2,8,2150,0,1991,0.0,98058,47.4621,-122.12899999999999,2400,10699,11942,0.8474311666193585,4622500,198584464,193961964
760000.0,3,1.5,1170,7645,1.0,0,0,3,7,1170,0,1955,0.0,98004,47.6077,-122.194,1870,7678,6475,0.8469587965990844,1368900,58446025,57077125
450000.0,3,1.75,1830,5488,1.0,0,2,3,7,1010,820,1939,0.0,98115,47.6914,-122.309,1200,5488,3658,0.6665451895043731,3348900,30118144,26769244
612500.0,4,2.5,2730,12261,2.0,0,0,2,9,2730,0,1991,0.0,98011,47.7419,-122.205,2730,10872,9531,0.7773427942255934,7452900,150332121,142879221
280000.0,3,1.0,1090,10710,1.0,0,0,3,7,1090,0,1962,0.0,98056,47.5,-122.169,1090,10440,9620,0.8982259570494865,1188100,114704100,113516000
750000.0,3,2.5,2560,9182,2.0,0,0,2,9,2560,0,1993,0.0,98027,47.5361,-122.051,2800,8784,6622,0.7211936397299064,6553600,84309124,77755524
237000.0,3,1.0,1160,6132,1.0,0,0,3,7,1160,0,1958,0.0,98056,47.5015,-122.17299999999999,1280,6132,4972,0.8108284409654273,1345600,37601424,36255824
441500.0,2,1.75,1010,4000,1.5,0,0,4,7,1010,0,1919,0.0,98105,47.6665,-122.287,1470,4000,2990,0.7475,1020100,16000000,14979900
251000.0,3,2.0,1650,7930,1.0,0,0,3,7,1650,0,1989,0.0,98038,47.3617,-122.05,1510,7930,6280,0.7919293820933165,2722500,62884900,60162400
200000.0,3,1.0,2120,31564,1.0,0,0,2,7,1220,900,1942,0.0,98168,47.4938,-122.29799999999999,1790,11571,29444,0.9328348751742491,4494400,996286096,991791696
332000.0,1,1.0,960,2640,1.0,0,0,2,7,760,200,1908,0.0,98112,47.6223,-122.294,1620,3759,1680,0.6363636363636364,921600,6969600,6048000
401500.0,3,2.5,1509,1114,3.0,0,0,2,8,1509,0,2014,0.0,98133,47.7048,-122.34,1509,2431,-395,-0.35457809694793535,2277081,1240996,-1036085
585000.0,4,1.75,2270,27122,1.0,0,0,4,8,1300,970,1957,0.0,98155,47.7637,-122.281,2380,11822,24852,0.9163041073667134,5152900,735602884,730449984
340000.0,4,2.5,1954,4805,2.0,0,0,2,8,1954,0,2005,0.0,98055,47.4297,-122.19,1714,3259,2851,0.5933402705515088,3818116,23088025,19269909
920000.0,3,3.5,2800,7694,1.0,0,0,2,9,2800,0,2005,0.0,98053,47.7095,-122.022,2420,7694,4894,0.636080062386275,7840000,59197636,51357636
153000.0,3,1.0,1270,6405,1.5,0,0,2,6,1270,0,1944,0.0,98178,47.4959,-122.241,1110,6405,5135,0.8017174082747853,1612900,41024025,39411125
299950.0,4,2.25,1810,7601,1.0,0,0,2,7,1080,730,1986,0.0,98023,47.2857,-122.35799999999999,1570,7601,5791,0.761873437705565,3276100,57775201,54499101
440000.0,4,2.5,2410,7517,2.0,0,0,2,8,2410,0,1983,0.0,98058,47.4388,-122.14200000000001,2420,8095,5107,0.679393375016629,5808100,56505289,50697189
293000.0,3,2.5,1690,17383,2.0,0,0,2,7,1690,0,2003,0.0,98038,47.3691,-122.031,2610,7999,15693,0.9027785767704078,2856100,302168689,299312589
203000.0,3,1.75,1190,6000,1.0,0,0,2,7,1190,0,1952,0.0,98178,47.5026,-122.236,1200,6000,4810,0.8016666666666666,1416100,36000000,34583900
193000.0,2,1.75,1280,6774,1.0,0,0,2,7,1280,0,1991,0.0,98002,47.2925,-122.219,1450,7810,5494,0.811042220253912,1638400,45887076,44248676
305000.0,3,1.75,1460,7862,1.0,0,0,2,7,1460,0,1965,0.0,98155,47.7755,-122.29899999999999,2200,9293,6402,0.814296616636988,2131600,61811044,59679444
495000.0,4,1.75,1600,6380,1.0,0,0,2,8,1130,470,1959,0.0,98125,47.701,-122.306,1090,6380,4780,0.7492163009404389,2560000,40704400,38144400
420000.0,3,1.75,1770,6000,1.0,0,0,2,7,1130,640,1952,0.0,98125,47.7135,-122.315,1900,7200,4230,0.705,3132900,36000000,32867100
569500.0,4,2.5,2800,8190,1.0,0,0,2,8,1700,1100,1971,0.0,98177,47.7695,-122.368,2460,8165,5390,0.6581196581196581,7840000,67076100,59236100
620000.0,4,2.5,2680,9185,2.0,0,0,2,9,2680,0,1989,0.0,98029,47.5738,-121.992,2810,8505,6505,0.7082199237887861,7182400,84364225,77181825
466000.0,3,1.75,1680,9460,1.0,0,0,3,7,1680,0,1959,0.0,98006,47.5525,-122.182,1690,9448,7780,0.8224101479915433,2822400,89491600,86669200
355500.0,3,1.0,1120,10032,1.0,0,0,2,7,1120,0,1962,0.0,98034,47.7182,-122.194,1210,9918,8912,0.8883572567783095,1254400,100641024,99386624
687500.0,2,1.0,1040,7200,1.0,0,0,3,6,1040,0,1955,0.0,98033,47.6823,-122.20299999999999,1640,7200,6160,0.8555555555555555,1081600,51840000,50758400
432100.0,3,2.25,1790,2240,2.0,0,0,3,8,1790,0,1975,0.0,98052,47.6343,-122.10600000000001,1780,2560,450,0.20089285714285715,3204100,5017600,1813500
500000.0,3,2.5,2410,34848,1.5,0,0,2,8,2410,0,1976,0.0,98006,47.5694,-122.12,2420,16424,32438,0.9308425160697889,5808100,1214383104,1208575004
690000.0,5,3.25,3370,7313,2.0,0,0,3,8,2140,1230,1988,0.0,98029,47.5632,-122.015,2990,7806,3943,0.5391768084233557,11356900,53479969,42123069
350000.0,2,1.0,800,5150,1.0,0,0,3,6,800,0,1949,0.0,98118,47.5525,-122.274,1280,5150,4350,0.8446601941747572,640000,26522500,25882500
268000.0,2,1.0,1380,5000,1.0,0,0,2,7,870,510,1943,0.0,98108,47.5339,-122.29299999999999,1450,5000,3620,0.724,1904400,25000000,23095600
120000.0,2,1.0,990,39964,1.0,0,0,1,4,990,0,1945,0.0,98042,47.3577,-122.085,1560,8990,38974,0.975227704934441,980100,1597121296,1596141196
285000.0,4,2.5,1800,9229,2.0,0,0,2,7,1800,0,1994,0.0,98022,47.1927,-122.015,1970,9231,7429,0.804962617835085,3240000,85174441,81934441
365000.0,4,1.5,1820,12327,1.0,0,0,3,7,1380,440,1955,0.0,98006,47.5767,-122.14399999999999,1450,9256,10507,0.8523566155593413,3312400,151954929,148642529
635000.0,3,2.5,2620,6842,2.0,0,0,2,7,2620,0,2002,0.0,98053,47.6846,-122.037,2280,4800,4222,0.6170710318620286,6864400,46812964,39948564
630000.0,2,2.5,2290,3507,2.0,0,0,2,9,2290,0,2005,0.0,98029,47.5545,-122.00200000000001,2290,3640,1217,0.34702024522383806,5244100,12299049,7054949
450000.0,4,3.0,2200,4466,2.0,0,0,2,7,2200,0,1968,0.0,98103,47.7005,-122.339,1780,2250,2266,0.5073891625615764,4840000,19945156,15105156
590000.0,4,2.5,2940,12600,1.0,0,0,3,8,1850,1090,1974,0.0,98074,47.6294,-122.06200000000001,2030,11770,9660,0.7666666666666667,8643600,158760000,150116400
895000.0,2,1.75,1700,3618,1.0,0,1,2,8,1260,440,1950,0.0,98199,47.6336,-122.397,2200,5000,1918,0.5301271420674406,2890000,13089924,10199924
160000.0,3,1.0,860,11900,1.0,0,0,3,6,860,0,1963,0.0,98030,47.3574,-122.186,1660,10248,11040,0.9277310924369748,739600,141610000,140870400
520000.0,2,1.0,910,5000,1.0,0,0,2,7,910,0,1924,0.0,98107,47.6733,-122.37,1050,5000,4090,0.818,828100,25000000,24171900
432000.0,4,3.25,2820,13059,2.0,0,0,3,8,2820,0,1976,0.0,98058,47.4508,-122.132,2360,8600,10239,0.7840569722030784,7952400,170537481,162585081
141800.0,2,1.0,930,4743,1.0,0,0,3,5,930,0,1942,0.0,98056,47.4966,-122.18700000000001,930,4779,3813,0.803921568627451,864900,22496049,21631149
980000.0,4,2.0,2190,4560,2.5,0,0,4,8,2190,0,1910,0.0,98103,47.662,-122.329,2190,4560,2370,0.5197368421052632,4796100,20793600,15997500
1290000.0,4,2.5,3430,7200,2.0,0,0,2,9,3430,0,2014,0.0,98033,47.6842,-122.196,1530,7800,3770,0.5236111111111111,11764900,51840000,40075100
740000.0,4,2.75,2560,6900,1.0,0,0,2,8,1480,1080,1959,0.0,98115,47.68600000000001,-122.29700000000001,2600,7200,4340,0.6289855072463768,6553600,47610000,41056400
230000.0,2,1.0,770,6450,1.0,0,0,3,6,770,0,1948,0.0,98106,47.53100000000001,-122.35799999999999,780,6063,5680,0.8806201550387597,592900,41602500,41009600
3400000.0,3,4.5,5230,17826,2.0,1,4,2,10,3740,1490,2005,0.0,98040,47.5348,-122.243,3670,17826,12596,0.7066083249186581,27352900,317766276,290413376
954500.0,3,2.25,2440,9689,1.0,0,2,3,8,1830,610,1974,0.0,98008,47.6141,-122.111,2730,9689,7249,0.7481680255960368,5953600,93876721,87923121
622000.0,3,1.5,1650,3150,1.5,0,0,3,8,1650,0,1929,0.0,98122,47.6156,-122.29700000000001,1650,4500,1500,0.47619047619047616,2722500,9922500,7200000
90000.0,1,1.0,780,4000,1.0,0,0,2,5,780,0,1905,0.0,98108,47.5424,-122.321,1150,4000,3220,0.805,608400,16000000,15391600
342000.0,3,3.0,1260,1634,3.0,0,0,2,8,1260,0,1998,0.0,98103,47.696999999999996,-122.34899999999999,1260,1135,374,0.22888616891064872,1587600,2669956,1082356
305000.0,4,2.5,2320,4683,2.0,0,0,2,7,2320,0,2007,0.0,98042,47.3349,-122.059,2230,5750,2363,0.5045910740978006,5382400,21930489,16548089
259900.0,4,2.75,1560,8820,1.0,0,3,2,7,1060,500,1979,0.0,98001,47.3382,-122.257,2140,7800,7260,0.8231292517006803,2433600,77792400,75358800
420000.0,3,2.0,2330,6346,1.5,0,0,2,6,1600,730,1934,2014.0,98146,47.5135,-122.38,1380,8400,4016,0.6328395839899149,5428900,40271716,34842816
250000.0,2,1.0,1400,19570,1.5,0,0,2,6,1100,300,1929,0.0,98168,47.4724,-122.271,2250,6500,18170,0.9284619315278487,1960000,382984900,381024900
249950.0,3,1.5,1450,6875,1.0,0,0,3,7,1450,0,1961,0.0,98198,47.4205,-122.316,1270,8000,5425,0.7890909090909091,2102500,47265625,45163125
199000.0,2,1.0,1140,15120,1.0,0,0,3,6,990,150,1932,0.0,98055,47.4521,-122.196,2320,11250,13980,0.9246031746031746,1299600,228614400,227314800
355200.0,3,1.0,1120,7320,1.0,0,0,3,7,1120,0,1954,0.0,98146,47.5103,-122.382,1410,6328,6200,0.8469945355191257,1254400,53582400,52328000
425000.0,3,1.5,1970,13709,1.0,0,0,3,7,1680,290,1955,0.0,98155,47.7562,-122.277,2200,16536,11739,0.8562987818221606,3880900,187936681,184055781
379500.0,3,1.0,1110,7128,1.0,0,0,2,7,1110,0,1980,0.0,98052,47.6968,-122.124,1510,7107,6018,0.8442760942760943,1232100,50808384,49576284
860000.0,4,2.5,3070,6923,2.0,0,0,2,9,3070,0,2009,0.0,98033,47.669,-122.17200000000001,2190,9218,3853,0.5565506283403149,9424900,47927929,38503029
335000.0,3,2.5,1940,4927,2.0,0,0,2,8,1940,0,2004,0.0,98058,47.4479,-122.12,2070,4892,2987,0.6062512685203978,3763600,24275329,20511729
865000.0,3,2.5,3050,12558,2.0,0,0,2,10,3050,0,1997,0.0,98074,47.6549,-122.089,3543,12558,9508,0.7571269310399745,9302500,157703364,148400864
390000.0,3,1.0,1240,3600,1.5,0,0,2,7,1240,0,1902,0.0,98144,47.5986,-122.29799999999999,1680,3600,2360,0.6555555555555556,1537600,12960000,11422400
569950.0,5,4.25,3380,7805,2.0,0,0,2,8,3380,0,2014,0.0,98148,47.4349,-122.32799999999999,2790,7805,4425,0.566944266495836,11424400,60918025,49493625
495500.0,3,2.5,3190,7828,2.0,0,0,2,9,3190,0,2006,0.0,98059,47.5047,-122.14399999999999,2970,7828,4638,0.5924885028104241,10176100,61277584,51101484
476500.0,4,1.75,1670,10200,1.0,0,0,2,7,1390,280,1953,0.0,98118,47.5524,-122.26700000000001,1720,6860,8530,0.8362745098039216,2788900,104040000,101251100
261000.0,3,1.0,1660,11200,1.0,0,0,2,7,1660,0,1957,0.0,98056,47.5121,-122.16799999999999,1380,10875,9540,0.8517857142857143,2755600,125440000,122684400
375000.0,4,2.0,2070,9822,1.0,0,0,4,7,2070,0,1955,0.0,98006,47.566,-122.14,1300,9572,7752,0.7892486255345144,4284900,96471684,92186784
550000.0,4,2.0,2070,9822,1.0,0,0,4,7,2070,0,1955,0.0,98006,47.566,-122.14,1300,9572,7752,0.7892486255345144,4284900,96471684,92186784
230000.0,2,1.0,1430,4000,1.0,0,0,2,7,930,500,1949,0.0,98118,47.5233,-122.28399999999999,1110,4000,2570,0.6425,2044900,16000000,13955100
526750.0,5,2.5,2270,10700,1.0,0,0,3,8,1570,0,1963,0.0,98028,47.74100000000001,-122.256,2020,10230,8430,0.7878504672897196,5152900,114490000,109337100
606000.0,3,2.0,1980,7680,1.5,0,0,3,6,1070,910,1911,0.0,98033,47.6839,-122.195,1330,8704,5700,0.7421875,3920400,58982400,55062000
368500.0,4,2.75,2500,26400,1.0,0,0,2,8,1780,720,1977,0.0,98031,47.3444,-122.084,2180,31900,23900,0.9053030303030303,6250000,696960000,690710000
275000.0,3,1.0,1230,171190,1.0,0,0,2,7,1230,0,1973,0.0,98070,47.4397,-122.46,1550,15450,169960,0.9928150008762194,1512900,29306016100,29304503200
342000.0,4,1.0,1390,9023,1.5,0,0,2,7,1390,0,1955,0.0,98155,47.7754,-122.296,1760,9023,7633,0.8459492408289926,1932100,81414529,79482429
278100.0,4,1.75,2120,8520,1.0,0,0,2,7,1600,520,1978,0.0,98023,47.302,-122.37299999999999,2160,8400,6400,0.7511737089201878,4494400,72590400,68096000
450000.0,4,2.75,1540,4840,1.0,0,2,3,7,850,690,1929,0.0,98126,47.5491,-122.375,1180,4840,3300,0.6818181818181818,2371600,23425600,21054000
349950.0,4,2.5,2000,5006,2.0,0,0,2,7,2000,0,2005,0.0,98058,47.466,-122.147,2410,4889,3006,0.6004794246903715,4000000,25060036,21060036
425000.0,4,2.5,2400,6053,2.0,0,0,2,8,2400,0,2001,0.0,98038,47.3869,-122.03299999999999,2460,6519,3653,0.6035023955063605,5760000,36638809,30878809
435000.0,4,2.75,2110,8751,1.0,0,0,2,7,1510,600,1962,0.0,98011,47.7617,-122.215,1660,10295,6641,0.7588846988915553,4452100,76580001,72127901
460000.0,4,2.5,2550,19017,1.0,0,0,3,7,1300,1250,1961,0.0,98155,47.7682,-122.28399999999999,2080,21100,16467,0.8659094494399747,6502500,361646289,355143789
323000.0,4,1.75,1440,8114,1.0,0,0,3,7,1440,0,1963,0.0,98155,47.7639,-122.33200000000001,1940,7208,6674,0.8225289622874045,2073600,65836996,63763396
325000.0,2,1.0,810,6827,1.0,0,0,2,6,810,0,1944,0.0,98106,47.5495,-122.35700000000001,990,6827,6017,0.8813534495385967,656100,46607929,45951829
480000.0,2,1.75,1170,4635,1.0,0,0,3,6,690,480,1924,0.0,98117,47.6842,-122.359,1240,4120,3465,0.7475728155339806,1368900,21483225,20114325
1330000.0,3,2.5,3590,8400,1.0,0,0,2,9,2950,640,1958,2007.0,98005,47.595,-122.17299999999999,1620,7875,4810,0.5726190476190476,12888100,70560000,57671900
210000.0,4,1.75,2090,6485,1.0,0,0,2,7,1280,810,1956,0.0,98178,47.4958,-122.265,2190,9600,4395,0.6777178103315343,4368100,42055225,37687125
920000.0,5,4.5,3820,5750,2.0,0,3,2,9,2830,990,2000,0.0,98116,47.5581,-122.385,1750,5750,1930,0.3356521739130435,14592400,33062500,18470100
399000.0,3,1.0,1460,8290,1.0,0,0,2,8,1460,0,1959,0.0,98125,47.7246,-122.3,1470,8290,6830,0.8238841978287093,2131600,68724100,66592500
631750.0,3,1.75,2360,4063,1.0,0,0,4,7,1180,1180,1940,0.0,98117,47.6902,-122.382,1660,4063,1703,0.41914841250307655,5569600,16507969,10938369
184000.0,3,1.0,1100,8680,1.0,0,0,2,6,1100,0,1962,0.0,98023,47.3072,-122.363,1100,9220,7580,0.8732718894009217,1210000,75342400,74132400
333000.0,4,2.5,2100,7208,2.0,0,0,2,8,2100,0,1974,0.0,98058,47.4478,-122.12799999999999,2060,7480,5108,0.7086570477247502,4410000,51955264,47545264
218000.0,2,2.0,1310,2841,2.0,0,0,2,6,1310,0,2004,0.0,98038,47.3502,-122.022,1360,2550,1531,0.5388947553678283,1716100,8071281,6355181
258305.0,2,1.5,750,2964,1.0,0,0,4,5,750,0,1919,0.0,98118,47.5518,-122.277,1350,3090,2214,0.7469635627530364,562500,8785296,8222796
775000.0,5,1.5,1720,5000,1.5,0,0,2,8,1720,0,1915,0.0,98103,47.6627,-122.355,1720,5000,3280,0.656,2958400,25000000,22041600
515000.0,3,2.5,3370,19585,2.0,0,0,2,7,3200,170,1951,0.0,98133,47.7388,-122.339,1730,9430,16215,0.8279295379116671,11356900,383572225,372215325
455000.0,2,1.5,1200,1259,2.0,0,0,2,8,1000,200,2015,0.0,98144,47.6001,-122.29799999999999,1320,1852,59,0.04686258935663225,1440000,1585081,145081
440000.0,3,2.5,1830,6807,2.5,0,0,4,7,1830,0,1954,0.0,98155,47.7613,-122.322,1340,6807,4977,0.7311591009255178,3348900,46335249,42986349
1440000.0,3,3.5,3870,3819,2.0,0,0,2,11,2760,1110,2002,0.0,98102,47.6452,-122.31700000000001,2530,5500,-51,-0.01335428122545169,14976900,14584761,-392139
850000.0,3,2.25,2220,3707,2.0,0,0,3,8,1620,600,1919,0.0,98122,47.617,-122.286,2030,4850,1487,0.40113299163744265,4928400,13741849,8813449
480000.0,3,1.75,2920,21375,1.0,0,0,2,8,1850,1070,1961,0.0,98028,47.7666,-122.265,1540,8482,18455,0.863391812865497,8526400,456890625,448364225
420000.0,5,2.75,2540,27007,1.0,0,0,2,8,1520,1020,1980,0.0,98058,47.4326,-122.155,1800,26572,24467,0.9059503091791017,6451600,729378049,722926449
408000.0,3,1.75,1970,7100,1.0,0,0,2,7,1590,0,1976,0.0,98072,47.7353,-122.17200000000001,1790,7455,5130,0.7225352112676057,3880900,50410000,46529100
278000.0,5,1.75,2170,9752,1.0,0,0,2,7,1100,0,1962,0.0,98003,47.3355,-122.331,1810,10609,7582,0.777481542247744,4708900,95101504,90392604
1200000.0,3,3.0,2350,1620,2.0,0,0,2,9,1560,790,2001,0.0,98112,47.6308,-122.279,2000,4380,-730,-0.4506172839506173,5522500,2624400,-2898100
454000.0,4,2.25,2630,39000,2.0,0,0,2,9,2630,0,1979,0.0,98042,47.4089,-122.149,2270,66647,36370,0.9325641025641026,6916900,1521000000,1514083100
1850000.0,4,2.5,4120,14866,1.0,1,4,2,8,2070,2050,1965,0.0,98006,47.5571,-122.193,3620,19729,10746,0.7228575272433742,16974400,220997956,204023556
499000.0,4,2.25,2440,5000,2.0,0,0,2,7,2440,0,2007,0.0,98065,47.5407,-121.89,2440,5212,2560,0.512,5953600,25000000,19046400
590000.0,5,3.0,3480,6625,2.0,0,0,2,8,3480,0,2012,0.0,98059,47.4815,-122.15299999999999,2800,9400,3145,0.47471698113207544,12110400,43890625,31780225
385000.0,3,3.5,1900,4805,2.0,0,0,2,8,1560,340,1999,0.0,98108,47.5686,-122.315,1360,4800,2905,0.6045785639958376,3610000,23088025,19478025
1250000.0,4,3.25,3160,10043,2.0,0,2,2,9,3160,0,2011,0.0,98034,47.7001,-122.238,3450,10043,6883,0.6853529821766404,9985600,100861849,90876249
202200.0,2,1.75,1330,2159,1.0,0,0,3,8,1330,0,1979,0.0,98198,47.3822,-122.32,1220,3679,829,0.38397406206577117,1768900,4661281,2892381
450000.0,3,2.25,1420,13468,1.0,0,0,2,7,960,460,1976,0.0,98033,47.6693,-122.176,1480,10980,12048,0.8945648945648945,2016400,181387024,179370624
435000.0,3,2.0,2570,233481,1.5,0,0,3,8,2570,0,1986,0.0,98038,47.4199,-122.03399999999999,2280,157687,230911,0.9889926803465806,6604900,54513377361,54506772461
550000.0,2,1.0,1270,43560,1.0,0,0,3,5,1270,0,1908,0.0,98042,47.3651,-122.165,1870,6960,42290,0.9708448117539027,1612900,1897473600,1895860700
361000.0,3,2.25,2470,5650,1.0,0,2,2,7,1550,920,1973,0.0,98178,47.5072,-122.25200000000001,1660,5650,3180,0.5628318584070796,6100900,31922500,25821600
760000.0,4,2.25,2590,12600,2.0,0,0,2,9,2590,0,1979,0.0,98006,47.5566,-122.162,2620,11050,10010,0.7944444444444444,6708100,158760000,152051900
902000.0,4,2.5,3030,8507,2.0,0,0,2,9,3030,0,2003,0.0,98033,47.6675,-122.176,2570,8830,5477,0.6438227342188786,9180900,72369049,63188149
505000.0,3,1.75,1240,4550,1.5,0,0,3,7,1240,0,1951,0.0,98116,47.5803,-122.398,2110,5700,3310,0.7274725274725274,1537600,20702500,19164900
200000.0,3,1.0,1040,8925,1.0,0,0,3,6,1040,0,1961,0.0,98023,47.3265,-122.335,1040,8925,7885,0.8834733893557423,1081600,79655625,78574025
260000.0,5,2.25,2320,6375,1.0,0,0,3,7,1270,1050,1967,0.0,98001,47.3351,-122.28200000000001,1760,7600,4055,0.636078431372549,5382400,40640625,35258225
417000.0,2,1.0,1190,5100,1.5,0,0,1,7,1190,0,1928,0.0,98117,47.6773,-122.382,1920,5100,3910,0.7666666666666667,1416100,26010000,24593900
287500.0,3,2.25,2030,8690,1.0,0,0,3,8,1360,670,1986,0.0,98023,47.3185,-122.391,1720,8800,6660,0.766398158803222,4120900,75516100,71395200
450000.0,3,1.5,1390,10530,1.0,0,0,2,7,1390,0,1961,0.0,98033,47.7025,-122.196,1750,10530,9140,0.8679962013295347,1932100,110880900,108948800
825000.0,2,1.75,2050,4000,1.5,0,2,2,8,2050,0,1979,0.0,98119,47.6415,-122.37299999999999,1940,4000,1950,0.4875,4202500,16000000,11797500
1480000.0,4,3.0,3050,6179,2.0,0,0,3,9,2330,720,1926,0.0,98112,47.6253,-122.28399999999999,3020,6505,3129,0.5063926201650752,9302500,38180041,28877541
319950.0,2,1.0,1240,5500,1.5,0,0,2,6,1240,0,1921,0.0,98118,47.5257,-122.26299999999999,1520,5500,4260,0.7745454545454545,1537600,30250000,28712400
682000.0,4,2.5,3030,30000,2.0,0,0,3,9,3030,0,1981,0.0,98072,47.7468,-122.11200000000001,2600,34932,26970,0.899,9180900,900000000,890819100
560000.0,3,1.75,1930,6000,1.0,0,0,2,8,1130,800,1956,0.0,98119,47.6516,-122.375,1870,6000,4070,0.6783333333333333,3724900,36000000,32275100
350000.0,3,1.75,1490,10344,1.0,0,0,2,7,1490,0,1985,0.0,98155,47.7517,-122.32600000000001,1450,8632,8854,0.8559551430781129,2220100,106998336,104778236
270000.0,3,2.0,1510,10215,1.0,0,0,3,7,1510,0,1995,0.0,98022,47.2078,-122.00299999999999,1370,8902,8705,0.8521781693587861,2280100,104346225,102066125
284000.0,3,1.75,1320,35100,1.0,0,0,2,7,1320,0,1990,0.0,98092,47.312,-122.12899999999999,1660,35100,33780,0.9623931623931624,1742400,1232010000,1230267600
308000.0,4,2.5,2330,4606,2.0,0,0,2,8,2330,0,2004,0.0,98031,47.3934,-122.184,2330,5783,2276,0.49413808076422056,5428900,21215236,15786336
450000.0,4,2.0,2240,7725,1.0,0,0,4,7,1120,1120,1956,0.0,98106,47.5331,-122.365,1340,6300,5485,0.7100323624595469,5017600,59675625,54658025
540000.0,4,2.5,2050,34222,2.0,0,0,3,8,2050,0,1989,0.0,98077,47.7572,-122.022,2240,51400,32172,0.9400970136169715,4202500,1171145284,1166942784
380000.0,4,1.5,1680,11123,1.0,0,0,2,7,1130,550,1959,0.0,98177,47.7565,-122.361,1770,10103,9443,0.8489616110761485,2822400,123721129,120898729
522500.0,4,2.75,2200,122403,1.5,0,0,2,7,2200,0,1971,0.0,98014,47.6301,-121.911,1710,74487,120203,0.9820265843157439,4840000,14982494409,14977654409
118000.0,1,1.0,670,7957,1.0,0,0,3,6,670,0,1978,0.0,98038,47.3594,-122.056,1600,7957,7287,0.9157974110845796,448900,63313849,62864949
280400.0,4,1.75,1730,7210,1.0,0,0,3,7,1010,720,1968,0.0,98003,47.354,-122.315,1620,7210,5480,0.7600554785020804,2992900,51984100,48991200
710000.0,4,2.75,2710,41811,1.5,0,0,3,8,1690,0,1995,0.0,98075,47.5836,-122.046,2110,35656,39101,0.9351845208198799,7344100,1748159721,1740815621
720000.0,3,3.25,3410,25741,2.0,0,0,3,8,3410,0,1993,0.0,98014,47.6929,-121.868,1660,25865,22331,0.8675265141214406,11628100,662599081,650970981
787000.0,3,1.75,1330,7500,1.0,0,0,2,8,1330,0,1961,0.0,98004,47.6074,-122.195,1690,7800,6170,0.8226666666666667,1768900,56250000,54481100
537000.0,4,2.5,1990,2660,2.0,0,0,2,8,1990,0,2012,0.0,98034,47.732,-122.178,1990,2665,670,0.2518796992481203,3960100,7075600,3115500
650000.0,2,1.5,1900,4450,1.0,0,0,4,7,1500,400,1916,0.0,98144,47.5834,-122.29299999999999,2130,5000,2550,0.5730337078651685,3610000,19802500,16192500
154200.0,4,1.0,1310,8640,1.0,0,0,2,6,910,400,1948,0.0,98146,47.5104,-122.34200000000001,1310,8640,7330,0.8483796296296297,1716100,74649600,72933500
238000.0,4,2.5,1690,7260,1.0,0,0,2,7,1080,610,1979,0.0,98023,47.3001,-122.368,1690,7700,5570,0.7672176308539945,2856100,52707600,49851500
285650.0,3,1.0,1040,8199,1.0,0,0,2,7,1040,0,1953,0.0,98155,47.7348,-122.302,1420,8200,7159,0.8731552628369313,1081600,67223601,66142001
485500.0,2,1.5,1340,1286,2.0,0,0,2,8,1190,150,2006,0.0,98122,47.617,-122.309,1460,1245,-54,-0.041990668740279936,1795600,1653796,-141804
315000.0,2,1.0,1120,7350,1.0,0,0,2,7,1120,0,1942,0.0,98155,47.7648,-122.31,1320,7545,6230,0.8476190476190476,1254400,54022500,52768100
4670000.0,5,6.75,9640,13068,1.0,1,4,2,12,4820,4820,1983,2009.0,98040,47.556999999999995,-122.21,3270,10454,3428,0.2623201714110805,92929600,170772624,77843024
627000.0,3,2.0,2310,10525,2.0,0,0,4,7,2310,0,1965,0.0,98033,47.6727,-122.17399999999999,1430,10523,8215,0.7805225653206651,5336100,110775625,105439525
525000.0,3,2.5,2190,34528,2.0,0,0,2,8,2190,0,1994,0.0,98027,47.4594,-121.986,2460,37901,32338,0.9365732159406858,4796100,1192182784,1187386684
526000.0,3,3.25,1220,1281,2.0,0,0,2,8,930,290,2014,0.0,98105,47.67,-122.31700000000001,1303,3810,61,0.047619047619047616,1488400,1640961,152561
480000.0,3,1.5,1200,3060,1.0,0,0,3,7,1060,140,1910,0.0,98115,47.678999999999995,-122.315,1410,3060,1860,0.6078431372549019,1440000,9363600,7923600
970000.0,3,3.5,3840,53696,2.0,0,0,2,9,3840,0,1996,0.0,98077,47.7322,-122.035,3810,35181,49856,0.9284862932061978,14745600,2883260416,2868514816
640000.0,4,2.5,2460,9973,1.0,0,0,3,8,1560,900,1965,0.0,98177,47.7133,-122.361,1830,7200,7513,0.7533340018048732,6051600,99460729,93409129
279000.0,3,2.5,1630,7950,1.0,0,0,2,8,1320,310,1985,0.0,98042,47.4224,-122.15899999999999,1650,7952,6320,0.7949685534591195,2656900,63202500,60545600
303000.0,2,2.0,970,9750,1.0,0,0,4,6,970,0,1940,0.0,98146,47.5073,-122.37200000000001,1850,9000,8780,0.9005128205128206,940900,95062500,94121600
315000.0,4,2.0,1780,5336,1.5,0,0,4,6,930,0,1918,0.0,98178,47.5094,-122.26299999999999,1910,10304,3556,0.6664167916041979,3168400,28472896,25304496
336500.0,4,1.75,1760,7268,1.0,0,0,3,7,1080,680,1979,0.0,98058,47.4267,-122.148,1830,8786,5508,0.7578425976884975,3097600,52823824,49726224
163250.0,2,1.0,770,8150,1.0,0,0,2,6,770,0,1951,0.0,98118,47.5324,-122.275,1140,8550,7380,0.905521472392638,592900,66422500,65829600
444950.0,3,1.0,1760,6927,1.0,0,0,2,7,1050,710,1962,0.0,98011,47.7623,-122.2,2060,9120,5167,0.7459217554496896,3097600,47983329,44885729
285000.0,2,1.0,990,2446,2.0,0,0,2,7,990,0,1998,0.0,98144,47.5919,-122.29700000000001,1260,2805,1456,0.5952575633687653,980100,5982916,5002816
370000.0,2,1.0,1250,4960,1.0,0,0,2,7,940,310,1938,0.0,98115,47.6893,-122.325,2030,7440,3710,0.7479838709677419,1562500,24601600,23039100
330000.0,3,2.25,1440,5150,2.0,0,0,2,7,1440,0,1997,0.0,98106,47.5456,-122.35600000000001,1530,5238,3710,0.7203883495145631,2073600,26522500,24448900
395000.0,2,2.0,1960,4018,1.0,0,0,4,7,980,980,1950,0.0,98108,47.5629,-122.32,1240,4641,2058,0.5121951219512195,3841600,16144324,12302724
440000.0,6,3.0,2510,5310,1.0,0,0,3,7,1460,1050,1944,0.0,98108,47.5533,-122.304,1390,5407,2800,0.527306967984934,6300100,28196100,21896000
625000.0,4,2.75,2920,6605,2.0,0,0,2,8,2920,0,2012,0.0,98059,47.4909,-122.14399999999999,3030,6605,3685,0.5579106737320212,8526400,43626025,35099625
435000.0,3,2.5,1730,46638,2.0,0,0,2,8,1730,0,1991,0.0,98045,47.4614,-121.709,1750,35508,44908,0.9629057849822034,2992900,2175103044,2172110144
299950.0,3,2.5,1570,2577,2.0,0,0,2,7,1570,0,2005,0.0,98019,47.7456,-121.984,1970,2952,1007,0.39076445479239424,2464900,6640929,4176029
560000.0,2,1.75,970,4233,1.0,0,0,3,7,970,0,1944,0.0,98199,47.6384,-122.4,1340,4233,3263,0.7708480982754548,940900,17918289,16977389
380000.0,4,3.0,2800,9764,2.0,0,0,2,8,2800,0,2002,0.0,98038,47.3543,-122.012,3610,8194,6964,0.7132322818517002,7840000,95335696,87495696
333000.0,4,2.0,1580,7800,2.0,0,0,1,6,1580,0,1906,0.0,98144,47.5848,-122.302,1190,4440,6220,0.7974358974358975,2496400,60840000,58343600
499000.0,2,1.0,1220,3000,1.0,0,0,2,7,920,300,1926,0.0,98117,47.6823,-122.365,1270,3000,1780,0.5933333333333334,1488400,9000000,7511600
386000.0,3,1.5,1550,8000,1.0,0,0,2,6,1330,220,1980,0.0,98118,47.5536,-122.286,1150,5150,6450,0.80625,2402500,64000000,61597500
320600.0,3,2.0,1220,7620,1.0,0,0,2,6,720,500,1947,0.0,98166,47.4564,-122.352,1640,7620,6400,0.8398950131233596,1488400,58064400,56576000
285000.0,2,2.0,1651,18200,1.0,0,0,2,6,1651,0,1946,0.0,98070,47.4621,-122.461,1510,89595,16549,0.9092857142857143,2725801,331240000,328514199
450000.0,7,4.0,3150,7800,2.0,0,0,2,8,3150,0,2013,0.0,98118,47.5259,-122.279,1880,6000,4650,0.5961538461538461,9922500,60840000,50917500
175000.0,2,1.0,800,7150,1.0,0,0,2,5,800,0,1933,0.0,98030,47.3788,-122.22399999999999,1220,8019,6350,0.8881118881118881,640000,51122500,50482500
544800.0,5,2.75,3190,5857,2.0,0,0,2,9,3190,0,2004,0.0,98058,47.4575,-122.119,3100,5857,2667,0.4553525695748677,10176100,34304449,24128349
220000.0,3,1.75,1720,7587,1.0,0,0,3,7,1140,580,1981,0.0,98092,47.3175,-122.182,1120,7287,5867,0.7732964281006985,2958400,57562569,54604169
374000.0,2,2.25,1100,1695,2.0,0,0,2,9,1100,0,2009,0.0,98118,47.5663,-122.289,1100,3082,595,0.35103244837758113,1210000,2873025,1663025
200000.0,3,2.0,1010,7896,1.0,0,0,2,7,1010,0,1984,0.0,98031,47.4046,-122.181,1540,7896,6886,0.8720871327254306,1020100,62346816,61326716
259950.0,3,2.0,1010,7896,1.0,0,0,2,7,1010,0,1984,0.0,98031,47.4046,-122.181,1540,7896,6886,0.8720871327254306,1020100,62346816,61326716
255000.0,4,2.75,1760,9222,1.0,0,0,2,7,1140,620,1971,0.0,98023,47.3099,-122.36200000000001,1800,9222,7462,0.8091520277597051,3097600,85045284,81947684
447000.0,3,1.75,1400,6750,1.0,0,0,2,7,1040,360,1975,0.0,98034,47.717,-122.226,1860,7480,5350,0.7925925925925926,1960000,45562500,43602500
287000.0,3,2.5,1820,8722,1.5,0,0,2,7,1820,0,1926,2008.0,98022,47.2137,-121.98899999999999,1480,12285,6902,0.7913322632423756,3312400,76073284,72760884
344950.0,3,2.0,1470,6950,1.0,0,0,4,6,1470,0,1932,0.0,98133,47.7619,-122.34299999999999,1660,5065,5480,0.7884892086330936,2160900,48302500,46141600
212000.0,2,1.0,770,7000,1.0,0,0,2,6,770,0,1921,0.0,98024,47.5654,-121.89,1100,8777,6230,0.89,592900,49000000,48407100
425000.0,5,2.75,1340,11583,1.0,0,0,2,7,1190,150,1962,0.0,98034,47.708999999999996,-122.214,1950,10514,10243,0.884313217646551,1795600,134165889,132370289
170000.0,1,1.0,480,4560,1.0,0,0,2,5,480,0,1922,0.0,98065,47.5253,-121.82600000000001,890,4803,4080,0.8947368421052632,230400,20793600,20563200
565000.0,3,1.0,1260,4080,1.5,0,0,3,7,1260,0,1928,0.0,98103,47.6893,-122.354,1130,3876,2820,0.6911764705882353,1587600,16646400,15058800
234000.0,2,1.0,870,11100,1.0,0,0,2,6,870,0,1940,0.0,98146,47.5038,-122.36399999999999,1370,10404,10230,0.9216216216216216,756900,123210000,122453100
1510000.0,3,2.5,4010,12105,1.0,0,3,4,11,2600,1410,1983,0.0,98006,47.553999999999995,-122.15100000000001,4010,15081,8095,0.6687319289549772,16080100,146531025,130450925
345000.0,3,2.5,2340,8414,1.0,0,0,2,7,1280,1060,1993,0.0,98188,47.4685,-122.265,2340,7268,6074,0.72189208462087,5475600,70795396,65319796
415000.0,3,2.75,1770,3172,2.0,0,0,2,8,1770,0,2009,0.0,98065,47.5164,-121.87799999999999,1760,2891,1402,0.44199243379571246,3132900,10061584,6928684
760000.0,5,1.75,2660,10637,1.5,0,0,4,7,1670,990,1922,0.0,98115,47.6945,-122.292,1570,6825,7977,0.7499294913979505,7075600,113145769,106070169
484000.0,5,2.5,3600,20001,2.0,0,0,3,9,3600,0,1976,0.0,98166,47.4484,-122.339,2860,21780,16401,0.8200089995500225,12960000,400040001,387080001
360000.0,2,1.75,1230,1107,2.0,0,0,2,8,1230,0,2006,0.0,98029,47.5475,-121.999,1380,1107,-123,-0.1111111111111111,1512900,1225449,-287451
875000.0,3,2.75,3270,39586,1.5,0,0,2,11,3270,0,1988,0.0,98077,47.731,-122.07799999999999,3480,35998,36316,0.9173950386500278,10692900,1567051396,1556358496
930000.0,3,2.5,3100,20553,1.0,0,0,2,10,3100,0,1954,0.0,98177,47.7635,-122.37700000000001,3000,22302,17453,0.8491704374057315,9610000,422425809,412815809
250000.0,3,2.0,1900,6660,1.0,0,0,4,7,950,950,1966,0.0,98038,47.3594,-122.054,1690,8111,4760,0.7147147147147147,3610000,44355600,40745600
394000.0,2,2.0,1750,2731,2.0,0,0,2,8,1750,0,2012,0.0,98065,47.5169,-121.87799999999999,1650,2731,981,0.3592090809227389,3062500,7458361,4395861
865000.0,4,3.5,3380,11270,2.0,0,1,2,9,2160,1220,2007,0.0,98074,47.6124,-122.06,2910,11214,7890,0.7000887311446318,11424400,127012900,115588500
477500.0,2,2.0,2090,6000,2.0,0,1,2,7,2090,0,1918,1985.0,98116,47.5732,-122.413,1600,5400,3910,0.6516666666666666,4368100,36000000,31631900
1250000.0,4,2.75,4120,12500,1.0,0,4,3,8,2060,2060,1947,0.0,98116,47.5914,-122.385,3680,5000,8380,0.6704,16974400,156250000,139275600
270000.0,3,1.75,1260,7500,1.0,0,0,2,6,840,420,1947,0.0,98155,47.772,-122.323,1340,7500,6240,0.832,1587600,56250000,54662400
567000.0,3,2.25,1800,6875,1.0,0,0,3,8,1230,570,1974,0.0,98052,47.6773,-122.11,1800,8749,5075,0.7381818181818182,3240000,47265625,44025625
635000.0,3,2.5,1960,7200,1.0,0,0,3,8,980,980,1940,0.0,98118,47.5655,-122.27,1440,7200,5240,0.7277777777777777,3841600,51840000,47998400
1870000.0,6,2.75,4460,6952,2.5,0,2,3,10,3460,1000,1930,0.0,98105,47.6626,-122.26899999999999,2750,4769,2492,0.358457997698504,19891600,48330304,28438704
183000.0,3,1.75,1330,9200,1.0,0,0,3,7,1330,0,1973,0.0,98092,47.2916,-122.185,1590,9200,7870,0.8554347826086957,1768900,84640000,82871100
309933.0,3,1.75,1820,78408,1.0,0,0,2,6,1220,600,1950,0.0,98042,47.3364,-122.12799999999999,1340,78408,76588,0.9767880828486889,3312400,6147814464,6144502064
945800.0,4,2.75,3360,9100,1.0,0,0,3,8,1760,1600,1973,0.0,98006,47.5641,-122.149,2620,8925,5740,0.6307692307692307,11289600,82810000,71520400
503000.0,2,1.75,2860,59612,1.0,1,4,2,8,1510,1350,1948,0.0,98023,47.3276,-122.389,2720,59612,56752,0.9520230826008186,8179600,3553590544,3545410944
220000.0,3,1.0,1460,10200,1.0,0,0,3,7,1460,0,1957,0.0,98055,47.4238,-122.197,1460,8500,8740,0.8568627450980392,2131600,104040000,101908400
335000.0,3,1.75,1900,36769,1.0,0,0,2,8,1900,0,1987,0.0,98092,47.3041,-122.066,1950,35847,34869,0.9483260355190514,3610000,1351959361,1348349361
650000.0,3,2.25,1790,9927,1.0,0,2,3,7,1240,550,1969,0.0,98075,47.5822,-122.07700000000001,2610,10700,8137,0.8196836909438904,3204100,98545329,95341229
511000.0,4,3.5,3100,7600,2.0,0,0,2,10,3100,0,2005,0.0,98031,47.3892,-122.215,3350,7638,4500,0.5921052631578947,9610000,57760000,48150000
275000.0,2,1.0,900,57063,1.0,0,0,3,6,900,0,1938,0.0,98045,47.4735,-121.786,1440,268765,56163,0.9842279585721045,810000,3256185969,3255375969
576250.0,2,1.75,1530,5000,2.0,0,0,3,7,1260,270,1989,0.0,98107,47.6755,-122.37,1470,5000,3470,0.694,2340900,25000000,22659100
1450000.0,2,3.25,2070,3128,2.0,1,3,2,9,1760,310,1988,0.0,98075,47.5686,-122.06,2740,3568,1058,0.3382352941176471,4284900,9784384,5499484
186000.0,3,2.0,1340,4320,1.0,0,0,2,5,920,420,1912,1993.0,98002,47.299,-122.228,980,6480,2980,0.6898148148148148,1795600,18662400,16866800
655100.0,1,1.0,1220,4160,1.0,0,0,2,7,1220,0,1922,0.0,98115,47.6746,-122.315,1970,4200,2940,0.7067307692307693,1488400,17305600,15817200
328000.0,4,2.5,2370,6500,2.0,0,0,2,9,2370,0,1998,0.0,98092,47.3328,-122.17299999999999,2590,6137,4130,0.6353846153846154,5616900,42250000,36633100
441000.0,3,2.5,1890,11036,1.0,0,0,2,8,1460,430,1973,0.0,98133,47.7426,-122.354,2040,7524,9146,0.8287422979340341,3572100,121793296,118221196
370000.0,3,1.75,1480,7725,1.5,0,0,3,7,1480,0,1981,0.0,98059,47.483000000000004,-122.163,1720,8379,6245,0.8084142394822007,2190400,59675625,57485225
630000.0,2,1.0,1050,8382,1.0,0,0,2,7,1050,0,1959,0.0,98040,47.5627,-122.221,2400,9525,7332,0.8747315676449535,1102500,70257924,69155424
470500.0,4,2.25,2070,14000,1.0,0,0,2,7,1720,350,1958,0.0,98028,47.7484,-122.23700000000001,1690,14444,11930,0.8521428571428571,4284900,196000000,191715100
285950.0,2,1.0,1170,6000,1.0,0,0,2,6,1170,0,1948,0.0,98168,47.5033,-122.331,1130,7500,4830,0.805,1368900,36000000,34631100
698000.0,3,1.5,1090,7200,1.0,0,0,3,7,1090,0,1958,0.0,98040,47.5817,-122.241,2010,8982,6110,0.8486111111111111,1188100,51840000,50651900
268000.0,3,2.5,1650,6684,2.0,0,0,2,7,1650,0,1991,0.0,98031,47.4051,-122.184,1850,7048,5034,0.7531418312387792,2722500,44675856,41953356
1630000.0,4,3.75,4410,8112,3.0,0,4,2,11,3570,840,2003,0.0,98116,47.5888,-122.39200000000001,2770,5750,3702,0.45636094674556216,19448100,65804544,46356444
355000.0,4,2.5,1780,15000,2.0,0,0,1,7,1780,0,1993,0.0,98058,47.4239,-122.15299999999999,2005,9680,13220,0.8813333333333333,3168400,225000000,221831600
299000.0,3,1.0,1550,8778,1.0,0,0,2,7,1250,300,1952,0.0,98118,47.5413,-122.281,2120,7268,7228,0.8234221918432445,2402500,77053284,74650784
1000000.0,4,2.75,2290,6120,2.0,0,0,3,7,2170,120,1926,0.0,98115,47.6746,-122.32700000000001,1910,4590,3830,0.6258169934640523,5244100,37454400,32210300
275000.0,4,2.0,2220,8229,1.5,0,0,3,7,2220,0,1958,0.0,98030,47.3722,-122.22,1660,8396,6009,0.7302223842508203,4928400,67716441,62788041
475000.0,3,1.75,1150,10240,1.0,0,0,2,6,1030,120,1918,0.0,98106,47.5222,-122.35700000000001,1270,2566,9090,0.8876953125,1322500,104857600,103535100
260000.0,4,2.5,2000,37045,2.0,0,0,2,8,2000,0,1989,0.0,98042,47.3398,-122.071,2390,36868,35045,0.9460116075043865,4000000,1372332025,1368332025
416000.0,2,1.75,1270,7560,1.5,0,0,3,7,1270,0,1932,0.0,98133,47.7083,-122.35700000000001,1480,7560,6290,0.832010582010582,1612900,57153600,55540700
495000.0,5,1.0,1810,11205,1.5,0,2,2,7,1810,0,1915,0.0,98178,47.5099,-122.262,1860,7965,9395,0.8384649709950914,3276100,125552025,122275925
357500.0,3,1.0,1450,8100,1.0,0,0,2,6,1450,0,1952,0.0,98125,47.7027,-122.289,1450,7800,6650,0.8209876543209876,2102500,65610000,63507500
459500.0,2,1.5,1170,1079,3.0,0,0,2,7,1170,0,2003,0.0,98103,47.6607,-122.333,1170,1116,-91,-0.08433734939759036,1368900,1164241,-204659
258000.0,3,2.5,1730,6930,2.0,0,0,2,8,1730,0,1994,0.0,98003,47.2621,-122.30799999999999,1780,6930,5200,0.7503607503607503,2992900,48024900,45032000
600000.0,3,2.25,2680,98445,1.0,0,0,4,8,2680,0,1962,0.0,98059,47.5015,-122.10799999999999,2340,98445,95765,0.9727766773325207,7182400,9691418025,9684235625
665000.0,3,1.0,1260,24550,1.5,0,2,3,7,1260,0,1937,0.0,98136,47.5442,-122.396,2500,12320,23290,0.9486761710794297,1587600,602702500,601114900
165000.0,3,1.5,1020,10152,1.0,0,0,4,6,1020,0,1959,0.0,98056,47.4971,-122.16799999999999,1320,8892,9132,0.8995271867612293,1040400,103063104,102022704
297000.0,5,2.5,1970,8605,2.0,0,0,3,7,1970,0,1994,0.0,98022,47.1944,-122.01299999999999,1970,8460,6635,0.7710633352701918,3880900,74046025,70165125
350000.0,2,1.0,830,5100,1.0,0,0,3,7,830,0,1942,0.0,98126,47.5259,-122.37899999999999,1220,5100,4270,0.8372549019607843,688900,26010000,25321100
2450000.0,4,4.5,5030,11023,2.0,0,2,2,11,3250,1780,2008,0.0,98040,47.5722,-122.236,3640,11490,5993,0.543681393450059,25300900,121506529,96205629
180000.0,2,1.0,800,9450,1.0,0,0,2,6,800,0,1958,0.0,98058,47.4563,-122.184,1090,9450,8650,0.9153439153439153,640000,89302500,88662500
339950.0,3,1.75,1330,12092,1.0,0,0,3,6,720,610,1981,0.0,98168,47.5102,-122.324,1770,11770,10762,0.8900099239166391,1768900,146216464,144447564
365000.0,3,1.0,1030,4700,1.0,0,0,2,7,1030,0,1952,0.0,98146,47.5118,-122.37700000000001,1030,4700,3670,0.7808510638297872,1060900,22090000,21029100
955000.0,4,4.25,5660,193593,2.0,0,0,2,10,4100,1560,2001,0.0,98019,47.7064,-121.98100000000001,3620,207141,187933,0.9707634057016524,32035600,37478249649,37446214049
732000.0,3,2.5,2330,1987,2.0,0,4,2,9,1410,920,2004,0.0,98107,47.6735,-122.405,2640,5250,-343,-0.17262204328132863,5428900,3948169,-1480731
500000.0,3,1.75,1540,10800,1.0,0,0,4,6,770,770,1947,0.0,98040,47.5763,-122.22200000000001,2020,10800,9260,0.8574074074074074,2371600,116640000,114268400
610000.0,6,2.75,2040,8560,1.0,0,2,3,7,1100,940,1961,0.0,98008,47.61600000000001,-122.115,2230,8560,6520,0.7616822429906542,4161600,73273600,69112000
525000.0,3,2.0,1540,7800,1.0,0,0,2,8,1540,0,2004,0.0,98125,47.7041,-122.288,1510,7800,6260,0.8025641025641026,2371600,60840000,58468400
170000.0,4,1.0,1920,13787,1.0,0,0,3,7,1220,700,1966,0.0,98188,47.4502,-122.277,1490,11200,11867,0.8607383767317037,3686400,190081369,186394969
300000.0,3,2.5,1870,3439,2.0,0,0,2,7,1870,0,2005,0.0,98042,47.3992,-122.163,2190,4029,1569,0.45623727827856936,3496900,11826721,8329821
389500.0,5,3.5,2960,12527,2.0,0,0,2,9,1940,1020,1986,0.0,98023,47.3134,-122.35,2210,10952,9567,0.7637103855671749,8761600,156925729,148164129
330000.0,3,1.5,1690,10250,1.0,0,0,3,7,1690,0,1955,0.0,98166,47.4531,-122.344,1990,11084,8560,0.8351219512195122,2856100,105062500,102206400
269950.0,3,2.25,1610,7187,2.0,0,0,2,7,1610,0,1988,0.0,98042,47.3764,-122.117,1640,7194,5577,0.7759844163072214,2592100,51652969,49060869
107000.0,2,1.0,670,4720,1.0,0,0,3,6,670,0,1948,0.0,98106,47.5243,-122.35799999999999,1480,4720,4050,0.8580508474576272,448900,22278400,21829500
249000.0,3,1.0,1752,14626,2.0,0,2,2,8,1752,0,2005,0.0,98032,47.3755,-122.27799999999999,1800,9000,12874,0.880213318747436,3069504,213919876,210850372
442500.0,4,2.0,1540,5920,1.5,0,0,4,7,1540,0,1935,0.0,98125,47.7148,-122.301,1630,6216,4380,0.7398648648648649,2371600,35046400,32674800
579000.0,3,2.5,3160,286181,2.0,0,3,2,9,3160,0,2002,0.0,98010,47.3401,-121.946,2110,94663,283021,0.9889580370464846,9985600,81899564761,81889579161
621500.0,3,1.75,2570,39634,2.0,0,0,2,8,2570,0,1984,0.0,98075,47.596000000000004,-122.08,2990,39634,37064,0.9351566836554474,6604900,1570853956,1564249056
203000.0,3,1.5,1370,7500,1.0,0,0,2,7,1080,290,1958,0.0,98198,47.4167,-122.322,1400,7500,6130,0.8173333333333334,1876900,56250000,54373100
222900.0,2,1.0,860,5800,1.0,0,0,4,5,860,0,1942,0.0,98056,47.4979,-122.18299999999999,900,6000,4940,0.8517241379310345,739600,33640000,32900400
453000.0,2,1.5,1680,17400,1.5,0,0,2,7,1680,0,1991,0.0,98038,47.3836,-122.006,1610,27600,15720,0.903448275862069,2822400,302760000,299937600
190000.0,1,0.75,930,29258,1.0,0,0,2,6,930,0,1941,0.0,98178,47.4837,-122.236,2000,18321,28328,0.9682138218606877,864900,856030564,855165664
320000.0,4,1.75,1820,7381,1.0,0,0,4,7,1150,670,1962,0.0,98058,47.4567,-122.171,1610,8462,5561,0.7534209456713182,3312400,54479161,51166761
733500.0,3,1.5,2120,4370,1.5,0,0,2,8,2120,0,1904,0.0,98122,47.606,-122.307,1960,5120,2250,0.5148741418764302,4494400,19096900,14602500
555000.0,4,2.25,3330,21785,2.0,0,0,2,9,3330,0,1994,0.0,98059,47.4725,-122.13600000000001,3330,21796,18455,0.8471425292632545,11088900,474586225,463497325
364950.0,3,2.25,2520,6170,2.0,0,0,2,7,1850,670,2003,0.0,98038,47.3522,-122.042,2260,6967,3650,0.5915721231766613,6350400,38068900,31718500
490000.0,3,1.75,1560,9247,1.0,0,0,2,7,1160,400,1989,0.0,98033,47.6954,-122.17399999999999,1690,8772,7687,0.8312966367470531,2433600,85507009,83073409
688000.0,5,1.75,2250,13526,1.0,0,1,2,8,1350,0,1957,0.0,98125,47.7108,-122.279,2580,10078,11276,0.8336537039775248,5062500,182952676,177890176
165000.0,2,1.0,640,7768,1.0,0,0,2,6,640,0,1942,0.0,98106,47.515,-122.359,840,7424,7128,0.917610710607621,409600,60341824,59932224
506000.0,5,3.75,3880,8370,2.0,0,0,3,7,3880,0,2004,0.0,98056,47.4811,-122.179,2160,4651,4490,0.5364396654719236,15054400,70056900,55002500
2190000.0,3,2.25,3360,7108,2.0,0,0,2,10,2770,590,1905,2004.0,98112,47.6187,-122.28399999999999,3450,8558,3748,0.5272931907709623,11289600,50523664,39234064
754000.0,5,1.75,2350,7800,1.0,0,0,3,8,1510,840,1968,0.0,98008,47.6225,-122.10700000000001,2220,8400,5450,0.6987179487179487,5522500,60840000,55317500
949950.0,5,2.5,2340,1989,2.0,1,4,2,8,2340,0,1959,0.0,98118,47.5193,-122.257,2200,3230,-351,-0.17647058823529413,5475600,3956121,-1519479
443600.0,3,2.5,1430,1056,3.0,0,0,2,8,1430,0,2003,0.0,98117,47.684,-122.38799999999999,1310,2135,-374,-0.3541666666666667,2044900,1115136,-929764
380600.0,3,2.5,1920,12244,2.0,0,0,2,7,1920,0,1998,0.0,98019,47.7256,-121.97,1920,11859,10324,0.8431885004900359,3686400,149915536,146229136
722800.0,3,3.25,4330,14600,2.0,0,0,2,10,3630,700,1985,0.0,98074,47.6341,-122.044,3220,12672,10270,0.7034246575342465,18748900,213160000,194411100
342888.0,2,1.0,790,5150,1.0,0,0,3,6,790,0,1948,0.0,98118,47.5528,-122.272,1460,5150,4360,0.8466019417475729,624100,26522500,25898400
555000.0,4,1.75,2350,5946,1.0,0,2,2,8,1350,1000,1957,0.0,98115,47.6879,-122.29799999999999,2060,6000,3596,0.6047763202152707,5522500,35354916,29832416
613000.0,3,2.5,1350,3068,2.0,0,0,2,7,1350,0,1991,0.0,98122,47.6099,-122.29299999999999,1900,4000,1718,0.559973924380704,1822500,9412624,7590124
480000.0,3,2.0,1470,10052,1.0,0,0,3,8,1470,0,1956,0.0,98125,47.726000000000006,-122.316,1480,9780,8582,0.8537604456824512,2160900,101042704,98881804
619500.0,6,1.5,1680,5202,1.5,0,0,1,7,1680,0,1911,0.0,98033,47.6798,-122.206,1890,5500,3522,0.6770472895040369,2822400,27060804,24238404
437000.0,4,2.5,1890,8505,1.0,0,0,2,8,1290,600,1980,0.0,98052,47.6796,-122.115,1720,9600,6615,0.7777777777777778,3572100,72335025,68762925
621000.0,4,2.5,2030,9905,1.0,0,0,3,8,2030,0,1959,0.0,98006,47.5518,-122.184,2130,10008,7875,0.7950530035335689,4120900,98109025,93988125
810000.0,4,1.75,1760,4080,1.5,0,0,3,8,1760,0,1906,0.0,98103,47.675,-122.331,1760,6120,2320,0.5686274509803921,3097600,16646400,13548800
415000.0,3,2.25,1950,8868,1.0,0,0,2,7,1350,600,1964,0.0,98155,47.7538,-122.31200000000001,1300,8880,6918,0.7801082543978349,3802500,78641424,74838924
250000.0,4,1.0,1440,7404,1.0,0,0,2,6,1080,360,1918,0.0,98126,47.5328,-122.37899999999999,1620,7436,5964,0.8055105348460292,2073600,54819216,52745616
585000.0,3,1.5,2230,6000,1.0,0,1,2,8,1260,970,1968,0.0,98136,47.5373,-122.395,2120,7200,3770,0.6283333333333333,4972900,36000000,31027100
220000.0,3,1.0,1180,5002,1.5,0,0,2,7,1180,0,1946,0.0,98155,47.7529,-122.324,1470,8410,3822,0.764094362255098,1392400,25020004,23627604
580000.0,5,2.5,2500,11900,1.0,0,0,2,7,1400,1100,1963,0.0,98007,47.5915,-122.132,2820,11900,9400,0.7899159663865546,6250000,141610000,135360000
1320000.0,3,2.75,2680,20104,1.0,0,0,4,9,1820,860,1964,0.0,98039,47.6304,-122.234,3060,19837,17424,0.8666931953840031,7182400,404170816,396988416
675000.0,4,2.5,2040,9225,1.0,0,0,4,8,1610,430,1968,0.0,98052,47.636,-122.09700000000001,1730,9225,7185,0.7788617886178861,4161600,85100625,80939025
695000.0,4,2.75,2660,7389,2.0,0,0,2,9,2660,0,2002,0.0,98075,47.5993,-121.977,2820,7388,4729,0.6400054134524293,7075600,54597321,47521721
915000.0,5,2.75,2580,7630,1.0,0,0,3,7,1730,850,1954,0.0,98004,47.6226,-122.205,2040,7717,5050,0.6618610747051114,6656400,58216900,51560500
375000.0,3,1.0,1000,6947,1.0,0,0,3,7,1000,0,1947,0.0,98125,47.7142,-122.319,1000,6947,5947,0.8560529725061178,1000000,48260809,47260809
500000.0,3,1.5,1330,1265,2.0,0,0,2,8,1140,190,2008,0.0,98116,47.5773,-122.40899999999999,1330,1264,-65,-0.05138339920948617,1768900,1600225,-168675
335000.0,2,2.0,1420,5185,1.0,0,0,2,7,1420,0,2004,0.0,98038,47.3543,-122.022,2140,4890,3765,0.7261330761812922,2016400,26884225,24867825
170000.0,2,1.0,1280,21750,1.5,0,0,4,6,1280,0,1912,0.0,98001,47.3096,-122.241,1520,21750,20470,0.9411494252873563,1638400,473062500,471424100
320900.0,5,2.5,2200,8500,1.0,0,0,3,7,1400,800,1971,0.0,98010,47.3073,-122.006,1360,8855,6300,0.7411764705882353,4840000,72250000,67410000
508000.0,3,1.75,1800,8462,1.0,0,0,2,8,1440,360,1978,0.0,98052,47.6623,-122.141,2210,8436,6662,0.7872843299456393,3240000,71605444,68365444
228950.0,3,1.75,1200,9085,1.0,0,0,3,7,1200,0,1968,0.0,98023,47.2795,-122.353,1200,9085,7885,0.8679141441937259,1440000,82537225,81097225
433000.0,4,2.0,1840,4760,1.5,0,0,3,6,1080,760,1929,0.0,98106,47.5297,-122.34899999999999,1170,5950,2920,0.6134453781512605,3385600,22657600,19272000
267500.0,2,1.0,960,5150,1.0,0,0,4,6,960,0,1951,0.0,98126,47.5201,-122.37200000000001,1010,5000,4190,0.8135922330097087,921600,26522500,25600900
910000.0,4,1.5,2890,9000,2.0,0,4,2,8,2090,800,1939,0.0,98118,47.5682,-122.274,2550,8400,6110,0.6788888888888889,8352100,81000000,72647900
370000.0,3,1.75,1290,10117,1.0,0,0,2,7,1290,0,1984,0.0,98072,47.7598,-122.146,1770,11839,8827,0.872491845408718,1664100,102353689,100689589
320000.0,2,1.0,1140,3834,1.5,0,0,2,6,1140,0,1911,0.0,98126,47.5642,-122.37799999999999,1190,5750,2694,0.702660406885759,1299600,14699556,13399956
660000.0,3,1.75,1750,5200,1.0,0,1,3,8,1750,0,1956,0.0,98117,47.6995,-122.383,2060,5200,3450,0.6634615384615384,3062500,27040000,23977500
787888.0,4,2.25,2580,21115,2.0,0,0,3,9,2580,0,1977,0.0,98040,47.5566,-122.219,2690,10165,18535,0.8778119820033152,6656400,445843225,439186825
329000.0,4,2.5,2650,5880,2.0,0,0,2,9,2650,0,2005,0.0,98042,47.3509,-122.165,2610,6490,3230,0.5493197278911565,7022500,34574400,27551900
602000.0,2,1.0,1470,6398,1.0,0,0,3,7,970,500,1941,0.0,98105,47.6716,-122.279,1950,6398,4928,0.7702407002188184,2160900,40934404,38773504
375000.0,3,2.0,1640,9750,1.0,0,0,2,7,1640,0,1959,0.0,98028,47.7425,-122.241,1340,9750,8110,0.8317948717948718,2689600,95062500,92372900
212000.0,1,1.0,620,7620,1.0,0,0,2,6,620,0,1926,0.0,98166,47.4697,-122.34899999999999,1160,7620,7000,0.9186351706036745,384400,58064400,57680000
224000.0,3,1.5,1440,8370,1.0,0,0,2,7,1440,0,1977,0.0,98118,47.5418,-122.275,1440,8370,6930,0.8279569892473119,2073600,70056900,67983300
315500.0,3,2.0,1160,10079,1.0,0,0,2,7,1160,0,1986,0.0,98019,47.7341,-121.976,1130,10087,8919,0.8849092171842444,1345600,101586241,100240641
350000.0,2,1.0,1070,2880,1.0,0,0,2,7,1070,0,1902,0.0,98102,47.6261,-122.324,2030,2880,1810,0.6284722222222222,1144900,8294400,7149500
389000.0,6,4.5,3560,14010,2.0,0,0,2,7,3560,0,1989,0.0,98002,47.3244,-122.21700000000001,1710,11116,10450,0.7458957887223412,12673600,196280100,183606500
285000.0,3,1.75,1720,13104,1.0,0,0,3,7,1720,0,1962,0.0,98168,47.4709,-122.26,1840,13104,11384,0.8687423687423688,2958400,171714816,168756416
425000.0,3,1.75,1530,9800,1.0,0,0,4,8,1530,0,1958,0.0,98133,47.7655,-122.336,1660,9800,8270,0.8438775510204082,2340900,96040000,93699100
190000.0,3,1.75,1270,7875,1.0,0,0,3,7,1270,0,1980,0.0,98030,47.3696,-122.17,1830,7210,6605,0.8387301587301588,1612900,62015625,60402725
374000.0,3,1.75,1510,18439,1.0,0,0,2,7,1510,0,1971,0.0,98027,47.5491,-122.046,1600,34326,16929,0.9181083572861869,2280100,339996721,337716621
292000.0,2,1.0,880,5500,1.0,0,0,2,6,880,0,1904,0.0,98118,47.5573,-122.289,1080,5500,4620,0.84,774400,30250000,29475600
475000.0,5,1.75,2020,5100,1.5,0,0,4,7,1320,700,1911,0.0,98103,47.6915,-122.345,1130,5100,3080,0.6039215686274509,4080400,26010000,21929600
546500.0,3,2.5,1410,2675,1.0,0,0,2,7,820,590,1985,0.0,98117,47.6786,-122.37100000000001,1410,4013,1265,0.47289719626168225,1988100,7155625,5167525
82000.0,3,1.0,860,10426,1.0,0,0,2,6,860,0,1954,0.0,98146,47.4987,-122.34100000000001,1140,11250,9566,0.9175139075388452,739600,108701476,107961876
219900.0,3,1.0,860,10426,1.0,0,0,2,6,860,0,1954,0.0,98146,47.4987,-122.34100000000001,1140,11250,9566,0.9175139075388452,739600,108701476,107961876
440000.0,3,1.0,1210,5750,1.5,0,0,3,7,1210,0,1910,0.0,98136,47.5403,-122.391,1160,5000,4540,0.7895652173913044,1464100,33062500,31598400
400000.0,3,2.5,2090,32718,2.0,1,4,2,7,1550,540,1919,0.0,98070,47.3338,-122.51100000000001,1200,192268,30628,0.9361207897793263,4368100,1070467524,1066099424
453000.0,3,1.75,1430,20193,1.0,0,0,2,7,1430,0,1955,0.0,98006,47.5619,-122.18299999999999,2140,18364,18763,0.9291833803793393,2044900,407757249,405712349
330000.0,6,3.25,2120,6893,1.0,0,0,3,7,1060,1060,1983,0.0,98106,47.5508,-122.355,1380,6986,4773,0.6924416074278253,4494400,47513449,43019049
359950.0,3,2.75,2540,8604,2.0,0,0,2,8,2540,0,1991,0.0,98092,47.3209,-122.185,2260,7438,6064,0.7047884704788471,6451600,74028816,67577216
616000.0,4,2.5,2490,12929,2.0,0,0,2,9,2490,0,1983,0.0,98074,47.6161,-122.021,2440,12929,10439,0.8074096991259958,6200100,167159041,160958941
245000.0,2,1.0,670,2356,1.0,0,0,4,6,670,0,1960,0.0,98144,47.5918,-122.295,1220,1740,1686,0.7156196943972836,448900,5550736,5101836
296000.0,2,2.0,1320,2040,3.0,0,0,2,7,1320,0,1997,0.0,98125,47.7224,-122.291,1430,2040,720,0.35294117647058826,1742400,4161600,2419200
193000.0,2,1.0,950,9000,1.0,0,0,2,6,950,0,1924,0.0,98106,47.5219,-122.361,1000,8280,8050,0.8944444444444445,902500,81000000,80097500
456000.0,3,2.0,1870,8442,1.5,0,0,4,7,1060,810,1927,0.0,98117,47.6964,-122.365,1640,6174,6572,0.7784885098317934,3496900,71267364,67770464
480000.0,4,1.75,1840,9250,1.0,0,0,3,7,980,860,1956,0.0,98133,47.708,-122.337,1520,9250,7410,0.8010810810810811,3385600,85562500,82176900
382000.0,3,3.25,1410,1253,3.0,0,0,2,8,1410,0,2005,0.0,98103,47.6981,-122.34,1410,1253,-157,-0.12529928172386273,1988100,1570009,-418091
650000.0,2,1.0,1050,2542,1.0,0,0,2,7,880,170,1904,0.0,98122,47.6172,-122.29799999999999,1620,1809,1492,0.5869394177812746,1102500,6461764,5359264
431750.0,2,2.0,1400,10052,1.0,0,0,2,8,1400,0,1957,0.0,98125,47.7262,-122.316,1400,8785,8652,0.8607242339832869,1960000,101042704,99082704
419900.0,3,2.5,1630,1755,2.0,0,0,2,8,1320,310,1997,0.0,98033,47.691,-122.176,1920,14550,125,0.07122507122507123,2656900,3080025,423125
315000.0,3,2.0,1900,9513,1.0,0,0,2,8,1900,0,1995,0.0,98023,47.2843,-122.35700000000001,1790,8028,7613,0.800273310207085,3610000,90497169,86887169
597500.0,4,3.0,1890,35280,1.0,0,0,2,9,1510,380,1979,0.0,98052,47.7112,-122.09899999999999,2730,34525,33390,0.9464285714285714,3572100,1244678400,1241106300
615000.0,3,2.5,2980,43301,1.0,0,0,3,8,1930,1050,1978,0.0,98077,47.7631,-122.09299999999999,2890,35915,40321,0.9311794184891804,8880400,1874976601,1866096201
605000.0,4,3.25,2885,33671,2.0,0,0,3,8,2885,0,1984,0.0,98027,47.5174,-122.046,1910,16000,30786,0.9143179590745746,8323225,1133736241,1125413016
220000.0,3,2.5,1980,11900,2.0,0,0,2,8,1980,0,1990,0.0,98092,47.2656,-122.21700000000001,2130,9933,9920,0.8336134453781513,3920400,141610000,137689600
340000.0,4,2.5,3020,8750,1.0,0,0,2,8,1710,1310,1960,0.0,98188,47.4298,-122.29,1900,8750,5730,0.6548571428571428,9120400,76562500,67442100
620000.0,4,2.5,2980,210395,2.0,0,0,2,9,2980,0,2001,0.0,98045,47.4575,-121.70700000000001,2530,45596,207415,0.9858361653081109,8880400,44266056025,44257175625
602000.0,5,1.75,3290,11900,1.5,0,0,2,8,3290,0,1973,0.0,98052,47.6626,-122.141,2210,8549,8610,0.7235294117647059,10824100,141610000,130785900
575000.0,3,1.75,1580,11750,1.0,0,0,3,7,1180,400,1951,0.0,98118,47.5368,-122.265,2150,11750,10170,0.865531914893617,2496400,138062500,135566100
285000.0,3,2.5,2090,10834,1.0,0,0,3,8,1360,730,1987,0.0,98003,47.3537,-122.303,1750,8595,8744,0.8070887945357209,4368100,117375556,113007456
306500.0,3,1.5,1100,8140,1.0,0,0,3,7,1100,0,1965,0.0,98059,47.5004,-122.162,1430,7700,7040,0.8648648648648649,1210000,66259600,65049600
325000.0,3,2.5,1870,3480,2.0,0,0,2,7,1870,0,2002,0.0,98056,47.4831,-122.18299999999999,2160,3480,1610,0.46264367816091956,3496900,12110400,8613500
623000.0,3,2.75,2390,21804,1.0,0,0,2,8,1450,940,1973,0.0,98034,47.7339,-122.18299999999999,2390,10136,19414,0.8903870849385433,5712100,475414416,469702316
256500.0,3,2.0,1320,8568,1.0,0,0,2,7,1320,0,1993,0.0,98042,47.3904,-122.164,1600,8463,7248,0.84593837535014,1742400,73410624,71668224
473000.0,5,3.5,3430,6872,2.0,0,0,2,10,2830,600,2002,0.0,98031,47.4065,-122.20700000000001,3650,6600,3442,0.5008731082654249,11764900,47224384,35459484
549000.0,3,2.5,2250,9235,2.0,0,0,2,8,2250,0,1985,0.0,98052,47.7268,-122.105,2290,8187,6985,0.7563616675690309,5062500,85285225,80222725
305000.0,3,1.0,1710,19115,1.0,0,0,2,6,1710,0,1986,0.0,98014,47.65600000000001,-121.913,1650,15144,17405,0.910541459586712,2924100,365383225,362459125
317000.0,4,2.5,2160,8049,2.0,0,0,2,9,2160,0,1988,0.0,98001,47.3337,-122.26,2490,8995,5889,0.7316436824450242,4665600,64786401,60120801
450000.0,3,1.75,1400,13775,1.0,0,0,2,8,1400,0,1963,0.0,98028,47.7413,-122.259,2200,10450,12375,0.8983666061705989,1960000,189750625,187790625
225000.0,2,2.5,1560,5333,1.0,0,0,2,5,780,780,1947,0.0,98055,47.4749,-122.213,1010,4800,3773,0.7074817176073505,2433600,28440889,26007289
500000.0,5,2.0,2300,7897,2.5,0,0,3,8,2300,0,1956,0.0,98133,47.7556,-122.35600000000001,2030,7902,5597,0.7087501582879574,5290000,62362609,57072609
207000.0,2,1.0,820,4860,1.0,0,0,4,6,820,0,1955,0.0,98118,47.5298,-122.271,1240,6000,4040,0.831275720164609,672400,23619600,22947200
474900.0,3,1.0,1630,8308,1.5,0,0,2,7,1630,0,1948,0.0,98146,47.5075,-122.37799999999999,1170,8308,6678,0.8038035628310063,2656900,69022864,66365964
515000.0,3,2.5,2010,7200,2.0,0,0,2,8,2010,0,1994,0.0,98028,47.7372,-122.223,1970,7202,5190,0.7208333333333333,4040100,51840000,47799900
542000.0,4,1.0,1540,5000,1.5,0,0,3,7,1090,450,1922,0.0,98115,47.6754,-122.294,1590,5000,3460,0.692,2371600,25000000,22628400
725000.0,4,2.75,2420,10962,1.0,0,0,2,8,1530,890,1977,0.0,98007,47.6218,-122.152,2620,13200,8542,0.779237365444262,5856400,120165444,114309044
314950.0,3,2.5,1690,4533,2.0,0,0,2,7,1690,0,2003,0.0,98038,47.3575,-122.016,1830,5175,2843,0.6271784690050739,2856100,20548089,17691989
375000.0,3,2.0,1410,10078,1.0,0,0,3,6,1410,0,1983,0.0,98072,47.7587,-122.14399999999999,2090,9202,8668,0.8600912879539592,1988100,101566084,99577984
500000.0,3,1.75,1640,47044,1.0,0,0,2,7,1640,0,1989,0.0,98014,47.653999999999996,-121.94,2280,200811,45404,0.9651390187909191,2689600,2213137936,2210448336
689000.0,3,1.75,2200,9840,1.0,0,0,4,8,1500,700,1978,0.0,98006,47.559,-122.13600000000001,2410,9623,7640,0.7764227642276422,4840000,96825600,91985600
525000.0,3,2.25,1290,1182,2.0,0,0,2,8,1000,290,2006,0.0,98102,47.637,-122.32700000000001,1300,1169,-108,-0.09137055837563451,1664100,1397124,-266976
360000.0,3,1.5,1060,6232,1.0,0,0,3,7,1060,0,1968,0.0,98118,47.5329,-122.271,1120,5379,5172,0.8299101412066753,1123600,38837824,37714224
425000.0,3,1.0,1240,5750,1.0,0,0,3,6,1240,0,1948,0.0,98116,47.56399999999999,-122.398,1240,5750,4510,0.7843478260869565,1537600,33062500,31524900
239950.0,2,1.0,1280,5500,1.0,0,0,2,7,1280,0,1949,0.0,98118,47.5179,-122.264,1270,5500,4220,0.7672727272727272,1638400,30250000,28611600
577500.0,2,2.5,2330,3000,2.0,0,3,2,8,2330,0,1915,1994.0,98144,47.5953,-122.294,1760,4000,670,0.22333333333333333,5428900,9000000,3571100
615000.0,3,1.75,2360,7291,1.0,0,0,3,8,1360,1000,1948,0.0,98136,47.5274,-122.384,1860,5499,4931,0.6763132629268962,5569600,53158681,47589081
516000.0,4,2.75,2210,10800,1.0,0,0,3,8,1170,1040,1997,0.0,98074,47.6086,-122.059,2210,10800,8590,0.7953703703703704,4884100,116640000,111755900
1220000.0,4,2.75,3670,15400,2.0,0,3,3,10,3670,0,1986,0.0,98006,47.5581,-122.156,3370,13300,11730,0.7616883116883116,13468900,237160000,223691100
1660000.0,4,3.5,3080,4815,2.0,0,3,2,10,2300,780,1937,2009.0,98199,47.6417,-122.411,2910,5350,1735,0.3603322949117342,9486400,23184225,13697825
315000.0,2,1.0,770,6731,1.0,0,0,3,6,770,0,1943,0.0,98155,47.7505,-122.31200000000001,1120,9212,5961,0.8856039221512405,592900,45306361,44713461
250000.0,4,2.0,2600,9000,1.0,0,0,2,8,1410,1190,1959,0.0,98032,47.381,-122.29899999999999,2600,7200,6400,0.7111111111111111,6760000,81000000,74240000
250000.0,4,1.5,1220,4900,1.0,0,0,2,6,1220,0,1942,0.0,98118,47.5292,-122.26899999999999,1410,3000,3680,0.7510204081632653,1488400,24010000,22521600
925000.0,4,2.5,2910,48351,1.0,0,0,3,8,1910,1000,1967,0.0,98005,47.6495,-122.164,2760,43560,45441,0.9398151020661414,8468100,2337819201,2329351101
358000.0,3,1.0,1150,4681,1.0,0,0,2,7,1150,0,1955,0.0,98133,47.7284,-122.336,1150,6800,3531,0.7543259987182226,1322500,21911761,20589261
262000.0,3,2.5,1700,6200,2.0,0,0,2,8,1700,0,1997,0.0,98092,47.2621,-122.221,1720,6205,4500,0.7258064516129032,2890000,38440000,35550000
500000.0,3,1.75,1220,7370,1.0,0,0,3,7,1220,0,1964,0.0,98008,47.6334,-122.12,1580,8213,6150,0.8344640434192673,1488400,54316900,52828500
1300000.0,5,1.0,1670,6400,1.5,0,0,2,8,1670,0,1919,0.0,98119,47.6542,-122.37299999999999,1910,2983,4730,0.7390625,2788900,40960000,38171100
500000.0,3,1.75,2420,65501,2.0,0,1,2,8,2420,0,1984,0.0,98074,47.6525,-122.087,2970,19036,63081,0.9630539991755851,5856400,4290381001,4284524601
675000.0,3,2.25,2610,9002,2.0,0,0,2,9,2610,0,1988,0.0,98052,47.6909,-122.104,2320,8306,6392,0.7100644301266386,6812100,81036004,74223904
235000.0,3,1.0,960,5030,1.0,0,0,2,7,960,0,1955,0.0,98118,47.5611,-122.28,1460,5400,4070,0.8091451292246521,921600,25300900,24379300
545000.0,3,1.0,960,5030,1.0,0,0,2,7,960,0,1955,0.0,98118,47.5611,-122.28,1460,5400,4070,0.8091451292246521,921600,25300900,24379300
350000.0,3,1.0,1010,9360,1.0,0,0,2,6,1010,0,1981,0.0,98033,47.6874,-122.16799999999999,1470,9360,8350,0.8920940170940171,1020100,87609600,86589500
320000.0,2,2.25,1550,1827,2.0,0,0,2,8,1550,0,2008,0.0,98106,47.5394,-122.368,1420,1826,277,0.15161466885604816,2402500,3337929,935429
452000.0,5,2.5,5067,13315,1.0,0,2,2,9,3154,1913,1968,0.0,98003,47.3391,-122.325,2860,13957,8248,0.6194517461509575,25674489,177289225,151614736
875000.0,3,2.0,2350,6000,1.5,0,0,3,8,1990,360,1922,0.0,98102,47.6476,-122.32,2010,5040,3650,0.6083333333333333,5522500,36000000,30477500
325000.0,3,1.5,1310,2998,2.0,0,0,2,7,1310,0,1998,0.0,98144,47.5873,-122.29899999999999,1310,2997,1688,0.5630420280186791,1716100,8988004,7271904
756000.0,4,2.25,2160,5600,1.0,0,0,4,7,1080,0,1947,0.0,98119,47.6442,-122.37200000000001,1850,5150,3440,0.6142857142857143,4665600,31360000,26694400
319000.0,4,2.5,2510,7992,1.0,0,0,2,8,1610,900,1978,0.0,98032,47.3715,-122.285,2030,7992,5482,0.6859359359359359,6300100,63872064,57571964
455000.0,3,1.75,890,3800,1.5,0,0,2,7,750,140,1926,0.0,98115,47.6803,-122.291,1280,3800,2910,0.7657894736842106,792100,14440000,13647900
330000.0,2,1.0,1129,3840,1.0,0,0,2,7,1129,0,1953,0.0,98106,47.5313,-122.351,1300,3880,2711,0.7059895833333333,1274641,14745600,13470959
510000.0,4,3.25,1980,9988,1.0,0,0,2,8,1340,640,1980,0.0,98052,47.6883,-122.111,1980,8972,8008,0.801762114537445,3920400,99760144,95839744
532000.0,3,1.0,2360,5012,1.0,0,0,2,7,1560,800,1964,0.0,98116,47.5705,-122.384,1690,4800,2652,0.5291300877893057,5569600,25120144,19550544
775000.0,3,2.5,2480,5007,2.0,0,0,2,8,1960,520,2014,0.0,98117,47.6974,-122.369,1650,7806,2527,0.5046934291991212,6150400,25070049,18919649
410000.0,3,1.75,2160,4000,1.0,0,0,2,7,1080,1080,1953,0.0,98144,47.5721,-122.309,1260,3200,1840,0.46,4665600,16000000,11334400
205000.0,2,1.75,1740,5100,1.0,0,0,2,6,580,1160,1915,0.0,98108,47.5211,-122.33,1440,5100,3360,0.6588235294117647,3027600,26010000,22982400
585000.0,4,2.5,2430,6766,2.0,0,0,2,8,2430,0,1999,0.0,98177,47.7294,-122.35799999999999,1820,6772,4336,0.6408513154005321,5904900,45778756,39873856
255000.0,2,1.75,1950,8200,1.0,0,0,2,8,1950,0,1975,0.0,98023,47.3161,-122.382,2370,8000,6250,0.7621951219512195,3802500,67240000,63437500
415000.0,2,1.0,910,3750,1.0,0,0,2,7,910,0,1904,0.0,98117,47.6772,-122.369,1160,4000,2840,0.7573333333333333,828100,14062500,13234400
459000.0,4,2.0,2360,7080,1.0,0,0,4,6,1180,1180,1925,0.0,98126,47.5261,-122.376,1340,7200,4720,0.6666666666666666,5569600,50126400,44556800
354000.0,3,1.0,1130,11250,1.0,0,0,2,7,1130,0,1965,0.0,98034,47.7254,-122.227,1410,11250,10120,0.8995555555555556,1276900,126562500,125285600
587000.0,3,2.5,2150,5193,2.0,0,0,2,8,2150,0,1995,0.0,98033,47.6952,-122.18700000000001,2150,7172,3043,0.5859811284421337,4622500,26967249,22344749
782000.0,4,3.5,5270,53428,2.0,0,0,2,10,3440,1830,2004,0.0,98058,47.4358,-122.085,2340,30904,48158,0.9013625814179831,27772900,2854551184,2826778284
570000.0,3,1.5,1300,7287,1.0,0,0,3,7,1300,0,1965,0.0,98033,47.6889,-122.18700000000001,1300,9129,5987,0.8216001097845478,1690000,53100369,51410369
414500.0,3,1.0,1050,6002,1.0,0,0,2,7,840,210,1941,0.0,98115,47.6988,-122.316,1180,6003,4952,0.8250583138953682,1102500,36024004,34921504
185000.0,4,1.0,1380,6700,1.0,0,0,2,7,1190,190,1928,0.0,98168,47.4871,-122.281,1380,8292,5320,0.7940298507462686,1904400,44890000,42985600
262500.0,3,1.5,1610,10291,1.0,0,0,3,7,1610,0,1961,0.0,98022,47.2025,-121.999,1410,7729,8681,0.8435526187931202,2592100,105904681,103312581
370000.0,4,2.75,3150,67518,1.0,0,0,3,9,2250,900,1965,0.0,98092,47.3382,-122.196,2210,32391,64368,0.953345774460144,9922500,4558680324,4548757824
362500.0,3,1.0,1520,9507,1.0,0,0,2,7,1520,0,1954,0.0,98125,47.7162,-122.324,1360,7219,7987,0.8401178079309982,2310400,90383049,88072649
536000.0,3,2.5,1990,7397,2.0,0,0,2,9,1990,0,1993,0.0,98072,47.7703,-122.165,2210,7397,5407,0.7309720156820333,3960100,54715609,50755509
425000.0,5,2.0,2500,7804,1.5,0,0,2,7,1570,930,1921,0.0,98146,47.5031,-122.348,1170,7676,5304,0.6796514607893388,6250000,60902416,54652416
435000.0,3,2.25,1890,7200,1.0,0,0,3,7,1230,660,1973,0.0,98125,47.7156,-122.31700000000001,1970,8101,5310,0.7375,3572100,51840000,48267900
435000.0,5,2.0,1840,9240,1.0,0,0,3,7,1540,300,1942,0.0,98133,47.7308,-122.34,1200,5250,7400,0.8008658008658008,3385600,85377600,81992000
400000.0,2,1.0,1220,6300,1.0,0,0,2,7,760,460,1942,0.0,98136,47.5299,-122.387,1850,4886,5080,0.8063492063492064,1488400,39690000,38201600
446000.0,2,1.5,1370,1221,2.0,0,0,2,8,1080,290,2008,0.0,98122,47.6039,-122.307,1560,2081,-149,-0.12203112203112203,1876900,1490841,-386059
1250000.0,3,2.5,2710,13120,1.0,0,0,2,10,2710,0,1959,0.0,98105,47.6718,-122.256,3130,13566,10410,0.7934451219512195,7344100,172134400,164790300
300000.0,3,2.25,1760,5421,2.0,0,0,2,7,1760,0,1991,0.0,98038,47.3484,-122.037,1570,6000,3661,0.6753366537539199,3097600,29387241,26289641
404500.0,2,1.0,800,5080,1.0,0,0,2,7,800,0,1938,0.0,98115,47.6978,-122.314,1560,5110,4280,0.84251968503937,640000,25806400,25166400
910000.0,4,2.5,3530,49222,2.0,0,0,3,9,3530,0,1986,0.0,98072,47.7285,-122.11200000000001,3750,49222,45692,0.9282841006054203,12460900,2422805284,2410344384
771000.0,3,2.25,1780,6120,1.5,0,0,3,9,1390,390,1927,0.0,98122,47.6025,-122.286,1960,5568,4340,0.7091503267973857,3168400,37454400,34286000
335000.0,4,2.5,2610,4781,2.0,0,0,2,8,2610,0,2009,0.0,98001,47.2649,-122.292,2583,4796,2171,0.4540891026981803,6812100,22857961,16045861
390000.0,3,1.75,1850,15170,1.0,0,0,2,7,1850,0,1965,0.0,98045,47.4991,-121.774,1160,14175,13320,0.8780487804878049,3422500,230128900,226706400
288000.0,3,2.25,1560,9706,1.0,0,0,3,7,1560,0,1963,0.0,98002,47.3191,-122.213,1510,9706,8146,0.8392746754584793,2433600,94206436,91772836
403000.0,3,1.75,1270,10790,1.0,0,0,2,7,1270,0,1956,0.0,98033,47.6647,-122.177,1270,10790,9520,0.8822984244670992,1612900,116424100,114811200
510000.0,3,2.25,1420,1309,3.0,0,0,2,8,1420,0,2006,0.0,98103,47.6534,-122.346,1500,1282,-111,-0.08479755538579067,2016400,1713481,-302919
751000.0,6,3.0,2880,6800,2.0,0,0,2,7,2880,0,1980,0.0,98144,47.5873,-122.29899999999999,1640,4000,3920,0.5764705882352941,8294400,46240000,37945600
408000.0,3,1.0,1420,8000,1.0,0,4,2,7,1420,0,1950,0.0,98118,47.5169,-122.255,1780,8295,6580,0.8225,2016400,64000000,61983600
1010000.0,3,1.0,1640,12855,1.5,0,0,4,6,1500,140,1920,0.0,98004,47.6169,-122.212,2190,11262,11215,0.8724231816413847,2689600,165251025,162561425
575000.0,3,2.0,1730,9030,1.0,0,0,3,7,1730,0,1956,0.0,98007,47.5875,-122.134,1470,9030,7300,0.8084163898117387,2992900,81540900,78548000
330000.0,3,1.75,1250,8100,1.0,0,0,2,7,1250,0,1951,0.0,98146,47.5016,-122.348,1300,8175,6850,0.845679012345679,1562500,65610000,64047500
565000.0,3,2.25,1520,1221,3.0,0,0,2,8,1520,0,2013,0.0,98107,47.674,-122.37700000000001,1550,4750,-299,-0.24488124488124488,2310400,1490841,-819559
456000.0,3,2.5,1820,2935,2.0,0,0,2,8,1820,0,1999,0.0,98074,47.6018,-122.021,1820,2936,1115,0.3798977853492334,3312400,8614225,5301825
652500.0,4,2.5,2700,9122,2.0,0,0,2,9,2700,0,1990,0.0,98029,47.5771,-121.994,2500,9122,6422,0.7040122780092085,7290000,83210884,75920884
582000.0,3,1.75,1820,3140,2.0,0,0,4,8,1820,0,1949,1990.0,98136,47.5271,-122.384,2030,5499,1320,0.42038216560509556,3312400,9859600,6547200
700000.0,4,2.5,2770,5686,2.0,0,0,2,9,2770,0,2004,0.0,98075,47.5997,-121.973,2910,5000,2916,0.5128385508265916,7672900,32330596,24657696
235000.0,2,1.0,1270,9182,1.5,0,0,2,6,1270,0,1917,0.0,98126,47.5365,-122.37799999999999,1760,9100,7912,0.8616859072097582,1612900,84309124,82696224
460000.0,3,1.75,1400,12155,1.0,0,0,3,7,1400,0,1977,0.0,98075,47.5926,-122.04700000000001,2540,23522,10755,0.8848210612916495,1960000,147744025,145784025
475000.0,3,2.25,1820,8008,1.0,0,0,2,8,1240,580,1981,0.0,98052,47.7206,-122.11,2030,8750,6188,0.7727272727272727,3312400,64128064,60815664
579000.0,2,2.0,1870,6275,1.0,0,0,2,8,1870,0,2003,0.0,98053,47.7108,-122.031,1670,5200,4405,0.7019920318725099,3496900,39375625,35878725
507000.0,4,2.0,1360,2746,1.5,0,0,2,7,1360,0,1945,2011.0,98107,47.6736,-122.39,1960,2746,1386,0.504734158776402,1849600,7540516,5690916
210000.0,3,2.5,1040,2643,2.0,0,0,2,7,720,320,2004,0.0,98118,47.5165,-122.26799999999999,1540,5110,1603,0.6065077563374953,1081600,6985449,5903849
359500.0,4,2.75,2140,10316,2.0,0,0,2,8,2140,0,1993,0.0,98001,47.3537,-122.274,1920,11337,8176,0.7925552539744087,4579600,106419856,101840256
248000.0,3,1.75,1330,9831,1.0,0,0,2,7,1330,0,1987,0.0,98001,47.3304,-122.277,1330,7500,8501,0.8647136608686807,1768900,96648561,94879661
239300.0,3,1.0,1070,5750,1.0,0,0,2,7,1070,0,1952,0.0,98178,47.5071,-122.255,1420,6500,4680,0.8139130434782609,1144900,33062500,31917600
315000.0,3,2.25,1370,1533,3.0,0,0,2,8,1370,0,2009,0.0,98133,47.7326,-122.34299999999999,1370,1125,163,0.10632746249184605,1876900,2350089,473189
970000.0,4,3.0,3510,12410,2.0,0,0,3,9,3510,0,1976,0.0,98005,47.6381,-122.166,3000,13209,8900,0.717163577759871,12320100,154008100,141688000
510000.0,3,1.5,1730,6240,1.0,0,1,2,8,1000,730,1954,0.0,98136,47.5282,-122.391,1620,6240,4510,0.7227564102564102,2992900,38937600,35944700
418000.0,4,1.5,1550,9176,1.0,0,0,2,7,1000,550,1956,0.0,98008,47.6005,-122.12899999999999,1730,8539,7626,0.831081081081081,2402500,84198976,81796476
699000.0,4,2.5,3280,27441,2.0,0,0,2,9,3280,0,1996,0.0,98053,47.6711,-122.012,3200,26960,24161,0.8804708283225829,10758400,753008481,742250081
871000.0,4,2.5,2150,8536,1.0,0,3,3,8,1400,750,1967,0.0,98006,47.5663,-122.163,2800,9500,6386,0.7481255857544518,4622500,72863296,68240796
515000.0,3,1.75,1580,9147,1.0,0,1,3,7,1210,370,1967,0.0,98008,47.6069,-122.11200000000001,2600,23564,7567,0.8272657701978791,2496400,83667609,81171209
400000.0,3,1.0,1460,43000,1.0,0,0,2,7,1460,0,1952,0.0,98166,47.4434,-122.34700000000001,2250,20023,41540,0.966046511627907,2131600,1849000000,1846868400
445000.0,3,1.75,1410,5100,1.0,0,0,3,7,1110,300,1954,0.0,98125,47.7026,-122.29,1600,7800,3690,0.7235294117647059,1988100,26010000,24021900
1110000.0,4,2.75,3090,6600,1.0,0,2,2,9,1800,1290,1956,0.0,98199,47.6339,-122.396,2380,5000,3510,0.5318181818181819,9548100,43560000,34011900
212000.0,3,1.5,1690,9600,1.0,0,0,2,7,1210,480,1976,0.0,98038,47.3857,-122.079,1450,9647,7910,0.8239583333333333,2856100,92160000,89303900
710000.0,4,2.5,2870,11304,2.0,0,0,2,9,2870,0,1980,0.0,98006,47.5547,-122.154,2690,9940,8434,0.7461075725406936,8236900,127780416,119543516
225800.0,4,1.0,1100,7110,1.0,0,0,3,7,880,220,1907,0.0,98030,47.3858,-122.227,1150,7110,6010,0.8452883263009845,1210000,50552100,49342100
520000.0,3,1.75,2310,36665,1.0,0,2,2,8,1580,730,1983,0.0,98155,47.7697,-122.274,2000,14000,34355,0.9369971362334651,5336100,1344322225,1338986125
1300000.0,5,3.75,3490,15246,1.0,0,1,3,10,1940,1550,1968,0.0,98040,47.5479,-122.212,3410,15682,11756,0.7710874983602256,12180100,232440516,220260416
248000.0,4,2.0,2080,13510,1.0,0,0,2,7,1040,1040,1950,0.0,98178,47.4918,-122.258,2010,11625,11430,0.8460399703923019,4326400,182520100,178193700
556000.0,4,2.5,2230,7200,1.0,0,0,3,7,1220,1010,1957,0.0,98005,47.589,-122.156,1920,7200,4970,0.6902777777777778,4972900,51840000,46867100
319950.0,5,1.75,1710,11900,1.0,0,0,2,7,1070,640,1958,0.0,98146,47.506,-122.365,1030,10360,10190,0.8563025210084033,2924100,141610000,138685900
320000.0,4,2.75,1640,3000,1.0,0,0,2,7,1000,640,1984,0.0,98118,47.5625,-122.28299999999999,1150,4545,1360,0.4533333333333333,2689600,9000000,6310400
245000.0,3,2.5,1600,2788,2.0,0,0,3,7,1600,0,1992,0.0,98031,47.4034,-122.18700000000001,1720,3605,1188,0.4261119081779053,2560000,7772944,5212944
700000.0,3,2.5,2850,36585,2.0,0,0,2,10,2850,0,1987,0.0,98072,47.7376,-122.102,3340,35671,33735,0.9220992209922099,8122500,1338462225,1330339725
628000.0,5,2.75,2600,8160,2.0,0,0,2,8,2600,0,2015,0.0,98133,47.7348,-122.34,1600,8160,5560,0.6813725490196079,6760000,66585600,59825600
640000.0,3,2.0,1380,4800,1.0,0,0,2,7,1380,0,1948,0.0,98199,47.651,-122.369,1740,5640,3420,0.7125,1904400,23040000,21135600
420000.0,4,1.75,1320,4978,1.0,0,0,3,7,940,380,1942,0.0,98126,47.5266,-122.37899999999999,1260,4693,3658,0.7348332663720369,1742400,24780484,23038084
349950.0,3,2.5,1420,1162,3.0,0,0,2,8,1420,0,2002,0.0,98103,47.6982,-122.34899999999999,1430,1560,-258,-0.22203098106712565,2016400,1350244,-666156
307999.0,4,2.75,2420,8438,2.0,0,0,2,8,2420,0,1996,0.0,98022,47.2091,-122.009,2420,8580,6018,0.7132021806115193,5856400,71199844,65343444
749950.0,4,2.75,2600,6050,2.0,0,0,4,8,1960,640,1949,0.0,98116,47.5656,-122.4,1990,6050,3450,0.5702479338842975,6760000,36602500,29842500
290000.0,2,1.0,840,3844,1.0,0,0,3,6,840,0,1919,0.0,98133,47.7048,-122.34700000000001,1040,3844,3004,0.7814776274713839,705600,14776336,14070736
235000.0,3,1.75,1420,7920,1.0,0,0,3,7,1420,0,1962,0.0,98092,47.2931,-122.18799999999999,1420,7920,6500,0.8207070707070707,2016400,62726400,60710000
225000.0,3,1.0,1790,6120,1.0,0,0,2,6,1790,0,1937,1964.0,98146,47.508,-122.337,830,6120,4330,0.7075163398692811,3204100,37454400,34250300
302100.0,3,1.0,1790,6120,1.0,0,0,2,6,1790,0,1937,1964.0,98146,47.508,-122.337,830,6120,4330,0.7075163398692811,3204100,37454400,34250300
520000.0,2,1.0,1340,6380,1.0,0,0,2,7,890,450,1939,0.0,98115,47.696999999999996,-122.31299999999999,1380,6380,5040,0.7899686520376176,1795600,40704400,38908800
285000.0,2,1.0,1010,7200,1.0,0,0,2,7,1010,0,1975,0.0,98155,47.7651,-122.291,1890,9248,6190,0.8597222222222223,1020100,51840000,50819900
525000.0,3,2.0,1640,15258,1.0,0,0,2,8,1640,0,1981,0.0,98074,47.6301,-122.037,1640,16345,13618,0.8925154017564556,2689600,232806564,230116964
374900.0,5,2.75,2980,8500,1.0,0,0,2,8,1540,1440,1982,0.0,98032,47.3641,-122.27799999999999,2310,8500,5520,0.6494117647058824,8880400,72250000,63369600
377500.0,3,2.0,1370,7200,1.0,0,0,2,7,1130,240,1926,1955.0,98125,47.7329,-122.30799999999999,1300,7208,5830,0.8097222222222222,1876900,51840000,49963100
587450.0,3,2.25,2190,8775,1.5,0,1,3,8,2190,0,1927,0.0,98125,47.7303,-122.287,1910,8145,6585,0.7504273504273504,4796100,77000625,72204525
245000.0,3,2.25,1530,12000,1.0,0,0,2,7,1070,460,1979,0.0,98023,47.2715,-122.338,2140,13636,10470,0.8725,2340900,144000000,141659100
200000.0,3,2.0,1290,5757,1.0,0,0,2,7,1290,0,1994,0.0,98092,47.3175,-122.17,1580,6798,4467,0.7759249609171444,1664100,33143049,31478949
2140000.0,4,3.75,5150,453895,2.0,0,3,2,11,4360,790,1997,0.0,98053,47.6795,-121.991,2500,215186,448745,0.9886537635356195,26522500,206020671025,205994148525
607000.0,3,2.5,2470,9226,2.0,0,0,2,9,2470,0,1991,0.0,98072,47.7439,-122.17,2820,11013,6756,0.732278343810969,6100900,85119076,79018176
1250000.0,1,1.25,1810,5070,1.5,1,4,3,8,1230,580,1967,0.0,98075,47.5814,-122.081,2280,5070,3260,0.6429980276134122,3276100,25704900,22428800
549950.0,4,2.5,2230,14694,1.0,0,0,3,7,1180,1050,1981,0.0,98074,47.6305,-122.03399999999999,1470,13458,12464,0.8482373757996461,4972900,215913636,210940736
250000.0,3,3.0,2300,7701,1.0,0,0,2,7,2300,0,1960,0.0,98056,47.5102,-122.18,1570,8116,5401,0.7013374886378393,5290000,59305401,54015401
525000.0,3,2.5,2030,6970,2.0,0,0,3,8,2030,0,1991,0.0,98029,47.5718,-121.999,2000,6140,4940,0.7087517934002869,4120900,48580900,44460000
440000.0,3,1.75,2000,9900,1.0,0,2,3,8,1480,520,1957,0.0,98166,47.4436,-122.339,2310,10200,7900,0.797979797979798,4000000,98010000,94010000
425000.0,3,2.75,3610,107386,1.5,0,3,2,8,3130,480,1918,1962.0,98023,47.3351,-122.36200000000001,2630,42126,103776,0.9663829549475723,13032100,11531752996,11518720896
739900.0,5,2.5,3290,5029,2.0,0,0,2,8,3290,0,2004,0.0,98075,47.5773,-122.056,2990,6441,1739,0.34579439252336447,10824100,25290841,14466741
315000.0,3,2.0,1300,3731,1.0,0,0,2,7,900,400,1993,0.0,98118,47.5374,-122.27,1300,3731,2431,0.6515679442508711,1690000,13920361,12230361
340000.0,5,1.0,1880,3774,1.5,0,0,2,6,1360,520,1917,0.0,98126,47.566,-122.37,1420,2550,1894,0.501854795972443,3534400,14243076,10708676
366000.0,4,2.75,2170,9743,2.0,0,0,2,7,2170,0,1995,0.0,98038,47.3814,-122.024,1670,7734,7573,0.7772759930206302,4708900,94926049,90217149
315000.0,3,1.75,1680,7250,1.0,0,0,2,7,930,750,1952,0.0,98133,47.7201,-122.35,1340,7250,5570,0.7682758620689655,2822400,52562500,49740100
299000.0,3,1.5,1190,9135,1.0,0,0,3,7,1190,0,1959,0.0,98056,47.5164,-122.189,1520,9146,7945,0.8697318007662835,1416100,83448225,82032125
350000.0,2,1.0,940,5000,1.0,0,0,2,7,940,0,1950,0.0,98155,47.7518,-122.279,1800,7400,4060,0.812,883600,25000000,24116400
340000.0,2,1.75,1010,1461,1.0,0,0,2,7,670,340,2003,0.0,98199,47.6515,-122.4,1500,2499,451,0.3086926762491444,1020100,2134521,1114421
460000.0,3,1.75,1290,8580,1.0,0,0,3,7,1290,0,1962,0.0,98033,47.6707,-122.17399999999999,1840,8580,7290,0.8496503496503497,1664100,73616400,71952300
224000.0,3,1.5,1480,10588,1.0,0,0,2,7,1480,0,1957,0.0,98002,47.2872,-122.212,1370,10588,9108,0.8602191159803552,2190400,112105744,109915344
140000.0,2,1.0,900,6400,1.0,0,0,1,6,900,0,1940,0.0,98118,47.5287,-122.281,1350,6405,5500,0.859375,810000,40960000,40150000
246000.0,4,2.0,1400,7632,1.5,0,0,4,6,1400,0,1930,0.0,98166,47.4625,-122.345,1400,7632,6232,0.8165618448637316,1960000,58247424,56287424
330000.0,3,2.5,2040,14071,2.0,0,0,2,7,2040,0,1995,0.0,98019,47.7278,-121.963,1890,14040,12031,0.8550209651055362,4161600,197993041,193831441
306000.0,3,1.0,1450,7200,1.0,0,0,2,7,1010,440,1969,0.0,98034,47.7311,-122.199,1500,6767,5750,0.7986111111111112,2102500,51840000,49737500
324950.0,3,1.0,1210,7440,1.0,0,0,2,7,1210,0,1949,0.0,98155,47.7402,-122.323,1120,7440,6230,0.8373655913978495,1464100,55353600,53889500
345000.0,2,1.5,1800,26615,1.0,0,0,4,7,1240,560,1987,0.0,98092,47.302,-122.12299999999999,2010,26337,24815,0.9323689648694345,3240000,708358225,705118225
207000.0,3,1.0,1490,8995,1.0,0,0,3,7,1490,0,1954,0.0,98168,47.4901,-122.303,1490,9000,7505,0.8343524180100056,2220100,80910025,78689925
238000.0,3,1.0,1240,5700,1.5,0,0,4,6,1240,0,1953,0.0,98056,47.4927,-122.169,1140,5700,4460,0.7824561403508772,1537600,32490000,30952400
695000.0,3,2.0,2632,18743,2.0,0,3,2,10,2632,0,2000,0.0,98070,47.3743,-122.421,1970,14171,16111,0.859574241049992,6927424,351300049,344372625
649950.0,3,2.5,2150,15304,2.0,0,0,3,9,2150,0,1979,0.0,98006,47.5573,-122.13600000000001,2540,10507,13154,0.8595138525875589,4622500,234212416,229589916
515000.0,3,2.75,1710,9448,1.0,0,0,2,7,1010,700,1947,0.0,98105,47.6693,-122.26700000000001,1960,8951,7738,0.8190093141405589,2924100,89264704,86340604
452000.0,3,2.5,1530,5032,2.0,0,0,2,7,1530,0,1998,0.0,98103,47.6985,-122.34899999999999,1450,2136,3502,0.6959459459459459,2340900,25321024,22980124
236000.0,4,2.5,1630,3060,2.0,0,0,2,7,1630,0,2003,0.0,98146,47.5072,-122.336,1270,4590,1430,0.4673202614379085,2656900,9363600,6706700
1290000.0,4,3.5,4080,14450,2.0,0,2,2,12,3210,870,1998,0.0,98006,47.5519,-122.10600000000001,4080,12114,10370,0.7176470588235294,16646400,208802500,192156100
563000.0,3,2.75,2340,16500,1.0,0,0,3,8,1500,840,1972,0.0,98075,47.5952,-122.051,2210,15251,14160,0.8581818181818182,5475600,272250000,266774400
410988.0,3,1.75,1000,14061,1.0,0,0,3,7,1000,0,1967,0.0,98072,47.7417,-122.09299999999999,1260,12635,13061,0.928881302894531,1000000,197711721,196711721
1200000.0,4,2.5,3180,13118,2.0,0,0,3,11,3180,0,1986,0.0,98040,47.5382,-122.23,3070,12861,9938,0.757584997713066,10112400,172081924,161969524
340000.0,4,2.5,2170,19785,2.0,0,0,2,8,2170,0,1992,0.0,98031,47.4034,-122.167,2280,8616,17615,0.8903209502148092,4708900,391446225,386737325
808100.0,4,3.25,3020,13457,1.0,0,0,4,9,3020,0,1956,0.0,98133,47.7174,-122.336,2120,7553,10437,0.7755814817567065,9120400,181090849,171970449
236000.0,3,1.75,1330,6301,1.0,0,0,2,7,1330,0,1998,0.0,98002,47.3411,-122.219,1330,6144,4971,0.7889223932709094,1768900,39702601,37933701
330000.0,4,1.75,1720,8300,1.0,0,0,3,8,1720,0,1965,0.0,98055,47.4654,-122.194,1840,8300,6580,0.7927710843373494,2958400,68890000,65931600
799990.0,4,3.5,2540,5808,2.0,0,0,4,8,1820,720,1910,1986.0,98117,47.6857,-122.376,1520,5461,3268,0.5626721763085399,6451600,33732864,27281264
343000.0,3,1.0,1410,18600,1.0,0,0,4,7,1410,0,1960,0.0,98059,47.5031,-122.152,1610,24941,17190,0.9241935483870968,1988100,345960000,343971900
332000.0,3,2.5,1530,9406,1.0,0,0,2,7,1270,260,1993,0.0,98059,47.4852,-122.162,1700,7682,7876,0.8373378694450351,2340900,88472836,86131936
945000.0,5,3.5,4380,14925,2.0,0,0,2,11,4380,0,2003,0.0,98075,47.5848,-121.969,4310,14633,10545,0.7065326633165829,19184400,222755625,203571225
239950.0,3,1.0,1140,8366,1.0,0,0,4,6,1140,0,1943,0.0,98058,47.4768,-122.177,960,7200,7226,0.8637341620846283,1299600,69989956,68690356
674000.0,5,1.75,2110,5000,1.5,0,0,3,7,1250,860,1946,0.0,98115,47.6745,-122.287,1720,5000,2890,0.578,4452100,25000000,20547900
200000.0,3,1.0,1050,5000,1.0,0,0,3,6,1050,0,1967,0.0,98056,47.4923,-122.165,1050,5200,3950,0.79,1102500,25000000,23897500
453000.0,3,1.75,1600,7232,1.0,0,0,2,8,1600,0,1966,0.0,98008,47.6293,-122.12100000000001,1970,8120,5632,0.7787610619469026,2560000,52301824,49741824
330000.0,3,1.75,1430,8865,1.0,0,0,2,7,1430,0,1950,0.0,98125,47.7331,-122.29899999999999,1250,8154,7435,0.8386914833615341,2044900,78588225,76543325
285000.0,4,2.5,1996,4547,2.0,0,0,2,7,1996,0,2009,0.0,98042,47.3365,-122.051,2180,5127,2551,0.5610292500549813,3984016,20675209,16691193
338000.0,4,1.75,1530,8152,1.0,0,0,4,6,910,620,1948,0.0,98155,47.7557,-122.32799999999999,1310,8152,6622,0.8123159960745829,2340900,66455104,64114204
264950.0,2,1.0,1000,6000,1.0,0,0,2,6,1000,0,1951,0.0,98126,47.5208,-122.37200000000001,1250,6000,5000,0.8333333333333334,1000000,36000000,35000000
880000.0,4,2.0,2530,10800,1.0,0,0,4,8,1350,1180,1954,0.0,98040,47.5705,-122.225,2960,12150,8270,0.7657407407407407,6400900,116640000,110239100
209500.0,3,1.5,970,5488,1.0,0,0,2,7,970,0,1976,0.0,98106,47.5366,-122.359,1040,5488,4518,0.8232507288629738,940900,30118144,29177244
380000.0,4,2.5,2400,9398,1.0,0,0,3,7,1310,1090,1958,0.0,98056,47.4952,-122.178,1330,8249,6998,0.7446265162800596,5760000,88322404,82562404
336500.0,3,2.0,1830,12891,1.0,0,0,2,7,1830,0,1994,0.0,98031,47.3924,-122.19200000000001,2320,8709,11061,0.8580404933674657,3348900,166177881,162828981
360000.0,3,2.25,2130,8466,1.0,0,0,2,7,1290,840,1983,0.0,98055,47.4537,-122.211,2250,9682,6336,0.7484053862508859,4536900,71673156,67136256
911100.0,4,3.25,3330,33826,2.0,0,0,4,8,3330,0,1924,0.0,98155,47.7596,-122.275,2580,28707,30496,0.9015550168509431,11088900,1144198276,1133109376
249900.0,2,1.0,560,7560,1.0,0,0,2,6,560,0,1944,0.0,98126,47.5271,-122.375,990,7560,7000,0.9259259259259259,313600,57153600,56840000
175000.0,4,1.0,1210,6250,1.0,0,0,2,7,1210,0,1962,0.0,98168,47.5008,-122.333,1210,8291,5040,0.8064,1464100,39062500,37598400
549950.0,3,2.5,2380,2500,3.0,0,3,2,9,2380,0,1988,0.0,98126,47.5734,-122.375,2270,5000,120,0.048,5664400,6250000,585600
225000.0,3,1.75,1370,10866,1.0,0,0,3,6,1370,0,1945,0.0,98052,47.6774,-122.164,1580,14250,9496,0.8739186453156635,1876900,118069956,116193056
270000.0,3,1.75,1370,10866,1.0,0,0,3,6,1370,0,1945,0.0,98052,47.6774,-122.164,1580,14250,9496,0.8739186453156635,1876900,118069956,116193056
400000.0,3,2.25,1740,11040,2.0,0,0,2,8,1740,0,1980,0.0,98028,47.7376,-122.242,1720,11778,9300,0.842391304347826,3027600,121881600,118854000
299800.0,2,1.0,790,5240,1.0,0,0,3,6,790,0,1925,0.0,98118,47.5303,-122.288,1430,5320,4450,0.8492366412213741,624100,27457600,26833500
555000.0,3,2.5,2480,8676,2.0,0,0,3,8,2480,0,1989,0.0,98056,47.53,-122.17200000000001,2540,9496,6196,0.7141539880129092,6150400,75272976,69122576
230000.0,3,2.5,1920,9180,2.0,0,0,2,8,1920,0,1988,0.0,98055,47.4818,-122.23100000000001,1930,7252,7260,0.7908496732026143,3686400,84272400,80586000
360000.0,4,2.5,2750,6259,2.0,0,0,2,9,2750,0,2002,0.0,98092,47.3304,-122.179,2810,6824,3509,0.5606326889279437,7562500,39175081,31612581
415000.0,2,1.0,880,3200,1.0,0,0,2,7,880,0,1910,1970.0,98199,47.6575,-122.402,1880,6000,2320,0.725,774400,10240000,9465600
355000.0,4,1.75,2160,8000,1.0,0,0,3,9,1660,500,1976,0.0,98023,47.3165,-122.382,2350,8200,5840,0.73,4665600,64000000,59334400
635000.0,4,2.5,2570,27972,2.0,0,0,2,8,2570,0,1997,0.0,98053,47.6343,-121.969,2500,29761,25402,0.9081224081224081,6604900,782432784,775827884
353000.0,5,2.75,2130,5000,1.0,0,0,4,7,1100,1030,1978,0.0,98118,47.5271,-122.274,1340,6837,2870,0.574,4536900,25000000,20463100
999000.0,7,4.0,3150,34830,1.0,0,0,2,9,3150,0,1957,2005.0,98007,47.6029,-122.147,2390,12054,31680,0.9095607235142119,9922500,1213128900,1203206400
265000.0,3,1.5,1780,10196,1.0,0,0,3,7,1270,510,1967,0.0,98001,47.3375,-122.291,1320,7875,8416,0.8254217340133385,3168400,103958416,100790016
250000.0,4,1.75,1910,8250,1.0,0,0,3,7,1910,0,1959,0.0,98008,47.6131,-122.12299999999999,1500,8250,6340,0.7684848484848484,3648100,68062500,64414400
225000.0,2,1.0,1170,7142,1.0,0,0,2,7,1170,0,1951,0.0,98155,47.7497,-122.31299999999999,1170,7615,5972,0.836180341640997,1368900,51008164,49639264
553000.0,2,1.0,900,5000,1.0,0,0,2,7,900,0,1944,0.0,98117,47.6883,-122.395,1280,5000,4100,0.82,810000,25000000,24190000
565000.0,5,2.5,2650,11455,1.0,0,0,2,7,1400,1250,1961,0.0,98008,47.6141,-122.116,1960,9880,8805,0.7686599738105631,7022500,131217025,124194525
312000.0,2,1.0,1170,5150,1.0,0,0,2,6,980,190,1907,0.0,98118,47.5503,-122.28299999999999,1660,5150,3980,0.7728155339805826,1368900,26522500,25153600
475000.0,3,2.5,2630,185130,2.0,0,0,2,9,2630,0,1991,0.0,98014,47.7035,-121.89399999999999,2630,210394,182500,0.9857937665424297,6916900,34273116900,34266200000
320000.0,4,2.75,2150,9163,1.0,0,0,2,8,1340,810,1992,0.0,98003,47.26600000000001,-122.307,2260,7750,7013,0.7653606897304376,4622500,83960569,79338069
453000.0,3,2.0,1430,9583,1.0,0,0,3,7,1430,0,1964,0.0,98034,47.7206,-122.197,1890,11100,8153,0.8507774183449859,2044900,91833889,89788989
320000.0,3,1.0,960,6180,1.0,0,0,3,6,960,0,1910,0.0,98118,47.5518,-122.279,1250,4120,5220,0.8446601941747572,921600,38192400,37270800
610000.0,4,2.75,2640,8400,1.0,0,2,2,8,1440,1200,1947,0.0,98144,47.5882,-122.29,2610,6000,5760,0.6857142857142857,6969600,70560000,63590400
385000.0,3,1.5,1490,9630,1.0,0,0,3,8,1490,0,1959,0.0,98028,47.7623,-122.256,1960,10469,8140,0.8452751817237798,2220100,92736900,90516800
215000.0,3,1.75,1210,8075,1.0,0,0,3,6,1210,0,1983,0.0,98001,47.2666,-122.25399999999999,1310,8025,6865,0.8501547987616099,1464100,65205625,63741525
215000.0,4,1.5,1860,5040,1.5,0,0,4,8,1860,0,1920,0.0,98022,47.2077,-121.993,1680,5800,3180,0.6309523809523809,3459600,25401600,21942000
415000.0,3,2.5,1980,4274,2.0,0,0,2,7,1980,0,2003,0.0,98028,47.7767,-122.23899999999999,2000,4394,2294,0.5367337388862892,3920400,18267076,14346676
350000.0,1,1.0,900,6380,1.0,0,0,2,6,900,0,1947,0.0,98125,47.7019,-122.311,1830,6380,5480,0.8589341692789969,810000,40704400,39894400
395000.0,1,1.0,900,6380,1.0,0,0,2,6,900,0,1947,0.0,98125,47.7019,-122.311,1830,6380,5480,0.8589341692789969,810000,40704400,39894400
898000.0,2,1.75,1490,9874,1.0,0,0,3,7,1490,0,1963,0.0,98004,47.6246,-122.199,2280,9869,8384,0.8490986429005469,2220100,97495876,95275776
480000.0,3,2.5,2980,7338,2.0,0,0,2,8,2980,0,2006,0.0,98055,47.437,-122.20700000000001,3010,5267,4358,0.5938947942218589,8880400,53846244,44965844
1240000.0,3,2.5,2660,1973,3.0,0,3,2,9,1870,790,2007,0.0,98119,47.6264,-122.36399999999999,1640,1369,-687,-0.3482007095793208,7075600,3892729,-3182871
599000.0,4,2.5,2790,230868,2.0,0,0,2,8,2790,0,1989,0.0,98077,47.7647,-122.01899999999999,1590,217800,228078,0.9879151723062529,7784100,53300033424,53292249324
770000.0,4,3.0,2800,9127,2.0,0,0,2,9,2800,0,1999,0.0,98074,47.6123,-122.007,2780,8165,6327,0.6932179248383916,7840000,83302129,75462129
1210000.0,3,2.25,1590,8520,2.0,0,0,3,8,1590,0,1980,0.0,98004,47.6477,-122.21600000000001,2470,12005,6930,0.8133802816901409,2528100,72590400,70062300
1590000.0,4,2.25,3240,11131,1.0,0,0,3,9,2080,1160,1953,0.0,98004,47.6182,-122.215,2300,12150,7891,0.7089210313538765,10497600,123899161,113401561
880000.0,3,2.0,2130,35169,1.0,0,0,3,8,2130,0,1989,0.0,98072,47.7489,-122.12299999999999,2860,43560,33039,0.9394352981318775,4536900,1236858561,1232321661
332000.0,3,2.0,1510,7884,1.0,0,0,2,6,1510,0,1942,2014.0,98166,47.4683,-122.348,1050,7620,6374,0.8084728564180619,2280100,62157456,59877356
445000.0,3,1.75,1750,7200,1.0,0,0,2,7,1750,0,1966,0.0,98008,47.6289,-122.119,1810,7590,5450,0.7569444444444444,3062500,51840000,48777500
849000.0,4,2.75,4010,87555,2.0,0,0,2,10,4010,0,2004,0.0,98038,47.4299,-121.99799999999999,2451,209523,83545,0.9542002170064531,16080100,7665878025,7649797925
752000.0,4,1.5,1650,2970,1.5,0,0,2,7,1650,0,1903,0.0,98102,47.6233,-122.319,1670,2970,1320,0.4444444444444444,2722500,8820900,6098400
450000.0,9,7.5,4050,6504,2.0,0,0,2,7,4050,0,1996,0.0,98144,47.5923,-122.301,1448,3866,2454,0.3773062730627306,16402500,42302016,25899516
420000.0,3,1.0,1320,5500,1.0,0,0,2,7,1320,0,1955,0.0,98116,47.5705,-122.398,1480,5250,4180,0.76,1742400,30250000,28507600
330000.0,4,2.5,2310,6320,2.0,0,0,2,8,2310,0,1997,0.0,98092,47.3287,-122.167,1850,6181,4010,0.634493670886076,5336100,39942400,34606300
409000.0,3,1.75,1440,9065,1.0,0,0,3,8,1440,0,1972,0.0,98133,47.7163,-122.333,1990,8812,7625,0.8411472697186982,2073600,82174225,80100625
350000.0,5,1.75,2330,14322,1.0,0,0,3,7,1180,1150,1968,0.0,98059,47.4768,-122.155,1690,10010,11992,0.8373132244099986,5428900,205119684,199690784
570000.0,4,2.5,2430,44001,1.0,0,0,2,8,2430,0,1994,0.0,98019,47.7125,-121.916,2200,46924,41571,0.9447739824094907,5904900,1936088001,1930183101
315000.0,3,1.0,1390,8333,1.0,0,0,2,7,1390,0,1982,0.0,98155,47.7652,-122.31,1320,7090,6943,0.8331933277331093,1932100,69438889,67506789
224000.0,2,1.0,1150,15000,1.0,0,0,2,6,1060,90,1930,2013.0,98168,47.4935,-122.316,1350,15000,13850,0.9233333333333333,1322500,225000000,223677500
293550.0,4,1.75,2120,9706,1.0,0,0,2,7,1370,750,1965,0.0,98168,47.4939,-122.29700000000001,1730,11337,7586,0.7815784051102411,4494400,94206436,89712036
350000.0,4,2.75,2300,3175,1.5,0,0,2,6,1340,960,1966,0.0,98144,47.5732,-122.305,1260,3175,875,0.2755905511811024,5290000,10080625,4790625
1110000.0,4,2.5,3320,9380,2.0,0,3,2,10,3320,0,1988,0.0,98006,47.5655,-122.11399999999999,2870,11779,6060,0.6460554371002132,11022400,87984400,76962000
442500.0,4,2.5,2400,7092,2.0,0,0,2,7,2400,0,1997,0.0,98133,47.7522,-122.338,2350,8310,4692,0.6615905245346869,5760000,50296464,44536464
616500.0,3,2.5,3580,118047,1.0,0,0,2,9,3240,340,1992,0.0,98027,47.4453,-121.98,3240,123275,114467,0.9696730963090973,12816400,13935094209,13922277809
506400.0,3,2.5,2100,9040,1.0,0,0,2,8,1700,400,1989,0.0,98056,47.5329,-122.17299999999999,2430,8809,6940,0.7676991150442478,4410000,81721600,77311600
324000.0,3,2.25,1550,4411,2.0,0,0,2,7,1550,0,2001,0.0,98019,47.7373,-121.96600000000001,1620,4621,2861,0.6486057583314441,2402500,19456921,17054421
169000.0,3,1.5,1570,6450,1.5,0,0,3,6,1570,0,1931,0.0,98022,47.2021,-121.99600000000001,1400,6450,4880,0.7565891472868217,2464900,41602500,39137600
595000.0,3,2.0,1480,5000,1.0,0,0,3,7,750,730,1928,0.0,98117,47.6859,-122.37,1250,4000,3520,0.704,2190400,25000000,22809600
299900.0,3,2.5,2720,6014,2.0,0,0,2,7,2720,0,2002,0.0,98092,47.3344,-122.17399999999999,2760,6537,3294,0.5477219820419023,7398400,36168196,28769796
332000.0,3,2.25,2270,8876,1.0,0,0,2,7,1380,890,1977,0.0,98058,47.4653,-122.176,2150,7455,6606,0.7442541685443894,5152900,78783376,73630476
432000.0,4,1.75,2410,8400,1.0,0,0,2,7,1600,810,1978,0.0,98011,47.7341,-122.2,1850,8400,5990,0.7130952380952381,5808100,70560000,64751900
510000.0,4,2.75,2730,9112,1.0,0,2,2,9,1740,990,1996,0.0,98198,47.4005,-122.31200000000001,3050,10454,6382,0.7003950834064969,7452900,83028544,75575644
270000.0,3,2.5,1540,7739,2.0,0,0,3,7,1540,0,1986,0.0,98030,47.3511,-122.169,1720,7200,6199,0.8010078821553173,2371600,59892121,57520521
750000.0,5,2.5,3120,15593,2.0,0,4,2,11,3120,0,1986,0.0,98074,47.6142,-122.065,3390,17003,12473,0.7999102161226191,9734400,243141649,233407249
509250.0,2,1.5,1480,3120,1.0,0,0,2,7,930,550,1914,2007.0,98105,47.6684,-122.323,1000,3780,1640,0.5256410256410257,2190400,9734400,7544000
189000.0,3,1.0,860,5200,1.0,0,0,4,6,860,0,1969,0.0,98042,47.3677,-122.07799999999999,1010,5200,4340,0.8346153846153846,739600,27040000,26300400
726500.0,4,2.5,2180,3893,2.0,0,0,2,8,2180,0,1999,0.0,98117,47.6886,-122.38799999999999,1710,4550,1713,0.440020549704598,4752400,15155449,10403049
287000.0,3,2.0,1300,11374,1.5,0,0,4,7,1300,0,1933,0.0,98168,47.4839,-122.302,1480,9670,10074,0.8857042377351855,1690000,129367876,127677876
679000.0,4,3.5,3420,49223,2.0,0,0,2,9,3420,0,2004,0.0,98010,47.3534,-121.992,3580,49223,45803,0.9305202852325133,11696400,2422903729,2411207329
316000.0,3,2.25,2130,8721,1.0,0,0,2,8,1570,0,1987,0.0,98031,47.4202,-122.204,2130,9477,6591,0.7557619539043687,4536900,76055841,71518941
498000.0,4,2.5,2300,22445,2.0,0,0,3,8,2300,0,1992,0.0,98014,47.6454,-121.902,2640,21886,20145,0.8975272889284919,5290000,503778025,498488025
448000.0,4,1.75,2560,8270,1.0,0,0,2,7,1480,1080,1979,0.0,98072,47.7572,-122.147,2320,8450,5710,0.6904474002418379,6553600,68392900,61839300
535000.0,2,1.0,1040,5527,1.0,0,0,2,7,1040,0,1951,0.0,98115,47.6774,-122.28399999999999,2080,7020,4487,0.8118328206983897,1081600,30547729,29466129
560000.0,4,3.0,3080,9601,2.0,0,1,2,10,3080,0,1990,0.0,98003,47.333999999999996,-122.33200000000001,3200,9375,6521,0.6792000833246536,9486400,92179201,82692801
437850.0,4,2.25,2670,14255,1.0,0,0,3,8,1610,1060,1975,0.0,98006,47.5623,-122.175,2470,10290,11585,0.8126972991932655,7128900,203205025,196076125
435000.0,4,2.75,3270,50994,2.0,0,0,3,8,2720,550,1983,0.0,98042,47.347,-122.087,2780,36036,47724,0.9358748088010355,10692900,2600388036,2589695136
510000.0,4,2.5,2610,8031,2.0,0,0,2,8,2610,0,1998,0.0,98155,47.7717,-122.27,2320,8031,5421,0.6750093388121031,6812100,64496961,57684861
520000.0,3,2.5,2460,54885,2.0,0,0,3,8,2460,0,1980,0.0,98059,47.4996,-122.146,2770,21407,52425,0.9551790106586499,6051600,3012363225,3006311625
509000.0,2,1.5,1930,3521,2.0,0,0,2,8,1930,0,1989,0.0,98007,47.6092,-122.146,1840,3576,1591,0.4518602669696109,3724900,12397441,8672541
575000.0,3,1.0,1220,5652,1.0,0,0,2,6,1220,0,1905,0.0,98116,47.5767,-122.40799999999999,1490,2467,4432,0.7841472045293701,1488400,31945104,30456704
365000.0,4,2.5,2030,7210,1.0,0,0,4,7,1330,0,1969,0.0,98059,47.5067,-122.16,1980,7560,5180,0.7184466019417476,4120900,51984100,47863200
795000.0,3,2.0,2420,17859,1.0,0,1,4,9,1500,920,1979,0.0,98034,47.7074,-122.24600000000001,2955,17859,15439,0.8644940926143682,5856400,318943881,313087481
285000.0,3,2.5,1870,4060,2.0,0,0,2,7,1870,0,2005,0.0,98042,47.3986,-122.163,2190,4060,2190,0.5394088669950738,3496900,16483600,12986700
955000.0,3,2.25,3020,43560,2.0,0,0,2,10,2720,300,1969,0.0,98005,47.6456,-122.17299999999999,3910,43560,40540,0.9306703397612488,9120400,1897473600,1888353200
775000.0,4,2.5,2880,8400,2.0,0,4,2,8,2050,830,1955,1987.0,98177,47.7704,-122.38600000000001,2880,7440,5520,0.6571428571428571,8294400,70560000,62265600
400000.0,4,3.0,1810,5012,2.0,0,0,3,7,1810,0,1997,0.0,98108,47.5691,-122.292,1670,5161,3202,0.6388667198723065,3276100,25120144,21844044
570000.0,4,2.5,2590,8483,2.0,0,0,2,9,2590,0,1991,0.0,98011,47.738,-122.221,2660,8717,5893,0.6946834846162914,6708100,71961289,65253189
955990.0,5,3.25,3830,6507,2.0,0,0,2,9,3830,0,2014,0.0,98053,47.6843,-122.016,3950,6723,2677,0.41140310434916244,14668900,42341049,27672149
1150000.0,3,2.25,3250,34848,1.0,0,0,2,10,2260,990,2006,0.0,98005,47.6077,-122.15799999999999,2770,21512,31598,0.9067378328741965,10562500,1214383104,1203820604
459950.0,4,2.0,2760,21465,1.0,0,0,3,9,2120,640,1979,0.0,98042,47.3818,-122.165,2550,13144,18705,0.8714185883997205,7617600,460746225,453128625
245000.0,2,1.75,1220,8382,1.0,0,0,2,6,1220,0,1942,0.0,98146,47.5033,-122.359,1100,8382,7162,0.8544500119303269,1488400,70257924,68769524
281000.0,3,1.5,1280,974,3.0,0,0,2,7,1280,0,2003,0.0,98125,47.7162,-122.29299999999999,1420,1422,-306,-0.3141683778234086,1638400,948676,-689724
205000.0,3,0.75,770,7000,1.0,0,0,2,4,770,0,1942,0.0,98024,47.5661,-121.887,950,10500,6230,0.89,592900,49000000,48407100
290000.0,3,1.75,1520,15090,1.0,0,0,3,7,1520,0,1968,0.0,98038,47.398,-121.964,1580,18618,13570,0.899271040424122,2310400,227708100,225397700
635000.0,4,2.5,2080,11176,1.0,0,0,4,8,2080,0,1954,0.0,98125,47.7107,-122.289,1390,7928,9096,0.8138869005010737,4326400,124902976,120576576
310000.0,1,1.0,570,6000,1.0,0,0,1,5,570,0,1918,0.0,98136,47.5517,-122.385,1530,6000,5430,0.905,324900,36000000,35675100
470000.0,4,2.0,1500,3659,1.0,0,0,2,7,830,670,1906,0.0,98122,47.6088,-122.29299999999999,1560,3706,2159,0.5900519267559442,2250000,13388281,11138281
600000.0,2,2.5,2510,14878,2.0,0,0,2,10,2510,0,1990,0.0,98011,47.7525,-122.205,3080,13594,12368,0.8312945288345208,6300100,221354884,215054784
279000.0,4,2.0,1980,10051,1.0,0,0,2,7,1980,0,1969,2003.0,98092,47.3231,-122.103,1520,10125,8071,0.8030046761516267,3920400,101022601,97102201
538500.0,3,3.5,2500,4270,2.0,0,0,2,8,2500,0,2000,0.0,98065,47.536,-121.87700000000001,2420,4205,1770,0.41451990632318503,6250000,18232900,11982900
594950.0,4,2.5,2720,10006,2.0,0,0,2,9,2720,0,1989,0.0,98074,47.6295,-122.042,2720,10759,7286,0.7281631021387168,7398400,100120036,92721636
533050.0,2,1.0,910,295772,1.0,0,0,2,5,910,0,1953,0.0,98042,47.3752,-122.11,2050,48351,294862,0.9969233057895946,828100,87481075984,87480247884
510000.0,3,1.75,1480,7040,1.0,0,0,2,7,1480,0,1974,0.0,98033,47.6723,-122.169,2040,7810,5560,0.7897727272727273,2190400,49561600,47371200
360000.0,4,2.25,2470,8686,1.0,0,0,3,7,1270,1200,1974,0.0,98058,47.4371,-122.166,1900,7350,6216,0.7156343541330877,6100900,75446596,69345696
435000.0,2,1.0,1650,5106,1.0,0,0,2,7,1090,560,1960,0.0,98115,47.6992,-122.309,1300,6947,3456,0.6768507638072856,2722500,26071236,23348736
559000.0,3,1.75,1700,6500,1.0,0,0,2,8,1700,0,1967,0.0,98115,47.6837,-122.28399999999999,1880,6000,4800,0.7384615384615385,2890000,42250000,39360000
645000.0,2,1.5,1995,115670,1.5,0,1,3,8,1995,0,1991,0.0,98070,47.4022,-122.464,2142,29375,113675,0.9827526584248293,3980025,13379548900,13375568875
340000.0,2,1.0,1280,9690,1.0,0,0,3,6,640,640,1919,0.0,98118,47.5341,-122.279,1630,15884,8410,0.8679050567595459,1638400,93896100,92257700
565000.0,4,2.5,2980,10459,2.0,0,0,2,9,2980,0,2001,0.0,98019,47.7354,-121.97399999999999,2920,7700,7479,0.715077923319629,8880400,109390681,100510281
575700.0,3,1.75,1730,6130,1.0,0,0,2,7,1480,250,1941,0.0,98115,47.6978,-122.316,1730,6131,4400,0.7177814029363785,2992900,37576900,34584000
1010000.0,3,3.25,2420,1923,2.0,0,2,2,10,1840,580,2006,0.0,98109,47.637,-122.34100000000001,1840,2890,-497,-0.2584503380135205,5856400,3697929,-2158471
540500.0,3,2.0,2800,185130,1.0,0,0,2,8,2320,480,1996,0.0,98038,47.4133,-122.006,2200,72055,182330,0.9848754928968833,7840000,34273116900,34265276900
265000.0,5,4.0,1400,8580,1.0,0,0,4,7,900,500,1954,0.0,98188,47.456,-122.292,1220,8832,7180,0.8368298368298368,1960000,73616400,71656400
699950.0,4,2.0,2070,7830,1.0,0,1,4,7,1180,890,1941,0.0,98125,47.7058,-122.27799999999999,2390,7830,5760,0.735632183908046,4284900,61308900,57024000
355000.0,1,1.75,750,20339,1.0,0,0,3,4,550,200,1946,0.0,98059,47.4756,-122.09,2020,23958,19589,0.963125030729141,562500,413674921,413112421
381000.0,3,1.5,1460,11407,1.0,0,0,2,7,1460,0,1954,0.0,98155,47.746,-122.294,1470,11407,9947,0.8720084158849829,2131600,130119649,127988049
564000.0,5,2.25,2140,8700,1.0,0,2,2,8,1220,920,1962,0.0,98115,47.6969,-122.31,1720,6670,6560,0.7540229885057471,4579600,75690000,71110400
114975.0,2,1.0,740,6250,1.0,0,0,2,6,740,0,1942,0.0,98146,47.506,-122.335,980,6957,5510,0.8816,547600,39062500,38514900
325000.0,1,0.75,410,8636,1.0,0,0,1,4,410,0,1953,0.0,98146,47.5077,-122.35700000000001,1190,8636,8226,0.9525243168133395,168100,74580496,74412396
299990.0,2,1.0,1570,125452,1.0,0,3,3,7,1570,0,1953,0.0,98022,47.2077,-122.016,1660,46119,123882,0.9874852533239805,2464900,15738204304,15735739404
751000.0,5,2.75,2860,5280,2.0,0,0,2,9,2860,0,2006,0.0,98052,47.707,-122.102,3150,6442,2420,0.4583333333333333,8179600,27878400,19698800
425000.0,3,2.25,1400,6970,2.0,0,0,2,8,1400,0,1984,0.0,98006,47.542,-122.184,1800,8140,5570,0.7991391678622669,1960000,48580900,46620900
665000.0,3,1.75,2700,5040,1.0,0,2,2,8,1560,1140,1947,0.0,98144,47.5834,-122.29,3010,5000,2340,0.4642857142857143,7290000,25401600,18111600
833450.0,5,4.0,4460,269345,2.0,0,4,2,9,3330,1130,1996,0.0,98027,47.4992,-122.06,2670,115434,264885,0.983441311329336,19891600,72546729025,72526837425
575000.0,7,1.5,2670,11250,1.5,0,0,3,8,2320,350,1948,0.0,98133,47.7121,-122.33200000000001,2030,9000,8580,0.7626666666666667,7128900,126562500,119433600
190000.0,3,1.75,1520,9600,1.0,0,0,3,7,1520,0,1967,0.0,98059,47.473,-122.149,1590,10183,8080,0.8416666666666667,2310400,92160000,89849600
314950.0,3,1.75,1520,9600,1.0,0,0,3,7,1520,0,1967,0.0,98059,47.473,-122.149,1590,10183,8080,0.8416666666666667,2310400,92160000,89849600
601150.0,2,2.0,1660,5200,1.0,0,0,4,7,1120,540,1906,0.0,98103,47.6871,-122.334,1260,5160,3540,0.6807692307692308,2755600,27040000,24284400
315000.0,2,1.0,860,8308,1.0,0,0,2,7,860,0,1948,0.0,98146,47.508,-122.37799999999999,1200,8308,7448,0.8964853153586905,739600,69022864,68283264
545000.0,2,1.5,2340,13380,1.0,0,0,3,7,1280,1060,1954,0.0,98146,47.5017,-122.37700000000001,1490,8100,11040,0.8251121076233184,5475600,179024400,173548800
565000.0,4,2.25,2110,10698,2.0,0,0,3,8,2110,0,1979,0.0,98027,47.5614,-122.08200000000001,2220,8252,8588,0.8027668723125818,4452100,114447204,109995104
175000.0,3,1.0,1010,7034,1.0,0,0,2,7,1010,0,1954,0.0,98055,47.49,-122.22,1440,10994,6024,0.8564117145294284,1020100,49477156,48457056
530000.0,3,2.0,2330,26571,2.5,0,0,2,8,2330,0,1987,0.0,98005,47.6009,-122.15799999999999,2030,20037,24241,0.9123104136088217,5428900,706018041,700589141
4490000.0,4,3.0,6430,27517,2.0,0,0,2,12,6430,0,2001,0.0,98004,47.6208,-122.219,3720,14592,21087,0.7663262710324527,41344900,757185289,715840389
430000.0,3,1.75,1610,7900,1.0,0,0,3,8,1310,300,1960,0.0,98177,47.7588,-122.36,2210,7700,6290,0.7962025316455696,2592100,62410000,59817900
225000.0,3,1.75,1460,8372,1.0,0,0,3,7,1460,0,1981,0.0,98042,47.3683,-122.087,1220,7803,6912,0.8256091734352604,2131600,70090384,67958784
312000.0,5,4.0,2900,9779,2.0,0,0,3,7,1950,950,1937,0.0,98168,47.5003,-122.306,1360,8000,6879,0.7034461601390736,8410000,95628841,87218841
380000.0,3,1.0,1260,7980,1.0,0,0,2,7,1260,0,1951,0.0,98177,47.7013,-122.37299999999999,1760,7606,6720,0.8421052631578947,1587600,63680400,62092800
222200.0,2,1.0,1210,10000,1.0,0,0,2,7,1210,0,1953,0.0,98148,47.4402,-122.333,1620,10959,8790,0.879,1464100,100000000,98535900
1440000.0,5,3.5,3420,8000,2.0,0,0,2,10,3420,0,2006,0.0,98040,47.5736,-122.212,1900,8000,4580,0.5725,11696400,64000000,52303600
329950.0,4,2.5,2120,4558,2.0,0,0,2,7,2120,0,2002,0.0,98038,47.3795,-122.022,2370,5506,2438,0.5348837209302325,4494400,20775364,16280964
995000.0,3,2.5,2460,10300,1.0,0,0,2,10,2460,0,1992,0.0,98117,47.6999,-122.391,2410,5250,7840,0.7611650485436893,6051600,106090000,100038400
929950.0,3,3.5,3790,10829,2.0,0,0,2,11,3790,0,1993,0.0,98027,47.5525,-122.098,3620,10989,7039,0.650013851694524,14364100,117267241,102903141
692000.0,4,2.5,2350,9779,1.0,0,0,2,10,2350,0,1987,0.0,98074,47.6411,-122.065,2700,10441,7429,0.75968912976787,5522500,95628841,90106341
402000.0,2,1.0,620,2475,1.0,0,0,4,6,620,0,1911,0.0,98107,47.6655,-122.37100000000001,1290,2475,1855,0.7494949494949495,384400,6125625,5741225
510000.0,3,1.75,1920,43560,1.0,0,0,3,7,1340,580,1962,0.0,98074,47.6052,-122.044,2540,58806,41640,0.9559228650137741,3686400,1897473600,1893787200
249000.0,3,1.0,1050,8498,1.0,0,0,3,7,1050,0,1959,0.0,98031,47.4043,-122.20200000000001,1050,8498,7448,0.8764415156507414,1102500,72216004,71113504
244900.0,3,1.5,1360,9980,1.0,0,0,3,7,1360,0,1966,0.0,98031,47.4143,-122.206,1360,9750,8620,0.8637274549098196,1849600,99600400,97750800
289900.0,3,1.0,1180,7068,1.0,0,0,2,6,1180,0,1944,0.0,98178,47.4947,-122.238,1180,7068,5888,0.8330503678551217,1392400,49956624,48564224
552500.0,4,1.0,1560,7980,1.0,0,0,3,7,1170,390,1939,0.0,98146,47.5093,-122.387,1570,7980,6420,0.8045112781954887,2433600,63680400,61246800
760000.0,4,2.5,3300,165528,2.0,0,0,2,8,3300,0,1984,0.0,98077,47.7657,-122.02799999999999,3030,144696,162228,0.9800637958532695,10890000,27399518784,27388628784
440000.0,2,2.75,1100,1088,2.0,0,0,2,7,750,350,2006,0.0,98102,47.6405,-122.324,2090,4125,-12,-0.011029411764705883,1210000,1183744,-26256
286000.0,3,1.75,1770,9000,1.0,0,0,2,7,1090,680,1954,0.0,98168,47.4997,-122.32600000000001,1520,21141,7230,0.8033333333333333,3132900,81000000,77867100
260000.0,3,1.0,1200,4592,1.0,0,0,2,6,800,400,1950,0.0,98106,47.519,-122.352,940,4440,3392,0.7386759581881533,1440000,21086464,19646464
355000.0,2,2.25,1330,10838,2.0,0,0,2,8,1330,0,1985,0.0,98028,47.7689,-122.241,1390,10310,9508,0.8772836316663591,1768900,117462244,115693344
318000.0,3,1.75,1570,12506,1.0,0,0,3,8,1570,0,1959,0.0,98003,47.3365,-122.319,2120,13243,10936,0.8744602590756437,2464900,156400036,153935136
255000.0,2,1.0,1610,19965,1.0,0,0,2,7,1610,0,1952,0.0,98168,47.5095,-122.31299999999999,2100,28400,18355,0.919358878036564,2592100,398601225,396009125
139000.0,3,1.0,1100,17334,1.0,0,0,2,7,1100,0,1978,0.0,98001,47.3003,-122.27,1530,18694,16234,0.9365409022729895,1210000,300467556,299257556
485000.0,4,2.25,1810,7068,2.0,0,0,4,7,1810,0,1976,0.0,98034,47.7319,-122.204,1460,7274,5258,0.7439162422184493,3276100,49956624,46680524
549950.0,3,1.75,2930,266587,2.0,0,0,2,8,2440,0,1995,0.0,98014,47.6991,-121.947,2700,438213,263657,0.9890092165034304,8584900,71068628569,71060043669
588000.0,3,1.5,1780,4200,1.5,0,0,3,8,1780,0,1916,0.0,98103,47.662,-122.34899999999999,1380,3333,2420,0.5761904761904761,3168400,17640000,14471600
975000.0,3,2.5,3050,7410,1.5,0,0,4,8,1950,1100,1950,0.0,98115,47.6772,-122.296,1890,5814,4360,0.5883940620782726,9302500,54908100,45605600
402000.0,3,2.0,1540,1827,2.0,0,0,2,8,1540,0,2005,0.0,98029,47.5479,-121.99799999999999,1540,1827,287,0.15708812260536398,2371600,3337929,966329
245000.0,3,1.0,1380,9875,1.0,0,0,2,7,1380,0,1959,0.0,98168,47.5131,-122.334,1200,6250,8495,0.860253164556962,1904400,97515625,95611225
445000.0,3,1.75,1890,32340,1.5,0,3,2,8,1890,0,1976,0.0,98070,47.4137,-122.439,1890,40180,30450,0.9415584415584416,3572100,1045875600,1042303500
195000.0,3,1.75,1570,8459,1.0,0,0,2,7,1570,0,1991,0.0,98022,47.2016,-122.006,1650,8844,6889,0.8143988651140797,2464900,71554681,69089781
385000.0,5,2.0,2540,11750,1.0,0,0,2,7,1480,1060,1962,0.0,98155,47.7754,-122.291,2000,12000,9210,0.7838297872340425,6451600,138062500,131610900
450000.0,3,1.5,1520,7903,1.0,0,0,3,7,1000,520,1955,0.0,98006,47.5659,-122.141,1520,9830,6383,0.8076679741870176,2310400,62457409,60147009
1090000.0,4,2.5,2780,6837,2.0,0,0,2,9,2780,0,2004,0.0,98033,47.666000000000004,-122.20100000000001,1160,6837,4057,0.5933889132660524,7728400,46744569,39016169
396675.0,2,1.0,1730,6375,2.0,0,0,3,6,1730,0,1945,0.0,98126,47.5357,-122.368,1180,6250,4645,0.7286274509803922,2992900,40640625,37647725
242000.0,5,2.25,2340,7494,1.0,0,0,2,7,1170,1170,1951,0.0,98188,47.448,-122.28,1650,10125,5154,0.6877502001601281,5475600,56160036,50684436
380000.0,3,1.75,1300,12378,1.0,0,0,3,6,1300,0,1943,0.0,98045,47.4996,-121.77799999999999,1300,11596,11078,0.8949749555663273,1690000,153214884,151524884
496000.0,2,1.0,1420,4635,2.0,0,0,3,7,1420,0,1941,1973.0,98115,47.68,-122.304,1810,4635,3215,0.6936353829557713,2016400,21483225,19466825
399950.0,3,2.5,1470,4488,2.0,0,0,4,7,1470,0,1980,0.0,98034,47.723,-122.162,1400,4441,3018,0.6724598930481284,2160900,20142144,17981244
895000.0,4,2.5,2850,8526,2.0,0,0,2,9,2850,0,1998,0.0,98033,47.6747,-122.191,2440,7072,5676,0.6657283603096411,8122500,72692676,64570176
690000.0,3,2.0,2360,6149,2.0,0,3,2,8,1560,0,1926,1989.0,98136,47.5433,-122.384,2000,6149,3789,0.6161977557326395,5569600,37810201,32240601
270000.0,3,1.5,1610,8375,2.0,0,0,2,7,1610,0,1927,0.0,98155,47.7527,-122.306,1610,9107,6765,0.8077611940298507,2592100,70140625,67548525
349900.0,3,2.0,2420,38781,1.0,0,0,4,7,1210,1210,1949,0.0,98027,47.4511,-121.976,2650,88426,36361,0.9375983084500141,5856400,1503965961,1498109561
454280.0,3,2.5,1470,1741,2.0,0,0,2,8,1170,300,2004,0.0,98029,47.5464,-121.999,1470,1583,271,0.1556576680068926,2160900,3031081,870181
390000.0,3,2.5,1410,26375,1.0,0,0,2,6,1410,0,1992,0.0,98077,47.7432,-122.07600000000001,1410,12474,24965,0.9465402843601896,1988100,695640625,693652525
275000.0,3,1.75,1840,14005,1.0,0,0,2,8,1840,0,1983,0.0,98023,47.3124,-122.345,2170,7992,12165,0.8686183505890753,3385600,196140025,192754425
300000.0,4,2.5,2450,8932,2.0,0,0,2,8,2450,0,1990,0.0,98023,47.3093,-122.345,2410,8775,6482,0.725705329153605,6002500,79780624,73778124
700000.0,3,1.75,1500,6000,1.0,0,0,4,7,850,650,1940,0.0,98199,47.6474,-122.402,1700,6000,4500,0.75,2250000,36000000,33750000
520000.0,3,1.75,2080,6609,1.0,0,0,2,7,1280,800,1950,0.0,98115,47.6883,-122.3,1680,6270,4529,0.6852776516870933,4326400,43678881,39352481
715000.0,3,2.5,2770,39529,2.0,0,0,2,9,2770,0,1987,0.0,98053,47.6495,-122.042,3010,35435,36759,0.9299248652887754,7672900,1562541841,1554868941
404000.0,3,2.5,2370,4324,2.0,0,0,2,8,2370,0,2006,0.0,98038,47.3515,-121.999,2370,4348,1954,0.4518963922294172,5616900,18696976,13080076
490500.0,3,2.0,3000,21883,2.0,0,0,2,7,1970,1030,1998,0.0,98011,47.7599,-122.214,2280,14025,18883,0.862907279623452,9000000,478865689,469865689
1490000.0,6,2.75,4430,6440,2.0,0,3,2,10,2680,1750,1964,2015.0,98118,47.5462,-122.265,3530,7314,2010,0.31211180124223603,19624900,41473600,21848700
557800.0,4,1.75,1550,6000,1.0,0,0,4,7,1550,0,1944,0.0,98199,47.6567,-122.399,1550,6000,4450,0.7416666666666667,2402500,36000000,33597500
571000.0,4,2.25,2290,9900,1.0,0,2,3,8,1550,740,1959,0.0,98166,47.4434,-122.34299999999999,2320,9900,7610,0.7686868686868686,5244100,98010000,92765900
410000.0,4,2.5,2560,4020,2.0,0,0,2,9,2560,0,2006,0.0,98038,47.3533,-122.027,3010,4916,1460,0.36318407960199006,6553600,16160400,9606800
225000.0,3,1.5,1240,5506,1.0,0,0,3,7,1240,0,1971,0.0,98118,47.5294,-122.285,1670,5589,4266,0.7747911369415184,1537600,30316036,28778436
700000.0,4,2.5,2590,4498,2.0,0,0,2,9,2590,0,2004,0.0,98052,47.7047,-122.12799999999999,2660,5238,1908,0.424188528234771,6708100,20232004,13523904
500000.0,3,1.0,1370,3500,1.5,0,0,2,7,1370,0,1905,1985.0,98103,47.6857,-122.348,1590,4500,2130,0.6085714285714285,1876900,12250000,10373100
536500.0,2,2.0,1360,1860,1.0,0,0,3,7,680,680,1925,0.0,98107,47.6727,-122.396,1440,5000,500,0.26881720430107525,1849600,3459600,1610000
330000.0,3,2.5,2060,25046,1.0,0,0,3,8,1600,460,1980,0.0,98022,47.184,-121.959,2050,21255,22986,0.9177513375389283,4243600,627302116,623058516
249950.0,3,1.75,1120,15210,1.0,0,0,4,7,1120,0,1976,0.0,98042,47.3659,-122.113,1710,8470,14090,0.9263642340565418,1254400,231344100,230089700
249000.0,4,1.75,1630,8410,1.5,0,0,4,7,1630,0,1943,0.0,98188,47.4538,-122.288,1390,8410,6780,0.8061831153388823,2656900,70728100,68071200
249000.0,3,1.75,1590,7535,1.5,0,0,4,6,1590,0,1909,0.0,98032,47.3769,-122.234,1110,6000,5945,0.7889847378898474,2528100,56776225,54248125
780000.0,4,1.75,2480,9195,1.0,0,0,2,7,1390,1090,1950,0.0,98004,47.583999999999996,-122.195,2440,9195,6715,0.7302882001087547,6150400,84548025,78397625
1200000.0,4,2.5,2700,4275,2.0,0,0,2,9,2700,0,2004,0.0,98115,47.6725,-122.32700000000001,1810,4500,1575,0.3684210526315789,7290000,18275625,10985625
434500.0,3,1.75,1930,7210,1.0,0,0,2,7,1110,820,1975,0.0,98072,47.735,-122.17399999999999,1870,7877,5280,0.7323162274618585,3724900,51984100,48259200
590000.0,4,2.0,2490,339332,1.0,0,0,2,8,2490,0,2002,0.0,98022,47.2725,-121.929,1910,129373,336842,0.9926620536819398,6200100,115146206224,115140006124
417200.0,2,1.0,1000,4000,1.0,0,0,2,6,1000,0,1910,0.0,98107,47.6742,-122.396,1490,5000,3000,0.75,1000000,16000000,15000000
649990.0,4,2.25,2130,11900,2.0,0,0,2,9,2130,0,1976,0.0,98074,47.6408,-122.05799999999999,2590,11900,9770,0.8210084033613445,4536900,141610000,137073100
506000.0,2,1.0,1060,3588,1.0,0,0,3,7,960,100,1926,0.0,98107,47.6721,-122.395,1570,3741,2528,0.7045707915273133,1123600,12873744,11750144
348000.0,3,2.5,1730,4004,2.0,0,0,2,7,1730,0,1999,0.0,98148,47.4317,-122.32799999999999,1730,5523,2274,0.567932067932068,2992900,16032016,13039116
301000.0,4,2.5,2810,6146,2.0,0,0,2,9,2810,0,1998,0.0,98031,47.4045,-122.208,2810,6180,3336,0.5427920598763424,7896100,37773316,29877216
427550.0,2,1.0,880,4000,1.0,0,0,2,7,880,0,1940,0.0,98117,47.6848,-122.38600000000001,1150,4000,3120,0.78,774400,16000000,15225600
361000.0,3,1.0,1040,6720,1.5,0,0,2,7,1040,0,1951,0.0,98155,47.7444,-122.294,1880,11407,5680,0.8452380952380952,1081600,45158400,44076800
460000.0,2,2.5,1830,8107,1.0,0,0,4,7,930,900,1946,0.0,98125,47.701,-122.305,1260,6960,6277,0.7742691501171827,3348900,65723449,62374549
958000.0,4,3.5,1800,6400,2.0,0,2,2,8,1800,0,1984,0.0,98112,47.625,-122.3,1700,4736,4600,0.71875,3240000,40960000,37720000
445000.0,5,1.75,2460,6846,1.5,0,0,4,7,1340,1120,1911,0.0,98108,47.5445,-122.321,1410,4800,4386,0.6406660823838738,6051600,46867716,40816116
373000.0,3,2.5,1670,3565,2.0,0,0,2,7,1670,0,1999,0.0,98072,47.7623,-122.161,1510,3770,1895,0.5315568022440392,2788900,12709225,9920325
525000.0,4,2.25,2660,7957,1.0,0,0,3,8,1750,910,1977,0.0,98011,47.7351,-122.199,1890,8250,5297,0.6657031544551967,7075600,63313849,56238249
364988.0,3,2.5,2850,12593,2.0,0,0,2,9,2850,0,1997,0.0,98023,47.2848,-122.345,2850,9435,9743,0.7736837925831811,8122500,158583649,150461149
324000.0,2,1.0,820,8370,1.0,0,0,3,7,820,0,1941,0.0,98177,47.7256,-122.361,1410,8370,7550,0.9020310633213859,672400,70056900,69384500
625000.0,4,3.0,2350,5627,1.0,0,0,4,8,1490,860,1960,0.0,98118,47.5514,-122.26799999999999,2020,5627,3277,0.5823707126355073,5522500,31663129,26140629
237500.0,3,1.75,1480,7830,1.0,0,0,2,7,1480,0,1980,0.0,98022,47.1967,-121.99799999999999,1130,7553,6350,0.8109833971902938,2190400,61308900,59118500
429300.0,6,2.25,2930,15949,1.0,0,0,3,8,1730,1200,1965,0.0,98034,47.7188,-122.185,1730,8550,13019,0.8162894225343281,8584900,254370601,245785701
155000.0,3,1.0,1250,6250,1.0,0,0,1,7,1030,220,1949,0.0,98108,47.5292,-122.323,1130,6250,5000,0.8,1562500,39062500,37500000
614000.0,4,2.75,2760,8160,1.5,0,2,3,8,1780,980,1940,0.0,98177,47.7248,-122.365,2720,8160,5400,0.6617647058823529,7617600,66585600,58968000
650000.0,3,2.5,2380,3332,2.0,0,0,2,9,2380,0,2014,0.0,98034,47.7194,-122.199,2590,4382,952,0.2857142857142857,5664400,11102224,5437824
625000.0,3,2.0,1730,12219,1.0,0,0,3,7,1730,0,1986,0.0,98004,47.5825,-122.189,2470,13594,10489,0.8584172190850315,2992900,149303961,146311061
587100.0,3,2.25,1670,6414,1.0,0,0,3,8,1670,0,1961,0.0,98117,47.6921,-122.38600000000001,2130,7035,4744,0.7396320548799501,2788900,41139396,38350496
380000.0,4,2.5,2150,37647,2.0,0,0,2,8,2150,0,1991,0.0,98042,47.3117,-122.083,2410,42193,35497,0.9428905357664621,4622500,1417296609,1412674109
479500.0,2,1.0,930,5760,1.0,0,0,2,6,730,200,1917,0.0,98118,47.5598,-122.266,1970,5760,4830,0.8385416666666666,864900,33177600,32312700
382888.0,1,1.0,620,2380,1.0,0,0,2,6,620,0,1900,0.0,98115,47.6746,-122.32600000000001,980,3570,1760,0.7394957983193278,384400,5664400,5280000
540000.0,4,4.25,1960,3565,2.0,0,0,2,7,1960,0,1940,2003.0,98116,47.5849,-122.384,1920,5750,1605,0.45021037868162694,3841600,12709225,8867625
691000.0,4,2.75,2550,8632,1.0,0,0,2,8,1700,850,1972,0.0,98033,47.6477,-122.197,2550,9534,6082,0.7045875810936052,6502500,74511424,68008924
760500.0,3,2.0,1990,3990,1.0,0,0,4,7,1130,860,1912,0.0,98103,47.6572,-122.333,1710,4000,2000,0.5012531328320802,3960100,15920100,11960000
685000.0,4,2.5,3550,10968,2.0,0,0,2,9,3550,0,2006,0.0,98065,47.5431,-121.88600000000001,3550,8583,7418,0.6763311451495259,12602500,120297024,107694524
199129.0,3,1.0,860,33664,1.0,0,0,3,6,860,0,1955,0.0,98001,47.295,-122.275,1290,18287,32804,0.9744534220532319,739600,1133264896,1132525296
335000.0,3,3.0,2031,7702,2.0,0,0,2,9,2031,0,1988,0.0,98023,47.3058,-122.348,2390,7700,5671,0.7363022591534666,4124961,59320804,55195843
305100.0,3,2.0,1590,35988,1.0,0,0,3,8,1590,0,1974,0.0,98058,47.4365,-122.10600000000001,2780,23789,34398,0.9558186062020674,2528100,1295136144,1292608044
830000.0,4,2.25,3010,12202,1.0,0,0,3,9,3010,0,1959,0.0,98005,47.6387,-122.17399999999999,2480,10143,9192,0.7533191280118013,9060100,148888804,139828704
810000.0,3,2.5,2610,8481,2.0,0,0,2,10,2610,0,1993,0.0,98006,47.5535,-122.115,3140,10008,5871,0.692253272019809,6812100,71927361,65115261
500000.0,3,2.25,1440,15661,1.0,0,0,2,8,1180,260,1988,0.0,98074,47.6225,-122.038,1440,13963,14221,0.9080518485409617,2073600,245266921,243193321
490000.0,3,1.75,1920,5405,1.0,0,2,3,7,960,960,1947,0.0,98126,47.5583,-122.38,1190,5405,3485,0.6447733580018501,3686400,29214025,25527625
490000.0,2,1.75,1670,4200,2.0,0,0,2,7,1670,0,1912,0.0,98116,47.5862,-122.387,1340,2875,2530,0.6023809523809524,2788900,17640000,14851100
272000.0,4,1.75,1390,10660,1.0,0,0,3,7,1030,360,1960,0.0,98198,47.4128,-122.323,1800,11960,9270,0.8696060037523452,1932100,113635600,111703500
280000.0,3,2.25,2140,7200,2.0,0,0,3,7,2140,0,1979,0.0,98031,47.3913,-122.191,1890,7455,5060,0.7027777777777777,4579600,51840000,47260400
233000.0,3,1.0,1250,6180,1.5,0,0,2,7,1250,0,1955,0.0,98155,47.7474,-122.32700000000001,1490,6180,4930,0.7977346278317152,1562500,38192400,36629900
275000.0,3,1.0,1080,6000,1.0,0,0,3,7,1080,0,1952,0.0,98133,47.7579,-122.33,1200,7210,4920,0.82,1166400,36000000,34833600
375000.0,3,3.25,2760,6420,2.0,0,2,2,9,2110,650,1991,0.0,98031,47.3895,-122.221,2030,7725,3660,0.5700934579439252,7617600,41216400,33598800
445000.0,3,2.75,2180,3703,2.0,0,0,2,8,2180,0,2004,0.0,98011,47.776,-122.169,2190,3963,1523,0.411288144747502,4752400,13712209,8959809
437500.0,3,2.5,1260,1125,3.0,0,0,2,8,1260,0,2002,0.0,98107,47.6706,-122.381,1360,1250,-135,-0.12,1587600,1265625,-321975
426250.0,4,1.0,1610,6000,1.5,0,0,3,7,1510,100,1905,0.0,98118,47.5261,-122.266,1430,6000,4390,0.7316666666666667,2592100,36000000,33407900
358000.0,3,1.5,2450,12497,1.0,0,0,3,7,2450,0,1967,0.0,98065,47.5317,-121.834,1560,11700,10047,0.8039529487076899,6002500,156175009,150172509
1180000.0,4,3.5,4150,49503,2.0,0,0,2,11,4150,0,2003,0.0,98053,47.6746,-122.01799999999999,3330,60137,45353,0.9161666969678606,17222500,2450547009,2433324509
305000.0,2,1.0,960,8276,1.0,0,0,2,5,960,0,1939,0.0,98027,47.5322,-122.03299999999999,1620,6000,7316,0.8840019333011117,921600,68492176,67570576
415000.0,2,1.75,1340,4664,1.0,0,0,2,8,1340,0,2004,0.0,98053,47.7182,-122.03399999999999,1350,4236,3324,0.7126929674099486,1795600,21752896,19957296
520000.0,11,3.0,3000,4960,2.0,0,0,2,7,2400,600,1918,1999.0,98106,47.556000000000004,-122.363,1420,4960,1960,0.3951612903225806,9000000,24601600,15601600
733000.0,4,3.5,3080,5974,2.0,0,0,2,9,3080,0,2003,0.0,98075,47.6007,-121.97399999999999,2950,5425,2894,0.4844325410110479,9486400,35688676,26202276
411500.0,3,1.0,1130,8159,1.0,0,0,3,7,1130,0,1954,0.0,98133,47.7362,-122.333,1570,8162,7029,0.8615026351268538,1276900,66569281,65292381
540000.0,3,1.75,2280,16671,1.5,0,0,3,6,1760,520,1909,0.0,98034,47.7096,-122.219,1850,9351,14391,0.8632355587547238,5198400,277922241,272723841
270500.0,3,1.5,1952,8613,1.0,0,0,3,7,1652,300,1960,0.0,98032,47.3715,-122.29,1400,8712,6661,0.7733658423313595,3810304,74183769,70373465
422250.0,2,1.5,1280,1256,2.0,0,0,2,8,1200,80,1998,0.0,98107,47.6741,-122.375,1390,1256,-24,-0.01910828025477707,1638400,1577536,-60864
655000.0,5,3.25,3690,12353,2.0,0,0,4,9,3690,0,1977,0.0,98155,47.7672,-122.292,2290,9082,8663,0.7012871367279203,13616100,152596609,138980509
1200000.0,5,3.25,4610,10576,2.0,0,3,2,11,3310,1300,2006,0.0,98027,47.5373,-122.07,4042,8321,5966,0.56410741301059,21252100,111851776,90599676
550000.0,3,2.5,2920,169448,2.5,0,0,2,9,2920,0,1990,0.0,98022,47.2492,-121.975,2360,326097,166528,0.9827675747131863,8526400,28712624704,28704098304
460000.0,2,2.25,1230,929,2.0,0,0,2,8,1020,210,2004,0.0,98122,47.6191,-122.301,1270,1370,-301,-0.3240043057050592,1512900,863041,-649859
159075.0,4,1.5,1580,6200,1.0,0,0,2,6,790,790,1944,0.0,98178,47.4971,-122.24,1320,6499,4620,0.7451612903225806,2496400,38440000,35943600
470000.0,2,1.0,1220,4000,1.5,0,0,3,6,1220,0,1908,0.0,98103,47.6801,-122.354,1580,4000,2780,0.695,1488400,16000000,14511600
235000.0,2,1.0,1020,7920,1.0,0,0,2,6,1020,0,1939,0.0,98108,47.5558,-122.31,1530,6900,6900,0.8712121212121212,1040400,62726400,61686000
309950.0,2,1.5,1510,9843,1.0,0,0,3,7,1510,0,1961,0.0,98188,47.4419,-122.27,1590,9368,8333,0.8465914863354669,2280100,96884649,94604549
433000.0,4,1.75,1830,9600,1.0,0,0,3,7,1010,820,1966,0.0,98006,47.5728,-122.125,1910,11100,7770,0.809375,3348900,92160000,88811100
895000.0,3,2.5,2750,10000,1.0,0,3,2,8,1650,1100,1967,0.0,98006,47.5644,-122.15299999999999,2490,10000,7250,0.725,7562500,100000000,92437500
291000.0,3,1.5,1860,60960,1.0,0,0,3,7,1140,720,1967,0.0,98042,47.3796,-122.102,2170,82764,59100,0.969488188976378,3459600,3716121600,3712662000
835000.0,3,2.5,2720,13124,2.0,0,0,2,9,2720,0,1988,0.0,98052,47.6371,-122.094,2760,16200,10404,0.7927461139896373,7398400,172239376,164840976
640000.0,2,1.0,1360,5000,1.0,0,0,2,7,1200,160,1936,0.0,98199,47.6372,-122.39200000000001,1540,4000,3640,0.728,1849600,25000000,23150400
438000.0,3,2.25,2340,14279,1.0,0,0,2,8,1340,1000,1965,0.0,98006,47.5715,-122.124,2340,13600,11939,0.8361229777995658,5475600,203889841,198414241
540000.0,4,2.5,2600,9935,2.0,0,0,2,8,2600,0,2005,0.0,98059,47.4865,-122.14200000000001,2830,7620,7335,0.7382989431303473,6760000,98704225,91944225
325000.0,4,2.5,2090,7434,1.0,0,0,2,7,1090,1000,1993,0.0,98146,47.4962,-122.34899999999999,1260,8404,5344,0.7188592951304815,4368100,55264356,50896256
380000.0,4,1.75,2260,7200,1.5,0,0,4,7,1360,900,1924,0.0,98056,47.5122,-122.186,1410,7465,4940,0.6861111111111111,5107600,51840000,46732400
510000.0,2,1.0,1390,5544,1.0,0,0,2,7,930,460,1947,0.0,98105,47.6696,-122.26700000000001,1710,6200,4154,0.7492784992784993,1932100,30735936,28803836
380000.0,4,2.5,2300,7707,2.0,0,0,2,8,2300,0,2004,0.0,98038,47.3497,-122.044,2320,6035,5407,0.7015700012975218,5290000,59397849,54107849
825000.0,4,2.5,2810,9800,1.0,0,0,3,8,1710,1100,1973,0.0,98006,47.5657,-122.149,2800,9800,6990,0.713265306122449,7896100,96040000,88143900
880000.0,4,3.25,4060,52707,2.0,0,0,3,9,4060,0,1996,0.0,98077,47.7615,-122.041,3100,50755,48647,0.9229703834405297,16483600,2778027849,2761544249
1800000.0,3,3.0,2790,13295,2.0,1,4,3,10,2370,420,1933,1989.0,98006,47.5466,-122.197,3140,11949,10505,0.7901466716810831,7784100,176757025,168972925
790000.0,3,1.0,1290,6380,1.5,0,0,2,7,1290,0,1930,0.0,98115,47.6951,-122.319,1630,6380,5090,0.7978056426332288,1664100,40704400,39040300
287000.0,2,1.5,720,4346,1.0,0,0,3,6,720,0,1942,0.0,98106,47.5225,-122.351,790,4346,3626,0.8343304187758859,518400,18887716,18369316
509000.0,3,3.0,2130,5000,1.5,0,0,2,7,1570,560,1913,0.0,98118,47.5451,-122.28399999999999,1638,4500,2870,0.574,4536900,25000000,20463100
270000.0,3,2.25,1750,8400,1.0,0,0,2,7,1350,400,1965,0.0,98188,47.4571,-122.272,2020,9110,6650,0.7916666666666666,3062500,70560000,67497500
210000.0,3,2.0,960,9380,1.0,0,0,2,6,960,0,1949,0.0,98146,47.4852,-122.34299999999999,1460,9240,8420,0.8976545842217484,921600,87984400,87062800
415000.0,3,1.0,1570,11752,1.5,0,0,4,8,1570,0,1930,0.0,98133,47.7686,-122.348,2010,8291,10182,0.8664057181756297,2464900,138109504,135644604
550000.0,3,2.5,3070,14400,1.0,0,3,4,9,1720,1350,1985,0.0,98198,47.3716,-122.321,2020,18211,11330,0.7868055555555555,9424900,207360000,197935100
1250000.0,4,2.5,2920,5500,1.0,0,3,2,10,2030,890,1957,0.0,98199,47.6406,-122.412,3790,5500,2580,0.4690909090909091,8526400,30250000,21723600
499950.0,3,1.0,1870,4984,1.0,0,0,2,7,1120,750,1955,0.0,98116,47.5771,-122.391,1650,5750,3114,0.6247993579454254,3496900,24840256,21343356
659000.0,3,1.5,1540,5040,2.0,0,0,2,8,1540,0,1907,0.0,98122,47.6138,-122.29899999999999,1590,3600,3500,0.6944444444444444,2371600,25401600,23030000
265000.0,2,1.5,1440,22081,2.0,0,0,2,7,1440,0,1990,0.0,98019,47.7698,-121.896,1440,19544,20641,0.9347855622480866,2073600,487570561,485496961
492000.0,4,3.75,2810,10840,2.0,0,2,3,8,2070,740,1994,0.0,98045,47.4861,-121.804,2370,11248,8030,0.7407749077490775,7896100,117505600,109609500
715000.0,4,2.5,2450,7700,1.0,0,0,2,8,1250,1200,1958,0.0,98040,47.5731,-122.212,2450,8000,5250,0.6818181818181818,6002500,59290000,53287500
175000.0,2,1.0,1330,28270,1.5,0,0,2,6,1330,0,1925,0.0,98168,47.4824,-122.274,1210,6926,26940,0.9529536611248673,1768900,799192900,797424000
975000.0,4,3.5,3130,52322,2.0,0,0,2,9,2430,700,2011,0.0,98005,47.5932,-122.15899999999999,3200,5820,49192,0.9401781277474103,9796900,2737591684,2727794784
306950.0,1,1.0,730,5005,1.0,0,0,3,5,730,0,1945,0.0,98117,47.6992,-122.36399999999999,1630,5667,4275,0.8541458541458542,532900,25050025,24517125
630000.0,4,2.0,2480,3680,1.5,0,0,3,7,1470,0,1916,0.0,98116,47.5686,-122.39200000000001,1500,5750,1200,0.32608695652173914,6150400,13542400,7392000
367500.0,3,1.0,1270,8792,1.0,0,0,4,7,1270,0,1969,0.0,98056,47.5351,-122.17399999999999,1780,8792,7522,0.8555505004549591,1612900,77299264,75686364
699950.0,3,3.25,2230,5460,1.0,0,1,3,8,1430,800,1977,0.0,98136,47.53,-122.38799999999999,2070,5600,3230,0.5915750915750916,4972900,29811600,24838700
1000000.0,3,3.0,2880,3750,2.0,0,0,2,9,2220,660,1909,1991.0,98122,47.6155,-122.29,1910,4000,870,0.232,8294400,14062500,5768100
285000.0,4,2.5,2434,4400,2.0,0,0,2,8,2434,0,2007,0.0,98001,47.2874,-122.28299999999999,2434,4400,1966,0.44681818181818184,5924356,19360000,13435644
215000.0,2,1.5,1120,1312,2.0,0,0,2,7,1000,120,2004,0.0,98106,47.534,-122.36399999999999,1560,1314,192,0.14634146341463414,1254400,1721344,466944
1050000.0,4,2.5,4080,11054,2.0,0,0,2,11,4080,0,2001,0.0,98059,47.5188,-122.15100000000001,3520,11914,6974,0.6309028406006876,16646400,122190916,105544516
1370000.0,4,2.75,3720,9450,1.0,0,4,4,10,1960,1760,1962,0.0,98006,47.5627,-122.156,2900,8605,5730,0.6063492063492063,13838400,89302500,75464100
235000.0,3,1.0,1430,7599,1.5,0,0,3,6,1010,420,1930,0.0,98168,47.4783,-122.265,1290,10320,6169,0.8118173443874194,2044900,57744801,55699901
604000.0,3,2.0,1560,2589,1.0,0,0,2,7,790,770,1923,0.0,98103,47.6587,-122.344,1450,3893,1029,0.39745075318655854,2433600,6702921,4269321
750000.0,3,1.75,1700,8400,1.0,0,0,2,8,1460,240,1947,0.0,98199,47.6534,-122.415,2010,7000,6700,0.7976190476190477,2890000,70560000,67670000
800000.0,4,2.25,2510,9963,1.0,0,0,3,9,2200,310,1967,0.0,98005,47.5973,-122.177,3110,9963,7453,0.7480678510488808,6300100,99261369,92961269
580000.0,5,2.0,2600,3750,1.5,0,0,3,6,1400,1200,1914,0.0,98105,47.6691,-122.29899999999999,1700,3750,1150,0.30666666666666664,6760000,14062500,7302500
350000.0,1,1.0,790,4590,1.0,0,0,2,6,790,0,1911,0.0,98118,47.5677,-122.285,1070,4590,3800,0.8278867102396514,624100,21068100,20444000
353750.0,4,2.0,1710,7490,2.0,0,0,2,7,1320,390,1956,0.0,98166,47.4544,-122.35700000000001,1880,7704,5780,0.7716955941255007,2924100,56100100,53176000
1100000.0,5,2.75,2660,8737,1.0,0,4,4,8,1470,1190,1969,0.0,98006,47.5667,-122.155,3280,8783,6077,0.6955476708252261,7075600,76335169,69259569
465000.0,4,2.0,1470,10291,1.0,0,0,3,7,1470,0,1963,0.0,98008,47.6316,-122.12100000000001,1460,9601,8821,0.8571567388980663,2160900,105904681,103743781
568000.0,3,2.0,2350,5080,1.5,0,0,2,8,1780,570,1929,0.0,98118,47.5516,-122.26299999999999,1700,5080,2730,0.5374015748031497,5522500,25806400,20283900
1010000.0,5,2.0,2440,3080,2.0,0,0,3,8,2440,0,1910,0.0,98112,47.6242,-122.306,1640,3077,640,0.2077922077922078,5953600,9486400,3532800
213500.0,3,1.5,1150,11571,1.0,0,0,2,7,1150,0,1961,0.0,98168,47.4931,-122.29799999999999,1630,11571,10421,0.9006136029729496,1322500,133888041,132565541
250000.0,3,2.5,1510,10384,1.0,0,0,1,7,1030,480,1976,0.0,98077,47.758,-122.071,1490,10000,8874,0.8545839753466872,2280100,107827456,105547356
357000.0,2,1.0,870,4600,1.0,0,0,3,7,870,0,1942,0.0,98126,47.5274,-122.37899999999999,930,4600,3730,0.8108695652173913,756900,21160000,20403100
425000.0,2,2.0,1280,4095,2.0,0,0,3,8,1280,0,1918,0.0,98136,47.5501,-122.39299999999999,1470,5500,2815,0.6874236874236874,1638400,16769025,15130625
571000.0,3,2.5,2600,7465,2.0,0,0,2,9,2600,0,1988,0.0,98011,47.7387,-122.21700000000001,2660,7683,4865,0.651707970529136,6760000,55726225,48966225
588000.0,3,2.25,2030,7350,1.0,0,0,3,7,1190,840,1977,0.0,98052,47.6939,-122.126,1950,7350,5320,0.7238095238095238,4120900,54022500,49901600
275000.0,4,1.5,1930,15531,2.0,0,0,2,7,1930,0,1979,0.0,98003,47.345,-122.296,1580,7800,13601,0.875732406155431,3724900,241211961,237487061
565000.0,3,2.75,3210,15939,2.0,0,1,2,10,3210,0,1998,0.0,98023,47.3357,-122.351,2870,15939,12729,0.7986071899115378,10304100,254051721,243747621
460000.0,3,1.75,1970,9135,1.0,0,0,3,7,1370,600,1961,0.0,98011,47.7603,-122.215,1880,9650,7165,0.7843459222769568,3880900,83448225,79567325
603500.0,4,2.5,4060,9734,1.0,0,4,2,9,2150,1910,1977,0.0,98028,47.7678,-122.25399999999999,2750,10370,5674,0.5829052804602425,16483600,94750756,78267156
490600.0,3,2.5,3316,11447,2.0,0,0,2,9,3316,0,1986,0.0,98023,47.3036,-122.34,3000,11447,8131,0.7103171136542326,10995856,131033809,120037953
1010000.0,2,2.0,1460,9052,1.0,0,2,4,6,1460,0,1900,0.0,98033,47.6857,-122.208,2554,7834,7592,0.8387096774193549,2131600,81938704,79807104
500000.0,4,2.0,2100,12620,1.0,0,0,3,7,2100,0,1972,0.0,98034,47.7239,-122.17299999999999,1720,7840,10520,0.8335974643423137,4410000,159264400,154854400
249000.0,4,2.25,1830,6136,2.0,0,0,2,7,1830,0,1990,0.0,98030,47.367,-122.181,1830,7664,4306,0.7017601043024772,3348900,37650496,34301596
235000.0,3,2.0,1530,8700,1.0,0,0,3,7,1530,0,1970,0.0,98055,47.4529,-122.20700000000001,1960,7600,7170,0.8241379310344827,2340900,75690000,73349100
410000.0,4,2.0,1490,13736,1.0,0,0,3,6,1490,0,1942,0.0,98125,47.711999999999996,-122.281,2040,7200,12246,0.8915259172976121,2220100,188677696,186457596
370000.0,2,1.0,860,6050,1.0,0,0,2,7,860,0,1952,0.0,98116,47.5697,-122.4,1130,6050,5190,0.8578512396694215,739600,36602500,35862900
360000.0,5,2.5,2130,7111,1.0,0,0,2,7,1330,800,1968,0.0,98059,47.5071,-122.16,1840,7592,4981,0.7004640697510899,4536900,50566321,46029421
1410000.0,5,2.25,3580,16789,2.0,0,0,4,9,3580,0,1966,0.0,98040,47.5364,-122.23899999999999,3390,17000,13209,0.7867651438441837,12816400,281870521,269054121
298000.0,4,2.5,2420,3825,2.0,0,0,2,8,2420,0,2003,0.0,98042,47.3687,-122.126,1880,4250,1405,0.3673202614379085,5856400,14630625,8774225
485000.0,4,2.25,1900,7200,1.0,0,0,2,8,1370,530,1977,0.0,98146,47.5033,-122.37200000000001,2030,8008,5300,0.7361111111111112,3610000,51840000,48230000
400000.0,3,1.75,1330,9143,1.0,0,0,2,7,1330,0,1960,0.0,98006,47.5538,-122.176,1950,10384,7813,0.8545335229137044,1768900,83594449,81825549
580000.0,3,2.5,2150,4604,2.0,0,0,2,8,2150,0,2003,0.0,98075,47.5893,-122.01899999999999,2280,4253,2454,0.5330147697654214,4622500,21196816,16574316
355000.0,2,2.5,1370,1140,2.0,0,0,2,8,1080,290,2009,0.0,98133,47.7055,-122.34200000000001,1340,1050,-230,-0.20175438596491227,1876900,1299600,-577300
650000.0,3,2.5,2430,12997,2.0,0,0,2,9,2430,0,1992,0.0,98011,47.744,-122.194,2720,12500,10567,0.8130337770254674,5904900,168922009,163017109
261490.0,4,1.0,1640,8467,1.0,0,2,3,6,1220,420,1943,0.0,98056,47.4894,-122.18799999999999,1060,7396,6827,0.8063068383134522,2689600,71690089,69000489
347000.0,3,1.0,1010,7200,1.0,0,0,2,7,1010,0,1968,0.0,98034,47.7225,-122.179,1120,7200,6190,0.8597222222222223,1020100,51840000,50819900
485000.0,3,1.0,1500,4100,1.5,0,0,2,7,1370,130,1926,0.0,98107,47.6689,-122.367,1500,4100,2600,0.6341463414634146,2250000,16810000,14560000
601000.0,3,2.5,1740,1251,2.0,0,0,2,9,1180,560,2012,0.0,98199,47.644,-122.385,1740,1625,-489,-0.3908872901678657,3027600,1565001,-1462599
380000.0,3,3.25,2090,51212,1.0,0,0,2,8,1510,580,1989,0.0,98092,47.3097,-122.09899999999999,2690,40820,49122,0.9591892525189408,4368100,2622668944,2618300844
565000.0,3,3.0,1850,12556,2.0,0,0,2,9,1850,0,1976,0.0,98074,47.6286,-122.053,2390,12474,10706,0.8526600828289264,3422500,157653136,154230636
750000.0,3,2.5,2790,21043,2.0,0,0,2,9,2790,0,1993,0.0,98053,47.673,-122.03,2900,34589,18253,0.8674143420614931,7784100,442807849,435023749
291000.0,3,2.25,1480,7200,1.0,0,0,2,7,1190,290,1975,0.0,98023,47.3037,-122.375,1830,7200,5720,0.7944444444444444,2190400,51840000,49649600
560000.0,3,2.5,2280,12498,2.0,0,0,3,9,2280,0,1987,0.0,98029,47.5688,-122.014,2330,8844,10218,0.8175708113298128,5198400,156200004,151001604
725000.0,4,2.25,3180,9600,2.0,0,0,2,10,3180,0,1984,0.0,98074,47.6313,-122.045,2840,10739,6420,0.66875,10112400,92160000,82047600
539000.0,3,2.0,2350,209088,1.0,0,0,2,7,2350,0,1993,0.0,98014,47.6527,-121.949,2300,209088,206738,0.9887607131925313,5522500,43717791744,43712269244
470000.0,5,3.25,3910,7077,2.0,0,0,2,9,2710,1200,2000,0.0,98038,47.3766,-122.027,2650,7077,3167,0.44750600536950685,15288100,50083929,34795829
264950.0,2,1.0,770,7434,1.0,0,0,2,6,770,0,1947,0.0,98155,47.7606,-122.32,1060,7453,6664,0.896421845574388,592900,55264356,54671456
200000.0,4,1.5,1780,8000,2.0,0,0,3,6,1080,700,1900,1996.0,98010,47.3124,-122.00299999999999,1750,9147,6220,0.7775,3168400,64000000,60831600
453500.0,5,2.5,2300,23345,1.0,0,0,4,7,1170,1130,1967,0.0,98059,47.4739,-122.11399999999999,2280,23345,21045,0.9014778325123153,5290000,544989025,539699025
811000.0,2,2.5,2510,17986,2.0,0,0,2,9,2510,0,1943,2014.0,98052,47.6832,-122.164,2440,8039,15476,0.8604470143444901,6300100,323496196,317196096
425000.0,3,3.25,1410,1350,3.0,0,0,2,8,1410,0,2005,0.0,98103,47.698,-122.34,1410,1253,-60,-0.044444444444444446,1988100,1822500,-165600
1530000.0,4,2.25,4250,16940,1.0,0,2,3,9,2380,1870,1974,0.0,98040,47.5453,-122.234,3460,17693,12690,0.7491145218417946,18062500,286963600,268901100
562000.0,4,2.75,2560,83200,1.0,0,0,2,8,1860,700,1980,0.0,98072,47.7511,-122.111,1990,38332,80640,0.9692307692307692,6553600,6922240000,6915686400
281000.0,3,2.5,1760,7601,2.0,0,0,2,8,1760,0,1992,0.0,98003,47.2672,-122.31299999999999,1920,6851,5841,0.768451519536903,3097600,57775201,54677601
270000.0,3,2.25,2100,14027,2.0,0,0,2,8,2100,0,1979,0.0,98042,47.3833,-122.1,2730,5999,11927,0.8502887288800172,4410000,196756729,192346729
205950.0,3,1.0,1490,8239,1.0,0,0,3,6,1490,0,1963,0.0,98023,47.306000000000004,-122.37,1200,8470,6749,0.8191528098070154,2220100,67881121,65661021
310000.0,2,1.0,870,5400,1.0,0,0,2,6,870,0,1950,2007.0,98126,47.52,-122.374,990,5200,4530,0.8388888888888889,756900,29160000,28403100
350000.0,3,1.75,1260,1111,2.0,0,0,2,8,1260,0,2003,0.0,98029,47.5476,-122.005,1410,1630,-149,-0.1341134113411341,1587600,1234321,-353279
843500.0,4,2.0,2630,16475,2.0,0,0,3,8,2630,0,1953,0.0,98004,47.638999999999996,-122.219,2670,15001,13845,0.8403641881638847,6916900,271425625,264508725
370000.0,4,2.0,1950,3757,1.0,0,0,3,6,1160,790,1908,0.0,98118,47.5372,-122.26899999999999,1720,3757,1807,0.4809688581314879,3802500,14115049,10312549
279000.0,4,2.0,2200,7700,1.0,0,0,2,7,1100,1100,1979,0.0,98058,47.464,-122.18,1790,7700,5500,0.7142857142857143,4840000,59290000,54450000
408000.0,3,1.75,1600,313672,1.0,0,0,3,7,1600,0,1960,0.0,98058,47.4129,-122.08,1780,90860,312072,0.9948991303017164,2560000,98390123584,98387563584
392000.0,3,1.0,1230,9600,1.0,0,0,2,7,1230,0,1952,0.0,98118,47.5553,-122.288,1510,6600,8370,0.871875,1512900,92160000,90647100
455000.0,2,1.0,1030,5000,1.0,0,0,4,6,1030,0,1917,0.0,98107,47.6585,-122.363,1550,5000,3970,0.794,1060900,25000000,23939100
310000.0,2,1.5,1040,83199,1.0,0,0,3,7,870,170,1965,0.0,98070,47.4222,-122.443,1760,75794,82159,0.9874998497578096,1081600,6922073601,6920992001
323500.0,3,3.0,2240,11536,2.0,0,0,2,7,2240,0,1943,0.0,98178,47.4886,-122.245,1650,8760,9296,0.8058252427184466,5017600,133079296,128061696
364500.0,3,1.0,1600,4489,1.0,0,2,2,6,800,800,1944,0.0,98126,47.5686,-122.37799999999999,1640,6013,2889,0.6435731788817108,2560000,20151121,17591121
280000.0,4,2.0,2190,14439,1.0,0,0,3,7,1180,1010,1977,0.0,98001,47.2702,-122.29,2160,14439,12249,0.848327446499065,4796100,208484721,203688621
289900.0,3,1.75,1899,11325,2.0,0,0,2,7,1899,0,1943,0.0,98198,47.3987,-122.3,2000,10454,9426,0.832317880794702,3606201,128255625,124649424
585000.0,3,1.0,1870,2807,1.5,0,0,3,7,1580,290,1927,0.0,98107,47.6674,-122.35799999999999,1640,4500,937,0.3338083363021019,3496900,7879249,4382349
269000.0,3,2.5,1730,6653,1.0,0,0,3,7,1360,370,1990,0.0,98042,47.3588,-122.088,1730,7061,4923,0.7399669322110326,2992900,44262409,41269509
280000.0,3,2.25,1860,9210,2.0,0,0,2,7,1860,0,1994,0.0,98038,47.3864,-122.03,1530,8091,7350,0.7980456026058632,3459600,84824100,81364500
287000.0,3,1.75,1940,9000,1.0,0,0,2,7,1290,650,1965,0.0,98055,47.4361,-122.189,1900,9120,7060,0.7844444444444445,3763600,81000000,77236400
183000.0,2,1.0,670,5140,1.0,0,0,2,6,670,0,1926,0.0,98126,47.5387,-122.37100000000001,850,5140,4470,0.8696498054474708,448900,26419600,25970700
309000.0,3,1.0,1820,8142,1.0,0,0,2,7,1040,780,1961,0.0,98168,47.505,-122.316,1820,8142,6322,0.7764676983542127,3312400,66292164,62979764
920000.0,4,2.5,3810,13579,2.0,0,0,2,10,3810,0,2003,0.0,98007,47.6006,-122.15299999999999,3310,9270,9769,0.7194196921717357,14516100,184389241,169873141
815241.0,5,2.25,2060,4800,2.5,0,0,2,8,2060,0,1907,0.0,98105,47.66,-122.28200000000001,1740,4800,2740,0.5708333333333333,4243600,23040000,18796400
405000.0,3,1.75,1520,7252,1.0,0,0,2,7,1140,380,1975,0.0,98072,47.7358,-122.175,1910,7820,5732,0.7904026475455047,2310400,52591504,50281104
525000.0,5,3.5,3450,19080,2.0,0,3,2,9,3450,0,2001,0.0,98022,47.2123,-122.005,2570,17007,15630,0.8191823899371069,11902500,364046400,352143900
150000.0,2,1.0,830,4045,1.0,0,0,2,6,830,0,1943,0.0,98106,47.5293,-122.351,1100,4116,3215,0.7948084054388134,688900,16362025,15673125
240000.0,4,1.75,1880,9600,1.0,0,0,4,7,1020,860,1946,0.0,98001,47.2633,-122.281,1560,14400,7720,0.8041666666666667,3534400,92160000,88625600
698000.0,4,2.25,2200,11250,1.5,0,0,4,7,1300,900,1920,0.0,98033,47.6845,-122.20100000000001,2320,10814,9050,0.8044444444444444,4840000,126562500,121722500
440000.0,3,2.0,1800,10950,1.0,0,0,3,8,1800,0,1982,0.0,98006,47.556999999999995,-122.163,2400,11300,9150,0.8356164383561644,3240000,119902500,116662500
204000.0,3,1.0,1200,12500,1.5,0,0,2,6,1200,0,1936,0.0,98198,47.4162,-122.329,1200,7500,11300,0.904,1440000,156250000,154810000
875000.0,3,2.0,2220,6641,1.0,0,2,3,7,1220,1000,1947,0.0,98199,47.6426,-122.38799999999999,1800,5900,4421,0.6657129950308689,4928400,44102881,39174481
650000.0,3,1.5,1380,4500,1.0,0,0,4,7,1380,0,1960,0.0,98040,47.5866,-122.25,1590,9000,3120,0.6933333333333334,1904400,20250000,18345600
392500.0,3,1.0,1660,8839,1.0,0,0,3,7,1660,0,1947,0.0,98155,47.7485,-122.3,1230,9236,7179,0.8121959497680733,2755600,78127921,75372321
400000.0,4,1.0,2320,4000,1.5,0,0,2,6,1310,1010,1921,0.0,98144,47.573,-122.31200000000001,1750,4000,1680,0.42,5382400,16000000,10617600
653000.0,3,2.25,2800,17300,1.0,0,0,3,8,1420,1380,1971,0.0,98006,47.5716,-122.12799999999999,2140,12650,14500,0.838150289017341,7840000,299290000,291450000
452000.0,4,1.0,1210,3760,1.5,0,0,2,6,1210,0,1900,0.0,98103,47.6872,-122.344,1540,3800,2550,0.6781914893617021,1464100,14137600,12673500
345000.0,4,2.5,2331,3826,2.0,0,0,2,8,2331,0,2007,0.0,98058,47.4444,-122.182,2441,3826,1495,0.3907475169890225,5433561,14638276,9204715
350000.0,4,1.75,1820,6930,1.0,0,2,3,7,1320,500,1952,0.0,98178,47.5053,-122.242,1820,6825,5110,0.7373737373737373,3312400,48024900,44712500
650000.0,4,2.5,2860,5576,2.0,0,0,2,8,2860,0,2004,0.0,98028,47.745,-122.22399999999999,2290,10667,2716,0.48708751793400284,8179600,31091776,22912176
525000.0,5,3.0,2750,3800,1.5,0,0,4,7,1750,1000,1926,0.0,98115,47.6845,-122.31299999999999,1900,3800,1050,0.27631578947368424,7562500,14440000,6877500
840000.0,5,3.0,2750,3800,1.5,0,0,4,7,1750,1000,1926,0.0,98115,47.6845,-122.31299999999999,1900,3800,1050,0.27631578947368424,7562500,14440000,6877500
1330000.0,3,2.5,2280,5000,2.0,0,3,3,9,2280,0,1926,0.0,98105,47.6574,-122.27799999999999,2200,5000,2720,0.544,5198400,25000000,19801600
259950.0,4,2.0,1610,6650,1.0,0,0,2,7,1610,0,1989,0.0,98023,47.3085,-122.35799999999999,1960,6650,5040,0.7578947368421053,2592100,44222500,41630400
998000.0,5,3.5,3760,10207,2.0,0,0,2,10,3150,610,1969,0.0,98040,47.5605,-122.225,3550,12118,6447,0.6316253551484275,14137600,104182849,90045249
1070000.0,3,3.0,2940,4622,2.0,0,0,3,9,2230,710,1988,0.0,98105,47.6641,-122.29299999999999,1580,4000,1682,0.36391172652531373,8643600,21362884,12719284
1910000.0,4,3.0,4460,6833,2.0,0,0,2,10,3140,1320,1955,2007.0,98112,47.6342,-122.289,3130,7450,2373,0.3472852334260208,19891600,46689889,26798289
190500.0,3,1.5,1110,1150,2.0,0,0,2,8,940,170,2007,0.0,98144,47.5929,-122.306,1380,1751,40,0.034782608695652174,1232100,1322500,90400
465000.0,3,2.25,2560,117176,1.0,0,0,3,9,1280,1280,1977,0.0,98027,47.4655,-122.03299999999999,2760,57063,114616,0.9781525227008944,6553600,13730214976,13723661376
370000.0,3,1.0,1060,7419,1.0,0,2,3,6,1060,0,1906,0.0,98177,47.7712,-122.39200000000001,2190,5953,6359,0.857123601563553,1123600,55041561,53917961
290000.0,6,4.5,2810,11214,1.0,0,0,2,8,2010,0,1958,0.0,98031,47.4045,-122.197,1940,8349,8404,0.7494203673978955,7896100,125753796,117857696
350000.0,3,1.75,1380,4590,1.0,0,0,1,7,930,450,1950,0.0,98115,47.6841,-122.29299999999999,1320,4692,3210,0.6993464052287581,1904400,21068100,19163700
740000.0,3,1.75,1380,4590,1.0,0,0,1,7,930,450,1950,0.0,98115,47.6841,-122.29299999999999,1320,4692,3210,0.6993464052287581,1904400,21068100,19163700
460000.0,3,1.75,2560,8400,1.0,0,0,2,7,1970,590,1959,0.0,98011,47.7668,-122.197,1970,8400,5840,0.6952380952380952,6553600,70560000,64006400
290000.0,3,1.0,1010,10800,1.0,0,0,3,7,1010,0,1972,0.0,98045,47.4483,-121.773,1370,9500,9790,0.9064814814814814,1020100,116640000,115619900
475000.0,3,1.5,1790,229125,2.0,0,3,2,7,1790,0,1987,0.0,98022,47.2309,-122.009,1970,216928,227335,0.9921876704855428,3204100,52498265625,52495061525
214000.0,3,2.5,1600,2231,2.0,0,0,2,7,1600,0,2003,0.0,98001,47.3314,-122.29,1600,2962,631,0.2828328103989243,2560000,4977361,2417361
455000.0,2,1.0,910,5759,1.0,0,0,2,6,910,0,1951,0.0,98125,47.7153,-122.28399999999999,1520,7518,4849,0.8419864559819413,828100,33166081,32337981
275000.0,3,2.5,2497,4400,2.0,0,0,2,8,2497,0,2007,0.0,98001,47.2873,-122.28299999999999,2434,4400,1903,0.4325,6235009,19360000,13124991
305000.0,3,1.5,1800,12196,1.0,0,0,3,7,1800,0,1966,0.0,98023,47.333,-122.345,1490,11730,10396,0.8524106264348967,3240000,148742416,145502416
449000.0,5,2.5,2570,61855,1.0,0,0,3,7,1470,1100,1981,0.0,98092,47.3013,-122.109,1990,49658,59285,0.958451216554846,6604900,3826041025,3819436125
366000.0,3,2.5,1320,4320,1.0,0,0,2,6,660,660,1918,0.0,98106,47.5327,-122.34700000000001,1190,4200,3000,0.6944444444444444,1742400,18662400,16920000
348000.0,3,2.5,1670,5090,2.0,0,0,2,7,1670,0,2003,0.0,98056,47.4799,-122.18,2560,4851,3420,0.6719056974459725,2788900,25908100,23119200
515000.0,4,2.5,2800,21370,2.0,0,0,2,8,2800,0,2003,0.0,98028,47.776,-122.24600000000001,1880,9336,18570,0.8689751988769303,7840000,456676900,448836900
950000.0,4,2.5,3360,11548,2.0,0,0,2,9,3360,0,1988,0.0,98033,47.6534,-122.182,3400,14091,8188,0.7090405264980949,11289600,133356304,122066704
815000.0,3,2.5,2590,21494,2.0,0,0,3,8,2590,0,1991,0.0,98074,47.6139,-122.061,2590,10720,18904,0.879501256164511,6708100,461992036,455283936
199950.0,3,3.0,1530,2132,2.0,0,0,2,8,1530,0,1993,0.0,98038,47.3746,-122.056,1530,3384,602,0.28236397748592873,2340900,4545424,2204524
386000.0,3,2.0,1330,8100,1.0,0,0,3,7,1330,0,1969,0.0,98034,47.7251,-122.175,1590,8100,6770,0.8358024691358025,1768900,65610000,63841100
273000.0,3,2.25,2160,7964,2.0,0,0,2,8,2160,0,1991,0.0,98042,47.3622,-122.074,2000,7964,5804,0.7287795077850326,4665600,63425296,58759696
284000.0,4,2.5,1830,6360,2.0,0,0,2,8,1830,0,1994,0.0,98031,47.4184,-122.18,1830,6596,4530,0.7122641509433962,3348900,40449600,37100700
399950.0,3,1.0,1470,7930,1.0,0,0,2,7,1070,400,1950,0.0,98177,47.7013,-122.368,1440,8100,6460,0.8146279949558638,2160900,62884900,60724000
285000.0,3,1.75,1150,6423,1.0,0,0,2,5,590,560,1927,0.0,98115,47.6973,-122.29700000000001,1150,8367,5273,0.8209559395920909,1322500,41254929,39932429
315000.0,3,2.5,1790,6452,2.0,0,0,2,7,1790,0,2004,0.0,98038,47.3841,-122.042,1610,3600,4662,0.7225666460012399,3204100,41628304,38424204
250000.0,3,1.0,1700,7700,1.0,0,0,2,7,1120,580,1960,0.0,98168,47.5114,-122.318,1700,8800,6000,0.7792207792207793,2890000,59290000,56400000
290000.0,4,2.0,1630,7618,1.5,0,0,2,7,1630,0,1967,0.0,98198,47.3658,-122.31700000000001,1320,8774,5988,0.7860330795484379,2656900,58033924,55377024
725000.0,4,2.5,3420,30410,2.0,0,0,2,9,3420,0,1988,0.0,98077,47.7745,-122.088,2940,45916,26990,0.8875369944097337,11696400,924768100,913071700
410000.0,3,2.0,1650,9641,1.5,0,0,2,7,1650,0,1983,0.0,98034,47.7145,-122.23100000000001,1940,6701,7991,0.8288559278083186,2722500,92948881,90226381
855000.0,4,2.5,2810,52062,1.5,0,0,3,9,2810,0,1988,0.0,98075,47.5941,-122.029,3330,49783,49252,0.9460258922054473,7896100,2710451844,2702555744
399900.0,4,2.5,2710,8127,2.0,0,0,2,8,2710,0,1994,0.0,98038,47.379,-122.03200000000001,2520,8436,5417,0.6665436200319921,7344100,66048129,58704029
852600.0,4,2.5,3320,11901,2.0,0,0,4,9,2650,670,1977,0.0,98006,47.553999999999995,-122.16,2700,11114,8581,0.721031846063356,11022400,141633801,130611401
235000.0,2,1.0,720,6321,1.0,0,0,2,6,720,0,1940,0.0,98118,47.551,-122.289,920,5684,5601,0.88609397247271,518400,39955041,39436641
230950.0,2,1.0,930,12724,1.0,0,0,3,6,930,0,1912,0.0,98014,47.6567,-121.90899999999999,1240,21828,11794,0.9269097767997485,864900,161900176,161035276
230000.0,3,2.25,1490,8722,2.0,0,0,2,7,1490,0,1997,0.0,98030,47.3648,-122.185,1510,8061,7232,0.8291676221050218,2220100,76073284,73853184
404763.0,3,2.5,1690,1609,2.0,0,0,2,8,1150,540,2014,0.0,98029,47.5521,-121.99799999999999,1690,1860,-81,-0.05034182722187694,2856100,2588881,-267219
245000.0,3,2.5,1720,3407,2.0,0,0,2,7,1720,0,1992,0.0,98031,47.4034,-122.18799999999999,1720,3407,1687,0.49515702964484887,2958400,11607649,8649249
188000.0,3,1.5,1140,8500,1.0,0,0,3,7,1140,0,1964,0.0,98022,47.2093,-122.005,1600,8500,7360,0.8658823529411764,1299600,72250000,70950400
626100.0,4,2.5,2280,7219,2.0,0,0,3,8,2280,0,1987,0.0,98029,47.5719,-122.021,2240,7471,4939,0.6841667821027844,5198400,52113961,46915561
428750.0,3,1.0,1100,4080,1.0,0,0,3,7,900,200,1929,0.0,98103,47.6872,-122.351,1170,4080,2980,0.7303921568627451,1210000,16646400,15436400
522000.0,4,2.25,1800,8623,1.0,0,0,3,8,1360,440,1980,0.0,98033,47.692,-122.184,2370,8623,6823,0.7912559434071669,3240000,74356129,71116129
684000.0,4,2.5,2500,8434,2.0,0,0,3,8,2500,0,1988,0.0,98052,47.6915,-122.101,1900,8131,5934,0.7035807446051695,6250000,71132356,64882356
1070000.0,3,2.25,2950,7232,1.0,0,2,2,8,1520,1430,1983,0.0,98136,47.5257,-122.382,2130,7140,4282,0.5920907079646017,8702500,52301824,43599324
611206.0,1,1.0,1940,6300,1.0,0,3,2,8,1940,0,1963,0.0,98116,47.5782,-122.4,2560,6300,4360,0.692063492063492,3763600,39690000,35926400
350000.0,2,1.0,1280,5250,1.0,0,0,3,7,1140,140,1942,0.0,98126,47.5258,-122.37700000000001,1050,5250,3970,0.7561904761904762,1638400,27562500,25924100
894000.0,4,2.5,3800,22029,2.0,0,0,2,9,3800,0,1993,0.0,98053,47.6734,-122.02600000000001,3170,24979,18229,0.8275001134867674,14440000,485276841,470836841
420000.0,2,1.0,930,5368,1.0,0,0,3,7,930,0,1953,0.0,98115,47.6952,-122.275,1770,6000,4438,0.8267511177347243,864900,28815424,27950524
400000.0,5,2.0,1930,9747,1.0,0,0,3,7,1020,910,1962,0.0,98028,47.7743,-122.235,2040,9370,7817,0.8019903560069765,3724900,95004009,91279109
675000.0,3,3.0,2980,28000,1.0,0,0,2,10,1820,1160,1981,0.0,98052,47.7318,-122.139,2570,28500,25020,0.8935714285714286,8880400,784000000,775119600
426000.0,4,2.5,2800,8494,2.0,0,0,2,8,2800,0,2004,0.0,98038,47.3521,-122.009,3740,8494,5694,0.6703555450906522,7840000,72148036,64308036
750000.0,4,2.25,3190,11597,2.0,0,0,2,10,2300,890,1984,0.0,98074,47.6323,-122.039,2990,10679,8407,0.7249288609123049,10176100,134490409,124314309
368000.0,3,1.75,1710,10800,1.0,0,0,3,7,1710,0,1958,0.0,98028,47.7391,-122.241,1890,10800,9090,0.8416666666666667,2924100,116640000,113715900
342000.0,3,1.0,1980,6450,1.0,0,0,3,6,1120,860,1950,0.0,98106,47.5291,-122.35600000000001,1180,5160,4470,0.6930232558139535,3920400,41602500,37682100
700000.0,3,1.75,1910,4800,1.0,0,0,2,7,1080,830,1959,0.0,98103,47.6844,-122.33200000000001,1750,4800,2890,0.6020833333333333,3648100,23040000,19391900
848750.0,6,3.75,3160,5000,2.0,0,0,2,8,3160,0,1989,0.0,98107,47.6748,-122.384,1740,5000,1840,0.368,9985600,25000000,15014400
720000.0,3,2.0,1590,5200,1.0,0,0,2,7,1320,270,1939,0.0,98103,47.6864,-122.34100000000001,1620,5150,3610,0.6942307692307692,2528100,27040000,24511900
525000.0,4,2.25,1890,8549,1.0,0,0,2,8,1890,0,1967,0.0,98008,47.6328,-122.117,1940,7210,6659,0.7789215112878699,3572100,73085401,69513301
397900.0,3,2.75,2500,35245,1.0,0,0,2,7,1580,920,2000,0.0,98042,47.3414,-122.117,2060,153766,32745,0.9290679529011208,6250000,1242210025,1235960025
405000.0,3,2.0,1740,18000,1.0,0,0,2,7,1230,510,1989,0.0,98028,47.7397,-122.242,1740,11250,16260,0.9033333333333333,3027600,324000000,320972400
392800.0,3,2.0,1080,11856,1.0,0,0,4,7,1080,0,1986,0.0,98033,47.6955,-122.175,1220,9247,10776,0.9089068825910931,1166400,140564736,139398336
394999.0,3,1.5,1730,7800,1.0,0,0,2,7,1330,400,1958,0.0,98133,47.7365,-122.337,1780,8309,6070,0.7782051282051282,2992900,60840000,57847100
340000.0,3,2.5,2480,6112,2.0,0,0,2,7,2480,0,2004,0.0,98058,47.4387,-122.11399999999999,3220,6727,3632,0.5942408376963351,6150400,37356544,31206144
482500.0,3,2.25,1450,1445,2.0,0,0,2,7,980,470,2005,0.0,98122,47.6184,-122.301,1510,1370,-5,-0.0034602076124567475,2102500,2088025,-14475
812500.0,4,2.5,2750,10159,2.0,0,0,2,10,2750,0,1991,0.0,98006,47.5426,-122.135,3160,10159,7409,0.7293040653607639,7562500,103205281,95642781
450000.0,3,2.5,2820,10208,1.0,0,1,3,8,1410,1410,1954,0.0,98028,47.7609,-122.26,1540,10684,7388,0.7237460815047022,7952400,104203264,96250864
398000.0,3,1.75,1830,27468,1.0,0,0,2,7,1830,0,1954,0.0,98028,47.7754,-122.23299999999999,1860,10180,25638,0.9333770205329839,3348900,754491024,751142124
1080000.0,2,3.25,1550,1767,3.0,0,3,2,8,1550,0,2006,0.0,98075,47.5684,-122.06,2710,3444,217,0.12280701754385964,2402500,3122289,719789
540000.0,2,2.0,1640,3021,1.0,0,2,2,7,840,800,1959,0.0,98107,47.666000000000004,-122.35799999999999,1780,4500,1381,0.4571333995365773,2689600,9126441,6436841
275000.0,4,2.0,1720,5472,1.0,0,0,2,6,860,860,1923,0.0,98118,47.5299,-122.288,1720,5670,3752,0.685672514619883,2958400,29942784,26984384
780000.0,5,2.0,2880,12000,2.0,0,0,2,8,2880,0,1921,0.0,98144,47.5861,-122.295,1720,5000,9120,0.76,8294400,144000000,135705600
225000.0,3,1.5,1220,8345,1.5,0,0,2,7,1220,0,1931,0.0,98178,47.5038,-122.266,1880,10169,7125,0.8538046734571599,1488400,69639025,68150625
503045.0,3,3.0,1560,2250,2.0,0,0,2,9,1560,0,2009,0.0,98103,47.6929,-122.333,1610,4500,690,0.30666666666666664,2433600,5062500,2628900
249000.0,2,2.0,1090,1357,2.0,0,0,2,7,1090,0,1990,0.0,98028,47.7526,-122.244,1078,1318,267,0.1967575534266765,1188100,1841449,653349
569950.0,4,1.0,1140,5940,1.0,0,2,2,7,1140,0,1916,0.0,98103,47.6795,-122.354,1630,4000,4800,0.8080808080808081,1299600,35283600,33984000
450000.0,2,2.25,1040,1377,2.0,0,0,2,8,1040,0,2003,0.0,98105,47.6692,-122.279,1264,1892,337,0.24473493100944083,1081600,1896129,814529
1100000.0,4,2.0,2580,6000,1.0,0,0,4,9,1300,1280,1950,0.0,98199,47.6514,-122.413,2300,6200,3420,0.57,6656400,36000000,29343600
700000.0,4,2.5,2310,3570,1.5,0,0,2,7,1490,820,1927,0.0,98103,47.6889,-122.34700000000001,1580,3060,1260,0.35294117647058826,5336100,12744900,7408800
454000.0,3,2.5,1590,4094,2.0,0,0,2,7,1590,0,1991,0.0,98122,47.61,-122.29299999999999,1940,3924,2504,0.6116267708842208,2528100,16760836,14232736
555000.0,3,1.75,1270,9170,1.0,0,0,2,7,1270,0,1969,0.0,98052,47.6706,-122.15100000000001,1700,8500,7900,0.861504907306434,1612900,84088900,82476000
214000.0,3,1.5,1240,5200,1.0,0,0,4,6,1240,0,1970,0.0,98042,47.3683,-122.079,1060,5200,3960,0.7615384615384615,1537600,27040000,25502400
590000.0,3,2.5,2210,8622,2.0,0,0,2,8,2210,0,1988,0.0,98029,47.5715,-122.02,2340,7192,6412,0.7436789607979587,4884100,74338884,69454784
459900.0,3,1.75,2340,51836,1.5,0,0,2,8,1510,830,1978,0.0,98027,47.4846,-122.035,2060,77536,49496,0.9548576279033876,5475600,2686970896,2681495296
205000.0,3,1.5,1420,5000,1.0,0,0,2,7,920,0,1987,0.0,98198,47.4192,-122.33,1400,7500,3580,0.716,2016400,25000000,22983600
390000.0,3,1.75,1430,9857,1.0,0,2,3,7,1140,290,1980,0.0,98045,47.4964,-121.771,1310,9880,8427,0.8549254337019377,2044900,97160449,95115549
970500.0,3,2.75,2470,10125,2.0,0,0,2,8,2470,0,1960,2012.0,98040,47.5651,-122.223,2290,10125,7655,0.7560493827160494,6100900,102515625,96414725
790000.0,3,2.5,2390,15084,2.0,0,0,2,8,2390,0,2000,0.0,98010,47.3389,-122.04799999999999,1850,17494,12694,0.841553964465659,5712100,227527056,221814956
320000.0,3,1.0,1120,10576,1.0,0,0,3,7,1120,0,1969,0.0,98077,47.7575,-122.072,1300,10000,9456,0.8940998487140696,1254400,111851776,110597376
552500.0,3,2.25,2700,4025,2.0,0,0,3,8,1760,940,1907,0.0,98122,47.6074,-122.294,1580,4025,1325,0.32919254658385094,7290000,16200625,8910625
1050000.0,3,3.0,3490,4500,2.5,0,0,2,9,3170,320,1924,0.0,98102,47.6394,-122.321,2840,4050,1010,0.22444444444444445,12180100,20250000,8069900
230000.0,3,1.0,1640,7187,1.0,0,0,2,7,1640,0,1966,0.0,98058,47.455,-122.182,1340,8346,5547,0.7718102128843746,2689600,51652969,48963369
680000.0,3,1.75,1620,5500,1.0,0,0,2,7,1110,510,1950,0.0,98112,47.6393,-122.30799999999999,2100,6500,3880,0.7054545454545454,2624400,30250000,27625600
985000.0,3,1.75,1670,5400,2.0,0,0,4,8,1670,0,1912,0.0,98112,47.635,-122.28399999999999,2100,5400,3730,0.6907407407407408,2788900,29160000,26371100
375000.0,4,2.5,1870,7471,2.0,0,0,2,8,1870,0,1990,0.0,98055,47.4314,-122.204,2020,8912,5601,0.749698835497256,3496900,55815841,52318941
431000.0,2,1.5,1300,4000,1.5,0,0,3,6,1300,0,1900,0.0,98144,47.5937,-122.301,1480,4000,2700,0.675,1690000,16000000,14310000
463000.0,3,2.5,2190,17108,2.0,0,0,2,8,2190,0,1991,0.0,98019,47.7321,-121.964,2400,14040,14918,0.8719897124152444,4796100,292683664,287887564
350000.0,3,1.75,1320,10500,1.0,0,0,2,7,1320,0,1966,0.0,98034,47.7267,-122.226,1310,10500,9180,0.8742857142857143,1742400,110250000,108507600
485000.0,3,1.0,1250,7200,1.0,0,0,2,7,1250,0,1964,0.0,98008,47.6342,-122.12,1430,7400,5950,0.8263888888888888,1562500,51840000,50277500
355000.0,4,1.75,2040,15000,1.0,0,0,3,7,1360,0,1967,0.0,98092,47.3107,-122.189,2310,15000,12960,0.864,4161600,225000000,220838400
603500.0,3,1.75,2140,7280,1.0,0,0,2,7,1070,1070,1910,0.0,98117,47.6993,-122.37700000000001,2280,8400,5140,0.7060439560439561,4579600,52998400,48418800
860000.0,5,1.75,2510,6000,1.5,0,0,4,8,2010,500,1920,0.0,98144,47.5798,-122.292,2240,5000,3490,0.5816666666666667,6300100,36000000,29699900
259875.0,5,2.5,2200,6250,2.0,0,0,2,7,2200,0,1996,0.0,98038,47.3675,-122.021,1850,6091,4050,0.648,4840000,39062500,34222500
685000.0,4,2.5,2170,8680,1.0,0,0,2,7,1220,950,1959,0.0,98004,47.6078,-122.19200000000001,2010,8680,6510,0.75,4708900,75342400,70633500
382500.0,4,2.5,2980,8786,2.0,0,0,2,8,2980,0,2003,0.0,98038,47.378,-122.03,2980,6718,5806,0.6608240382426588,8880400,77193796,68313396
490000.0,3,1.0,1180,2250,1.5,0,0,2,7,1180,0,1902,0.0,98117,47.6779,-122.37700000000001,1320,5100,1070,0.47555555555555556,1392400,5062500,3670100
229000.0,3,2.0,1540,6000,1.0,0,0,3,6,1540,0,1953,0.0,98155,47.7372,-122.307,1490,8213,4460,0.7433333333333333,2371600,36000000,33628400
430000.0,3,2.0,1540,6000,1.0,0,0,3,6,1540,0,1953,0.0,98155,47.7372,-122.307,1490,8213,4460,0.7433333333333333,2371600,36000000,33628400
580000.0,5,2.5,3110,15783,1.0,0,0,2,8,1720,1390,1974,0.0,98052,47.6301,-122.103,2550,12220,12673,0.8029525438763226,9672100,249103089,239430989
510000.0,3,1.75,1370,6700,1.0,0,0,2,8,1370,0,1940,2012.0,98117,47.6982,-122.36200000000001,1180,6694,5330,0.7955223880597015,1876900,44890000,43013100
489990.0,5,2.25,2440,20828,1.5,0,0,3,8,2440,0,1975,0.0,98042,47.3762,-122.15799999999999,2670,14472,18388,0.8828500096024582,5953600,433805584,427851984
440000.0,3,2.25,1760,1800,2.0,0,0,2,7,1330,430,1983,0.0,98199,47.6579,-122.39399999999999,1150,4575,40,0.022222222222222223,3097600,3240000,142400
479950.0,3,2.5,2810,4984,1.0,0,0,2,9,1750,1060,2006,0.0,98055,47.4461,-122.209,2810,5711,2174,0.43619582664526485,7896100,24840256,16944156
806000.0,4,2.5,2500,206474,1.0,0,0,2,10,2500,0,1997,0.0,98053,47.6778,-121.994,3680,208652,203974,0.9878919379679766,6250000,42631512676,42625262676
875000.0,4,2.5,3220,22588,2.0,0,0,2,10,3220,0,1996,0.0,98077,47.7311,-122.055,3220,22922,19368,0.8574464317336639,10368400,510217744,499849344
710800.0,3,2.5,2880,36820,2.0,0,0,2,10,2880,0,1992,0.0,98077,47.76600000000001,-122.044,3190,36820,33940,0.9217816404128191,8294400,1355712400,1347418000
565000.0,3,2.5,2700,6037,2.0,0,0,2,8,2700,0,2004,0.0,98065,47.5376,-121.87899999999999,2740,6054,3337,0.5527579923803213,7290000,36445369,29155369
359999.0,5,3.0,2680,9624,2.0,0,0,2,7,1870,810,1995,0.0,98010,47.3279,-122.006,1860,9921,6944,0.7215295095594347,7182400,92621376,85438976
625000.0,3,1.75,1780,4500,1.0,0,0,3,7,920,860,1922,0.0,98117,47.6827,-122.36200000000001,1360,4000,2720,0.6044444444444445,3168400,20250000,17081600
349950.0,3,2.5,2240,7565,2.0,0,0,2,8,2240,0,1999,0.0,98003,47.3485,-122.301,2190,8254,5325,0.7038995373430271,5017600,57229225,52211625
415000.0,4,2.0,1610,9600,1.0,0,0,4,7,1610,0,1967,0.0,98056,47.5327,-122.186,1450,9600,7990,0.8322916666666667,2592100,92160000,89567900
435000.0,2,2.0,1440,1170,2.0,0,0,2,9,960,480,2004,0.0,98116,47.5592,-122.385,1440,1350,-270,-0.23076923076923078,2073600,1368900,-704700
225000.0,3,1.75,1550,9060,2.0,0,0,2,7,1550,0,1948,0.0,98146,47.5093,-122.345,1080,7620,7510,0.8289183222958058,2402500,82083600,79681100
770000.0,3,1.75,1720,5000,1.0,0,0,2,9,1720,0,1954,2014.0,98122,47.6157,-122.29,2120,4188,3280,0.656,2958400,25000000,22041600
340000.0,3,1.75,1740,10800,1.0,0,0,2,7,1740,0,1959,0.0,98133,47.7717,-122.351,1810,7735,9060,0.8388888888888889,3027600,116640000,113612400
965000.0,5,2.75,3280,12673,1.0,0,0,3,9,2050,1230,1981,0.0,98006,47.5504,-122.146,3060,12847,9393,0.741182040558668,10758400,160604929,149846529
667000.0,3,2.75,2216,31215,1.0,0,0,2,9,2216,0,1968,2005.0,98092,47.3164,-122.199,2216,30048,28999,0.9290084895082492,4910656,974376225,969465569
250000.0,1,1.0,1100,4373,1.0,0,0,1,6,820,280,1947,0.0,98166,47.4653,-122.338,1100,7500,3273,0.7484564372284472,1210000,19123129,17913129
397990.0,3,1.0,1180,11862,1.0,0,0,3,7,1180,0,1948,0.0,98177,47.7153,-122.363,1540,8100,10682,0.9005226774574271,1392400,140707044,139314644
535000.0,3,1.75,2020,10031,1.0,0,0,4,7,1370,650,1952,0.0,98155,47.7487,-122.319,1500,8456,8011,0.7986242647791846,4080400,100620961,96540561
265950.0,3,1.5,1150,8450,1.0,0,0,3,6,1150,0,1951,0.0,98178,47.4927,-122.22399999999999,1160,6800,7300,0.863905325443787,1322500,71402500,70080000
258000.0,3,1.75,2090,7461,1.0,0,0,2,6,1200,890,1986,0.0,98030,47.3764,-122.184,1420,7462,5371,0.7198766921324219,4368100,55666521,51298421
505500.0,3,2.5,1300,1187,3.0,0,0,2,8,1300,0,2005,0.0,98107,47.6704,-122.391,1320,1194,-113,-0.09519797809604044,1690000,1408969,-281031
455000.0,5,2.5,2240,7770,1.0,0,0,2,7,1340,900,1978,0.0,98034,47.7198,-122.171,1820,7770,5530,0.7117117117117117,5017600,60372900,55355300
1350000.0,5,3.25,3540,5971,1.0,0,2,2,10,2000,1540,2005,0.0,98033,47.6643,-122.20200000000001,2820,6029,2431,0.4071344833361246,12531600,35652841,23121241
600000.0,4,2.25,2840,31720,1.0,0,0,2,8,1780,1060,1958,0.0,98177,47.7505,-122.375,2290,29577,28880,0.9104665825977302,8065600,1006158400,998092800
329800.0,4,2.5,2080,7047,2.0,0,0,2,8,2080,0,1996,0.0,98092,47.2627,-122.215,2580,7227,4967,0.7048389385554137,4326400,49660209,45333809
222000.0,2,1.0,1550,38449,1.0,0,0,2,6,1550,0,1947,0.0,98055,47.4315,-122.199,1188,25875,36899,0.9596868579156805,2402500,1478325601,1475923101
450000.0,4,2.5,1900,9240,1.0,0,0,2,7,1900,0,1962,0.0,98007,47.6167,-122.137,2040,8052,7340,0.7943722943722944,3610000,85377600,81767600
952000.0,3,3.5,2760,4500,2.0,0,0,2,9,2120,640,2004,0.0,98119,47.6529,-122.37200000000001,1950,6000,1740,0.38666666666666666,7617600,20250000,12632400
625000.0,4,2.0,1410,4480,1.5,0,0,2,8,1410,0,1927,0.0,98109,47.6385,-122.344,1240,3400,3070,0.6852678571428571,1988100,20070400,18082300
226800.0,2,1.0,1240,11393,1.0,0,0,3,7,1240,0,1960,0.0,98030,47.3714,-122.20700000000001,1660,11393,10153,0.8911612393575002,1537600,129800449,128262849
1210000.0,5,4.25,4420,13497,2.0,0,0,2,11,3510,910,2000,0.0,98059,47.5262,-122.14299999999999,4220,12015,9077,0.6725198192190858,19536400,182169009,162632609
350000.0,4,2.75,3390,16153,1.0,0,0,3,7,1970,1420,1961,0.0,98031,47.3954,-122.184,2530,8495,12763,0.7901318640500217,11492100,260919409,249427309
395000.0,3,1.75,1400,8640,1.0,0,0,2,7,1400,0,1962,0.0,98011,47.7659,-122.204,1630,8640,7240,0.8379629629629629,1960000,74649600,72689600
285000.0,5,3.0,2110,5260,2.0,0,0,2,7,1670,440,2002,0.0,98118,47.5449,-122.272,2110,5260,3150,0.5988593155893536,4452100,27667600,23215500
553000.0,3,1.0,1310,18135,1.0,0,0,2,7,1310,0,1948,0.0,98008,47.6065,-122.113,2150,18135,16825,0.9277639922801213,1716100,328878225,327162125
254000.0,3,1.0,1270,16800,1.0,0,0,3,7,1270,0,1957,0.0,98188,47.4599,-122.27600000000001,1700,10200,15530,0.924404761904762,1612900,282240000,280627100
348140.0,2,1.5,2060,10880,1.0,0,0,2,6,1190,870,1924,0.0,98106,47.515,-122.36200000000001,1430,8781,8820,0.8106617647058824,4243600,118374400,114130800
354950.0,4,2.75,2530,7350,1.0,0,0,4,8,1280,1250,1977,0.0,98023,47.313,-122.374,2280,7350,4820,0.6557823129251701,6400900,54022500,47621600
706000.0,3,2.75,1900,6400,1.0,0,0,4,7,1410,490,1942,0.0,98105,47.6697,-122.281,1350,6400,4500,0.703125,3610000,40960000,37350000
499000.0,4,2.5,2910,6479,2.0,0,0,2,7,2910,0,2006,0.0,98065,47.5402,-121.887,2320,5178,3569,0.5508566136749499,8468100,41977441,33509341
427500.0,3,1.5,1900,43186,1.5,0,0,3,7,1300,600,1971,0.0,98038,47.4199,-121.99,2080,108028,41286,0.9560042606400222,3610000,1865030596,1861420596
439000.0,5,3.5,2880,10000,2.0,0,3,2,8,1980,900,1991,0.0,98055,47.4874,-122.223,2120,9535,7120,0.712,8294400,100000000,91705600
545000.0,4,2.5,2820,25995,2.0,0,0,2,9,2820,0,1998,0.0,98010,47.3415,-122.029,3330,27653,23175,0.8915175995383727,7952400,675740025,667787625
842000.0,3,1.0,1620,4774,1.5,0,0,2,7,1620,0,1920,0.0,98103,47.659,-122.339,1880,4560,3154,0.6606619187264349,2624400,22791076,20166676
685000.0,4,2.5,3320,38043,2.0,0,0,2,9,3320,0,1997,0.0,98053,47.6504,-122.00399999999999,3170,42621,34723,0.9127303314670242,11022400,1447269849,1436247449
665000.0,4,3.5,3770,47480,2.0,0,0,2,9,3770,0,2003,0.0,98010,47.3552,-121.99,3380,42689,43710,0.9205981465880371,14212900,2254350400,2240137500
255000.0,2,1.0,1200,9000,1.0,0,2,4,6,1200,0,1917,0.0,98198,47.4039,-122.323,1660,9000,7800,0.8666666666666667,1440000,81000000,79560000
565000.0,5,2.25,2130,4360,1.0,0,2,2,8,1240,890,1959,0.0,98199,47.6586,-122.395,1830,5000,2230,0.5114678899082569,4536900,19009600,14472700
274000.0,5,1.75,1950,8720,1.0,0,0,2,7,1050,900,1962,0.0,98001,47.3381,-122.289,1660,8030,6770,0.7763761467889908,3802500,76038400,72235900
260000.0,3,2.0,1920,8075,1.0,0,0,3,7,1510,410,1969,0.0,98023,47.3092,-122.375,1920,7826,6155,0.7622291021671826,3686400,65205625,61519225
581000.0,4,2.0,2510,13695,1.0,0,0,3,7,1280,1230,1961,2001.0,98033,47.7005,-122.17399999999999,1220,12500,11185,0.8167214311792625,6300100,187553025,181252925
625000.0,3,1.5,1990,5978,1.5,0,4,3,7,1990,0,1926,0.0,98198,47.3449,-122.329,2100,6221,3988,0.6671127467380394,3960100,35736484,31776384
220000.0,3,1.0,1230,9720,1.0,0,0,4,7,1230,0,1969,0.0,98042,47.3266,-122.13799999999999,1230,9720,8490,0.8734567901234568,1512900,94478400,92965500
765000.0,3,2.25,3190,324086,2.0,0,2,2,9,3190,0,1982,0.0,98024,47.5477,-121.93,3190,217800,320896,0.990156933653413,10176100,105031735396,105021559296
1330000.0,6,4.25,5720,10213,2.0,0,0,2,10,4170,1550,2004,0.0,98006,47.5464,-122.116,4300,10224,4493,0.43992950161558797,32718400,104305369,71586969
700000.0,8,2.5,2280,3000,1.5,0,0,2,7,1210,1070,1911,0.0,98105,47.6675,-122.316,1610,3000,720,0.24,5198400,9000000,3801600
351000.0,4,1.0,1550,7260,1.0,0,0,3,6,1550,0,1959,0.0,98008,47.6229,-122.12100000000001,1210,7260,5710,0.7865013774104683,2402500,52707600,50305100
413565.0,3,2.5,1690,1613,2.0,0,0,2,8,1150,540,2014,0.0,98029,47.5524,-121.99799999999999,1690,1619,-77,-0.04773713577185369,2856100,2601769,-254331
363000.0,3,3.25,1651,1779,2.0,0,0,2,8,1341,310,2008,0.0,98133,47.7076,-122.346,1650,2908,128,0.07195053400786959,2725801,3164841,439040
679000.0,4,1.75,2260,41236,1.0,0,0,3,8,1690,570,1962,0.0,98029,47.5528,-122.03399999999999,3080,30240,38976,0.9451935202250461,5107600,1700407696,1695300096
473000.0,2,1.75,1510,4555,1.0,0,0,2,8,1510,0,2005,0.0,98053,47.7136,-122.031,1640,4500,3045,0.6684961580680571,2280100,20748025,18467925
585888.0,3,2.0,1490,7431,1.0,0,0,3,7,1490,0,1966,0.0,98052,47.6697,-122.162,1700,7725,5941,0.7994886287175347,2220100,55219761,52999661
405000.0,4,2.5,2220,4652,2.0,0,0,2,7,2220,0,2001,0.0,98059,47.4902,-122.154,1840,4500,2432,0.5227858985382631,4928400,21641104,16712704
650000.0,3,1.75,2800,19386,1.0,1,4,2,8,1400,1400,1965,0.0,98198,47.3554,-122.324,3270,31450,16586,0.8555658722789642,7840000,375816996,367976996
415000.0,4,2.5,2210,213008,1.0,0,0,3,7,1210,1000,1975,0.0,98038,47.4039,-121.98,2270,52707,210798,0.9896248028243071,4884100,45372408064,45367523964
575000.0,3,2.0,2150,3880,1.0,0,0,2,8,1080,1070,1951,0.0,98117,47.6814,-122.39200000000001,2130,4000,1730,0.44587628865979384,4622500,15054400,10431900
220000.0,3,2.25,1400,7205,1.0,0,0,2,7,1140,260,1985,0.0,98030,47.349,-122.166,1970,7252,5805,0.8056904927133934,1960000,51912025,49952025
610000.0,4,3.0,2450,10117,1.0,0,0,4,8,1580,870,1967,0.0,98006,47.5694,-122.132,2530,10125,7667,0.7578333498072551,6002500,102353689,96351189
499950.0,3,1.0,980,6380,1.0,0,0,2,7,760,220,1941,0.0,98115,47.692,-122.30799999999999,1390,6380,5400,0.8463949843260188,960400,40704400,39744000
883000.0,4,2.5,2800,6874,2.0,0,0,2,9,2170,630,1990,0.0,98112,47.6215,-122.29,1430,6240,4074,0.5926680244399185,7840000,47251876,39411876
436000.0,2,1.0,1240,8100,1.5,0,2,2,7,1240,0,1925,0.0,98125,47.7326,-122.288,2790,8100,6860,0.8469135802469135,1537600,65610000,64072400
320000.0,3,2.5,1610,1356,2.0,0,0,2,8,1240,370,2007,0.0,98106,47.5257,-122.361,1270,1314,-254,-0.1873156342182891,2592100,1838736,-753364
425000.0,3,1.75,1510,44000,1.0,0,0,2,7,1240,270,1989,0.0,98045,47.4851,-121.71600000000001,2290,36242,42490,0.9656818181818182,2280100,1936000000,1933719900
204700.0,4,2.0,1670,9987,1.0,0,0,2,7,1670,0,1967,0.0,98001,47.3406,-122.28399999999999,1640,7280,8317,0.8327826174026234,2788900,99740169,96951269
384000.0,6,3.0,2320,4502,1.0,0,0,3,7,1200,1120,1987,0.0,98108,47.5552,-122.3,1160,5628,2182,0.4846734784540204,5382400,20268004,14885604
314000.0,3,2.75,1900,8200,2.0,0,0,3,7,1900,0,1984,0.0,98031,47.402,-122.18299999999999,1620,8200,6300,0.7682926829268293,3610000,67240000,63630000
535000.0,3,2.5,2390,6263,2.0,0,0,2,9,2390,0,2003,0.0,98028,47.7379,-122.24799999999999,2390,11761,3873,0.6183937410186812,5712100,39225169,33513069
568000.0,4,1.75,2110,265716,1.0,0,0,3,8,2110,0,1979,0.0,98053,47.657,-122.02600000000001,2110,110597,263606,0.992059191015972,4452100,70604992656,70600540556
426000.0,4,1.5,1470,5850,1.0,0,0,3,7,810,660,1973,0.0,98052,47.7,-122.12899999999999,1290,7300,4380,0.7487179487179487,2160900,34222500,32061600
675000.0,4,2.75,2670,6780,2.0,0,3,4,8,1630,1040,1908,0.0,98118,47.5131,-122.256,2400,5989,4110,0.6061946902654868,7128900,45968400,38839500
380000.0,4,2.5,2540,6365,2.0,0,0,2,8,1870,670,2000,0.0,98055,47.4608,-122.215,2290,5942,3825,0.600942655145326,6451600,40513225,34061625
685000.0,3,2.5,3450,8000,3.0,0,0,3,8,2970,480,1927,1975.0,98116,47.5605,-122.402,1880,6135,4550,0.56875,11902500,64000000,52097500
429000.0,3,2.0,1700,52826,1.0,0,0,2,7,1700,0,1991,0.0,98058,47.4164,-122.09200000000001,2480,114728,51126,0.9678188770681104,2890000,2790586276,2787696276
799000.0,4,1.5,1810,6583,1.0,0,0,2,7,1500,310,1968,0.0,98133,47.7273,-122.351,860,8670,4773,0.7250493695883335,3276100,43335889,40059789
318500.0,5,1.75,1550,6986,1.0,0,0,2,7,1030,520,1978,0.0,98106,47.5503,-122.35600000000001,1550,6986,5436,0.7781276839393072,2402500,48804196,46401696
925000.0,3,3.25,4110,20900,2.0,0,0,2,9,2630,0,2002,0.0,98006,47.5506,-122.18700000000001,2640,14700,16790,0.8033492822966507,16892100,436810000,419917900
420000.0,3,1.5,2080,5000,1.0,0,0,2,7,1300,780,1963,0.0,98118,47.5322,-122.29,1860,5000,2920,0.584,4326400,25000000,20673600
570000.0,2,1.0,1100,4000,1.0,0,0,2,7,1100,0,1906,0.0,98109,47.6388,-122.35,1590,4000,2900,0.725,1210000,16000000,14790000
1050000.0,4,2.75,3950,12840,2.0,0,0,4,8,3950,0,1960,0.0,98040,47.5489,-122.219,2350,12507,8890,0.692367601246106,15602500,164865600,149263100
333000.0,3,1.0,1250,8450,1.0,0,0,3,7,1250,0,1954,0.0,98146,47.503,-122.36399999999999,1350,9300,7200,0.8520710059171598,1562500,71402500,69840000
1360000.0,2,1.75,2620,14138,2.0,1,4,2,8,2120,0,1931,1991.0,98125,47.7142,-122.277,1830,8279,11518,0.8146838308105814,6864400,199883044,193018644
660000.0,3,2.5,2290,2798,3.0,0,0,3,9,2290,0,1953,1983.0,98102,47.64100000000001,-122.315,2260,5000,508,0.18155825589706934,5244100,7828804,2584704
350000.0,6,4.5,3500,8504,2.0,0,0,2,7,3500,0,1980,0.0,98155,47.7351,-122.295,1550,8460,5004,0.5884289746001882,12250000,72318016,60068016
682500.0,6,4.5,3500,8504,2.0,0,0,2,7,3500,0,1980,0.0,98155,47.7351,-122.295,1550,8460,5004,0.5884289746001882,12250000,72318016,60068016
399990.0,5,2.75,1690,4000,1.0,0,0,4,7,970,720,1943,0.0,98106,47.5312,-122.354,1240,4000,2310,0.5775,2856100,16000000,13143900
860000.0,5,3.25,4500,9648,2.0,0,4,3,8,3000,1500,1968,0.0,98125,47.7262,-122.28200000000001,2780,21132,5148,0.5335820895522388,20250000,93083904,72833904
216180.0,2,1.0,1120,7797,1.0,0,0,2,6,1120,0,1948,0.0,98055,47.4871,-122.22,2180,7200,6677,0.8563550083365397,1254400,60793209,59538809
300000.0,4,2.25,1740,9613,2.0,0,0,4,8,1740,0,1989,0.0,98058,47.463,-122.125,1680,9769,7873,0.8189951107874753,3027600,92409769,89382169
145000.0,3,1.0,1010,11880,1.0,0,0,2,7,1010,0,1960,0.0,98030,47.3762,-122.219,1150,9435,10870,0.914983164983165,1020100,141134400,140114300
255000.0,3,1.0,1010,11880,1.0,0,0,2,7,1010,0,1960,0.0,98030,47.3762,-122.219,1150,9435,10870,0.914983164983165,1020100,141134400,140114300
250000.0,3,1.75,1200,24805,1.0,0,0,2,6,1200,0,1984,0.0,98031,47.4236,-122.195,2150,4339,23605,0.951622656722435,1440000,615288025,613848025
245000.0,3,1.0,1020,8625,1.0,0,0,2,7,1020,0,1978,0.0,98045,47.4465,-121.77,1290,9440,7605,0.8817391304347826,1040400,74390625,73350225
445000.0,3,1.75,1850,7056,2.5,0,0,3,8,1850,0,1979,0.0,98052,47.6602,-122.13,1970,7056,5206,0.73781179138322,3422500,49787136,46364636
562000.0,3,1.5,1830,8000,1.0,0,0,3,7,1830,0,1957,0.0,98008,47.6017,-122.12200000000001,1310,7500,6170,0.77125,3348900,64000000,60651100
501000.0,4,1.0,2070,7519,1.0,0,0,2,7,1160,910,1963,0.0,98008,47.632,-122.119,1730,7519,5449,0.7246974331693045,4284900,56535361,52250461
190000.0,3,1.75,1160,5850,1.0,0,0,3,6,1160,0,1918,0.0,98146,47.5064,-122.35600000000001,1110,8382,4690,0.8017094017094017,1345600,34222500,32876900
862500.0,4,2.75,3280,24440,2.0,0,0,2,10,3280,0,1996,0.0,98077,47.7073,-122.07,3490,25138,21160,0.8657937806873978,10758400,597313600,586555200
1090000.0,5,2.5,2340,6000,2.0,0,0,3,10,2340,0,1922,0.0,98144,47.5764,-122.287,2350,6000,3660,0.61,5475600,36000000,30524400
575000.0,5,3.0,3690,49709,1.0,0,2,2,9,2690,1000,1960,0.0,98198,47.3908,-122.32,2590,8691,46019,0.9257679695829729,13616100,2470984681,2457368581
250000.0,1,1.0,720,123710,1.0,0,0,3,6,720,0,1935,0.0,98092,47.2893,-122.084,1860,297514,122990,0.994179936949317,518400,15304164100,15303645700
310000.0,7,1.5,2660,15111,1.5,0,0,3,7,2660,0,1962,0.0,98059,47.4644,-122.066,1710,15429,12451,0.8239692938918669,7075600,228342321,221266721
1400000.0,5,3.25,4300,9270,2.0,0,3,2,10,2910,1390,1957,2009.0,98116,47.5717,-122.40899999999999,2780,6610,4970,0.5361380798274002,18490000,85932900,67442900
284850.0,3,1.5,1590,8256,1.0,0,1,2,7,1090,500,1969,0.0,98003,47.3488,-122.304,1950,7840,6666,0.8074127906976745,2528100,68161536,65633436
570000.0,4,2.5,2590,7910,2.0,0,0,2,9,2590,0,2003,0.0,98028,47.7378,-122.24799999999999,2110,11761,5320,0.672566371681416,6708100,62568100,55860000
304000.0,3,1.75,1720,6000,1.0,0,2,2,7,1000,720,1954,0.0,98178,47.4999,-122.223,1690,6000,4280,0.7133333333333334,2958400,36000000,33041600
560000.0,4,2.5,1790,9787,1.0,0,2,3,8,1240,550,1983,0.0,98056,47.5344,-122.189,1790,9787,7997,0.8171043220598754,3204100,95785369,92581269
325000.0,3,1.0,1590,8160,1.0,0,1,2,7,1090,500,1954,0.0,98198,47.4013,-122.321,1540,10500,6570,0.8051470588235294,2528100,66585600,64057500
557510.0,4,2.0,1580,4800,1.5,0,2,2,7,1580,0,1912,0.0,98136,47.5454,-122.383,1580,4800,3220,0.6708333333333333,2496400,23040000,20543600
305000.0,4,2.25,2580,8820,1.0,0,0,3,9,1620,960,1967,0.0,98023,47.3122,-122.376,2140,8400,6240,0.7074829931972789,6656400,77792400,71136000
320000.0,5,1.0,1740,27350,1.0,0,0,3,5,1740,0,1958,0.0,98059,47.4809,-122.15299999999999,2760,10749,25610,0.9363802559414991,3027600,748022500,744994900
455000.0,5,2.25,3470,28212,1.5,0,0,3,8,2790,680,1978,0.0,98042,47.3342,-122.10799999999999,2020,28177,24742,0.8770026938891252,12040900,795916944,783876044
383001.0,3,1.0,1180,7210,1.0,0,0,3,7,1180,0,1963,0.0,98034,47.7267,-122.241,1700,7210,6030,0.8363384188626907,1392400,51984100,50591700
545000.0,3,1.75,1700,51649,1.5,0,0,4,6,1700,0,1931,0.0,98059,47.4704,-122.07600000000001,1100,39504,49949,0.9670855195647544,2890000,2667619201,2664729201
487500.0,2,1.0,1190,5000,1.0,0,0,2,7,1190,0,1925,0.0,98116,47.5717,-122.382,1600,5000,3810,0.762,1416100,25000000,23583900
345000.0,5,2.5,2450,6994,2.0,0,0,2,8,2450,0,2002,0.0,98030,47.3572,-122.19200000000001,1940,6035,4544,0.6496997426365456,6002500,48916036,42913536
583000.0,6,2.75,2630,16411,1.0,0,0,3,8,1650,980,1974,0.0,98052,47.6309,-122.09299999999999,2250,12255,13781,0.8397416367070867,6916900,269320921,262404021
534950.0,3,2.25,2130,12286,2.0,0,0,2,8,2130,0,1977,0.0,98052,47.6471,-122.11399999999999,2130,10158,10156,0.8266319387921212,4536900,150945796,146408896
403504.0,4,1.0,1060,5750,1.0,0,0,2,6,950,110,1904,0.0,98199,47.6562,-122.389,1790,5857,4690,0.8156521739130435,1123600,33062500,31938900
500000.0,3,1.75,1480,6120,1.5,0,0,2,7,1480,0,1946,0.0,98115,47.6858,-122.295,1480,6120,4640,0.7581699346405228,2190400,37454400,35264000
319502.0,3,1.75,1610,38707,1.0,0,0,2,7,1610,0,1990,0.0,98010,47.3778,-122.001,1930,45151,37097,0.9584054563773995,2592100,1498231849,1495639749
525000.0,4,2.75,2440,5080,2.0,0,0,2,8,1750,690,1960,0.0,98126,47.5547,-122.37899999999999,1920,6375,2640,0.5196850393700787,5953600,25806400,19852800
563000.0,4,3.0,3100,15480,2.0,0,0,2,8,2400,700,1996,0.0,98028,47.7466,-122.241,2000,42500,12380,0.7997416020671835,9610000,239630400,230020400
898500.0,4,2.75,2890,5000,1.5,0,0,2,8,1990,900,1911,2014.0,98117,47.6768,-122.363,1080,3750,2110,0.422,8352100,25000000,16647900
651000.0,3,2.5,3240,108366,2.0,0,0,3,10,3240,0,1991,0.0,98042,47.327,-122.094,2090,108366,105126,0.9701013232932839,10497600,11743189956,11732692356
450000.0,4,2.75,2900,6400,2.0,0,0,2,7,2040,860,1911,1970.0,98136,47.5563,-122.39299999999999,1340,6144,3500,0.546875,8410000,40960000,32550000
665000.0,4,2.25,2650,8149,1.0,0,0,3,8,1610,1040,1975,0.0,98006,47.5624,-122.176,2290,8019,5499,0.6748067247515033,7022500,66406201,59383701
825000.0,4,2.5,2560,4000,2.0,0,0,4,8,1610,950,1929,0.0,98117,47.6885,-122.38600000000001,1760,4000,1440,0.36,6553600,16000000,9446400
200000.0,3,1.0,1150,4800,1.5,0,0,3,6,1150,0,1938,0.0,98002,47.3101,-122.212,1310,9510,3650,0.7604166666666666,1322500,23040000,21717500
295000.0,3,2.0,1760,6092,1.0,0,0,2,7,1760,0,1998,0.0,98030,47.3838,-122.184,2590,6255,4332,0.711096520026264,3097600,37112464,34014864
748000.0,4,2.5,3220,8379,2.0,0,0,2,10,3220,0,2004,0.0,98034,47.7043,-122.19200000000001,2720,7635,5159,0.6157059314954052,10368400,70207641,59839241
580000.0,3,2.5,3200,18750,1.0,0,0,1,9,2660,540,1967,1996.0,98027,47.5717,-122.12,3200,22475,15550,0.8293333333333334,10240000,351562500,341322500
275000.0,3,1.0,1250,10744,1.0,0,0,2,6,1250,0,1942,0.0,98198,47.4226,-122.32700000000001,1500,10710,9494,0.8836559940431868,1562500,115433536,113871036
196000.0,3,1.0,1000,8470,1.0,0,0,3,6,1000,0,1963,0.0,98023,47.3056,-122.37,1020,8470,7470,0.8819362455726092,1000000,71740900,70740900
235750.0,2,1.0,740,11250,1.0,0,0,1,6,740,0,1938,0.0,98146,47.5036,-122.36200000000001,1390,11250,10510,0.9342222222222222,547600,126562500,126014900
315000.0,3,2.25,2170,8480,1.0,0,0,2,8,2170,0,1965,0.0,98148,47.4562,-122.33,2080,8452,6310,0.7441037735849056,4708900,71910400,67201500
338000.0,4,2.5,2370,10631,2.0,0,0,2,8,2370,0,1999,0.0,98003,47.3473,-122.302,2200,8297,8261,0.7770670680086539,5616900,113018161,107401261
353000.0,4,2.5,2300,4249,2.0,0,0,2,8,2300,0,2006,0.0,98038,47.3516,-122.0,2390,4385,1949,0.45869616380324785,5290000,18054001,12764001
235000.0,3,1.75,1400,6300,1.0,0,0,2,7,1400,0,1998,0.0,98022,47.2074,-122.001,1400,8490,4900,0.7777777777777778,1960000,39690000,37730000
569999.0,3,2.5,3080,13880,2.0,0,0,2,9,3080,0,1990,0.0,98038,47.3726,-122.025,2780,15318,10800,0.7780979827089337,9486400,192654400,183168000
505000.0,4,2.25,2350,12540,2.0,0,0,2,8,2350,0,1968,0.0,98177,47.7732,-122.382,2090,7964,10190,0.8125996810207337,5522500,157251600,151729100
1230000.0,4,3.0,2660,4600,1.5,0,0,2,8,1820,840,1906,0.0,98112,47.6258,-122.305,2350,4600,1940,0.4217391304347826,7075600,21160000,14084400
299000.0,2,1.75,1250,34395,1.0,0,0,3,7,1250,0,1950,0.0,98003,47.2802,-122.316,1910,26042,33145,0.9636575083587731,1562500,1183016025,1181453525
240000.0,3,2.0,1100,6360,1.0,0,0,2,7,1100,0,1991,0.0,98038,47.3878,-122.052,1620,6360,5260,0.8270440251572327,1210000,40449600,39239600
1960000.0,3,1.75,3330,12566,1.0,1,4,3,8,1940,1390,1960,0.0,98040,47.5287,-122.22,3730,16560,9236,0.7349992042018144,11088900,157904356,146815456
1270000.0,4,3.25,3640,3604,2.0,0,2,4,9,1960,1680,1913,0.0,98122,47.6145,-122.28399999999999,1940,4600,-36,-0.009988901220865706,13249600,12988816,-260784
405000.0,2,1.75,1350,2653,2.0,0,0,2,7,1350,0,1986,0.0,98033,47.6934,-122.184,1370,4115,1303,0.49114210327930646,1822500,7038409,5215909
304000.0,4,2.0,1310,8454,1.0,0,0,3,7,1310,0,1953,0.0,98155,47.7572,-122.318,1320,8274,7144,0.8450437662644902,1716100,71470116,69754016
272000.0,4,2.25,1800,5555,2.0,0,0,2,7,1800,0,2003,0.0,98038,47.3498,-122.052,1810,5669,3755,0.675967596759676,3240000,30858025,27618025
412000.0,2,1.0,1260,3960,1.0,0,0,2,6,690,570,1925,0.0,98117,47.6899,-122.391,1250,3960,2700,0.6818181818181818,1587600,15681600,14094000
698000.0,4,2.5,2990,7231,2.0,0,0,2,9,2990,0,2001,0.0,98075,47.5623,-122.03200000000001,3160,8339,4241,0.5865025584289864,8940100,52287361,43347261
400000.0,2,1.0,1140,5100,1.0,0,0,2,7,1140,0,1942,0.0,98136,47.5323,-122.383,1230,5100,3960,0.7764705882352941,1299600,26010000,24710400
305000.0,3,2.5,2100,6825,2.0,0,0,2,8,2100,0,1994,0.0,98055,47.4314,-122.189,2180,7614,4725,0.6923076923076923,4410000,46580625,42170625
585000.0,4,2.0,2400,12753,1.0,0,0,3,7,2400,0,1962,0.0,98033,47.6947,-122.177,1830,12060,10353,0.8118089861209127,5760000,162639009,156879009
190000.0,2,1.5,1400,9031,1.0,0,0,2,7,960,440,1982,0.0,98023,47.2915,-122.368,1450,7658,7631,0.8449784077067878,1960000,81558961,79598961
760000.0,4,2.5,2990,12788,2.0,0,0,2,10,2990,0,1988,0.0,98075,47.5601,-122.037,3250,12212,9798,0.7661870503597122,8940100,163532944,154592844
570000.0,3,1.75,1930,36210,1.0,0,0,2,8,1930,0,1977,0.0,98072,47.7692,-122.12799999999999,1930,35060,34280,0.9466998066832367,3724900,1311164100,1307439200
144000.0,3,1.0,980,6800,1.0,0,0,2,6,980,0,1946,0.0,98058,47.4411,-122.186,1140,9975,5820,0.8558823529411764,960400,46240000,45279600
139000.0,2,1.0,690,5280,1.0,0,0,3,5,690,0,1942,0.0,98056,47.4953,-122.18700000000001,1140,4860,4590,0.8693181818181818,476100,27878400,27402300
525000.0,4,1.5,1430,6380,1.5,0,0,3,7,1130,300,1945,0.0,98115,47.6942,-122.319,1570,6380,4950,0.7758620689655172,2044900,40704400,38659500
293000.0,1,1.0,1110,5421,1.0,0,0,2,6,1110,0,1935,0.0,98177,47.7322,-122.359,1230,8100,4311,0.7952407304925291,1232100,29387241,28155141
267100.0,2,2.5,1250,1580,2.0,0,0,2,7,1030,220,2005,0.0,98106,47.5243,-122.36,1250,1361,330,0.2088607594936709,1562500,2496400,933900
1500000.0,4,3.25,3470,5222,2.0,0,0,2,10,2830,640,2005,0.0,98033,47.6845,-122.209,3090,6758,1752,0.3355036384527001,12040900,27269284,15228384
240000.0,3,2.25,1500,15334,2.0,0,0,3,7,1500,0,1992,0.0,98042,47.3719,-122.09100000000001,1530,8102,13834,0.9021781661666884,2250000,235131556,232881556
975000.0,3,2.5,2530,7000,2.5,0,4,2,9,2530,0,1915,1999.0,98136,47.5465,-122.398,2380,7000,4470,0.6385714285714286,6400900,49000000,42599100
279950.0,5,1.75,2150,7171,1.0,0,0,3,7,1460,690,1970,0.0,98031,47.3952,-122.176,1710,7300,5021,0.7001812857342072,4622500,51423241,46800741
405000.0,3,1.75,1260,7373,1.0,0,0,3,7,1260,0,1979,0.0,98034,47.7296,-122.23299999999999,1360,7373,6113,0.829106198291062,1587600,54361129,52773529
400000.0,3,2.5,2740,83199,2.0,0,4,2,9,2740,0,1973,0.0,98032,47.3581,-122.266,2500,29269,80459,0.9670669118619214,7507600,6922073601,6914566001
225000.0,3,1.0,960,6500,1.0,0,0,3,5,960,0,1954,0.0,98056,47.497,-122.171,1150,6500,5540,0.8523076923076923,921600,42250000,41328400
250000.0,3,1.0,1520,7800,1.0,0,0,3,7,1120,400,1967,0.0,98032,47.3784,-122.29,1740,8000,6280,0.8051282051282052,2310400,60840000,58529600
272950.0,3,2.25,1570,9096,1.0,0,0,3,7,1180,390,1991,0.0,98022,47.1937,-121.99,1570,8418,7526,0.8273966578715919,2464900,82737216,80272316
625000.0,5,1.0,3240,5324,2.0,0,0,2,9,3240,0,2007,0.0,98065,47.523,-121.875,3240,6036,2084,0.391435011269722,10497600,28344976,17847376
670000.0,3,1.75,1280,2147,1.5,0,0,3,7,1280,0,1910,0.0,98102,47.6362,-122.324,2010,2640,867,0.4038192827200745,1638400,4609609,2971209
1070000.0,3,2.5,2130,3545,3.0,0,0,4,9,2130,0,1990,0.0,98109,47.6389,-122.34899999999999,1970,3464,1415,0.3991537376586742,4536900,12567025,8030125
540000.0,3,1.75,1970,8200,1.0,0,0,4,8,1420,550,1963,0.0,98177,47.7602,-122.363,2140,8000,6230,0.7597560975609756,3880900,67240000,63359100
525000.0,3,2.5,2990,6725,2.0,0,0,2,9,2990,0,2003,0.0,98059,47.4928,-122.14200000000001,2790,6725,3735,0.5553903345724907,8940100,45225625,36285525
425000.0,2,1.0,1160,17700,1.0,0,0,2,7,1160,0,1947,0.0,98133,47.7244,-122.331,1440,9000,16540,0.9344632768361582,1345600,313290000,311944400
465500.0,3,1.75,1890,7004,1.0,0,0,2,7,1290,600,1965,0.0,98118,47.5557,-122.28,1440,5378,5114,0.7301541976013707,3572100,49056016,45483916
443500.0,3,2.5,2170,5866,2.0,0,0,2,7,2170,0,2006,0.0,98065,47.5403,-121.889,2440,5798,3696,0.630071599045346,4708900,34409956,29701056
350000.0,4,2.25,1570,499571,1.0,0,3,3,7,1570,0,1972,0.0,98022,47.1808,-122.023,1700,181708,498001,0.9968573035664601,2464900,249571184041,249568719141
850000.0,3,2.5,3260,91911,2.0,0,0,3,9,3260,0,1984,0.0,98077,47.736999999999995,-122.074,2520,65775,88651,0.9645309048971288,10627600,8447631921,8437004321
205000.0,3,2.25,1250,952,3.0,0,0,2,8,1250,0,2008,0.0,98133,47.7098,-122.333,1250,1030,-298,-0.3130252100840336,1562500,906304,-656196
315000.0,4,2.5,1940,10200,1.0,0,0,3,8,1140,800,1977,0.0,98042,47.4157,-122.161,1920,12600,8260,0.8098039215686275,3763600,104040000,100276400
470000.0,3,2.5,2150,8221,2.0,0,0,2,8,2150,0,1992,0.0,98059,47.5085,-122.15,2490,7951,6071,0.738474638121883,4622500,67584841,62962341
1100000.0,4,2.25,3310,8540,1.0,0,4,3,9,1660,1650,1973,0.0,98006,47.5603,-122.15799999999999,3450,9566,5230,0.6124121779859485,10956100,72931600,61975500
340000.0,3,1.75,3400,46382,1.0,0,0,2,7,2050,1350,1979,0.0,98053,47.6458,-121.955,2320,20624,42982,0.9266957009184598,11560000,2151289924,2139729924
310000.0,4,2.5,2660,12672,1.0,0,0,3,8,1740,920,1960,0.0,98003,47.3334,-122.323,2280,12477,10012,0.7900883838383839,7075600,160579584,153503984
305000.0,3,1.0,950,13475,1.0,0,0,2,7,950,0,1950,0.0,98155,47.7543,-122.306,1240,8910,12525,0.9294990723562152,902500,181575625,180673125
307150.0,3,1.5,1480,6752,1.0,0,0,3,7,1480,0,1959,0.0,98056,47.4993,-122.176,1450,8023,5272,0.7808056872037915,2190400,45589504,43399104
729032.0,4,2.5,2840,12866,1.0,0,0,3,9,1780,1060,1977,0.0,98005,47.6388,-122.167,2840,13209,10026,0.7792631742577336,8065600,165533956,157468356
750000.0,5,2.5,3240,9960,1.0,0,1,2,8,2020,1220,1958,0.0,98008,47.5858,-122.11200000000001,2730,10400,6720,0.6746987951807228,10497600,99201600,88704000
289000.0,4,2.5,1961,3207,2.0,0,0,2,7,1961,0,2006,0.0,98042,47.3507,-122.16,1961,3401,1246,0.38852510134081697,3845521,10284849,6439328
480000.0,3,1.0,1100,5700,1.0,0,0,2,7,1100,0,1950,0.0,98115,47.6883,-122.28200000000001,1560,6588,4600,0.8070175438596491,1210000,32490000,31280000
529000.0,3,1.75,1500,7367,1.0,0,0,2,8,1500,0,1974,0.0,98033,47.6722,-122.167,1920,7579,5867,0.7963893036514185,2250000,54272689,52022689
585000.0,3,1.75,1480,4800,2.0,0,0,3,7,1140,340,1944,0.0,98199,47.6567,-122.397,1810,4800,3320,0.6916666666666667,2190400,23040000,20849600
704000.0,4,2.75,2510,12500,1.0,0,0,4,8,2050,460,1976,0.0,98052,47.6278,-122.11,2200,12088,9990,0.7992,6300100,156250000,149949900
607000.0,4,2.0,1490,4054,1.5,0,0,4,7,1490,0,1926,0.0,98115,47.6744,-122.301,1510,3889,2564,0.6324617661568821,2220100,16434916,14214816
580000.0,3,2.25,2190,8188,2.0,0,0,2,8,1810,380,1978,0.0,98052,47.6883,-122.113,2190,8374,5998,0.7325354176844162,4796100,67043344,62247244
875000.0,5,2.5,2530,8564,2.0,0,0,3,8,2530,0,1976,0.0,98006,47.5622,-122.15299999999999,2480,8714,6034,0.70457730032695,6400900,73342096,66941196
610000.0,4,2.5,2440,9350,1.0,0,0,3,8,1560,880,1976,0.0,98006,47.5614,-122.13,2260,8500,6910,0.7390374331550802,5953600,87422500,81468900
230000.0,3,0.75,1040,15000,1.0,0,0,2,6,1040,0,1941,0.0,98028,47.7639,-122.234,1410,19000,13960,0.9306666666666666,1081600,225000000,223918400
510000.0,4,2.25,2450,62290,2.0,0,0,2,8,2450,0,1976,0.0,98077,47.7603,-122.074,2450,41181,59840,0.9606678439556912,6002500,3880044100,3874041600
733000.0,4,2.5,2210,5002,1.0,0,0,2,7,1370,840,1977,0.0,98199,47.6637,-122.40100000000001,1970,4920,2792,0.5581767293082767,4884100,25020004,20135904
169100.0,3,2.0,1050,18304,1.0,0,0,3,7,1050,0,1953,0.0,98001,47.3206,-122.26899999999999,1690,15675,17254,0.9426354895104895,1102500,335036416,333933916
250000.0,3,2.0,1050,18304,1.0,0,0,3,7,1050,0,1953,0.0,98001,47.3206,-122.26899999999999,1690,15675,17254,0.9426354895104895,1102500,335036416,333933916
500000.0,4,2.25,2730,35100,2.0,0,0,2,8,2730,0,1977,0.0,98075,47.5913,-122.012,2730,36677,32370,0.9222222222222223,7452900,1232010000,1224557100
700000.0,2,1.0,1620,9855,1.0,0,4,2,8,1320,300,1948,0.0,98136,47.5264,-122.384,1820,7700,8235,0.8356164383561644,2624400,97121025,94496625
379000.0,4,2.75,2410,5225,2.0,0,0,2,8,2410,0,2001,0.0,98058,47.4244,-122.15100000000001,2300,5378,2815,0.538755980861244,5808100,27300625,21492525
650000.0,4,2.5,3420,222156,2.0,0,0,2,9,3420,0,2002,0.0,98010,47.3608,-121.97,3340,222156,218736,0.984605412412899,11696400,49353288336,49341591936
412133.0,2,1.0,920,4400,1.0,0,0,2,7,920,0,1948,0.0,98103,47.6903,-122.33200000000001,1560,4600,3480,0.7909090909090909,846400,19360000,18513600
480000.0,4,2.25,2330,14190,1.0,0,0,2,8,1740,590,1962,0.0,98034,47.718,-122.242,2330,14190,11860,0.835799859055673,5428900,201356100,195927200
650000.0,3,1.75,1940,10245,1.0,0,0,2,7,1940,0,1957,0.0,98040,47.5833,-122.241,2720,11448,8305,0.810639336261591,3763600,104960025,101196425
505000.0,2,2.5,1900,5065,2.0,0,0,2,8,1900,0,2005,0.0,98053,47.7175,-122.03399999999999,1350,4664,3165,0.6248766041461007,3610000,25654225,22044225
931088.0,4,2.5,3510,17400,1.0,0,0,3,9,1930,1580,1957,0.0,98005,47.5963,-122.171,2730,12120,13890,0.7982758620689655,12320100,302760000,290439900
570000.0,4,1.75,1860,7700,1.0,0,0,3,8,1860,0,1964,0.0,98008,47.62600000000001,-122.11200000000001,1860,7700,5840,0.7584415584415585,3459600,59290000,55830400
475000.0,3,1.0,1380,4635,1.0,0,0,3,6,1380,0,1919,0.0,98144,47.57,-122.285,1790,4635,3255,0.7022653721682848,1904400,21483225,19578825
240000.0,6,1.75,2210,8594,1.0,0,0,2,7,1310,900,1959,0.0,98188,47.4594,-122.273,1850,8594,6384,0.7428438445427042,4884100,73856836,68972736
462000.0,4,2.5,2640,47480,1.0,0,0,3,8,1590,1050,1979,0.0,98038,47.4258,-122.021,2390,67415,44840,0.9443976411120472,6969600,2254350400,2247380800
1120000.0,3,2.5,4530,22873,2.0,0,2,4,8,3220,1310,1912,0.0,98166,47.4567,-122.369,3100,18210,18343,0.8019498972587767,20520900,523174129,502653229
243000.0,3,1.0,1500,6600,1.0,0,0,1,6,1500,0,1970,0.0,98168,47.4845,-122.33,1730,6600,5100,0.7727272727272727,2250000,43560000,41310000
660000.0,4,2.25,2010,15375,1.0,0,0,3,8,2010,0,1957,0.0,98005,47.5956,-122.17399999999999,1930,15375,13365,0.8692682926829268,4040100,236390625,232350525
1190000.0,2,1.75,2080,8112,1.0,1,4,3,8,1040,1040,1939,1984.0,98125,47.7134,-122.277,2030,8408,6032,0.7435897435897436,4326400,65804544,61478144
1680000.0,4,4.25,5584,68257,2.0,0,0,2,11,5584,0,1998,0.0,98014,47.6113,-121.95200000000001,5030,101901,62673,0.9181915407943507,31181056,4659018049,4627836993
6890000.0,6,7.75,9890,31374,2.0,0,4,2,13,8860,1030,2001,0.0,98039,47.6305,-122.24,4540,42730,21484,0.6847708293491426,97812100,984327876,886515776
368000.0,3,2.5,2080,4307,2.0,0,0,2,7,2080,0,2004,0.0,98065,47.53,-121.848,2080,4947,2227,0.5170652426282796,4326400,18550249,14223849
811500.0,5,4.25,3970,4500,2.0,0,0,2,9,2860,1110,2004,0.0,98027,47.5402,-122.069,3480,4500,530,0.11777777777777777,15760900,20250000,4489100
275000.0,2,1.0,770,8149,1.0,0,0,4,6,770,0,1948,0.0,98155,47.7406,-122.302,770,8150,7379,0.9055098785127009,592900,66406201,65813301
650000.0,4,2.5,2500,6005,2.0,0,0,2,9,2500,0,2001,0.0,98033,47.6922,-122.17399999999999,2680,7200,3505,0.5836802664446294,6250000,36060025,29810025
485000.0,3,2.0,2410,50654,1.5,0,0,2,7,2410,0,1995,0.0,98070,47.4154,-122.458,1900,36300,48244,0.9524223161053421,5808100,2565827716,2560019616
425000.0,3,2.5,1340,10018,1.0,0,0,3,7,1340,0,1976,0.0,98052,47.6366,-122.094,2520,13068,8678,0.8662407666200839,1795600,100360324,98564724
530000.0,3,2.5,2640,13775,1.0,0,0,2,8,1550,1090,1978,0.0,98005,47.5875,-122.177,2120,12432,11135,0.8083484573502723,6969600,189750625,182781025
657000.0,4,1.75,2740,8520,1.0,0,2,2,8,1370,1370,1954,0.0,98118,47.5445,-122.26299999999999,2740,9286,5780,0.6784037558685446,7507600,72590400,65082800
315000.0,4,2.75,1580,3770,1.0,0,0,2,7,1080,500,2002,0.0,98019,47.7368,-121.96799999999999,1740,3800,2190,0.5809018567639257,2496400,14212900,11716500
273000.0,4,1.5,2180,22870,1.0,0,0,3,6,1280,900,1954,1975.0,98042,47.3187,-122.081,2420,22614,20690,0.9046786182772191,4752400,523036900,518284500
550000.0,3,2.75,1960,13252,1.0,0,0,4,8,1240,720,1975,0.0,98006,47.5582,-122.139,2040,9866,11292,0.85209779655901,3841600,175615504,171773904
347000.0,2,2.25,1560,1705,2.0,0,0,2,8,1270,290,2006,0.0,98126,47.5482,-122.374,1560,1758,145,0.08504398826979472,2433600,2907025,473425
525000.0,5,2.75,2440,8000,1.0,0,0,3,7,1240,1200,1972,0.0,98034,47.7283,-122.17,1780,8391,5560,0.695,5953600,64000000,58046400
490000.0,3,1.5,990,1343,2.0,0,0,2,8,840,150,2007,0.0,98112,47.6236,-122.306,1350,2521,353,0.2628443782576322,980100,1803649,823549
500000.0,3,2.25,2210,7916,2.0,0,0,2,8,2210,0,1978,0.0,98133,47.7175,-122.339,1450,7955,5706,0.7208185952501264,4884100,62663056,57778956
585000.0,3,2.75,3080,7282,2.0,0,0,2,9,3080,0,2008,0.0,98059,47.4826,-122.149,3080,7274,4202,0.5770392749244713,9486400,53027524,43541124
926500.0,4,2.75,2900,17802,1.0,0,2,2,9,1750,1150,1981,0.0,98034,47.7004,-122.229,2900,15720,14902,0.8370969553982699,8410000,316911204,308501204
465000.0,1,1.0,1020,3200,1.0,0,0,2,7,1020,0,1927,0.0,98109,47.6361,-122.34299999999999,1670,3480,2180,0.68125,1040400,10240000,9199600
200000.0,4,2.0,1900,8160,1.0,0,0,2,7,1900,0,1975,0.0,98022,47.2114,-121.986,1280,6532,6260,0.7671568627450981,3610000,66585600,62975600
1680000.0,6,4.75,5770,16747,2.0,0,3,2,12,4500,1270,1998,0.0,98006,47.5512,-122.11,4470,14571,10977,0.655460679524691,33292900,280462009,247169109
220500.0,2,1.0,990,57499,1.0,0,0,1,6,990,0,1949,0.0,98070,47.4145,-122.463,2090,27442,56509,0.9827823092575523,980100,3306135001,3305154901
329000.0,2,1.0,990,57499,1.0,0,0,1,6,990,0,1949,0.0,98070,47.4145,-122.463,2090,27442,56509,0.9827823092575523,980100,3306135001,3305154901
715000.0,3,4.0,2080,2250,3.0,0,4,2,8,2080,0,1997,0.0,98103,47.6598,-122.355,2080,2250,170,0.07555555555555556,4326400,5062500,736100
780000.0,3,4.0,2080,2250,3.0,0,4,2,8,2080,0,1997,0.0,98103,47.6598,-122.355,2080,2250,170,0.07555555555555556,4326400,5062500,736100
410000.0,2,1.0,1480,4080,1.0,0,0,2,7,1050,430,1949,0.0,98117,47.6842,-122.39299999999999,1310,4080,2600,0.6372549019607843,2190400,16646400,14456000
778100.0,2,1.0,1480,4080,1.0,0,0,2,7,1050,430,1949,0.0,98117,47.6842,-122.39299999999999,1310,4080,2600,0.6372549019607843,2190400,16646400,14456000
406000.0,3,1.0,1090,11292,1.0,0,0,3,7,1090,0,1952,0.0,98133,47.7429,-122.35799999999999,1570,8198,10202,0.9034714842366277,1188100,127509264,126321164
665000.0,4,2.5,2800,5900,1.0,0,0,2,8,1660,1140,1963,0.0,98115,47.6809,-122.286,2580,5900,3100,0.5254237288135594,7840000,34810000,26970000
305000.0,2,1.0,1000,8212,1.0,0,0,3,7,1000,0,1947,0.0,98133,47.7444,-122.34100000000001,1620,8214,7212,0.8782269849001462,1000000,67436944,66436944
265000.0,3,2.5,1640,7668,2.0,0,0,2,7,1640,0,1991,0.0,98038,47.3505,-122.027,1850,7200,6028,0.7861241523213354,2689600,58798224,56108624
485000.0,4,1.0,1620,4080,1.5,0,0,2,7,1620,0,1923,0.0,98105,47.6696,-122.324,1760,4080,2460,0.6029411764705882,2624400,16646400,14022000
600000.0,3,2.5,2460,108900,1.0,0,0,3,9,1860,0,1977,0.0,98027,47.4824,-122.0,2870,102366,106440,0.9774104683195592,6051600,11859210000,11853158400
510000.0,2,1.5,1860,5100,1.0,0,0,2,7,1060,800,1940,0.0,98136,47.5573,-122.39200000000001,1710,5100,3240,0.6352941176470588,3459600,26010000,22550400
195000.0,2,1.0,1080,3899,1.0,0,0,3,8,1080,0,1972,0.0,98198,47.3792,-122.321,1090,3899,2819,0.7230058989484484,1166400,15202201,14035801
432500.0,3,1.75,1980,5100,1.0,0,0,2,7,1270,710,1965,0.0,98103,47.6911,-122.34700000000001,1400,5100,3120,0.611764705882353,3920400,26010000,22089600
490000.0,3,1.75,1510,8433,1.0,0,0,3,7,1220,290,1967,0.0,98008,47.6226,-122.103,1950,8199,6923,0.8209415391912723,2280100,71115489,68835389
270000.0,3,2.5,1690,7165,2.0,0,0,3,7,1690,0,1992,0.0,98038,47.3498,-122.05799999999999,1410,8590,5475,0.7641311933007676,2856100,51337225,48481125
370000.0,2,1.5,1010,2102,2.0,0,0,2,7,1010,0,1984,0.0,98119,47.6374,-122.375,1480,2632,1092,0.5195052331113226,1020100,4418404,3398304
327500.0,3,2.5,2090,12027,2.0,0,0,2,8,2090,0,1991,0.0,98031,47.4084,-122.213,2090,12666,9937,0.8262243285939969,4368100,144648729,140280629
826000.0,2,1.0,1060,6120,1.0,0,0,2,7,1060,0,1908,0.0,98103,47.6739,-122.329,1730,4080,5060,0.826797385620915,1123600,37454400,36330800
510000.0,3,1.75,1750,7020,2.0,0,0,2,7,1750,0,1934,1978.0,98010,47.3264,-122.038,1170,9546,5270,0.7507122507122507,3062500,49280400,46217900
587750.0,2,1.0,890,4730,1.0,0,0,2,7,890,0,1941,0.0,98103,47.6876,-122.34100000000001,1330,5904,3840,0.8118393234672304,792100,22372900,21580800
449228.0,5,2.5,3020,24750,1.0,0,0,2,8,1650,1370,1965,0.0,98005,47.5897,-122.179,2930,16062,21730,0.877979797979798,9120400,612562500,603442100
565000.0,3,2.5,2030,217805,1.0,0,0,2,9,2030,0,1999,0.0,98070,47.3942,-122.515,1870,109468,215775,0.9906797364615137,4120900,47439018025,47434897125
660000.0,4,2.5,3170,186436,2.0,0,0,2,9,3170,0,2000,0.0,98038,47.4475,-122.03399999999999,3250,215186,183266,0.982996846102684,10048900,34758382096,34748333196
400000.0,5,2.75,2470,19200,1.0,0,0,4,8,1250,1220,1977,0.0,98058,47.4496,-122.083,2140,35140,16730,0.8713541666666667,6100900,368640000,362539100
612500.0,4,2.0,2060,5000,1.0,0,0,2,7,1030,1030,1949,2013.0,98117,47.6992,-122.37899999999999,1280,5000,2940,0.588,4243600,25000000,20756400
560000.0,4,1.75,2120,6250,1.0,0,0,4,7,1060,1060,1917,0.0,98136,47.5506,-122.385,1410,6250,4130,0.6608,4494400,39062500,34568100
727000.0,3,2.25,2180,4200,1.5,0,0,4,8,1520,660,1939,0.0,98112,47.6412,-122.302,1850,4200,2020,0.48095238095238096,4752400,17640000,12887600
224000.0,4,3.0,2300,7609,2.0,0,0,3,7,2300,0,1976,0.0,98002,47.2943,-122.227,940,5937,5309,0.6977263766592193,5290000,57896881,52606881
1080000.0,4,2.5,4200,35267,2.0,0,0,2,11,4200,0,1990,0.0,98077,47.7108,-122.071,3540,22234,31067,0.8809084980293191,17640000,1243761289,1226121289
439000.0,3,2.25,1480,7565,1.0,0,0,2,7,1220,260,1977,0.0,98034,47.7288,-122.191,1660,7565,6085,0.8043621943159286,2190400,57229225,55038825
335000.0,3,1.5,2240,87625,1.5,0,0,1,7,1480,760,1980,0.0,98092,47.3043,-122.094,1920,110206,85385,0.9744365192582025,5017600,7678140625,7673123025
779000.0,4,1.5,2740,4912,1.0,0,0,3,8,1370,1370,1937,0.0,98199,47.6523,-122.412,2160,5006,2172,0.44218241042345274,7507600,24127744,16620144
452000.0,5,1.75,1830,47916,1.5,0,0,2,6,1830,0,1948,0.0,98045,47.4881,-121.777,2010,13135,46086,0.9618081642875032,3348900,2295943056,2292594156
775000.0,4,3.0,2000,5304,1.5,0,0,3,7,2000,0,1947,0.0,98115,47.6762,-122.285,1670,5304,3304,0.6229260935143288,4000000,28132416,24132416
235000.0,3,1.75,1380,8362,1.0,0,0,2,7,1380,0,1967,0.0,98003,47.3121,-122.323,1380,8800,6982,0.8349677110739058,1904400,69923044,68018644
370000.0,3,1.75,1620,37913,2.0,0,0,3,7,1620,0,1953,0.0,98001,47.2875,-122.289,2190,21518,36293,0.9572705932002216,2624400,1437395569,1434771169
790000.0,4,3.0,3180,12070,2.0,0,0,3,9,3180,0,1976,0.0,98074,47.6371,-122.05799999999999,3110,12600,8890,0.7365368682684341,10112400,145684900,135572500
903000.0,2,1.5,1140,7800,1.0,0,0,3,6,1140,0,1947,0.0,98004,47.6142,-122.209,2020,7800,6660,0.8538461538461538,1299600,60840000,59540400
209950.0,3,1.0,970,9583,1.0,0,0,3,6,970,0,1967,0.0,98023,47.3044,-122.366,970,7875,8613,0.8987790879682772,940900,91833889,90892989
309000.0,3,2.5,1780,7859,2.0,0,0,2,7,1780,0,1988,0.0,98038,47.3772,-122.045,1670,6618,6079,0.7735080799083853,3168400,61763881,58595481
440000.0,3,1.75,2240,8153,1.0,0,0,2,7,1120,1120,1948,0.0,98125,47.7303,-122.329,1710,8100,5913,0.7252545075432356,5017600,66471409,61453809
571500.0,4,2.25,2810,25990,2.0,0,0,2,8,1860,950,1959,0.0,98001,47.2993,-122.29299999999999,2020,16140,23180,0.8918814928818777,7896100,675480100,667584000
514000.0,2,1.0,920,4000,1.0,0,0,3,7,920,0,1906,0.0,98105,47.6711,-122.32799999999999,1300,4000,3080,0.77,846400,16000000,15153600
323000.0,3,1.75,1830,12500,1.0,0,1,2,7,1200,630,1947,0.0,98178,47.5087,-122.25,1830,7300,10670,0.8536,3348900,156250000,152901100
290000.0,2,1.75,1560,7575,1.0,0,0,2,8,1560,0,2002,0.0,98030,47.3776,-122.228,2050,9000,6015,0.7940594059405941,2433600,57380625,54947025
2580000.0,4,4.25,5540,15408,2.0,0,1,2,11,4280,1260,2006,0.0,98004,47.6071,-122.212,3570,14750,9868,0.6404465212876428,30691600,237406464,206714864
1360000.0,3,2.0,2310,21318,1.0,0,0,2,10,2310,0,1979,0.0,98004,47.6381,-122.22399999999999,2950,21814,19008,0.891640866873065,5336100,454457124,449121024
551000.0,4,1.5,1470,5100,1.5,0,0,2,7,1470,0,1946,0.0,98117,47.6769,-122.381,1470,5100,3630,0.711764705882353,2160900,26010000,23849100
960000.0,4,2.5,3430,43560,1.5,0,2,4,10,3430,0,1979,0.0,98005,47.6426,-122.18,3700,44431,40130,0.9212580348943985,11764900,1897473600,1885708700
720000.0,5,2.5,2900,9525,2.0,0,0,2,9,2900,0,1989,0.0,98006,47.5442,-122.13799999999999,2910,11854,6625,0.6955380577427821,8410000,90725625,82315625
218000.0,3,1.75,1850,7684,1.0,0,0,2,8,1320,530,1979,0.0,98023,47.2975,-122.37,1940,7630,5834,0.7592399791775117,3422500,59043856,55621356
334950.0,4,2.5,2190,7000,2.0,0,0,2,8,2190,0,1997,0.0,98042,47.3718,-122.109,2040,7700,4810,0.6871428571428572,4796100,49000000,44203900
605000.0,4,2.25,2510,31584,2.0,0,0,3,9,2510,0,1979,0.0,98074,47.6153,-122.054,2510,39221,29074,0.9205293819655522,6300100,997549056,991248956
825000.0,4,3.25,3200,4477,2.0,0,0,2,9,2390,810,2006,0.0,98199,47.663999999999994,-122.402,1830,4920,1277,0.2852356488720125,10240000,20043529,9803529
268500.0,4,1.75,1670,8000,1.0,0,0,3,8,1670,0,1974,0.0,98023,47.3193,-122.383,1720,8000,6330,0.79125,2788900,64000000,61211100
230000.0,3,1.75,1010,9600,1.0,0,0,4,7,1010,0,1969,0.0,98042,47.3828,-122.09,1320,9600,8590,0.8947916666666667,1020100,92160000,91139900
1340000.0,4,4.0,5050,202554,2.0,0,0,2,10,3260,1790,2000,0.0,98027,47.5269,-121.92200000000001,3370,213444,197504,0.9750683768279076,25502500,41028122916,41002620416
245500.0,2,1.5,1430,9782,1.0,0,0,2,7,1430,0,1955,0.0,98188,47.441,-122.28200000000001,1430,9828,8352,0.8538131261500715,2044900,95687524,93642624
440000.0,3,2.25,1880,7989,1.0,0,0,2,7,1280,600,1982,0.0,98125,47.7077,-122.29899999999999,1820,7414,6109,0.7646764300913756,3534400,63824121,60289721
571500.0,4,2.75,2180,5799,2.0,0,0,3,8,2180,0,1993,0.0,98029,47.5702,-121.995,2060,6061,3619,0.6240731160544921,4752400,33628401,28876001
182500.0,3,2.25,1830,4744,2.0,0,0,2,7,1830,0,1997,0.0,98001,47.2734,-122.24799999999999,1670,8001,2914,0.6142495784148398,3348900,22505536,19156636
217000.0,2,1.0,970,5600,1.0,0,0,2,6,970,0,1951,0.0,98118,47.5297,-122.277,1020,5600,4630,0.8267857142857142,940900,31360000,30419100
335000.0,2,1.5,1170,5248,1.0,0,0,4,6,1170,0,1941,0.0,98126,47.5318,-122.374,1170,5120,4078,0.7770579268292683,1368900,27541504,26172604
501000.0,2,1.0,1010,4320,1.0,0,0,4,7,1010,0,1924,0.0,98115,47.6846,-122.31700000000001,1680,4320,3310,0.7662037037037037,1020100,18662400,17642300
339950.0,3,2.5,2140,7641,1.0,0,0,2,8,1290,850,1979,0.0,98056,47.5053,-122.186,2090,8000,5501,0.7199319460803559,4579600,58384881,53805281
340000.0,3,1.75,2230,10403,1.0,0,0,2,8,1630,600,1968,0.0,98198,47.4092,-122.295,1730,9450,8173,0.7856387580505624,4972900,108222409,103249509
582500.0,2,1.0,1140,23779,1.5,0,0,2,6,1140,0,1966,0.0,98033,47.6948,-122.17200000000001,2940,8417,22639,0.9520585390470583,1299600,565440841,564141241
298800.0,2,1.0,860,8189,1.0,0,0,2,6,860,0,1948,0.0,98155,47.735,-122.306,1180,8189,7329,0.8949810721699841,739600,67059721,66320121
317500.0,6,1.75,2540,8400,1.0,0,0,2,8,1340,1200,1977,0.0,98058,47.4414,-122.12899999999999,1900,7695,5860,0.6976190476190476,6451600,70560000,64108400
598000.0,4,2.5,2420,5118,1.5,0,2,4,7,1550,870,1926,0.0,98126,47.5671,-122.37799999999999,1740,5750,2698,0.5271590465025401,5856400,26193924,20337524
375000.0,2,2.25,1640,2240,2.0,0,0,2,8,1640,0,1980,0.0,98133,47.7154,-122.34100000000001,1640,2240,600,0.26785714285714285,2689600,5017600,2328000
465000.0,4,2.25,2550,7650,2.0,0,2,3,9,2550,0,1996,0.0,98106,47.5296,-122.34200000000001,2550,7650,5100,0.6666666666666666,6502500,58522500,52020000
551870.0,3,2.5,2507,18400,2.0,0,0,2,8,2507,0,2006,0.0,98001,47.2867,-122.27,1520,14709,15893,0.86375,6285049,338560000,332274951
295000.0,3,2.5,1920,7229,2.0,0,0,2,8,1920,0,1993,0.0,98003,47.2659,-122.31,2310,8009,5309,0.734403098630516,3686400,52258441,48572041
263500.0,4,1.75,2210,6375,1.0,0,0,2,8,1640,570,1977,0.0,98003,47.3268,-122.32799999999999,2070,7210,4165,0.6533333333333333,4884100,40640625,35756525
1100000.0,4,4.0,3530,8400,2.0,0,0,4,8,2630,900,1958,0.0,98199,47.6402,-122.395,2340,8216,4870,0.5797619047619048,12460900,70560000,58099100
300000.0,2,1.0,1100,4010,1.5,0,0,4,6,1100,0,1920,0.0,98106,47.5296,-122.351,980,4501,2910,0.7256857855361596,1210000,16080100,14870100
780000.0,4,1.0,3390,4500,1.5,0,0,2,8,2190,1200,1924,2014.0,98144,47.5824,-122.29299999999999,2030,4872,1110,0.24666666666666667,11492100,20250000,8757900
325000.0,3,1.5,1590,7936,1.0,0,0,2,7,1590,0,1956,0.0,98106,47.5201,-122.366,1590,7936,6346,0.7996471774193549,2528100,62980096,60451996
370000.0,2,1.0,820,6550,1.0,0,0,2,7,820,0,1949,2012.0,98126,47.5478,-122.381,1640,6550,5730,0.8748091603053435,672400,42902500,42230100
715000.0,4,2.5,2370,10000,1.0,0,0,4,8,1660,710,1974,0.0,98052,47.6383,-122.09899999999999,2480,9875,7630,0.763,5616900,100000000,94383100
356000.0,4,2.0,1600,12500,1.0,0,0,4,7,1600,0,1938,0.0,98166,47.4713,-122.355,1260,8306,10900,0.872,2560000,156250000,153690000
329950.0,4,1.75,1740,7208,1.5,0,0,2,8,1740,0,1976,0.0,98058,47.4483,-122.13,1680,7350,5468,0.7586015538290788,3027600,51955264,48927664
490000.0,3,2.25,1470,2500,2.0,0,0,2,8,1080,390,1984,0.0,98117,47.6762,-122.36,1640,4300,1030,0.412,2160900,6250000,4089100
429000.0,3,3.25,1410,1246,3.0,0,0,2,8,1410,0,2005,0.0,98103,47.6981,-122.34,1410,1253,-164,-0.13162118780096307,1988100,1552516,-435584
510000.0,4,2.5,1620,8125,2.0,0,0,3,7,1620,0,1983,0.0,98074,47.6255,-122.059,1480,8120,6505,0.8006153846153846,2624400,66015625,63391225
550000.0,3,2.5,2360,4080,2.0,0,0,2,7,2360,0,2003,0.0,98053,47.6825,-122.038,2290,4080,1720,0.4215686274509804,5569600,16646400,11076800
467500.0,3,1.0,1830,6453,1.0,0,0,3,7,1830,0,1956,0.0,98125,47.7139,-122.288,1670,8012,4623,0.7164109716410971,3348900,41641209,38292309
615000.0,5,2.0,2130,4180,1.5,0,0,4,7,1270,860,1926,0.0,98116,47.575,-122.38799999999999,1710,4180,2050,0.4904306220095694,4536900,17472400,12935500
325000.0,2,1.0,990,15120,1.0,0,0,3,6,990,0,1953,0.0,98011,47.7669,-122.206,1300,11500,14130,0.9345238095238095,980100,228614400,227634300
219950.0,2,1.0,1010,4120,2.0,0,0,2,6,1010,0,1907,0.0,98055,47.488,-122.2,1200,4120,3110,0.7548543689320388,1020100,16974400,15954300
950000.0,3,1.0,1720,9830,1.0,0,0,3,7,1720,0,1946,0.0,98040,47.5905,-122.245,3200,8923,8110,0.8250254323499492,2958400,96628900,93670500
925000.0,3,1.0,1630,3200,1.5,0,0,3,8,1630,0,1912,0.0,98109,47.6351,-122.352,1710,3600,1570,0.490625,2656900,10240000,7583100
251200.0,4,1.5,1310,8250,1.0,0,0,2,7,1060,250,1953,0.0,98148,47.425,-122.33200000000001,1260,8255,6940,0.8412121212121212,1716100,68062500,66346400
215000.0,3,1.5,1610,5304,1.0,0,0,3,6,1610,0,1968,0.0,98042,47.3632,-122.087,1060,5304,3694,0.6964555052790347,2592100,28132416,25540316
245000.0,3,2.0,1850,8208,1.0,0,0,3,7,1180,670,1970,0.0,98023,47.3109,-122.36200000000001,1790,8174,6358,0.7746101364522417,3422500,67371264,63948764
259000.0,3,1.75,1270,4815,1.5,0,0,2,6,980,0,1922,0.0,98108,47.5495,-122.31,1270,6431,3545,0.7362409138110073,1612900,23184225,21571325
349950.0,4,1.5,1420,6720,1.5,0,0,2,7,1420,0,1925,0.0,98108,47.5518,-122.311,1560,5600,5300,0.7886904761904762,2016400,45158400,43142000
1570000.0,5,4.5,5220,67319,2.0,0,0,2,11,5220,0,2001,0.0,98072,47.7666,-122.12799999999999,4190,40609,62099,0.9224587412171898,27248400,4531847761,4504599361
600000.0,2,1.0,1410,4500,1.0,0,0,2,7,1020,390,1939,0.0,98117,47.6883,-122.384,1300,4500,3090,0.6866666666666666,1988100,20250000,18261900
405000.0,2,1.5,1170,1274,3.0,0,0,2,8,1170,0,2001,0.0,98107,47.6719,-122.381,1290,1308,104,0.08163265306122448,1368900,1623076,254176
625000.0,3,2.5,1860,10027,2.0,0,0,2,8,1860,0,1993,0.0,98033,47.6775,-122.165,1530,9204,8167,0.8145008477111798,3459600,100540729,97081129
430000.0,4,1.0,1620,37075,1.5,0,0,2,7,1620,0,1943,0.0,98024,47.5654,-121.929,2190,87117,35455,0.9563047875927174,2624400,1374555625,1371931225
533000.0,3,3.0,1280,1085,3.0,0,0,2,8,1280,0,2004,0.0,98103,47.6569,-122.346,1300,1310,-195,-0.17972350230414746,1638400,1177225,-461175
1050000.0,4,2.5,2750,9949,2.0,0,0,2,10,2750,0,1999,0.0,98007,47.6595,-122.147,2750,9860,7199,0.7235903105839783,7562500,98982601,91420101
230000.0,3,1.75,1420,3000,1.0,0,0,2,5,710,710,1931,2014.0,98178,47.4928,-122.274,1960,5000,1580,0.5266666666666666,2016400,9000000,6983600
275000.0,4,1.75,2000,8700,1.0,0,0,4,7,1010,990,1975,0.0,98042,47.373999999999995,-122.141,1490,7350,6700,0.7701149425287356,4000000,75690000,71690000
403000.0,2,1.0,1100,3598,1.0,0,0,3,7,1100,0,1926,0.0,98144,47.5738,-122.31299999999999,1240,3598,2498,0.6942745969983324,1210000,12945604,11735604
550388.0,3,3.0,1720,70567,1.0,0,2,4,7,1720,0,1966,0.0,98027,47.4936,-122.069,2740,70567,68847,0.975626000821914,2958400,4979701489,4976743089
415500.0,3,1.5,1240,12400,1.0,0,0,2,7,1240,0,1958,0.0,98007,47.607,-122.132,1640,9600,11160,0.9,1537600,153760000,152222400
913000.0,3,1.75,2170,4000,1.0,0,0,3,7,1110,1060,1925,0.0,98103,47.6546,-122.337,1890,4000,1830,0.4575,4708900,16000000,11291100
334998.0,2,1.0,1800,5182,1.0,0,0,2,6,900,900,1942,0.0,98108,47.5508,-122.3,1570,5876,3382,0.6526437668853724,3240000,26853124,23613124
201500.0,3,1.0,1160,8320,1.0,0,0,3,7,1160,0,1959,0.0,98032,47.3831,-122.288,1480,7800,7160,0.8605769230769231,1345600,69222400,67876800
820000.0,3,2.5,3030,46538,2.0,0,0,2,10,3030,0,1997,0.0,98053,47.663999999999994,-122.041,3370,51450,43508,0.9348919162834672,9180900,2165785444,2156604544
371000.0,3,1.0,890,7200,1.0,0,0,2,7,890,0,1951,0.0,98125,47.71,-122.286,1630,7455,6310,0.8763888888888889,792100,51840000,51047900
229950.0,4,2.5,2150,7670,1.0,0,0,4,7,1240,910,1976,0.0,98031,47.3942,-122.189,1610,7350,5520,0.7196870925684485,4622500,58828900,54206400
344900.0,4,2.5,2150,7670,1.0,0,0,4,7,1240,910,1976,0.0,98031,47.3942,-122.189,1610,7350,5520,0.7196870925684485,4622500,58828900,54206400
840000.0,3,2.5,2060,9715,2.0,0,0,2,8,2060,0,1924,2006.0,98115,47.6961,-122.316,1240,7072,7655,0.7879567678847144,4243600,94381225,90137625
285000.0,3,1.5,1380,12196,1.0,0,0,3,7,1380,0,1967,0.0,98003,47.3204,-122.322,1600,10720,10816,0.8868481469334208,1904400,148742416,146838016
475000.0,4,2.25,1800,7200,1.0,0,0,2,7,1230,570,1979,0.0,98177,47.7717,-122.376,2260,7498,5400,0.75,3240000,51840000,48600000
420000.0,2,1.0,1460,7832,1.0,0,0,2,6,1460,0,1924,0.0,98166,47.4617,-122.346,1460,7632,6372,0.813585291113381,2131600,61340224,59208624
685000.0,3,2.0,2210,5000,1.5,0,2,2,7,1710,500,1909,0.0,98103,47.6754,-122.35700000000001,1920,5000,2790,0.558,4884100,25000000,20115900
879000.0,4,3.0,3590,89640,2.0,0,0,2,10,3590,0,2005,0.0,98077,47.7557,-122.036,2790,54014,86050,0.9599509147701919,12888100,8035329600,8022441500
197200.0,3,1.0,1140,8775,1.0,0,0,2,6,990,150,1942,0.0,98146,47.4824,-122.336,1300,8775,7635,0.8700854700854701,1299600,77000625,75701025
529950.0,3,1.0,1240,5000,1.5,0,0,4,7,1240,0,1909,0.0,98107,47.6755,-122.367,1240,4900,3760,0.752,1537600,25000000,23462400
1090000.0,4,2.5,4340,141570,2.5,0,0,2,11,4340,0,1992,0.0,98053,47.6805,-122.04799999999999,2720,97138,137230,0.9693437875256057,18835600,20042064900,20023229300
792000.0,3,1.5,1570,1050,2.0,0,0,2,8,1570,0,1915,0.0,98109,47.6358,-122.35600000000001,2070,3600,-520,-0.49523809523809526,2464900,1102500,-1362400
262000.0,3,2.5,1680,10300,2.0,0,0,3,7,1680,0,1994,0.0,98010,47.31399999999999,-122.001,1680,9849,8620,0.8368932038834952,2822400,106090000,103267600
353900.0,3,1.75,1560,5760,1.0,0,0,4,6,780,780,1927,0.0,98106,47.5272,-122.359,1320,7680,4200,0.7291666666666666,2433600,33177600,30744000
380000.0,1,1.5,1200,44866,1.5,0,0,2,7,1200,0,1983,0.0,98019,47.7205,-121.93,1480,67082,43666,0.9732536887620915,1440000,2012957956,2011517956
305000.0,3,2.5,1690,5175,2.0,0,0,2,7,1690,0,2002,0.0,98038,47.3564,-122.016,1830,5175,3485,0.6734299516908212,2856100,26780625,23924525
440000.0,4,2.0,2310,5004,1.0,0,0,2,7,1430,880,1994,0.0,98108,47.5471,-122.29799999999999,1630,5060,2694,0.5383693045563549,5336100,25040016,19703916
1010000.0,4,3.5,2650,3060,2.0,0,0,2,9,2060,590,2001,0.0,98103,47.6735,-122.33200000000001,1470,3060,410,0.13398692810457516,7022500,9363600,2341100
549900.0,5,3.0,3610,7555,2.0,0,0,2,8,3610,0,2003,0.0,98038,47.3534,-122.012,3610,7979,3945,0.5221707478491066,13032100,57078025,44045925
678500.0,4,3.0,2620,214750,2.0,0,0,2,8,2620,0,1992,0.0,98058,47.4239,-122.068,2060,212137,212130,0.9877997671711293,6864400,46117562500,46110698100
270000.0,3,2.25,1760,8287,1.0,0,0,2,7,1160,600,1986,0.0,98188,47.4501,-122.274,1290,9587,6527,0.7876191625437432,3097600,68674369,65576769
430000.0,3,1.0,940,12521,1.5,0,0,3,7,940,0,1949,0.0,98133,47.7169,-122.331,1920,9046,11581,0.9249261241114927,883600,156775441,155891841
1930000.0,5,4.25,4830,8050,2.5,0,0,3,11,3710,1120,1914,0.0,98144,47.5789,-122.286,4470,9194,3220,0.4,23328900,64802500,41473600
790500.0,4,2.75,3350,5416,2.0,0,0,2,9,3350,0,2014,0.0,98053,47.6849,-122.016,3625,5637,2066,0.3814623338257016,11222500,29333056,18110556
447450.0,3,2.25,1570,7200,2.0,0,0,2,8,1570,0,1991,0.0,98034,47.7332,-122.23200000000001,1620,7318,5630,0.7819444444444444,2464900,51840000,49375100
375000.0,3,2.0,2240,5200,1.0,0,0,2,7,1630,610,1954,0.0,98112,47.6191,-122.296,1470,3775,2960,0.5692307692307692,5017600,27040000,22022400
565000.0,4,2.0,1950,9940,1.0,0,0,3,7,1950,0,1963,0.0,98008,47.6332,-122.118,1920,9270,7990,0.8038229376257545,3802500,98803600,95001100
400000.0,2,1.0,1010,3916,1.0,0,2,3,6,810,200,1918,0.0,98144,47.5728,-122.306,1580,3888,2906,0.7420837589376915,1020100,15335056,14314956
246000.0,3,1.5,1630,10200,1.0,0,0,3,8,1300,330,1976,0.0,98023,47.3155,-122.36399999999999,1960,6700,8570,0.8401960784313726,2656900,104040000,101383100
329922.0,3,1.75,1420,6289,1.0,0,0,2,7,1100,320,1967,0.0,98155,47.7398,-122.314,1460,7402,4869,0.7742089362378757,2016400,39551521,37535121
1250000.0,5,3.25,3950,44431,1.0,0,0,2,10,2100,1850,1969,0.0,98005,47.6451,-122.17299999999999,3860,45870,40481,0.9110981071774211,15602500,1974113761,1958511261
375000.0,3,1.0,1210,7425,1.0,0,0,3,6,1210,0,1910,0.0,98133,47.7125,-122.33,1260,7425,6215,0.837037037037037,1464100,55130625,53666525
385000.0,3,1.75,1890,9920,1.0,0,0,2,7,1230,660,1944,0.0,98125,47.7327,-122.306,1380,9086,8030,0.8094758064516129,3572100,98406400,94834300
591500.0,4,2.5,1690,4080,1.5,0,0,3,7,1140,550,1912,0.0,98117,47.6825,-122.37899999999999,1600,4590,2390,0.5857843137254902,2856100,16646400,13790300
255000.0,4,2.0,2560,12155,1.0,0,0,3,7,1350,1210,1960,0.0,98003,47.3326,-122.323,1790,11906,9595,0.7893870835047305,6553600,147744025,141190425
275000.0,3,1.5,1350,7800,1.0,0,0,2,7,1350,0,1959,0.0,98059,47.4805,-122.15799999999999,1510,8040,6450,0.8269230769230769,1822500,60840000,59017500
800000.0,4,2.75,3120,5000,2.0,0,0,2,9,3120,0,2010,0.0,98074,47.593999999999994,-122.06200000000001,3200,5000,1880,0.376,9734400,25000000,15265600
327000.0,2,1.0,1140,7435,1.0,0,0,2,7,1140,0,1952,1990.0,98125,47.73,-122.31,1320,9385,6295,0.8466711499663753,1299600,55279225,53979625
355000.0,4,1.5,2230,11536,1.0,0,1,3,7,1220,1010,1954,0.0,98166,47.4409,-122.348,2170,12465,9306,0.8066920943134536,4972900,133079296,128106396
310000.0,2,1.0,1050,8220,1.0,0,0,3,6,780,270,1947,0.0,98155,47.7598,-122.316,1340,7651,7170,0.8722627737226277,1102500,67568400,66465900
869000.0,5,3.25,4180,49222,2.0,0,0,3,8,2880,1300,1979,0.0,98027,47.5488,-122.094,3170,8029,45042,0.9150786233797895,17472400,2422805284,2405332884
272000.0,3,2.0,1200,5700,1.0,0,0,4,7,1200,0,1942,0.0,98178,47.5031,-122.242,1190,6384,4500,0.7894736842105263,1440000,32490000,31050000
665000.0,5,2.25,3320,60984,2.0,0,0,2,9,3320,0,2000,0.0,98045,47.4862,-121.71799999999999,1580,55322,57664,0.9455594910140365,11022400,3719048256,3708025856
225000.0,3,2.5,1590,8449,2.0,0,0,2,7,1590,0,1989,0.0,98030,47.3493,-122.177,1750,7172,6859,0.8118120487631673,2528100,71385601,68857501
375000.0,3,2.5,2750,37096,2.0,0,0,2,9,2750,0,1989,0.0,98038,47.3732,-122.023,2700,40091,34346,0.9258680181151606,7562500,1376113216,1368550716
375500.0,3,1.5,1530,7200,1.0,0,0,2,8,1530,0,1975,0.0,98155,47.7691,-122.29700000000001,2150,7216,5670,0.7875,2340900,51840000,49499100
550000.0,3,1.75,1570,6500,1.0,0,0,2,7,920,650,1948,0.0,98116,47.565,-122.398,1570,5750,4930,0.7584615384615384,2464900,42250000,39785100
248000.0,3,1.0,1470,7680,1.0,0,0,2,7,1220,250,1946,0.0,98106,47.5276,-122.359,1470,6784,6210,0.80859375,2160900,58982400,56821500
546940.0,3,1.0,1470,7680,1.0,0,0,2,7,1220,250,1946,0.0,98106,47.5276,-122.359,1470,6784,6210,0.80859375,2160900,58982400,56821500
680000.0,4,3.0,3150,6175,2.0,0,0,2,9,3150,0,2001,0.0,98075,47.5968,-122.01700000000001,3150,6986,3025,0.4898785425101215,9922500,38130625,28208125
350000.0,4,2.5,2380,6124,2.0,0,0,2,8,2380,0,1997,0.0,98030,47.3662,-122.175,2170,6097,3744,0.6113651208360549,5664400,37503376,31838976
593000.0,2,2.5,2000,2500,3.0,0,1,2,8,1810,190,1994,0.0,98116,47.5788,-122.396,1970,5650,500,0.2,4000000,6250000,2250000
390000.0,2,1.0,1140,8147,1.0,0,0,2,7,1140,0,1958,0.0,98125,47.7278,-122.289,1260,8148,7007,0.8600711918497607,1299600,66373609,65074009
297000.0,3,1.0,1340,18000,1.0,0,0,3,7,1340,0,1924,0.0,98070,47.4443,-122.509,1660,196591,16660,0.9255555555555556,1795600,324000000,322204400
355000.0,2,1.0,1450,9150,1.0,0,0,3,7,1450,0,1965,0.0,98188,47.4689,-122.277,1440,10636,7700,0.8415300546448088,2102500,83722500,81620000
309900.0,3,2.5,2020,26670,2.0,0,0,2,7,2020,0,1987,0.0,98003,47.2597,-122.31,1680,10939,24650,0.9242594675665542,4080400,711288900,707208500
257000.0,3,2.25,1810,12000,2.0,0,0,2,7,1810,0,1992,0.0,98003,47.3476,-122.3,1720,9916,10190,0.8491666666666666,3276100,144000000,140723900
1700000.0,4,3.0,3600,9687,2.0,0,0,3,9,3600,0,1959,1995.0,98004,47.6257,-122.208,2620,10400,6087,0.6283679157633942,12960000,93837969,80877969
300000.0,3,2.0,1260,2550,2.0,0,0,2,7,1260,0,1987,0.0,98117,47.6821,-122.37799999999999,1590,3825,1290,0.5058823529411764,1587600,6502500,4914900
500000.0,3,2.0,1560,1156,3.0,0,0,2,8,1560,0,2014,0.0,98122,47.605,-122.304,1560,1728,-404,-0.3494809688581315,2433600,1336336,-1097264
900000.0,8,4.0,4020,7500,1.0,0,0,2,8,2010,2010,1968,0.0,98107,47.6732,-122.363,1560,3737,3480,0.464,16160400,56250000,40089600
695000.0,4,3.0,3150,9130,2.0,0,0,2,9,3150,0,2001,0.0,98075,47.5974,-122.01700000000001,2970,6228,5980,0.6549835706462213,9922500,83356900,73434400
213400.0,4,2.5,1680,6655,2.0,0,0,2,7,1680,0,2001,0.0,98030,47.3867,-122.191,1680,6982,4975,0.7475582268970699,2822400,44289025,41466625
425000.0,2,1.0,1320,8830,1.0,0,0,2,7,1020,300,1939,0.0,98199,47.6433,-122.404,1620,8531,7510,0.8505096262740657,1742400,77968900,76226500
420000.0,3,3.0,2700,47050,2.0,0,0,3,9,1570,1130,1986,0.0,98058,47.4446,-122.104,2260,45901,44350,0.9426142401700319,7290000,2213702500,2206412500
411000.0,1,1.0,1080,5000,1.5,0,0,2,7,1080,0,1948,0.0,98199,47.6603,-122.39399999999999,1620,4000,3920,0.784,1166400,25000000,23833600
762500.0,4,2.25,3130,41382,2.0,0,0,2,9,3130,0,1986,0.0,98053,47.6683,-122.03399999999999,3130,54886,38252,0.9243632497221014,9796900,1712469924,1702673024
569950.0,5,4.5,4850,40902,2.0,0,0,2,10,4850,0,2001,0.0,98023,47.3181,-122.344,1640,13503,36052,0.8814238912522615,23522500,1672973604,1649451104
258000.0,4,1.0,1220,8500,1.5,0,0,4,6,1220,0,1916,0.0,98168,47.4792,-122.277,1460,8500,7280,0.8564705882352941,1488400,72250000,70761600
499000.0,3,2.25,1780,3665,2.0,0,0,2,8,1780,0,2004,0.0,98029,47.5495,-121.99700000000001,1770,3669,1885,0.514324693042292,3168400,13432225,10263825
310000.0,3,1.0,1250,10723,1.0,0,0,3,7,1250,0,1961,0.0,98059,47.4894,-122.135,1520,10723,9473,0.883428145108645,1562500,114982729,113420229
398500.0,2,2.5,1780,1311,3.0,0,0,2,8,1350,430,2005,0.0,98103,47.6962,-122.34,1390,1227,-469,-0.35774218154080856,3168400,1718721,-1449679
250600.0,4,2.5,1930,8660,1.0,0,0,2,7,1120,810,1981,0.0,98001,47.3261,-122.26,1830,9591,6730,0.7771362586605081,3724900,74995600,71270700
352000.0,4,2.5,2470,6116,1.0,0,0,2,7,1420,1050,1985,0.0,98038,47.3792,-122.04700000000001,1670,7627,3646,0.5961412688031393,6100900,37405456,31304556
600000.0,2,1.0,1180,2160,1.0,0,1,2,7,940,240,1909,0.0,98119,47.6313,-122.368,2700,5400,980,0.4537037037037037,1392400,4665600,3273200
645000.0,3,1.0,2270,4182,1.0,0,0,3,7,1170,1100,1946,0.0,98115,47.688,-122.32,1860,4080,1912,0.4571975131516021,5152900,17489124,12336224
291500.0,4,2.5,1770,5000,2.0,0,0,2,7,1770,0,2004,0.0,98038,47.3503,-122.005,2080,5100,3230,0.646,3132900,25000000,21867100
350000.0,4,1.75,2250,13515,1.0,0,0,3,8,2150,100,1940,0.0,98030,47.3789,-122.229,2150,12508,11265,0.8335183129855716,5062500,182655225,177592725
279000.0,3,2.5,1540,7280,1.0,0,0,2,7,1080,460,1974,0.0,98003,47.3102,-122.322,1220,6440,5740,0.7884615384615384,2371600,52998400,50626800
320000.0,2,1.0,820,5400,1.0,0,0,2,6,820,0,1940,0.0,98117,47.6976,-122.375,1370,5632,4580,0.8481481481481481,672400,29160000,28487600
495000.0,2,2.0,1580,5203,1.0,0,0,2,8,1580,0,2004,0.0,98053,47.7174,-122.03200000000001,1560,4770,3623,0.6963290409379205,2496400,27071209,24574809
490000.0,4,2.5,2430,42646,1.0,0,0,2,7,1450,980,1989,0.0,98014,47.6164,-121.95299999999999,2000,38159,40216,0.9430192749613094,5904900,1818681316,1812776416
770000.0,5,1.5,2160,5000,1.5,0,2,3,8,2160,0,1926,0.0,98107,47.6645,-122.36,1450,4265,2840,0.568,4665600,25000000,20334400
215000.0,3,1.75,1770,29004,1.0,0,0,2,8,1770,0,1959,0.0,98023,47.3204,-122.36399999999999,2300,24534,27234,0.9389739346297062,3132900,841232016,838099116
665000.0,3,3.5,3580,95832,1.5,0,0,2,9,3580,0,2005,0.0,98038,47.4239,-122.015,2880,60548,92252,0.9626429585107271,12816400,9183772224,9170955824
423500.0,3,2.25,1890,7498,1.0,0,0,2,7,1190,700,1987,0.0,98125,47.73,-122.29700000000001,1660,8100,5608,0.7479327820752201,3572100,56220004,52647904
850000.0,3,3.0,1910,4800,1.5,0,0,2,9,1910,0,1900,0.0,98103,47.6572,-122.346,1280,1310,2890,0.6020833333333333,3648100,23040000,19391900
155000.0,2,1.0,910,6232,1.0,0,0,2,6,910,0,1943,0.0,98118,47.5328,-122.272,1070,6232,5322,0.8539794608472401,828100,38837824,38009724
505000.0,3,2.25,1460,7210,1.0,0,0,2,7,1460,0,1963,0.0,98008,47.6316,-122.119,1850,7519,5750,0.79750346740638,2131600,51984100,49852500
780000.0,3,3.5,3310,5558,2.0,0,0,2,9,3310,0,2005,0.0,98029,47.5553,-122.00299999999999,3310,5270,2248,0.4044620367038503,10956100,30891364,19935264
165000.0,3,1.5,1630,22764,1.0,0,0,2,7,1630,0,1970,0.0,98032,47.3611,-122.29299999999999,1620,17859,21134,0.9283957125285539,2656900,518199696,515542796
707000.0,2,2.5,2130,5001,1.0,0,0,4,8,1330,800,1972,0.0,98199,47.6573,-122.399,1750,6000,2871,0.5740851829634073,4536900,25010001,20473101
497000.0,3,2.5,1220,1475,3.0,0,0,2,8,1220,0,2000,0.0,98117,47.6909,-122.395,1220,1546,255,0.17288135593220338,1488400,2175625,687225
349170.0,4,1.75,1670,8856,1.0,0,2,2,7,1070,600,1955,0.0,98178,47.5056,-122.251,1660,8088,7186,0.811427280939476,2788900,78428736,75639836
287000.0,4,1.5,1300,10050,1.5,0,0,2,7,1300,0,1963,0.0,98059,47.4899,-122.116,1730,10050,8750,0.8706467661691543,1690000,101002500,99312500
2380000.0,4,2.5,3220,20251,1.0,0,0,2,10,3220,0,1969,0.0,98006,47.5692,-122.19200000000001,4200,22114,17031,0.840995506394746,10368400,410103001,399734601
645000.0,4,2.5,2430,14400,1.0,0,0,4,8,1670,760,1963,0.0,98007,47.6202,-122.13799999999999,2140,9048,11970,0.83125,5904900,207360000,201455100
238000.0,5,2.25,2240,9652,2.0,0,0,2,7,2240,0,1990,0.0,98055,47.4249,-122.211,2180,11644,7412,0.7679237463738086,5017600,93161104,88143504
328000.0,5,2.25,2240,9652,2.0,0,0,2,7,2240,0,1990,0.0,98055,47.4249,-122.211,2180,11644,7412,0.7679237463738086,5017600,93161104,88143504
365000.0,2,1.5,790,1123,2.0,0,0,2,8,700,90,2003,0.0,98119,47.651,-122.368,1370,1281,333,0.2965271593944791,624100,1261129,637029
380000.0,3,1.0,1380,8147,1.0,0,0,3,7,1380,0,1948,0.0,98155,47.7407,-122.3,1360,8147,6767,0.8306124953970787,1904400,66373609,64469209
525000.0,4,1.5,1680,10500,2.0,0,0,2,7,1680,0,1962,0.0,98033,47.6806,-122.166,1830,10264,8820,0.84,2822400,110250000,107427600
402000.0,4,2.25,2000,3672,2.0,0,0,4,7,1650,350,1926,0.0,98117,47.6769,-122.383,2000,5100,1672,0.4553376906318083,4000000,13483584,9483584
308000.0,2,1.0,1680,9250,1.0,0,0,2,7,860,820,1969,0.0,98072,47.7618,-122.162,1590,9542,7570,0.8183783783783783,2822400,85562500,82740100
405000.0,3,2.5,1960,6997,2.0,0,0,2,7,1960,0,2006,0.0,98065,47.5415,-121.887,2320,5178,5037,0.7198799485493783,3841600,48958009,45116409
808000.0,3,1.75,2590,32380,1.0,0,0,2,8,2590,0,1951,1994.0,98177,47.7539,-122.37,2340,28456,29790,0.9200123533045089,6708100,1048464400,1041756300
875000.0,4,3.5,3790,6874,2.5,0,0,2,9,3790,0,2010,0.0,98053,47.6956,-122.022,3370,6535,3084,0.4486470759383183,14364100,47251876,32887776
860000.0,3,2.5,2370,55321,3.0,0,0,3,8,2370,0,1982,0.0,98074,47.6148,-122.057,2590,41553,52951,0.9571591258292511,5616900,3060413041,3054796141
367500.0,4,2.25,1930,7925,1.0,0,0,2,8,1300,630,1960,0.0,98155,47.7626,-122.31200000000001,1930,7200,5995,0.7564668769716089,3724900,62805625,59080725
604000.0,6,3.5,2580,13572,1.0,0,0,2,8,1290,1290,1987,0.0,98052,47.6796,-122.113,2020,11656,10992,0.8099027409372237,6656400,184199184,177542784
230000.0,2,0.75,890,19703,1.0,0,0,2,6,890,0,1934,0.0,98045,47.4922,-121.78299999999999,1270,9800,18813,0.9548292138253058,792100,388208209,387416109
435000.0,4,2.75,2160,8148,1.0,0,0,2,7,1410,750,1978,0.0,98125,47.7261,-122.306,2060,8100,5988,0.7349042709867453,4665600,66389904,61724304
347500.0,4,2.5,1970,7098,2.0,0,0,2,7,1970,0,2007,0.0,98038,47.3576,-122.05799999999999,1970,5361,5128,0.7224570301493378,3880900,50381604,46500704
525000.0,4,1.75,1570,16697,1.0,0,2,2,7,1030,540,1981,0.0,98052,47.67100000000001,-122.135,1560,9698,15127,0.9059711325387794,2464900,278789809,276324909
280000.0,2,1.5,1480,15641,1.0,0,0,3,7,1480,0,1940,0.0,98146,47.5008,-122.366,1520,7525,14161,0.905376894060482,2190400,244640881,242450481
490000.0,2,1.5,1480,15641,1.0,0,0,3,7,1480,0,1940,0.0,98146,47.5008,-122.366,1520,7525,14161,0.905376894060482,2190400,244640881,242450481
265000.0,4,1.75,1430,5490,1.0,0,0,4,6,1430,0,1942,0.0,98056,47.494,-122.184,1030,5900,4060,0.7395264116575592,2044900,30140100,28095200
645000.0,4,2.25,2720,18295,1.0,0,0,3,8,2000,720,1979,0.0,98075,47.5851,-122.073,2720,18295,15575,0.8513254987701557,7398400,334707025,327308625
390000.0,3,2.25,2420,31497,1.0,0,0,3,8,1750,670,1964,0.0,98058,47.4422,-122.15100000000001,2040,30472,29077,0.9231672857732482,5856400,992061009,986204609
267500.0,3,2.5,1400,7629,1.0,0,0,2,7,1120,280,1988,0.0,98030,47.3788,-122.179,1530,7688,6229,0.8164897103158999,1960000,58201641,56241641
1280000.0,4,3.5,5844,10766,2.0,0,1,2,11,5844,0,2007,0.0,98023,47.3293,-122.36399999999999,3413,10766,4922,0.457180011146201,34152336,115906756,81754420
404000.0,4,1.75,1840,10720,1.0,0,0,2,7,960,880,1958,0.0,98008,47.6074,-122.125,1840,9044,8880,0.8283582089552238,3385600,114918400,111532800
380000.0,3,2.25,2530,12042,2.0,0,0,2,8,2530,0,1989,0.0,98042,47.3742,-122.125,2480,10172,9512,0.7899020096329513,6400900,145009764,138608864
812500.0,4,2.75,2810,10300,1.0,0,0,3,9,1810,1000,1978,0.0,98006,47.5626,-122.149,2710,9900,7490,0.7271844660194174,7896100,106090000,98193900
265000.0,3,1.0,1020,8610,1.0,0,0,4,7,1020,0,1959,0.0,98056,47.4974,-122.169,1070,5940,7590,0.8815331010452961,1040400,74132100,73091700
480000.0,5,2.75,2550,7725,1.0,0,0,4,8,1390,1160,1967,0.0,98056,47.5388,-122.171,2450,7725,5175,0.6699029126213593,6502500,59675625,53173125
264000.0,1,1.0,710,4725,1.0,0,0,2,6,710,0,1939,0.0,98133,47.7328,-122.34,900,5250,4015,0.8497354497354498,504100,22325625,21821525
1350000.0,5,3.0,5530,38816,1.5,0,2,2,10,5530,0,1969,0.0,98072,47.7352,-122.116,3800,44417,33286,0.857532976092333,30580900,1506681856,1476100956
550000.0,4,1.75,2150,9000,1.0,0,0,3,7,1110,1040,1966,0.0,98052,47.6812,-122.113,2040,9000,6850,0.7611111111111111,4622500,81000000,76377500
615000.0,2,1.5,880,2400,1.5,0,0,2,7,880,0,1929,0.0,98122,47.6144,-122.295,1220,4440,1520,0.6333333333333333,774400,5760000,4985600
464000.0,3,1.75,1630,28600,1.0,0,0,2,8,1630,0,1967,0.0,98072,47.7742,-122.14,2260,26000,26970,0.943006993006993,2656900,817960000,815303100
365000.0,3,1.0,1380,30940,2.0,0,0,2,8,1380,0,1976,0.0,98042,47.333999999999996,-122.10600000000001,2350,32500,29560,0.9553975436328378,1904400,957283600,955379200
490000.0,4,2.25,2800,10800,1.0,0,0,2,8,1680,1120,1977,0.0,98011,47.7448,-122.177,2260,9800,8000,0.7407407407407407,7840000,116640000,108800000
280927.0,4,2.25,2070,7350,2.0,0,0,3,8,2070,0,1977,0.0,98032,47.3615,-122.274,2080,7210,5280,0.7183673469387755,4284900,54022500,49737600
282613.0,2,1.0,830,6017,1.0,0,0,3,6,830,0,1954,0.0,98133,47.7466,-122.334,1340,6040,5187,0.862057503739405,688900,36204289,35515389
675000.0,3,2.25,2770,15886,2.0,0,0,2,10,2770,0,1982,0.0,98177,47.7464,-122.36200000000001,3290,15886,13116,0.8256326325066096,7672900,252364996,244692096
575550.0,4,2.5,2060,7475,1.0,0,0,2,8,1440,620,1985,0.0,98052,47.7272,-122.105,2280,8396,5415,0.7244147157190636,4243600,55875625,51632025
259900.0,3,2.0,1490,7770,1.0,0,0,3,7,1490,0,1990,0.0,98042,47.3686,-122.09,1540,7366,6280,0.8082368082368082,2220100,60372900,58152800
450000.0,4,2.25,2120,8267,2.0,0,0,2,8,2120,0,1996,0.0,98045,47.4885,-121.779,2150,7746,6147,0.7435587274706665,4494400,68343289,63848889
487500.0,4,2.5,2810,6296,2.0,0,0,2,9,2810,0,2013,0.0,98059,47.5019,-122.15100000000001,2850,6140,3486,0.5536848792884371,7896100,39639616,31743516
275000.0,4,2.25,2400,17842,2.0,0,0,3,7,2400,0,1973,0.0,98002,47.2866,-122.21700000000001,1610,12100,15442,0.8654859320703957,5760000,318336964,312576964
305000.0,3,2.5,2460,5027,2.0,0,0,2,8,2460,0,2002,0.0,98042,47.372,-122.102,2740,5000,2567,0.5106425303361846,6051600,25270729,19219129
395000.0,3,1.75,2030,217800,1.0,0,2,3,8,2030,0,1977,0.0,98092,47.2618,-122.12,2570,216057,215770,0.9906795224977043,4120900,47436840000,47432719100
215000.0,3,1.0,880,7648,1.0,0,2,3,6,880,0,1940,0.0,98022,47.1963,-121.99700000000001,1020,7566,6768,0.8849372384937239,774400,58491904,57717504
410000.0,3,2.0,1320,6000,1.5,0,0,3,7,1320,0,1920,0.0,98144,47.5752,-122.304,1620,4000,4680,0.78,1742400,36000000,34257600
440000.0,4,2.5,2160,7826,1.0,0,0,3,7,1390,770,1976,0.0,98155,47.7754,-122.27600000000001,2190,9900,5666,0.7239969332992588,4665600,61246276,56580676
1160000.0,4,3.5,4190,15724,2.0,0,2,2,11,4190,0,1994,0.0,98027,47.5518,-122.096,3300,10113,11534,0.7335283642838972,17556100,247244176,229688076
500000.0,4,2.0,2280,7200,1.0,0,0,3,7,2280,0,1956,0.0,98133,47.7132,-122.355,1100,7620,4920,0.6833333333333333,5198400,51840000,46641600
961000.0,5,2.75,2590,6120,2.0,0,0,2,8,2590,0,1909,0.0,98105,47.6667,-122.32700000000001,1390,3060,3530,0.576797385620915,6708100,37454400,30746300
825000.0,4,2.25,2770,9340,2.0,0,0,3,9,2770,0,1979,0.0,98027,47.5628,-122.081,3010,9340,6570,0.7034261241970021,7672900,87235600,79562700
734000.0,3,1.75,2145,3840,1.5,0,0,4,8,2145,0,1910,0.0,98103,47.6875,-122.35700000000001,1140,3840,1695,0.44140625,4601025,14745600,10144575
490000.0,4,4.25,4480,5715,2.0,0,0,2,7,3680,800,2003,0.0,98030,47.37300000000001,-122.179,2190,6070,1235,0.21609798775153105,20070400,32661225,12590825
175000.0,4,2.5,1780,6000,2.0,0,0,2,7,1780,0,1991,0.0,98198,47.3828,-122.302,1630,6000,4220,0.7033333333333334,3168400,36000000,32831600
190000.0,1,1.0,720,4800,1.0,0,0,2,6,720,0,1914,0.0,98118,47.5303,-122.27,1240,4860,4080,0.85,518400,23040000,22521600
305000.0,4,2.25,2050,12581,2.0,0,0,3,7,2050,0,1978,0.0,98002,47.3215,-122.204,1620,7400,10531,0.8370558779111359,4202500,158281561,154079061
1300000.0,3,1.0,2040,7936,1.0,0,3,4,8,1680,360,1940,0.0,98177,47.7028,-122.385,2300,10080,5896,0.7429435483870968,4161600,62980096,58818496
417000.0,2,1.0,920,6600,1.0,0,0,2,6,920,0,1919,2003.0,98118,47.5452,-122.27,1510,5944,5680,0.8606060606060606,846400,43560000,42713600
275000.0,2,1.0,680,4190,1.0,0,0,1,5,680,0,1906,0.0,98103,47.6901,-122.35799999999999,1070,4175,3510,0.837708830548926,462400,17556100,17093700
661000.0,3,2.5,1940,8196,2.0,0,0,2,8,1940,0,1991,0.0,98052,47.6786,-122.15100000000001,2070,8514,6256,0.7632991703269888,3763600,67174416,63410816
435000.0,4,2.75,2230,9640,1.0,0,0,2,8,1320,910,1998,0.0,98125,47.7269,-122.325,2100,9600,7410,0.7686721991701245,4972900,92929600,87956700
788000.0,5,2.25,2910,9454,1.0,0,1,2,8,1910,1000,1972,0.0,98005,47.5871,-122.17299999999999,2400,10690,6544,0.6921937804104082,8468100,89378116,80910016
1800000.0,5,3.25,5270,17232,2.0,0,1,2,10,4010,1260,1977,2003.0,98040,47.5536,-122.228,3550,13917,11962,0.6941736304549675,27772900,296941824,269168924
408000.0,5,3.25,2820,6589,1.5,0,0,2,7,2320,0,1906,2014.0,98118,47.5357,-122.273,1560,5647,3769,0.5720139626650478,7952400,43414921,35462521
570000.0,2,1.0,1790,3760,1.5,0,0,3,8,1490,300,1912,0.0,98144,47.5926,-122.29299999999999,1458,3760,1970,0.523936170212766,3204100,14137600,10933500
1540000.0,5,3.25,2920,6960,2.0,0,1,2,9,2120,800,1953,2008.0,98105,47.6712,-122.272,2470,6735,4040,0.5804597701149425,8526400,48441600,39915200
400000.0,2,1.0,840,5510,1.0,0,0,2,7,840,0,1955,0.0,98136,47.5247,-122.391,1630,5510,4670,0.8475499092558983,705600,30360100,29654500
247000.0,3,1.75,1820,8740,1.0,0,0,3,8,1820,0,1987,0.0,98023,47.3074,-122.385,2210,8320,6920,0.7917620137299771,3312400,76387600,73075200
453000.0,3,1.75,1550,7200,1.0,0,0,2,7,1100,450,1949,0.0,98125,47.7071,-122.314,1560,7440,5650,0.7847222222222222,2402500,51840000,49437500
235000.0,2,1.0,1270,3008,1.0,0,0,3,6,650,620,1923,0.0,98118,47.5351,-122.279,1270,1514,1738,0.5777925531914894,1612900,9048064,7435164
675000.0,4,1.75,2460,5750,1.5,0,3,4,7,1620,840,1919,0.0,98126,47.5601,-122.37799999999999,1760,4830,3290,0.5721739130434783,6051600,33062500,27010900
516200.0,3,2.0,2110,5150,1.0,0,0,4,6,1080,1030,1919,0.0,98118,47.5521,-122.271,1170,5107,3040,0.5902912621359223,4452100,26522500,22070400
650000.0,1,1.0,920,91476,1.5,0,0,2,6,920,0,1996,0.0,98070,47.448,-122.47200000000001,1746,91476,90556,0.9899427172154445,846400,8367858576,8367012176
257100.0,3,1.5,1500,10227,1.0,0,0,3,7,1000,500,1945,0.0,98022,47.2043,-121.99600000000001,1490,7670,8727,0.8533294221179232,2250000,104591529,102341529
457000.0,2,2.0,1440,9985,1.0,0,0,2,8,1440,0,2006,0.0,98053,47.7217,-122.03,1510,4560,8545,0.85578367551327,2073600,99700225,97626625
540000.0,3,1.75,1610,3478,1.5,0,0,3,7,1060,550,1929,0.0,98117,47.6774,-122.37200000000001,1610,3478,1868,0.5370902817711328,2592100,12096484,9504384
268000.0,3,1.75,1970,10270,1.0,0,0,3,8,1970,0,1966,0.0,98032,47.3619,-122.285,1970,8400,8300,0.8081791626095424,3880900,105472900,101592000
300000.0,3,1.0,1150,7314,1.0,0,0,2,7,1150,0,1960,0.0,98008,47.6246,-122.113,1350,7350,6164,0.8427672955974843,1322500,53494596,52172096
380000.0,2,2.5,2110,114127,1.0,0,0,3,8,1590,520,1975,0.0,98031,47.4137,-122.212,1960,11250,112017,0.9815118245463387,4452100,13024972129,13020520029
725000.0,3,2.5,3580,54450,1.5,0,0,2,9,3580,0,1990,0.0,98038,47.4026,-122.03299999999999,3090,35943,50870,0.9342516069788797,12816400,2964802500,2951986100
249000.0,3,1.0,1000,19204,1.0,0,0,2,7,1000,0,1968,0.0,98042,47.3167,-122.081,2450,25927,18204,0.9479275151010206,1000000,368793616,367793616
274000.0,5,1.0,1680,9383,1.0,0,0,2,7,1400,280,1929,0.0,98155,47.7523,-122.311,1680,9458,7703,0.8209527869551316,2822400,88040689,85218289
1780000.0,4,3.25,3950,10912,2.0,0,0,2,10,3950,0,2003,0.0,98004,47.5877,-122.196,3000,10998,6962,0.6380131964809385,15602500,119071744,103469244
396500.0,3,1.75,2390,7149,1.0,0,0,2,8,1350,1040,1955,0.0,98125,47.7244,-122.32600000000001,1710,7402,4759,0.6656875087424815,5712100,51108201,45396101
460000.0,2,1.5,1820,7800,1.0,0,0,3,7,1240,580,1956,0.0,98133,47.7513,-122.35700000000001,1400,7800,5980,0.7666666666666667,3312400,60840000,57527600
277000.0,3,1.0,1100,8536,1.0,0,0,3,7,1100,0,1957,0.0,98118,47.5162,-122.26100000000001,1570,8040,7436,0.8711340206185567,1210000,72863296,71653296
449500.0,6,4.0,2280,5275,1.0,0,0,2,7,1270,1010,1998,0.0,98108,47.5556,-122.294,1760,6642,2995,0.5677725118483412,5198400,27825625,22627225
785950.0,4,3.0,2530,4560,1.5,0,0,2,7,1540,990,1925,2014.0,98112,47.6287,-122.3,1640,4560,2030,0.4451754385964912,6400900,20793600,14392700
545000.0,3,2.5,1940,9775,1.0,0,2,2,8,1440,500,1975,0.0,98034,47.7142,-122.22200000000001,2830,9775,7835,0.80153452685422,3763600,95550625,91787025
244000.0,3,2.0,1360,9688,1.0,0,0,3,7,1360,0,1983,0.0,98003,47.2574,-122.31,1390,9685,8328,0.8596201486374897,1849600,93857344,92007744
165000.0,3,2.5,1660,2415,2.0,0,0,2,7,1660,0,1983,0.0,98042,47.3763,-122.148,1740,2624,755,0.31262939958592134,2755600,5832225,3076625
435000.0,2,1.0,800,5000,1.0,0,0,2,7,800,0,1906,0.0,98107,47.6751,-122.37200000000001,1410,5000,4200,0.84,640000,25000000,24360000
642000.0,3,2.5,2670,10082,1.0,0,0,2,10,2670,0,1987,0.0,98074,47.6359,-122.045,2740,10854,7412,0.7351715929379091,7128900,101646724,94517824
340000.0,3,2.5,1720,4120,2.0,0,0,2,7,1720,0,1999,0.0,98148,47.4319,-122.32799999999999,1720,5544,2400,0.5825242718446602,2958400,16974400,14016000
730000.0,4,2.5,3550,35689,2.0,0,0,3,9,3550,0,1991,0.0,98077,47.7503,-122.074,3350,35711,32139,0.9005295749390568,12602500,1273704721,1261102221
563250.0,3,1.75,1370,2800,1.0,0,0,4,7,800,570,1982,0.0,98122,47.6157,-122.291,2270,3773,1430,0.5107142857142857,1876900,7840000,5963100
675000.0,5,2.5,2820,67518,2.0,0,0,2,8,2820,0,1979,0.0,98029,47.5794,-122.025,2820,48351,64698,0.9582333599928908,7952400,4558680324,4550727924
620000.0,3,1.5,1620,6630,1.0,0,0,2,8,1280,340,1954,0.0,98117,47.6948,-122.39399999999999,1880,5100,5010,0.755656108597285,2624400,43956900,41332500
275000.0,2,2.0,1290,9041,1.0,0,0,2,7,950,340,1956,0.0,98108,47.5346,-122.291,1290,5000,7751,0.8573166685101206,1664100,81739681,80075581
270000.0,3,1.0,1830,8209,1.0,0,0,2,7,1830,0,1942,0.0,98028,47.7439,-122.228,2150,12000,6379,0.7770739432330369,3348900,67387681,64038781
325000.0,4,2.5,2040,5472,2.0,0,0,2,8,2040,0,2003,0.0,98092,47.3337,-122.189,2420,5782,3432,0.6271929824561403,4161600,29942784,25781184
476100.0,4,2.5,1850,1836,2.0,0,0,2,7,1600,250,2005,0.0,98029,47.5529,-121.99600000000001,1770,2236,-14,-0.007625272331154684,3422500,3370896,-51604
700000.0,2,1.0,1300,12000,1.0,0,0,3,8,1300,0,1959,0.0,98004,47.6366,-122.229,2420,15000,10700,0.8916666666666667,1690000,144000000,142310000
220000.0,4,2.0,1620,5200,1.5,0,0,3,7,1620,0,1978,0.0,98042,47.3629,-122.09100000000001,1500,5200,3580,0.6884615384615385,2624400,27040000,24415600
236000.0,3,1.75,1560,10919,1.0,0,0,2,7,1560,0,1975,0.0,98023,47.2917,-122.366,1730,10919,9359,0.8571297737888085,2433600,119224561,116790961
790000.0,3,2.5,2600,4750,1.0,0,0,3,9,1700,900,1951,0.0,98117,47.6833,-122.4,2380,4750,2150,0.45263157894736844,6760000,22562500,15802500
350000.0,3,1.0,2010,6000,1.0,0,0,2,7,1210,800,1967,0.0,98108,47.5515,-122.29799999999999,2460,6000,3990,0.665,4040100,36000000,31959900
130000.0,2,1.0,780,5300,1.0,0,0,2,6,780,0,1941,0.0,98146,47.51300000000001,-122.354,780,5300,4520,0.8528301886792453,608400,28090000,27481600
283200.0,4,2.5,1982,6406,2.0,0,0,2,8,1982,0,2004,0.0,98030,47.3636,-122.19200000000001,2340,6501,4424,0.6906025600999064,3928324,41036836,37108512
273000.0,3,1.0,1500,6250,1.0,0,0,2,6,890,610,1945,0.0,98126,47.5365,-122.368,1210,6250,4750,0.76,2250000,39062500,36812500
599000.0,5,2.25,2460,8710,1.0,0,0,3,8,1330,1130,1976,0.0,98052,47.6651,-122.15,2460,8870,6250,0.7175660160734788,6051600,75864100,69812500
460000.0,4,2.5,2680,11998,1.0,0,3,2,8,1510,1170,1960,0.0,98003,47.336999999999996,-122.321,2680,12746,9318,0.7766294382397066,7182400,143952004,136769604
1160000.0,4,4.25,5860,52889,2.0,0,0,3,10,4910,950,1996,0.0,98072,47.7245,-122.095,3320,39066,47029,0.8892019134413583,34339600,2797246321,2762906721
385000.0,4,1.75,1720,8750,1.0,0,0,2,7,860,860,1971,0.0,98034,47.726000000000006,-122.21,1790,8750,7030,0.8034285714285714,2958400,76562500,73604100
264250.0,3,1.0,1420,7420,1.5,0,0,2,6,1420,0,1944,0.0,98178,47.4949,-122.23899999999999,1290,6600,6000,0.8086253369272237,2016400,55056400,53040000
608000.0,3,2.5,1760,1472,3.0,0,0,2,8,1640,120,2006,0.0,98119,47.6473,-122.374,1760,5400,-288,-0.1956521739130435,3097600,2166784,-930816
450000.0,3,2.5,2790,48994,2.0,0,0,3,9,2790,0,1984,0.0,98042,47.3487,-122.088,2550,37834,46204,0.943054251541005,7784100,2400412036,2392627936
1760000.0,3,2.0,2360,4800,2.0,0,0,2,9,2360,0,1909,0.0,98112,47.6317,-122.31200000000001,2260,4800,2440,0.5083333333333333,5569600,23040000,17470400
339950.0,5,2.0,1890,6050,2.0,0,0,3,7,1890,0,1944,0.0,98178,47.5018,-122.242,1170,6050,4160,0.687603305785124,3572100,36602500,33030400
760000.0,6,3.75,3810,6150,2.0,0,0,3,8,3810,0,1977,0.0,98103,47.693999999999996,-122.34,1830,5125,2340,0.3804878048780488,14516100,37822500,23306400
350000.0,2,1.0,1160,5395,1.0,0,0,2,7,860,300,1940,0.0,98103,47.7007,-122.354,1664,5363,4235,0.7849860982391103,1345600,29106025,27760425
541500.0,3,1.75,2320,55847,1.0,0,2,3,8,2320,0,1960,0.0,98001,47.3121,-122.25299999999999,2400,26112,53527,0.9584579297007897,5382400,3118887409,3113505009
730000.0,6,2.75,3280,16449,1.0,0,0,3,7,1910,1370,1963,0.0,98007,47.5914,-122.134,2550,9532,13169,0.8005957808985349,10758400,270569601,259811201
215000.0,3,1.0,980,5600,1.0,0,0,1,6,980,0,1949,0.0,98106,47.5308,-122.361,1840,5302,4620,0.825,960400,31360000,30399600
420000.0,3,2.0,1640,9972,1.0,0,0,3,7,1640,0,1977,0.0,98075,47.5812,-122.00200000000001,1680,10165,8332,0.8355395106297633,2689600,99440784,96751184
655000.0,4,2.25,2060,8470,1.0,0,0,2,8,1440,620,1983,0.0,98006,47.5605,-122.124,2180,8978,6410,0.7567886658795749,4243600,71740900,67497300
240000.0,3,2.5,1500,10652,2.0,0,0,3,7,1500,0,1981,0.0,98031,47.4015,-122.176,1610,7417,9152,0.8591813743897859,2250000,113465104,111215104
730000.0,4,2.0,2360,6000,1.0,0,0,4,7,1260,1100,1939,0.0,98199,47.6534,-122.41,1720,6000,3640,0.6066666666666667,5569600,36000000,30430400
390000.0,4,1.5,1940,12100,1.0,0,0,2,7,1940,0,1962,0.0,98033,47.6892,-122.164,1380,12100,10160,0.8396694214876033,3763600,146410000,142646400
473000.0,3,1.0,1280,10000,1.0,0,0,3,7,1280,0,1954,0.0,98006,47.5716,-122.139,1240,10000,8720,0.872,1638400,100000000,98361600
698000.0,4,3.5,3630,5670,2.0,0,0,2,10,3630,0,1970,0.0,98056,47.5189,-122.206,1620,5400,2040,0.35978835978835977,13176900,32148900,18972000
511000.0,3,2.5,1820,4883,2.0,0,0,2,9,1820,0,2005,0.0,98028,47.7355,-122.22399999999999,2720,5002,3063,0.6272783125127995,3312400,23843689,20531289
358000.0,2,1.5,960,1808,2.0,0,0,2,7,960,0,1993,0.0,98122,47.6183,-122.29799999999999,1290,1668,848,0.4690265486725664,921600,3268864,2347264
499990.0,3,1.75,1630,8400,1.0,0,0,3,7,1060,570,1955,0.0,98007,47.5983,-122.149,1630,7245,6770,0.805952380952381,2656900,70560000,67903100
322000.0,4,2.25,1940,10200,1.0,0,0,2,7,1360,580,1960,0.0,98188,47.4253,-122.28299999999999,1940,10200,8260,0.8098039215686275,3763600,104040000,100276400
201000.0,3,1.0,980,9682,1.0,0,0,2,7,980,0,1969,0.0,98031,47.4136,-122.20700000000001,1580,9682,8702,0.8987812435447222,960400,93741124,92780724
765000.0,4,2.5,3140,16200,1.0,0,1,2,9,2570,570,1988,0.0,98166,47.4363,-122.34200000000001,2530,13200,13060,0.8061728395061728,9859600,262440000,252580400
920000.0,4,2.75,2880,5750,1.5,0,0,4,9,1710,1170,1928,0.0,98116,47.5874,-122.387,1640,5750,2870,0.4991304347826087,8294400,33062500,24768100
360000.0,4,2.0,1650,7552,1.0,0,0,3,7,860,790,1977,0.0,98155,47.7765,-122.324,1410,7199,5902,0.7815148305084746,2722500,57032704,54310204
297300.0,3,1.75,1980,9220,2.0,0,0,2,8,1980,0,1987,0.0,98092,47.2602,-122.219,2080,8305,7240,0.7852494577006508,3920400,85008400,81088000
399000.0,3,1.0,860,9403,1.0,0,0,3,6,860,0,1942,0.0,98033,47.6815,-122.17299999999999,2136,13009,8543,0.9085398277145592,739600,88416409,87676809
400000.0,3,1.0,1430,10005,1.5,0,0,3,7,1430,0,1950,0.0,98133,47.7181,-122.338,1720,8822,8575,0.8570714642678661,2044900,100100025,98055125
230000.0,3,1.75,1260,10164,1.0,0,0,3,6,1260,0,1964,0.0,98059,47.4752,-122.133,1190,10640,8904,0.8760330578512396,1587600,103306896,101719296
290000.0,3,1.0,960,4560,1.0,0,0,3,7,960,0,1968,0.0,98106,47.5539,-122.365,970,4800,3600,0.7894736842105263,921600,20793600,19872000
323800.0,3,2.5,2060,7658,2.0,0,0,2,8,2060,0,2003,0.0,98023,47.2923,-122.36,2250,7299,5598,0.731000261164795,4243600,58644964,54401364
574500.0,4,1.5,1430,6380,1.5,0,0,3,9,1430,0,1930,0.0,98125,47.7014,-122.31299999999999,1220,5112,4950,0.7758620689655172,2044900,40704400,38659500
505000.0,3,2.25,1670,1596,2.0,0,0,2,8,1220,450,2002,0.0,98199,47.6474,-122.396,1670,1596,-74,-0.046365914786967416,2788900,2547216,-241684
372500.0,2,1.0,880,10950,1.0,0,0,3,7,880,0,1944,0.0,98133,47.7332,-122.352,1450,7560,10070,0.919634703196347,774400,119902500,119128100
425000.0,3,1.5,1300,19163,1.0,0,0,2,7,1300,0,1964,0.0,98052,47.6686,-122.15299999999999,1590,9744,17863,0.9321609351354172,1690000,367220569,365530569
446250.0,3,2.5,2380,214315,1.5,0,0,2,9,2380,0,2000,0.0,98045,47.4525,-121.74799999999999,2400,68824,211935,0.9888948510370249,5664400,45930919225,45925254825
330000.0,2,0.75,520,6862,1.0,0,0,3,4,520,0,1924,1980.0,98010,47.326,-122.037,1170,8756,6342,0.9242203439230545,270400,47087044,46816644
608095.0,3,2.5,2680,17707,2.0,0,1,2,9,2680,0,1983,0.0,98034,47.7031,-122.22399999999999,2840,21743,15027,0.8486474275710171,7182400,313537849,306355449
550000.0,3,2.5,2140,10136,1.0,0,0,2,8,1320,820,1958,0.0,98006,47.5602,-122.184,1980,11200,7996,0.7888713496448303,4579600,102738496,98158896
265000.0,4,2.5,1820,16103,2.0,0,0,2,7,1820,0,2004,0.0,98030,47.3553,-122.196,2120,21277,14283,0.8869775818170528,3312400,259306609,255994209
399888.0,4,2.25,1820,8255,1.5,0,0,3,7,1320,500,1930,0.0,98133,47.723,-122.337,1550,7628,6435,0.7795275590551181,3312400,68145025,64832625
430000.0,2,1.0,1050,2570,1.0,0,0,4,7,850,200,1927,0.0,98117,47.6764,-122.366,1080,2800,1520,0.5914396887159533,1102500,6604900,5502400
554990.0,3,2.5,2100,6092,2.0,0,0,2,8,2100,0,2013,0.0,98028,47.7508,-122.23899999999999,2250,8592,3992,0.6552856204858831,4410000,37112464,32702464
359950.0,3,2.5,2210,6280,2.0,0,0,2,8,2210,0,2003,0.0,98038,47.35,-122.04299999999999,2250,5972,4070,0.6480891719745223,4884100,39438400,34554300
405000.0,2,1.0,860,2599,1.0,0,0,3,6,860,0,1901,0.0,98107,47.675,-122.37899999999999,1300,3900,1739,0.6691035013466718,739600,6754801,6015201
280000.0,2,1.0,870,4025,1.0,0,0,2,7,870,0,1981,0.0,98034,47.7243,-122.161,1370,3488,3155,0.7838509316770186,756900,16200625,15443725
479950.0,4,2.25,2570,11070,2.0,0,0,3,8,2570,0,1966,0.0,98058,47.4507,-122.152,2210,9600,8500,0.7678410117434508,6604900,122544900,115940000
575000.0,5,1.75,2980,53578,1.0,0,0,3,9,2230,750,1976,0.0,98027,47.4908,-122.059,2860,75546,50598,0.9443801560341931,8880400,2870602084,2861721684
392000.0,4,2.25,2360,7733,2.0,0,0,2,8,2360,0,1983,0.0,98058,47.4403,-122.137,2160,7733,5373,0.6948144316565369,5569600,59799289,54229689
760500.0,4,2.25,2310,36136,2.0,0,0,3,9,2310,0,1977,0.0,98072,47.7506,-122.12200000000001,3930,36136,33826,0.9360748284259465,5336100,1305810496,1300474396
435000.0,3,2.5,2300,9521,2.0,0,0,2,8,2300,0,2003,0.0,98019,47.7447,-121.976,3020,10042,7221,0.7584287364772608,5290000,90649441,85359441
1570000.0,4,2.75,2810,8570,2.0,0,0,2,10,2810,0,1993,0.0,98004,47.6159,-122.211,2810,9621,5760,0.6721120186697783,7896100,73444900,65548800
261000.0,4,1.5,2040,10488,1.0,0,0,2,7,1190,850,1961,0.0,98188,47.4557,-122.26899999999999,1960,10488,8448,0.8054919908466819,4161600,109998144,105836544
1480000.0,3,2.25,3290,5000,2.0,0,0,2,9,2730,560,1939,0.0,98105,47.6582,-122.28,2340,4000,1710,0.342,10824100,25000000,14175900
853800.0,7,4.0,2960,2665,2.0,0,0,2,9,1950,1010,1927,2013.0,98144,47.5835,-122.31299999999999,1970,4410,-295,-0.11069418386491557,8761600,7102225,-1659375
657500.0,3,2.5,2670,10496,2.0,0,0,2,9,2670,0,1989,0.0,98074,47.6272,-122.02600000000001,2490,8636,7826,0.7456173780487805,7128900,110166016,103037116
331950.0,4,2.5,2530,9933,2.0,0,2,2,8,2010,520,1990,0.0,98092,47.2654,-122.21600000000001,2140,9933,7403,0.7452934662236987,6400900,98664489,92263589
514000.0,3,1.75,1720,5899,1.0,0,1,2,8,1220,500,1986,0.0,98136,47.5399,-122.385,1900,6244,4179,0.7084251568062383,2958400,34798201,31839801
496000.0,3,3.5,3090,27598,2.0,0,2,3,9,2020,1070,1995,0.0,98070,47.3541,-122.45299999999999,2180,17085,24508,0.8880353648815131,9548100,761649604,752101504
1090000.0,4,2.5,3930,21894,2.0,0,0,2,11,3930,0,1987,0.0,98052,47.7209,-122.12799999999999,3930,20000,17964,0.8204987667854207,15444900,479347236,463902336
195700.0,3,1.0,1120,5200,1.0,0,0,4,7,1120,0,1976,0.0,98042,47.3638,-122.088,1690,5200,4080,0.7846153846153846,1254400,27040000,25785600
1400000.0,4,2.25,3960,8640,2.0,0,2,2,9,2630,1330,1925,0.0,98112,47.6317,-122.304,3850,8640,4680,0.5416666666666666,15681600,74649600,58968000
1180000.0,4,3.25,4060,20822,2.0,0,0,2,10,4060,0,1991,0.0,98077,47.7213,-122.055,4170,23958,16762,0.8050139275766016,16483600,433555684,417072084
643403.0,3,2.5,2350,9648,1.0,0,0,3,9,2350,0,1966,0.0,98008,47.6156,-122.10799999999999,2320,10512,7298,0.7564262023217247,5522500,93083904,87561404
357000.0,4,2.5,2380,7066,2.0,0,0,3,7,2380,0,1997,0.0,98031,47.3982,-122.17200000000001,2310,8127,4686,0.6631757712991792,5664400,49928356,44263956
865000.0,3,1.75,1480,8163,1.0,0,0,2,7,1040,440,1953,0.0,98004,47.63800000000001,-122.206,2170,11124,6683,0.8186941075584957,2190400,66634569,64444169
905000.0,3,2.5,2930,9280,2.0,0,0,3,10,2930,0,1988,0.0,98007,47.6335,-122.15100000000001,2730,10090,6350,0.6842672413793104,8584900,86118400,77533500
265000.0,3,1.5,1290,7100,1.0,0,0,2,6,1290,0,1954,0.0,98198,47.4227,-122.33200000000001,1300,7183,5810,0.8183098591549296,1664100,50410000,48745900
535000.0,2,2.5,2730,7246,2.0,0,0,2,9,2730,0,1998,0.0,98056,47.512,-122.175,3220,7214,4516,0.6232404085012421,7452900,52504516,45051616
450000.0,3,1.0,1290,5440,1.0,0,0,3,6,790,500,1929,0.0,98117,47.6951,-122.367,1220,5464,4150,0.7628676470588235,1664100,29593600,27929500
460500.0,4,2.5,2170,7533,2.0,0,0,2,8,2170,0,1991,0.0,98059,47.5057,-122.149,2170,8728,5363,0.7119341563786008,4708900,56746089,52037189
315000.0,4,1.75,1850,8580,1.0,0,0,2,7,1140,710,1960,0.0,98178,47.4877,-122.24,2210,9240,6730,0.7843822843822844,3422500,73616400,70193900
607500.0,4,2.5,2110,13939,1.0,0,0,2,8,1270,840,1978,0.0,98008,47.6431,-122.113,2140,8882,11829,0.8486261568261712,4452100,194295721,189843621
432000.0,2,1.0,960,3235,1.0,0,0,3,7,960,0,1916,0.0,98103,47.661,-122.344,1290,2069,2275,0.7032457496136012,921600,10465225,9543625
1700000.0,3,4.0,3910,5350,2.0,0,2,4,10,2610,1300,1933,0.0,98199,47.6393,-122.40799999999999,2890,5350,1440,0.2691588785046729,15288100,28622500,13334400
479000.0,4,2.5,2590,6139,2.0,0,0,2,8,2590,0,2001,0.0,98038,47.3883,-122.035,2410,6139,3549,0.5781071835803877,6708100,37687321,30979221
475000.0,5,2.75,3080,6600,2.0,0,0,2,9,3080,0,2002,0.0,98058,47.4501,-122.12200000000001,3080,6600,3520,0.5333333333333333,9486400,43560000,34073600
415000.0,3,1.0,1630,8146,1.0,0,0,2,7,1630,0,1952,0.0,98125,47.7293,-122.29,1480,8146,6516,0.7999017922906948,2656900,66357316,63700416
450000.0,2,1.0,910,5000,1.0,0,0,3,6,910,0,1914,0.0,98117,47.683,-122.374,1480,5000,4090,0.818,828100,25000000,24171900
1140000.0,3,2.5,2780,33503,1.5,0,1,3,8,2110,670,1969,0.0,98075,47.5844,-122.081,3150,15542,30723,0.9170223562069069,7728400,1122451009,1114722609
430000.0,5,3.0,3880,8432,2.0,0,0,2,7,3880,0,2004,0.0,98056,47.4806,-122.176,2620,5623,4552,0.5398481973434535,15054400,71098624,56044224
296000.0,3,1.75,1360,10742,1.0,0,0,4,7,960,400,1971,0.0,98058,47.4351,-122.17299999999999,1830,9000,9382,0.8733941537888661,1849600,115390564,113540964
303000.0,4,2.25,2560,8927,1.0,0,0,2,7,1790,770,1976,0.0,98001,47.34,-122.271,1920,9669,6367,0.7132295283969978,6553600,79691329,73137729
641000.0,4,2.5,2600,6015,2.0,0,0,2,8,2600,0,2004,0.0,98075,47.5971,-122.031,2910,5305,3415,0.5677472984206151,6760000,36180225,29420225
280000.0,3,2.25,1220,5739,1.0,0,0,2,7,790,430,1984,0.0,98115,47.6952,-122.32600000000001,1870,5739,4519,0.7874194110472208,1488400,32936121,31447721
260750.0,3,2.0,1560,9635,1.0,0,0,2,7,1260,300,1966,0.0,98003,47.341,-122.309,1570,8276,8075,0.838090295796575,2433600,92833225,90399625
601000.0,4,2.5,2080,5191,2.0,0,0,2,8,2080,0,2001,0.0,98075,47.5978,-122.01700000000001,2170,5518,3111,0.599306492005394,4326400,26946481,22620081
255000.0,3,1.5,1490,6604,1.0,0,0,3,6,1490,0,1918,0.0,98166,47.4683,-122.351,1330,6604,5114,0.7743791641429437,2220100,43612816,41392716
555000.0,4,2.75,2020,10720,1.0,0,0,3,8,1420,600,1976,0.0,98052,47.6373,-122.104,2190,10164,8700,0.8115671641791045,4080400,114918400,110838000
865000.0,3,1.5,1530,10827,1.0,0,0,3,8,1530,0,1955,0.0,98039,47.6354,-122.234,2050,10827,9297,0.8586866167913549,2340900,117223929,114883029
1390000.0,4,2.5,3450,17400,1.5,0,0,3,9,2180,1270,1964,0.0,98004,47.5969,-122.206,3770,19530,13950,0.8017241379310345,11902500,302760000,290857500
315000.0,3,2.25,1400,31626,1.0,0,0,1,7,1140,260,1987,0.0,98092,47.3029,-122.069,1680,35093,30226,0.9557326250553342,1960000,1000203876,998243876
200000.0,2,1.0,1730,9610,1.0,0,0,2,7,1380,350,1962,0.0,98001,47.2956,-122.285,1310,9812,7880,0.8199791883454735,2992900,92352100,89359200
357000.0,3,1.0,1370,6450,1.0,0,0,2,7,1370,0,1948,0.0,98125,47.7195,-122.288,1550,6898,5080,0.7875968992248062,1876900,41602500,39725600
390000.0,2,1.5,1050,934,2.0,0,0,2,8,960,90,2007,0.0,98122,47.6029,-122.309,1470,1885,-116,-0.12419700214132762,1102500,872356,-230144
462000.0,5,1.75,2840,10220,1.0,0,0,3,7,2210,630,1954,0.0,98177,47.763999999999996,-122.36,2000,9750,7380,0.7221135029354208,8065600,104448400,96382800
174500.0,2,1.0,1010,5200,1.0,0,0,2,7,1010,0,1955,0.0,98198,47.4166,-122.323,1580,7500,4190,0.8057692307692308,1020100,27040000,26019900
305000.0,2,1.0,1210,7140,1.5,0,0,2,6,1210,0,1921,0.0,98133,47.7225,-122.34899999999999,1150,7376,5930,0.8305322128851541,1464100,50979600,49515500
449000.0,5,1.75,1720,14040,1.0,0,0,3,8,1150,570,1956,0.0,98133,47.7365,-122.339,1750,7800,12320,0.8774928774928775,2958400,197121600,194163200
260000.0,3,2.0,2710,5000,2.0,0,0,2,6,2710,0,1951,0.0,98126,47.5188,-122.37299999999999,850,5000,2290,0.458,7344100,25000000,17655900
751000.0,4,2.5,3110,6142,2.0,0,0,2,9,3110,0,2004,0.0,98052,47.701,-122.111,3200,6826,3032,0.49365027678280693,9672100,37724164,28052064
370037.0,2,1.0,1250,9270,1.0,0,0,3,7,1250,0,1948,0.0,98133,47.7284,-122.339,1130,6800,8020,0.8651564185544768,1562500,85932900,84370400
229950.0,3,1.75,1900,8910,2.0,0,0,3,7,1900,0,1988,0.0,98092,47.2769,-122.145,1610,8586,7010,0.7867564534231201,3610000,79388100,75778100
349000.0,3,1.75,1740,7682,1.0,0,0,2,8,1330,410,1978,0.0,98058,47.4451,-122.126,2010,8820,5942,0.773496485290289,3027600,59013124,55985524
348000.0,4,2.5,2070,3808,2.0,0,0,2,8,2070,0,2003,0.0,98058,47.4498,-122.12,1900,2992,1738,0.4564075630252101,4284900,14500864,10215964
1220000.0,3,3.25,3030,5600,2.0,0,2,2,9,2220,810,1905,2005.0,98144,47.5978,-122.292,2040,6600,2570,0.4589285714285714,9180900,31360000,22179100
510000.0,4,3.0,3610,18948,2.0,0,0,2,10,3610,0,1993,0.0,98023,47.2911,-122.34200000000001,3568,18948,15338,0.8094785729364576,13032100,359026704,345994604
265000.0,3,1.5,1520,6805,1.0,0,0,3,7,1040,480,1981,0.0,98023,47.2907,-122.367,1440,7041,5285,0.7766348273328435,2310400,46308025,43997625
1250000.0,3,2.75,2780,4815,3.0,0,2,2,10,2780,0,1974,0.0,98105,47.6569,-122.286,2820,5000,2035,0.4226375908618899,7728400,23184225,15455825
937500.0,4,4.0,5545,871200,2.0,0,0,2,11,3605,1940,2003,0.0,98014,47.676,-121.882,3420,871200,865655,0.9936352157943067,30747025,758989440000,758958692975
485000.0,3,1.75,2590,8384,1.0,0,0,3,8,1590,1000,1971,0.0,98011,47.7739,-122.199,2590,8800,5794,0.6910782442748091,6708100,70291456,63583356
489000.0,4,1.0,1150,5217,1.5,0,0,2,7,1150,0,1951,0.0,98115,47.6806,-122.287,1220,5217,4067,0.7795668008433966,1322500,27217089,25894589
400000.0,2,1.0,920,5120,1.0,0,0,4,7,920,0,1952,0.0,98136,47.5569,-122.39399999999999,1190,5120,4200,0.8203125,846400,26214400,25368000
638000.0,3,2.5,2110,3600,2.0,0,0,2,9,2110,0,2005,0.0,98052,47.665,-122.08200000000001,2540,4384,1490,0.41388888888888886,4452100,12960000,8507900
440000.0,3,1.75,1170,8740,1.0,0,0,3,7,1170,0,1968,0.0,98052,47.6849,-122.117,1870,8448,7570,0.8661327231121282,1368900,76387600,75018700
305000.0,6,2.0,1900,8240,1.0,0,0,1,7,1200,700,1964,0.0,98125,47.7037,-122.296,1900,8240,6340,0.7694174757281553,3610000,67897600,64287600
649950.0,6,2.0,1900,8240,1.0,0,0,1,7,1200,700,1964,0.0,98125,47.7037,-122.296,1900,8240,6340,0.7694174757281553,3610000,67897600,64287600
680000.0,4,2.5,3290,6012,2.0,0,0,2,9,3290,0,2005,0.0,98075,47.5961,-121.98,3210,6005,2722,0.4527611443779108,10824100,36144144,25320044
629000.0,4,2.5,2660,22050,2.0,0,0,2,9,2660,0,1996,0.0,98059,47.4911,-122.125,3060,21111,19390,0.8793650793650793,7075600,486202500,479126900
555000.0,3,2.5,2160,7584,2.0,0,0,2,8,2160,0,1988,0.0,98029,47.5751,-122.014,2160,7372,5424,0.7151898734177216,4665600,57517056,52851456
669000.0,4,2.75,2700,35362,2.0,0,0,4,8,2700,0,1976,0.0,98077,47.7628,-122.094,2810,35915,32662,0.9236468525535886,7290000,1250471044,1243181044
272000.0,3,2.5,1980,6608,2.0,0,0,2,8,1980,0,1994,0.0,98092,47.2642,-122.213,2150,7495,4628,0.700363196125908,3920400,43665664,39745264
270000.0,4,2.25,2600,9900,1.0,0,0,2,7,1600,1000,1965,0.0,98178,47.4881,-122.23700000000001,1770,11250,7300,0.7373737373737373,6760000,98010000,91250000
215000.0,3,1.0,1280,9775,1.0,0,0,2,6,1280,0,1964,0.0,98003,47.3262,-122.334,1230,8750,8495,0.8690537084398977,1638400,95550625,93912225
690000.0,3,1.5,1710,17707,1.0,0,0,3,7,1180,530,1947,0.0,98040,47.5393,-122.21600000000001,2590,9508,15997,0.9034280228158356,2924100,313537849,310613749
256000.0,4,1.75,1270,6825,1.0,0,2,2,7,1270,0,1950,0.0,98178,47.5051,-122.242,1800,6930,5555,0.8139194139194139,1612900,46580625,44967725
255000.0,3,2.25,1890,7314,1.0,0,0,2,7,1100,790,1981,0.0,98031,47.4121,-122.17200000000001,1520,7676,5424,0.7415914684167351,3572100,53494596,49922496
550000.0,7,4.0,3440,8100,2.0,0,0,2,7,3440,0,1970,0.0,98103,47.6981,-122.34899999999999,1420,1560,4660,0.5753086419753086,11833600,65610000,53776400
410000.0,3,1.0,1190,5280,1.0,0,0,3,7,1190,0,1957,0.0,98146,47.5131,-122.383,1280,5280,4090,0.7746212121212122,1416100,27878400,26462300
410000.0,2,1.0,1030,4366,1.0,0,0,2,7,1030,0,1912,0.0,98136,47.5311,-122.384,1890,4499,3336,0.7640861200183234,1060900,19061956,18001056
259000.0,3,1.75,1240,4000,1.0,0,0,2,7,1240,0,1986,0.0,98055,47.4728,-122.191,1570,4586,2760,0.69,1537600,16000000,14462400
292000.0,3,1.0,1730,21183,1.0,0,0,2,7,1030,700,1955,0.0,98168,47.5024,-122.33200000000001,1610,13000,19453,0.9183307369116744,2992900,448719489,445726589
1650000.0,4,3.5,4610,12500,2.0,0,2,2,11,4610,0,2003,0.0,98033,47.6508,-122.20299999999999,2340,11538,7890,0.6312,21252100,156250000,134997900
518000.0,5,1.0,1590,5000,1.5,0,0,2,7,1190,400,1929,0.0,98116,47.5752,-122.381,1590,5000,3410,0.682,2528100,25000000,22471900
485000.0,3,2.5,1760,3097,2.0,0,0,2,8,1760,0,1992,0.0,98029,47.5764,-121.99600000000001,1760,3285,1337,0.43170810461737164,3097600,9591409,6493809
259500.0,3,2.0,1330,35060,1.0,0,0,2,7,1330,0,1989,0.0,98092,47.3128,-122.13,1660,35100,33730,0.962065031374786,1768900,1229203600,1227434700
354000.0,4,2.5,2340,5420,2.0,0,0,2,8,2340,0,2003,0.0,98038,47.3773,-122.029,2420,6252,3080,0.5682656826568265,5475600,29376400,23900800
999950.0,3,2.25,3740,22464,2.0,0,0,4,8,2330,1410,1966,0.0,98004,47.6354,-122.196,2680,19564,18724,0.833511396011396,13987600,504631296,490643696
464500.0,3,1.75,1150,10466,1.0,0,0,4,7,1150,0,1959,0.0,98006,47.5531,-122.177,1350,10384,9316,0.8901203898337474,1322500,109537156,108214656
300000.0,3,2.5,1750,4200,2.0,0,0,2,7,1750,0,2005,0.0,98038,47.3605,-122.04,1890,4048,2450,0.5833333333333334,3062500,17640000,14577500
1080000.0,3,2.75,3890,7216,2.0,0,1,2,8,3260,630,1967,2010.0,98118,47.5445,-122.266,2490,9920,3326,0.46092017738359203,15132100,52070656,36938556
309950.0,4,2.5,1770,6666,2.0,0,0,2,7,1770,0,1989,0.0,98023,47.2877,-122.34899999999999,1780,6666,4896,0.7344734473447345,3132900,44435556,41302656
315000.0,3,1.0,1160,3700,1.5,0,0,2,7,1160,0,1909,0.0,98106,47.5651,-122.359,1340,3750,2540,0.6864864864864865,1345600,13690000,12344400
499950.0,3,1.0,1440,5580,1.5,0,0,2,7,1440,0,1908,0.0,98115,47.6898,-122.32600000000001,2010,5580,4140,0.7419354838709677,2073600,31136400,29062800
780000.0,4,2.0,2600,4800,1.0,0,2,2,8,1400,1200,1953,0.0,98119,47.637,-122.37100000000001,2050,3505,2200,0.4583333333333333,6760000,23040000,16280000
885000.0,3,3.25,2640,16090,1.0,0,2,3,8,1960,680,1976,0.0,98040,47.5374,-122.213,3690,15000,13450,0.8359229334990678,6969600,258888100,251918500
500000.0,2,1.0,1010,3885,1.5,0,0,3,7,1010,0,1906,0.0,98112,47.6224,-122.304,1770,4200,2875,0.7400257400257401,1020100,15093225,14073125
329000.0,3,2.0,1840,6755,1.0,0,2,2,8,1840,0,1989,0.0,98003,47.3512,-122.305,1790,6459,4915,0.7276091783863805,3385600,45630025,42244425
246000.0,4,1.75,1720,7455,1.0,0,0,3,7,1020,700,1963,0.0,98058,47.4669,-122.182,1720,7700,5735,0.7692823608316566,2958400,55577025,52618625
405000.0,3,1.5,1280,9600,1.0,0,0,3,7,1280,0,1960,0.0,98033,47.6922,-122.163,1510,10005,8320,0.8666666666666667,1638400,92160000,90521600
349000.0,4,1.75,1700,7800,1.0,0,0,4,7,1120,580,1981,0.0,98059,47.4801,-122.15799999999999,1560,7800,6100,0.782051282051282,2890000,60840000,57950000
374950.0,4,2.5,1980,12062,2.0,0,0,2,8,1980,0,1992,0.0,98031,47.4038,-122.167,2300,7902,10082,0.835848118056707,3920400,145491844,141571444
306000.0,3,2.0,1160,7217,1.0,0,0,2,7,1160,0,1969,0.0,98034,47.7279,-122.227,1870,9104,6057,0.839268394069558,1345600,52085089,50739489
416000.0,4,1.75,1980,7840,1.0,0,0,3,7,990,990,1961,0.0,98008,47.6226,-122.115,1520,8400,5860,0.7474489795918368,3920400,61465600,57545200
560000.0,3,2.5,1960,12476,2.0,0,0,3,8,1960,0,1989,0.0,98056,47.5315,-122.17200000000001,2450,12177,10516,0.8428983648605323,3841600,155650576,151808976
260000.0,3,1.5,1270,20700,1.0,0,0,1,7,1150,120,1948,0.0,98155,47.7576,-122.296,1990,15000,19430,0.938647342995169,1612900,428490000,426877100
306500.0,3,2.25,2060,38377,1.0,0,0,3,8,1560,500,1978,0.0,98003,47.2752,-122.319,2080,60513,36317,0.946322015790708,4243600,1472794129,1468550529
299950.0,3,1.75,1980,11274,1.0,0,0,3,7,1480,500,1968,0.0,98058,47.4474,-122.167,1520,8010,9294,0.824374667376264,3920400,127103076,123182676
265500.0,3,2.5,1450,8977,1.0,0,0,2,8,1450,0,1990,0.0,98092,47.2576,-122.214,2410,8850,7527,0.8384761056032082,2102500,80586529,78484029
219000.0,3,1.5,1200,12000,1.0,0,0,2,7,1200,0,1986,0.0,98001,47.268,-122.245,1200,9405,10800,0.9,1440000,144000000,142560000
365000.0,3,1.75,1830,17349,1.0,0,0,2,8,1230,600,1977,0.0,98072,47.7427,-122.109,1840,11694,15519,0.8945184160470344,3348900,300987801,297638901
499000.0,3,2.0,2090,42689,1.5,0,0,2,7,2090,0,1959,1998.0,98010,47.3497,-121.944,1890,18276,40599,0.9510412518447375,4368100,1822350721,1817982621
366000.0,3,1.75,1510,8301,1.0,0,0,2,7,1510,0,1967,0.0,98034,47.7243,-122.22200000000001,1460,7910,6791,0.8180942055174075,2280100,68906601,66626501
514950.0,3,2.25,1310,1264,3.0,0,0,2,8,1310,0,2014,0.0,98117,47.6987,-122.366,1330,2183,-46,-0.03639240506329114,1716100,1597696,-118404
875000.0,4,2.75,3790,10669,2.0,0,0,2,10,3790,0,1999,0.0,98075,47.5976,-121.98299999999999,3750,11634,6879,0.6447652076108351,14364100,113827561,99463461
831000.0,3,2.25,2240,8800,1.0,0,0,4,8,2240,0,1957,0.0,98005,47.5937,-122.17200000000001,2240,8800,6560,0.7454545454545455,5017600,77440000,72422400
689900.0,4,3.25,2740,7266,2.0,0,0,2,9,2060,680,2003,0.0,98027,47.5346,-122.066,3030,6546,4526,0.6229011835948252,7507600,52794756,45287156
315000.0,3,2.5,1660,10763,2.0,0,0,2,7,1660,0,1994,0.0,98038,47.3812,-122.029,2010,7983,9103,0.845767908575676,2755600,115842169,113086569
336500.0,3,1.0,1480,7284,1.0,0,0,2,7,970,510,1963,0.0,98133,47.7757,-122.353,2020,7920,5804,0.7968149368478857,2190400,53056656,50866256
1100000.0,3,2.75,2640,4050,1.5,0,0,4,8,1750,890,1926,0.0,98112,47.6332,-122.281,1920,3600,1410,0.34814814814814815,6969600,16402500,9432900
375000.0,6,2.0,1900,8057,1.0,0,0,3,7,1170,730,1959,0.0,98133,47.762,-122.335,2090,8626,6157,0.7641802159612759,3610000,64915249,61305249
289275.0,3,2.0,2860,24046,1.0,0,0,2,9,1700,1160,1985,0.0,98019,47.7718,-121.904,1460,13648,21186,0.8810612991765783,8179600,578210116,570030516
455000.0,4,3.5,3440,6000,2.0,0,0,3,8,3440,0,2002,0.0,98198,47.4077,-122.331,1660,7800,2560,0.4266666666666667,11833600,36000000,24166400
505000.0,3,1.75,1640,10695,1.0,0,2,2,8,1640,0,1975,0.0,98034,47.7145,-122.22200000000001,2790,9775,9055,0.8466573165030388,2689600,114383025,111693425
450000.0,3,1.0,1450,3350,1.5,0,0,3,7,1450,0,1919,0.0,98126,47.5607,-122.37799999999999,1340,4255,1900,0.5671641791044776,2102500,11222500,9120000
567500.0,3,2.5,2300,7398,2.0,0,0,2,8,2300,0,2001,0.0,98065,47.5369,-121.876,2580,6983,5098,0.6891051635577183,5290000,54730404,49440404
265000.0,3,1.5,1460,8505,1.0,0,0,3,7,1460,0,1955,0.0,98055,47.4402,-122.195,1580,8505,7045,0.8283362727807172,2131600,72335025,70203425
340000.0,3,2.0,1570,14992,1.0,0,0,2,8,1570,0,2001,0.0,98014,47.6965,-121.92200000000001,1640,15000,13422,0.8952774813233725,2464900,224760064,222295164
375000.0,3,2.0,1540,8885,1.5,0,0,4,6,1540,0,1939,0.0,98019,47.7403,-121.984,1730,5000,7345,0.8266741699493528,2371600,78943225,76571625
920000.0,6,3.0,3300,4218,2.0,0,0,2,8,2200,1100,1970,0.0,98103,47.6557,-122.344,1420,4218,918,0.21763869132290184,10890000,17791524,6901524
850000.0,4,2.25,2130,11843,2.0,0,0,3,9,2130,0,1972,0.0,98040,47.5358,-122.225,2380,11643,9713,0.8201469222325424,4536900,140256649,135719749
202000.0,3,1.0,1010,9750,1.0,0,0,4,7,1010,0,1969,0.0,98042,47.3244,-122.14399999999999,1230,9750,8740,0.8964102564102564,1020100,95062500,94042400
725000.0,4,3.0,2420,12000,1.0,0,0,2,9,2420,0,1984,0.0,98077,47.7267,-122.06299999999999,3100,13020,9580,0.7983333333333333,5856400,144000000,138143600
900000.0,3,3.25,3870,33980,2.0,0,0,2,10,3150,720,1991,0.0,98006,47.5589,-122.117,3590,10750,30110,0.8861094761624485,14976900,1154640400,1139663500
680200.0,2,1.5,1960,6000,1.0,0,0,2,8,1210,750,1951,0.0,98103,47.6849,-122.333,2060,6000,4040,0.6733333333333333,3841600,36000000,32158400
216500.0,3,1.0,1170,9000,1.0,0,0,3,6,1170,0,1918,0.0,98022,47.2109,-121.98700000000001,1280,8160,7830,0.87,1368900,81000000,79631100
325000.0,3,1.5,1890,7650,1.0,0,0,4,7,1890,0,1966,0.0,98003,47.3454,-122.314,1510,7560,5760,0.7529411764705882,3572100,58522500,54950400
675000.0,3,2.5,2250,4134,2.0,0,0,2,9,2250,0,2004,0.0,98052,47.6651,-122.084,2390,4134,1884,0.45573294629898403,5062500,17089956,12027456
435000.0,2,0.75,750,16321,1.0,0,1,2,4,750,0,1936,0.0,98034,47.6985,-122.229,3020,10625,15571,0.9540469333986888,562500,266375041,265812541
263500.0,3,1.75,1610,14000,1.0,0,0,3,7,1050,560,1977,0.0,98010,47.3429,-122.036,1550,10080,12390,0.885,2592100,196000000,193407900
550000.0,4,2.25,2590,36256,2.0,0,0,2,8,2590,0,1978,0.0,98077,47.769,-122.094,2670,35657,33666,0.9285635481023831,6708100,1314497536,1307789436
875000.0,3,2.5,2520,3750,2.0,0,1,3,9,2520,0,1995,0.0,98116,47.5671,-122.404,2250,6200,1230,0.328,6350400,14062500,7712100
246600.0,4,1.0,1340,8400,1.0,0,0,4,7,1340,0,1966,0.0,98023,47.3313,-122.34299999999999,1120,8400,7060,0.8404761904761905,1795600,70560000,68764400
337000.0,3,2.25,1460,941,3.0,0,0,2,8,1460,0,2006,0.0,98133,47.7145,-122.35600000000001,1490,1399,-519,-0.5515409139213603,2131600,885481,-1246119
240000.0,3,1.75,1380,7500,1.0,0,0,2,7,1380,0,1988,0.0,98038,47.3628,-122.045,1530,7500,6120,0.816,1904400,56250000,54345600
490000.0,3,1.75,1510,11120,1.0,0,0,3,8,1510,0,1984,0.0,98005,47.5931,-122.15799999999999,2660,10800,9610,0.8642086330935251,2280100,123654400,121374300
510000.0,5,2.5,2510,83231,1.0,0,0,3,7,1260,1250,1975,0.0,98027,47.4576,-121.984,2460,46431,80721,0.969842967163677,6300100,6927399361,6921099261
305000.0,3,1.0,910,8008,1.0,0,0,2,7,910,0,1971,0.0,98034,47.726000000000006,-122.22,1480,7404,7098,0.8863636363636364,828100,64128064,63299964
350000.0,3,2.5,1970,3655,2.0,0,0,2,7,1970,0,2003,0.0,98019,47.7453,-121.984,1970,2952,1685,0.46101231190150477,3880900,13359025,9478125
284200.0,3,1.75,1540,6632,1.0,0,0,2,7,1070,470,1959,0.0,98178,47.4973,-122.25200000000001,2510,6618,5092,0.7677925211097708,2371600,43983424,41611824
357000.0,4,2.5,1980,9757,2.0,0,0,4,7,1980,0,1995,0.0,98038,47.3675,-122.01899999999999,1610,6147,7777,0.7970687711386697,3920400,95199049,91278649
854000.0,4,2.75,3150,38865,1.0,0,0,2,10,2480,670,1986,0.0,98052,47.7302,-122.10600000000001,3150,35880,35715,0.9189502122732536,9922500,1510488225,1500565725
1180000.0,4,2.5,4700,49658,2.0,0,0,2,10,4700,0,1999,0.0,98075,47.5878,-122.022,2870,49658,44958,0.9053526118651577,22090000,2465916964,2443826964
1000000.0,3,2.25,2300,15952,1.0,0,0,3,8,1150,1150,1963,0.0,98039,47.6322,-122.23200000000001,2200,14284,13652,0.8558174523570712,5290000,254466304,249176304
616500.0,4,2.25,1880,3000,2.0,0,0,2,8,1760,120,1909,1977.0,98103,47.6864,-122.34899999999999,1880,3000,1120,0.37333333333333335,3534400,9000000,5465600
750000.0,4,2.75,2640,3750,2.0,0,0,4,7,1840,800,1911,0.0,98117,47.6783,-122.363,1690,5000,1110,0.296,6969600,14062500,7092900
650000.0,6,4.5,3900,9100,2.0,0,0,2,8,2870,1030,1979,0.0,98052,47.6612,-122.137,2080,9216,5200,0.5714285714285714,15210000,82810000,67600000
275000.0,4,2.25,2670,10050,1.0,0,0,3,8,1420,1250,1962,0.0,98032,47.3792,-122.28,2190,10050,7380,0.7343283582089553,7128900,101002500,93873600
540000.0,4,1.75,1840,4280,1.0,0,0,3,7,920,920,1918,0.0,98105,47.6681,-122.32,1660,4280,2440,0.5700934579439252,3385600,18318400,14932800
225000.0,3,1.0,1120,10665,1.0,0,0,3,6,1120,0,1961,0.0,98001,47.2886,-122.274,1240,10639,9545,0.8949835911861228,1254400,113742225,112487825
845000.0,4,2.5,2970,9072,2.0,0,0,2,10,2970,0,1991,0.0,98006,47.562,-122.11399999999999,2740,8729,6102,0.6726190476190477,8820900,82301184,73480284
490000.0,3,2.25,1410,7740,1.0,0,0,4,6,1410,0,1923,0.0,98126,47.523,-122.37100000000001,1220,7740,6330,0.8178294573643411,1988100,59907600,57919500
753000.0,4,2.5,3060,8167,2.0,0,0,2,9,3060,0,2005,0.0,98029,47.5521,-121.98899999999999,2930,4800,5107,0.6253214154524305,9363600,66699889,57336289
475000.0,3,1.75,2490,7210,1.0,0,0,2,7,1290,0,1972,0.0,98034,47.726000000000006,-122.198,1610,7210,4720,0.6546463245492372,6200100,51984100,45784000
124000.0,1,0.75,840,7203,1.5,0,0,2,6,840,0,1949,0.0,98168,47.4756,-122.301,1560,8603,6363,0.8833819241982507,705600,51883209,51177609
224000.0,1,0.75,840,7203,1.5,0,0,2,6,840,0,1949,0.0,98168,47.4756,-122.301,1560,8603,6363,0.8833819241982507,705600,51883209,51177609
485000.0,2,1.0,1130,3800,1.0,0,0,3,7,1130,0,1916,0.0,98117,47.6862,-122.37799999999999,1470,3800,2670,0.7026315789473684,1276900,14440000,13163100
230000.0,4,1.75,1850,6000,1.0,0,0,3,6,1270,580,1944,0.0,98178,47.4923,-122.24700000000001,1270,6600,4150,0.6916666666666667,3422500,36000000,32577500
372000.0,4,2.75,2330,14175,1.0,0,0,2,7,1800,530,1980,0.0,98031,47.4193,-122.194,1480,10125,11845,0.835626102292769,5428900,200930625,195501725
306000.0,4,2.5,1880,9426,2.0,0,0,3,7,1880,0,1990,0.0,98042,47.3584,-122.089,1760,7040,7546,0.8005516656057713,3534400,88849476,85315076
905000.0,4,3.5,2980,3000,2.0,0,0,2,9,2340,640,2008,0.0,98115,47.6768,-122.32600000000001,1810,4545,20,0.006666666666666667,8880400,9000000,119600
440000.0,4,1.0,1440,6678,1.0,0,0,2,7,1040,400,1950,0.0,98116,47.57100000000001,-122.39200000000001,1320,6678,5238,0.784366576819407,2073600,44595684,42522084
280000.0,3,1.75,1630,10001,1.0,0,0,3,7,1100,530,1977,0.0,98042,47.3605,-122.12,1630,10001,8371,0.837016298370163,2656900,100020001,97363101
435000.0,3,2.5,1778,147823,2.0,0,0,2,7,1778,0,1999,0.0,98014,47.6811,-121.915,2840,43676,146045,0.9879721017703605,3161284,21851639329,21848478045
425000.0,3,2.5,1930,4500,2.0,0,0,2,8,1930,0,1990,0.0,98029,47.5791,-122.001,1770,4500,2570,0.5711111111111111,3724900,20250000,16525100
204950.0,2,0.75,1130,11429,1.0,0,0,2,7,1130,0,1956,0.0,98188,47.4526,-122.28399999999999,1550,10700,10299,0.9011287076734622,1276900,130622041,129345141
670000.0,2,1.75,1650,7500,1.0,0,0,3,7,1000,650,1959,0.0,98033,47.6871,-122.20700000000001,2530,9000,5850,0.78,2722500,56250000,53527500
475000.0,2,1.0,820,2723,1.0,0,0,2,7,820,0,1921,0.0,98103,47.6623,-122.339,1370,3850,1903,0.6988615497612927,672400,7414729,6742329
352000.0,5,2.5,2900,6650,1.0,0,0,2,7,1450,1450,1964,0.0,98168,47.4935,-122.33200000000001,1600,8246,3750,0.5639097744360902,8410000,44222500,35812500
575000.0,4,1.75,2330,8800,1.0,0,2,3,7,1260,1070,1961,0.0,98008,47.6148,-122.113,2270,8800,6470,0.7352272727272727,5428900,77440000,72011100
1730000.0,4,3.5,4440,20668,2.0,0,2,4,10,3240,1200,1965,0.0,98040,47.5472,-122.235,4240,18650,16228,0.7851751499903232,19713600,427166224,407452624
491000.0,3,2.0,1660,5070,2.0,0,3,2,8,1660,0,1950,0.0,98108,47.5552,-122.296,2440,6664,3410,0.6725838264299803,2755600,25704900,22949300
750000.0,4,2.5,3020,7465,2.0,0,0,2,9,3020,0,2004,0.0,98075,47.5982,-121.98,3100,5587,4445,0.595445411922304,9120400,55726225,46605825
830000.0,4,2.5,1850,50662,1.0,0,0,2,8,1430,420,1978,0.0,98052,47.6535,-122.119,2090,10599,48812,0.963483478741463,3422500,2566638244,2563215744
1140000.0,6,3.75,5960,20197,2.0,0,4,2,10,3900,2060,2005,0.0,98065,47.5398,-121.869,3860,12800,14237,0.7049066693073228,35521600,407918809,372397209
137124.0,3,1.0,960,27442,1.0,0,0,3,6,960,0,1970,0.0,98058,47.4676,-122.134,1100,29019,26482,0.9650171270315575,921600,753063364,752141764
225000.0,4,1.0,1150,6000,1.5,0,0,2,6,1150,0,1907,0.0,98118,47.562,-122.28299999999999,840,3030,4850,0.8083333333333333,1322500,36000000,34677500
732600.0,4,2.5,2130,7300,1.0,0,0,3,7,1230,900,1963,0.0,98005,47.605,-122.167,2130,7560,5170,0.7082191780821918,4536900,53290000,48753100
818000.0,4,2.25,2460,8001,2.0,0,0,3,8,2460,0,1984,0.0,98006,47.548,-122.154,2460,9126,5541,0.692538432695913,6051600,64016001,57964401
431000.0,3,2.25,2360,14950,1.0,0,0,3,9,2360,0,1978,0.0,98042,47.3856,-122.15799999999999,2720,14388,12590,0.8421404682274247,5569600,223502500,217932900
304000.0,2,2.25,1320,1034,3.0,0,0,2,7,1320,0,1996,0.0,98133,47.7039,-122.344,1330,1206,-286,-0.2765957446808511,1742400,1069156,-673244
650000.0,5,2.0,1910,4667,1.0,0,0,2,7,1010,900,1908,0.0,98112,47.6236,-122.306,1230,2545,2757,0.59074351832012,3648100,21780889,18132789
450000.0,2,2.0,1610,6160,2.0,0,0,3,8,1610,0,1977,0.0,98052,47.6644,-122.13,1750,6305,4550,0.7386363636363636,2592100,37945600,35353500
269000.0,4,1.0,1610,8401,1.0,0,0,2,7,1610,0,1958,0.0,98056,47.5104,-122.165,1610,8401,6791,0.8083561480776098,2592100,70576801,67984701
875000.0,3,1.0,1160,10732,1.0,0,0,2,7,1160,0,1953,0.0,98004,47.6391,-122.205,2390,13656,9572,0.8919120387625792,1345600,115175824,113830224
890000.0,4,2.25,2870,8393,1.0,0,0,3,8,1480,1390,1977,0.0,98040,47.5787,-122.245,2930,9850,5523,0.6580483736447039,8236900,70442449,62205549
565000.0,4,2.5,2280,9725,2.0,0,0,2,8,2280,0,1986,0.0,98072,47.7568,-122.141,2140,8780,7445,0.7655526992287918,5198400,94575625,89377225
448175.0,2,2.0,1370,1339,2.0,0,0,3,8,1150,220,2006,0.0,98122,47.6021,-122.295,1370,1339,-31,-0.02315160567587752,1876900,1792921,-83979
680000.0,5,3.0,2970,6500,2.0,0,0,2,9,2970,0,2000,0.0,98075,47.5973,-122.01799999999999,2970,6588,3530,0.5430769230769231,8820900,42250000,33429100
629000.0,3,1.75,1460,12367,2.0,1,4,3,8,1120,340,1970,0.0,98023,47.3311,-122.375,1970,18893,10907,0.8819438829142071,2131600,152942689,150811089
494000.0,3,3.5,1570,1486,2.5,0,0,2,8,1330,240,2000,0.0,98199,47.652,-122.384,1610,1486,-84,-0.05652759084791386,2464900,2208196,-256704
1100000.0,4,3.0,2880,5500,2.0,0,0,3,9,1920,960,1926,0.0,98102,47.6448,-122.31700000000001,2110,5500,2620,0.4763636363636364,8294400,30250000,21955600
450000.0,5,2.5,1900,9460,1.0,0,0,2,7,1190,710,1969,0.0,98034,47.7096,-122.20200000000001,1940,8360,7560,0.7991543340380549,3610000,89491600,85881600
330000.0,3,1.75,2020,11050,1.0,0,0,3,8,1320,700,1969,0.0,98059,47.4706,-122.119,1940,11050,9030,0.8171945701357466,4080400,122102500,118022100
960000.0,4,2.5,3110,11397,2.0,0,3,3,10,3110,0,1984,0.0,98006,47.5623,-122.10600000000001,3110,11586,8287,0.7271211722383083,9672100,129891609,120219509
360000.0,4,2.5,2390,7056,2.0,0,0,2,9,2390,0,1990,0.0,98001,47.3385,-122.264,2590,7801,4666,0.661281179138322,5712100,49787136,44075036
378000.0,3,2.5,2150,11672,2.0,0,0,2,8,2150,0,2004,0.0,98038,47.3515,-122.006,2150,5450,9522,0.815798492117889,4622500,136235584,131613084
499950.0,3,1.75,1340,6250,1.0,0,0,3,7,1090,250,1941,0.0,98136,47.5427,-122.38600000000001,1550,1755,4910,0.7856,1795600,39062500,37266900
450000.0,3,2.5,1990,12866,2.0,0,0,3,7,1990,0,1986,0.0,98072,47.7477,-122.17,2310,8803,10876,0.8453287735115809,3960100,165533956,161573856
523500.0,2,2.0,1600,5969,1.0,0,0,3,7,800,800,1950,0.0,98116,47.5691,-122.39399999999999,1520,5969,4369,0.7319484000670129,2560000,35628961,33068961
600000.0,3,2.5,2680,43995,2.0,0,0,2,9,2680,0,1986,0.0,98077,47.7655,-122.086,2520,37277,41315,0.9390839868166837,7182400,1935560025,1928377625
290000.0,3,2.5,2080,4828,2.0,0,0,2,8,2080,0,2002,0.0,98042,47.3737,-122.132,2190,4620,2748,0.5691797845898923,4326400,23309584,18983184
176000.0,3,3.25,1340,5434,2.0,0,0,2,7,1340,0,1986,0.0,98038,47.3779,-122.045,1670,6203,4094,0.7534044902465955,1795600,29528356,27732756
885000.0,3,2.0,2590,3750,1.5,0,0,4,7,1790,800,1904,0.0,98109,47.635,-122.353,2440,4000,1160,0.30933333333333335,6708100,14062500,7354400
483000.0,2,1.75,1240,3000,1.5,0,0,2,7,1240,0,1906,0.0,98105,47.6689,-122.32600000000001,1800,4080,1760,0.5866666666666667,1537600,9000000,7462400
240000.0,3,1.0,1310,7125,1.0,0,0,3,7,1310,0,1978,0.0,98042,47.3739,-122.148,1650,7290,5815,0.8161403508771929,1716100,50765625,49049525
720000.0,4,2.25,2530,5200,1.0,0,1,3,8,1530,1000,1957,0.0,98117,47.6985,-122.382,2240,5200,2670,0.5134615384615384,6400900,27040000,20639100
311000.0,4,2.5,1780,5822,2.0,0,0,2,7,1780,0,2001,0.0,98058,47.4455,-122.169,1990,4092,4042,0.6942631398144967,3168400,33895684,30727284
332500.0,3,2.0,1600,7995,1.0,0,0,2,7,1600,0,1950,1984.0,98118,47.5177,-122.257,2440,6900,6395,0.7998749218261413,2560000,63920025,61360025
164950.0,3,1.75,1570,15330,1.0,0,0,2,7,1080,490,1956,0.0,98166,47.4608,-122.34,1250,13330,13760,0.8975864318330071,2464900,235008900,232544000
371000.0,3,1.75,1570,15330,1.0,0,0,2,7,1080,490,1956,0.0,98166,47.4608,-122.34,1250,13330,13760,0.8975864318330071,2464900,235008900,232544000
264500.0,3,1.75,1650,16200,1.0,0,0,2,7,1650,0,1976,0.0,98031,47.3926,-122.16799999999999,1650,8680,14550,0.8981481481481481,2722500,262440000,259717500
1740000.0,4,2.25,2920,6513,2.0,0,0,3,9,2260,660,1937,0.0,98112,47.63800000000001,-122.29,4510,9248,3593,0.5516658989712881,8526400,42419169,33892769
503000.0,2,1.0,870,4280,1.0,0,2,3,6,870,0,1921,0.0,98105,47.6697,-122.29,1750,4280,3410,0.7967289719626168,756900,18318400,17561500
738000.0,4,2.5,2830,5010,2.0,0,0,2,9,2170,660,2000,0.0,98115,47.6952,-122.32700000000001,1880,5739,2180,0.4351297405189621,8008900,25100100,17091200
393000.0,2,1.0,980,3350,1.0,0,0,3,7,980,0,1925,0.0,98103,47.6858,-122.352,1260,4000,2370,0.7074626865671642,960400,11222500,10262100
280000.0,2,1.0,990,45528,1.0,0,0,3,7,990,0,1992,0.0,98070,47.5013,-122.463,1730,45528,44538,0.978255139694254,980100,2072798784,2071818684
260000.0,4,2.5,2360,9647,1.0,0,2,2,8,1530,830,1964,0.0,98003,47.3367,-122.33200000000001,2580,9680,7287,0.755364361977817,5569600,93064609,87495009
505000.0,2,1.0,1000,4640,1.0,0,2,2,7,1000,0,1915,0.0,98116,47.5659,-122.389,1940,5800,3640,0.7844827586206896,1000000,21529600,20529600
241000.0,3,1.5,1660,8000,1.0,0,0,3,7,1120,540,1976,0.0,98030,47.353,-122.17200000000001,1900,7500,6340,0.7925,2755600,64000000,61244400
530000.0,3,1.75,1520,9605,1.0,0,0,2,7,1520,0,1975,0.0,98052,47.667,-122.14200000000001,2040,9900,8085,0.8417490890161374,2310400,92256025,89945625
713000.0,1,1.0,1180,4000,1.5,0,2,3,8,840,340,1910,0.0,98118,47.5561,-122.266,1420,4000,2820,0.705,1392400,16000000,14607600
487000.0,3,1.75,1770,10125,2.0,0,0,2,7,1770,0,1944,0.0,98133,47.7289,-122.353,1680,9825,8355,0.8251851851851851,3132900,102515625,99382725
128000.0,2,1.0,980,5393,1.0,0,0,2,6,980,0,1969,0.0,98042,47.3674,-122.081,980,5200,4413,0.8182829593918042,960400,29084449,28124049
210500.0,3,1.0,1840,10178,1.0,0,0,2,7,1040,800,1960,0.0,98198,47.3979,-122.31700000000001,2040,10660,8338,0.8192179210060916,3385600,103591684,100206084
420000.0,3,2.5,1810,7210,1.0,0,0,4,7,1210,600,1968,0.0,98059,47.5067,-122.163,1770,7210,5400,0.7489597780859917,3276100,51984100,48708000
679000.0,3,2.5,1780,4320,2.0,0,0,3,8,1780,0,1930,1986.0,98115,47.6809,-122.29299999999999,1690,4952,2540,0.5879629629629629,3168400,18662400,15494000
784950.0,4,2.75,2840,4227,3.0,0,0,2,9,2840,0,2014,0.0,98052,47.7097,-122.10700000000001,2880,4227,1387,0.3281286964750414,8065600,17867529,9801929
352000.0,4,2.5,2650,6366,2.0,0,0,2,9,2650,0,1998,0.0,98092,47.3325,-122.171,2650,6200,3716,0.5837260446120013,7022500,40525956,33503456
386000.0,3,1.5,1270,1318,2.0,0,0,2,7,1080,190,2004,0.0,98199,47.6526,-122.384,1360,1488,48,0.036418816388467376,1612900,1737124,124224
335000.0,3,1.75,1260,17000,1.0,0,0,2,7,1260,0,1994,0.0,98146,47.5114,-122.361,1540,7213,15740,0.9258823529411765,1587600,289000000,287412400
472500.0,3,2.0,1750,15500,1.0,0,0,2,7,1490,260,1982,0.0,98075,47.5887,-122.065,2450,50094,13750,0.8870967741935484,3062500,240250000,237187500
599950.0,5,2.25,2680,13292,1.0,0,0,2,8,1340,1340,1976,0.0,98028,47.7422,-122.257,2220,13181,10612,0.7983749623833885,7182400,176677264,169494864
963990.0,4,3.25,3830,6765,2.0,0,0,2,9,3830,0,2014,0.0,98053,47.685,-122.016,3830,6507,2935,0.43385070214338506,14668900,45765225,31096325
735000.0,3,2.0,1610,3600,2.0,0,2,4,8,1610,0,1925,0.0,98144,47.5969,-122.29299999999999,2540,6600,1990,0.5527777777777778,2592100,12960000,10367900
858450.0,3,4.25,3840,9751,2.0,0,0,2,10,3840,0,1998,0.0,98074,47.6347,-122.064,3230,7189,5911,0.6061942364885653,14745600,95082001,80336401
665000.0,5,2.75,2670,4000,2.0,0,0,3,7,1800,870,1914,0.0,98105,47.6711,-122.315,2460,4000,1330,0.3325,7128900,16000000,8871100
290000.0,3,2.5,2000,7414,2.0,0,0,3,7,2000,0,1993,0.0,98038,47.3508,-122.057,2000,7414,5414,0.7302400863231724,4000000,54967396,50967396
250000.0,2,1.0,860,4320,1.0,0,0,2,7,860,0,1925,0.0,98108,47.5263,-122.325,980,6000,3460,0.8009259259259259,739600,18662400,17922800
192500.0,3,1.75,1420,7205,1.0,0,0,2,7,1420,0,1986,0.0,98030,47.3555,-122.175,1690,7405,5785,0.8029146426092991,2016400,51912025,49895625
350000.0,4,2.0,2060,13400,1.0,0,2,3,8,2060,0,1957,0.0,98166,47.4404,-122.34,1950,10370,11340,0.8462686567164179,4243600,179560000,175316400
518000.0,4,2.5,2790,9910,2.0,0,0,2,8,2790,0,2003,0.0,98059,47.4891,-122.141,2590,9910,7120,0.7184661957618567,7784100,98208100,90424000
563000.0,4,1.0,1410,3376,1.5,0,0,4,7,1410,0,1911,0.0,98107,47.6606,-122.365,1040,3600,1966,0.582345971563981,1988100,11397376,9409276
375000.0,4,3.0,2420,9566,2.0,0,0,2,7,2420,0,2003,0.0,98188,47.4693,-122.266,2420,9135,7146,0.7470206983065022,5856400,91508356,85651956
400000.0,3,2.5,1460,1319,3.0,0,0,2,8,1460,0,2002,0.0,98103,47.698,-122.34899999999999,1430,1530,-141,-0.1068991660348749,2131600,1739761,-391839
240000.0,5,1.75,2460,16000,1.0,0,0,2,7,1230,1230,1957,0.0,98023,47.3305,-122.351,1990,16000,13540,0.84625,6051600,256000000,249948400
317500.0,2,1.0,1000,5120,1.0,0,0,2,6,1000,0,1902,0.0,98122,47.6088,-122.307,1940,4300,4120,0.8046875,1000000,26214400,25214400
1320000.0,5,4.0,4420,36342,2.0,0,0,4,10,2740,1680,1982,0.0,98007,47.6468,-122.15100000000001,3720,37034,31922,0.8783776346926421,19536400,1320740964,1301204564
234000.0,3,1.0,1240,239144,1.0,0,0,2,6,1240,0,1921,1992.0,98038,47.4303,-122.046,1990,109335,237904,0.9948148395945539,1537600,57189852736,57188315136
645000.0,3,2.5,1740,13750,2.0,0,0,3,9,1740,0,1975,0.0,98008,47.6264,-122.09200000000001,2540,14300,12010,0.8734545454545455,3027600,189062500,186034900
649000.0,2,1.0,1280,4840,1.0,0,0,2,7,1200,80,1908,0.0,98115,47.6762,-122.29899999999999,1860,5500,3560,0.7355371900826446,1638400,23425600,21787200
605000.0,4,2.5,2520,3980,2.0,0,0,2,8,2520,0,2004,0.0,98027,47.5399,-122.07,2580,3980,1460,0.36683417085427134,6350400,15840400,9490000
337900.0,3,3.5,1500,1471,3.0,0,0,2,7,1500,0,1999,0.0,98177,47.7034,-122.36200000000001,1500,1445,-29,-0.01971447994561523,2250000,2163841,-86159
535000.0,3,2.75,2490,3600,2.0,0,0,2,8,2290,200,1906,0.0,98122,47.6098,-122.292,1880,3600,1110,0.30833333333333335,6200100,12960000,6759900
325000.0,4,1.0,1530,5684,1.0,0,0,2,7,1130,400,1957,0.0,98108,47.5507,-122.29799999999999,1540,6095,4154,0.7308233638282899,2340900,32307856,29966956
429950.0,4,2.25,1740,10875,1.0,0,0,2,8,1740,0,1967,0.0,98059,47.5132,-122.15700000000001,1680,10701,9135,0.84,3027600,118265625,115238025
775000.0,3,2.5,3550,32807,2.0,0,0,2,9,3550,0,1989,0.0,98077,47.7292,-122.08200000000001,3270,35001,29257,0.8917913859846984,12602500,1076299249,1063696749
650000.0,2,1.0,1280,6000,1.0,0,0,2,7,1280,0,1965,0.0,98112,47.6339,-122.28200000000001,2460,4800,4720,0.7866666666666666,1638400,36000000,34361600
1200000.0,4,2.25,2320,13114,2.0,0,0,4,8,2320,0,1967,0.0,98040,47.5762,-122.23899999999999,2740,15000,10794,0.8230898276650908,5382400,171976996,166594596
275000.0,2,1.0,1140,10404,1.0,0,0,2,5,1140,0,1935,0.0,98155,47.7497,-122.286,2200,11550,9264,0.8904267589388697,1299600,108243216,106943616
575000.0,4,3.5,3930,16970,2.0,0,0,2,9,3930,0,1997,0.0,98019,47.7412,-121.96600000000001,2740,17219,13040,0.7684148497348262,15444900,287980900,272536000
540000.0,3,2.5,2370,16455,1.0,0,0,4,7,1640,730,1959,0.0,98155,47.7634,-122.277,2170,15551,14085,0.8559708295350957,5616900,270767025,265150125
640000.0,3,1.75,2340,4206,1.0,0,0,4,7,1170,1170,1917,0.0,98144,47.5759,-122.288,1360,4725,1866,0.44365192582025675,5475600,17690436,12214836
275000.0,3,1.5,1240,9125,1.0,0,0,3,7,1240,0,1967,0.0,98058,47.4469,-122.155,1670,9125,7885,0.8641095890410959,1537600,83265625,81728025
672800.0,4,2.5,2740,10533,2.0,0,0,2,9,2740,0,1997,0.0,98074,47.6095,-122.006,2760,8603,7793,0.7398651856071394,7507600,110944089,103436489
495000.0,4,2.25,1940,9144,1.0,0,0,3,7,1430,510,1956,0.0,98007,47.5942,-122.135,1460,9437,7204,0.7878390201224846,3763600,83612736,79849136
820000.0,3,2.5,2950,35108,1.5,0,0,2,10,2950,0,1995,0.0,98077,47.7316,-122.035,3810,35181,32158,0.9159735672781133,8702500,1232571664,1223869164
475000.0,4,2.75,1980,11443,1.0,0,0,4,7,1980,0,1952,0.0,98155,47.7707,-122.273,2080,15700,9463,0.8269684523289347,3920400,130942249,127021849
1280000.0,4,2.0,2850,7861,1.0,0,4,3,10,1450,1400,1970,0.0,98117,47.6995,-122.397,2810,8087,5011,0.6374507060170462,8122500,61795321,53672821
380000.0,3,1.0,1160,9375,1.0,0,0,2,7,1160,0,1967,0.0,98077,47.7419,-122.073,1160,9650,8215,0.8762666666666666,1345600,87890625,86545025
397500.0,3,2.0,2130,8225,1.0,0,0,3,8,2130,0,1987,0.0,98058,47.4396,-122.162,2580,8225,6095,0.7410334346504559,4536900,67650625,63113725
352000.0,5,2.5,2420,8560,1.0,0,2,2,7,1620,800,1978,0.0,98118,47.532,-122.285,2210,7040,6140,0.7172897196261683,5856400,73273600,67417200
893880.0,6,2.5,2820,8600,1.0,0,0,4,8,1430,1390,1967,0.0,98006,47.565,-122.14399999999999,2070,8900,5780,0.672093023255814,7952400,73960000,66007600
635000.0,5,3.25,3710,34200,2.0,0,0,2,8,2510,1200,1986,0.0,98074,47.6101,-122.04700000000001,1720,23100,30490,0.8915204678362573,13764100,1169640000,1155875900
420000.0,3,2.25,1770,8165,2.0,0,0,2,7,1770,0,1977,0.0,98034,47.7166,-122.236,1650,8165,6395,0.7832210655235763,3132900,66667225,63534325
503000.0,3,2.0,1260,2500,1.0,0,0,3,7,750,510,1987,0.0,98107,47.6748,-122.37100000000001,1710,5000,1240,0.496,1587600,6250000,4662400
689000.0,2,1.75,2330,10143,1.0,0,2,3,7,1220,1110,1953,0.0,98146,47.4899,-122.359,2560,9750,7813,0.7702849255644286,5428900,102880449,97451549
749500.0,4,2.75,2490,3840,1.5,0,0,3,7,1610,880,1922,0.0,98103,47.6551,-122.344,1420,4000,1350,0.3515625,6200100,14745600,8545500
1150000.0,6,3.75,4090,49542,2.0,0,0,2,9,3100,990,1984,0.0,98005,47.6408,-122.15299999999999,2980,43357,45452,0.9174437850712527,16728100,2454409764,2437681664
563500.0,4,2.5,2800,12831,2.0,0,0,2,8,2800,0,2001,0.0,98019,47.7392,-121.96600000000001,2810,10235,10031,0.7817785051827605,7840000,164634561,156794561
480000.0,4,3.0,2440,9664,2.0,0,0,2,8,1890,550,1981,0.0,98028,47.7649,-122.25299999999999,2380,9609,7224,0.7475165562913907,5953600,93392896,87439296
374950.0,4,3.0,2540,8800,1.0,0,1,2,9,1620,920,1977,0.0,98023,47.3204,-122.387,2540,8800,6260,0.7113636363636363,6451600,77440000,70988400
308950.0,3,2.5,1600,6250,2.0,0,0,2,7,1600,0,1995,0.0,98038,47.3675,-122.02,1760,6110,4650,0.744,2560000,39062500,36502500
445000.0,4,2.75,2680,16934,1.0,0,0,3,7,1340,1340,1958,0.0,98106,47.542,-122.36399999999999,1240,7000,14254,0.8417385142317232,7182400,286760356,279577956
237200.0,3,1.5,1220,9000,1.0,0,0,3,7,1220,0,1968,0.0,98042,47.3642,-122.109,1220,9472,7780,0.8644444444444445,1488400,81000000,79511600
453500.0,3,1.75,1550,7270,1.5,0,0,4,7,1550,0,1953,0.0,98125,47.72,-122.31700000000001,1050,7210,5720,0.7867950481430537,2402500,52852900,50450400
616500.0,3,2.0,2080,4549,1.0,0,0,4,7,1040,1040,1954,0.0,98115,47.6886,-122.309,1620,4549,2469,0.5427566498131458,4326400,20693401,16367001
1250000.0,5,5.0,5000,32909,2.0,0,0,2,10,5000,0,2000,0.0,98075,47.6012,-122.022,3030,12601,27909,0.8480658786350238,25000000,1083002281,1058002281
396000.0,1,1.0,630,5150,1.0,0,0,3,5,630,0,1954,0.0,98117,47.6923,-122.369,1390,5150,4520,0.8776699029126214,396900,26522500,26125600
210000.0,3,1.0,1070,8179,1.0,0,0,2,6,1070,0,1949,0.0,98146,47.5015,-122.34899999999999,1050,8177,7109,0.8691771610221298,1144900,66896041,65751141
539000.0,2,1.75,1900,5175,1.0,0,0,2,7,1200,700,1919,0.0,98116,47.5689,-122.38600000000001,1370,5175,3275,0.6328502415458938,3610000,26780625,23170625
605000.0,3,2.5,2960,18600,2.0,0,0,2,8,2960,0,1979,0.0,98166,47.4358,-122.344,2740,15681,15640,0.8408602150537634,8761600,345960000,337198400
437500.0,3,2.0,1490,4800,2.0,0,0,4,6,1490,0,1948,0.0,98117,47.6933,-122.361,1500,4800,3310,0.6895833333333333,2220100,23040000,20819900
215000.0,3,1.5,1500,15000,1.0,0,0,2,7,1500,0,1952,0.0,98031,47.3926,-122.208,1790,13905,13500,0.9,2250000,225000000,222750000
440000.0,4,2.5,2410,4780,2.0,0,0,2,7,2410,0,2000,0.0,98065,47.5326,-121.87899999999999,2410,4025,2370,0.49581589958158995,5808100,22848400,17040300
525000.0,3,1.0,2000,22500,1.0,0,0,2,7,1680,320,1939,0.0,98125,47.71100000000001,-122.30799999999999,2000,10000,20500,0.9111111111111111,4000000,506250000,502250000
319900.0,3,1.5,1140,20383,1.0,0,0,2,7,840,300,1985,0.0,98045,47.4755,-121.758,1200,15625,19243,0.9440710395918167,1299600,415466689,414167089
335000.0,3,1.0,1120,9075,1.0,0,0,2,7,1120,0,1977,0.0,98077,47.7551,-122.072,1120,9705,7955,0.8765840220385674,1254400,82355625,81101225
485000.0,3,2.25,2900,35273,2.0,0,0,2,9,2900,0,1986,0.0,98038,47.4013,-122.03,2510,38487,32373,0.9177841408442718,8410000,1244184529,1235774529
359999.0,4,2.25,3220,7700,2.0,0,0,3,8,3220,0,1976,0.0,98023,47.3188,-122.38,2570,7700,4480,0.5818181818181818,10368400,59290000,48921600
799000.0,5,2.75,2500,19783,1.0,0,3,3,8,2500,0,1959,0.0,98005,47.5938,-122.17399999999999,1700,15375,17283,0.8736288732750341,6250000,391367089,385117089
280000.0,3,2.25,1610,10454,1.0,0,0,2,7,1610,0,1977,0.0,98148,47.4517,-122.331,1720,9583,8844,0.8459919647981634,2592100,109286116,106694016
1050000.0,4,2.75,2250,3433,1.5,0,0,2,8,1500,750,1927,2013.0,98112,47.6382,-122.307,1970,3484,1183,0.34459656277308476,5062500,11785489,6722989
290000.0,1,2.0,1240,4800,2.0,0,0,2,6,1240,0,1910,0.0,98055,47.4778,-122.211,1030,4800,3560,0.7416666666666667,1537600,23040000,21502400
235000.0,2,2.25,1660,2748,2.0,0,0,2,7,1660,0,1995,0.0,98055,47.4333,-122.212,1620,3167,1088,0.39592430858806404,2755600,7551504,4795904
495000.0,3,1.75,2080,3000,1.0,0,0,3,7,1040,1040,1925,0.0,98103,47.6853,-122.35,1000,3193,920,0.30666666666666664,4326400,9000000,4673600
290000.0,3,2.25,1880,7488,2.0,0,0,2,8,1880,0,1980,0.0,98032,47.3631,-122.277,2180,7344,5608,0.7489316239316239,3534400,56070144,52535744
230000.0,4,1.5,1050,9516,1.0,0,0,3,7,1050,0,1969,0.0,98031,47.4151,-122.181,1390,9600,8466,0.8896595208070618,1102500,90554256,89451756
234000.0,3,1.75,1480,8475,1.0,0,0,3,7,1480,0,1968,0.0,98023,47.3126,-122.361,1800,8800,6995,0.8253687315634218,2190400,71825625,69635225
597400.0,4,2.5,2420,4500,2.0,0,0,2,7,2420,0,2001,0.0,98053,47.6874,-122.037,2280,4500,2080,0.4622222222222222,5856400,20250000,14393600
370000.0,4,2.5,2190,17600,1.0,0,0,3,7,1110,1080,1966,0.0,98059,47.4712,-122.11200000000001,1820,17600,15410,0.8755681818181819,4796100,309760000,304963900
755000.0,4,2.5,2660,10452,2.0,0,0,2,9,2660,0,1993,0.0,98052,47.6972,-122.104,2890,9025,7792,0.7455032529659396,7075600,109244304,102168704
342000.0,3,2.5,2430,5715,2.0,0,0,2,7,2430,0,1999,0.0,98030,47.3718,-122.16799999999999,3040,5702,3285,0.5748031496062992,5904900,32661225,26756325
497000.0,2,1.0,770,3325,1.0,0,0,2,7,770,0,1918,0.0,98122,47.6102,-122.29899999999999,960,4800,2555,0.7684210526315789,592900,11055625,10462725
835000.0,3,1.0,3060,30166,1.0,0,0,4,8,3060,0,1959,0.0,98027,47.5656,-122.09299999999999,1880,19602,27106,0.898561294172247,9363600,909987556,900623956
730000.0,4,2.75,2920,4500,2.0,0,0,2,9,2920,0,1999,0.0,98006,47.5646,-122.124,2920,4505,1580,0.3511111111111111,8526400,20250000,11723600
655000.0,3,1.0,1370,5250,1.0,0,0,2,7,1070,300,1939,0.0,98109,47.6421,-122.348,2410,4200,3880,0.7390476190476191,1876900,27562500,25685600
205000.0,3,2.5,1870,3118,2.0,0,0,2,8,1870,0,1993,0.0,98038,47.3739,-122.056,1580,3601,1248,0.40025657472738935,3496900,9721924,6225024
632750.0,4,2.0,1800,4800,1.5,0,0,2,7,1800,0,1918,0.0,98112,47.6388,-122.302,1950,4800,3000,0.625,3240000,23040000,19800000
330000.0,5,3.0,2100,7715,1.0,0,0,2,7,1250,850,2013,0.0,98168,47.4866,-122.319,2100,7959,5615,0.727802981205444,4410000,59521225,55111225
527500.0,5,2.25,2530,8250,2.0,0,0,3,7,2530,0,1961,0.0,98007,47.6117,-122.134,2020,8250,5720,0.6933333333333334,6400900,68062500,61661600
716500.0,4,2.5,3290,6465,2.0,0,0,2,9,3290,0,2002,0.0,98075,47.5981,-121.976,3100,5929,3175,0.4911059551430781,10824100,41796225,30972125
388500.0,4,2.5,1890,5395,2.0,0,0,2,7,1890,0,2006,0.0,98065,47.5415,-121.883,2060,5395,3505,0.6496756255792401,3572100,29106025,25533925
530000.0,3,1.75,1680,7770,1.0,0,0,3,7,1680,0,1967,0.0,98005,47.6028,-122.167,1880,7770,6090,0.7837837837837838,2822400,60372900,57550500
419000.0,3,2.5,2170,4517,2.0,0,0,2,8,2170,0,2002,0.0,98059,47.4819,-122.14,2610,4770,2347,0.5195926499889307,4708900,20403289,15694389
385000.0,3,1.75,1200,7360,1.0,0,0,3,7,1200,0,1978,0.0,98052,47.6979,-122.13,1200,7500,6160,0.8369565217391305,1440000,54169600,52729600
655000.0,4,2.5,2990,5669,2.0,0,0,2,8,2990,0,2003,0.0,98074,47.6119,-122.01100000000001,3110,5058,2679,0.47257011818662903,8940100,32137561,23197461
1700000.0,4,2.75,3770,10900,2.0,0,2,4,9,3070,700,1924,0.0,98144,47.5849,-122.29,3000,5000,7130,0.6541284403669725,14212900,118810000,104597100
279000.0,2,1.0,1020,47044,1.0,0,0,4,7,1020,0,1904,0.0,98042,47.4206,-122.155,1930,12139,46024,0.9783181702236204,1040400,2213137936,2212097536
262000.0,3,1.5,1700,9579,1.0,0,0,3,7,1100,600,1962,0.0,98023,47.3209,-122.338,1700,9628,7879,0.8225284476458921,2890000,91757241,88867241
533000.0,4,1.0,1550,4750,1.5,0,0,2,7,1550,0,1919,0.0,98117,47.6824,-122.389,1320,4750,3200,0.6736842105263158,2402500,22562500,20160000
640000.0,3,1.75,1680,8100,1.0,0,2,2,8,1680,0,1950,0.0,98177,47.7212,-122.36399999999999,1880,7750,6420,0.7925925925925926,2822400,65610000,62787600
285000.0,3,2.25,1680,35127,2.0,0,0,2,7,1680,0,1987,0.0,98092,47.3025,-122.06700000000001,1820,35166,33447,0.9521735417200444,2822400,1233906129,1231083729
458400.0,4,2.5,1910,10300,1.0,0,0,2,8,1910,0,1921,0.0,98177,47.7581,-122.359,1910,7750,8390,0.8145631067961165,3648100,106090000,102441900
620000.0,5,3.25,3160,10587,1.0,0,0,4,7,2190,970,1960,0.0,98034,47.7238,-122.165,2200,7761,7427,0.7015207329744025,9985600,112084569,102098969
465000.0,3,1.5,2020,11358,1.0,0,0,3,6,1190,830,1956,0.0,98033,47.6641,-122.185,2370,9520,9338,0.8221517872864941,4080400,129004164,124923764
690000.0,4,3.75,3210,7054,2.0,0,0,3,8,3210,0,1985,0.0,98052,47.7268,-122.103,2350,8020,3844,0.5449390416784803,10304100,49758916,39454816
462500.0,3,2.25,2350,51400,1.0,0,0,2,7,1390,960,1977,0.0,98077,47.7417,-122.053,2350,51400,49050,0.9542801556420234,5522500,2641960000,2636437500
369950.0,4,2.5,1910,10221,2.0,0,0,2,8,1910,0,1994,0.0,98038,47.381,-122.035,2210,8705,8311,0.813129830740632,3648100,104468841,100820741
124500.0,2,1.0,840,6480,1.0,0,0,3,5,840,0,1954,0.0,98001,47.263999999999996,-122.258,1100,7300,5640,0.8703703703703703,705600,41990400,41284800
950000.0,4,2.25,2620,10920,1.0,0,0,2,9,2620,0,1965,0.0,98005,47.6117,-122.164,2370,11907,8300,0.76007326007326,6864400,119246400,112382000
418000.0,4,1.5,1220,10580,1.0,0,0,2,7,1220,0,1965,0.0,98008,47.6205,-122.116,1350,7800,9360,0.8846880907372401,1488400,111936400,110448000
160000.0,3,1.0,1060,8000,1.0,0,0,3,6,1060,0,1927,0.0,98002,47.305,-122.21799999999999,1060,4697,6940,0.8675,1123600,64000000,62876400
457000.0,4,2.5,2200,10800,1.0,0,0,2,8,1500,700,1964,0.0,98155,47.7711,-122.288,2280,10800,8600,0.7962962962962963,4840000,116640000,111800000
530000.0,2,1.75,2120,7680,1.0,0,0,4,6,1130,990,1948,0.0,98126,47.5304,-122.374,1220,7680,5560,0.7239583333333334,4494400,58982400,54488000
385000.0,3,1.0,1250,7300,1.0,0,0,3,7,1250,0,1956,0.0,98008,47.6032,-122.125,1540,7400,6050,0.8287671232876712,1562500,53290000,51727500
491000.0,3,1.75,1440,7800,1.0,0,0,3,7,1440,0,1958,0.0,98008,47.5996,-122.12,1440,7800,6360,0.8153846153846154,2073600,60840000,58766400
521000.0,4,2.25,1890,8034,1.0,0,0,3,8,1890,0,1967,0.0,98008,47.6338,-122.117,1920,7210,6144,0.7647498132935027,3572100,64545156,60973056
255000.0,3,1.0,1140,8528,1.0,0,0,4,7,1140,0,1967,0.0,98022,47.2098,-122.00399999999999,1140,8112,7388,0.8663227016885553,1299600,72726784,71427184
292050.0,5,3.0,2840,7199,1.0,0,0,2,7,1710,1130,2003,0.0,98178,47.5065,-122.275,2210,10800,4359,0.6055007639949993,8065600,51825601,43760001
326000.0,6,3.0,1880,7200,1.0,0,0,3,7,1880,0,1966,0.0,98056,47.5029,-122.18799999999999,1540,13022,5320,0.7388888888888889,3534400,51840000,48305600
300000.0,2,1.0,750,5120,1.0,0,0,3,6,750,0,1941,0.0,98126,47.5312,-122.375,930,7200,4370,0.853515625,562500,26214400,25651900
291600.0,3,1.75,1630,7480,1.0,0,0,2,7,1330,300,1979,0.0,98058,47.4514,-122.15899999999999,1940,7480,5850,0.7820855614973262,2656900,55950400,53293500
435000.0,5,1.5,1720,12551,1.0,0,0,2,7,1720,0,1967,0.0,98027,47.5241,-122.053,1560,12960,10831,0.8629591267628077,2958400,157527601,154569201
465000.0,3,2.5,1600,1311,3.0,0,0,2,8,1600,0,2005,0.0,98117,47.6903,-122.39399999999999,1390,1321,-289,-0.2204424103737605,2560000,1718721,-841279
200000.0,3,2.25,1230,7420,1.5,0,0,4,7,1230,0,1913,0.0,98002,47.3184,-122.22,1260,7556,6190,0.8342318059299192,1512900,55056400,53543500
238000.0,3,1.5,1610,6132,1.0,0,2,3,7,1090,520,1959,0.0,98056,47.5017,-122.17399999999999,1650,6132,4522,0.7374429223744292,2592100,37601424,35009324
455000.0,4,2.5,1320,7000,1.0,0,0,3,7,1320,0,1956,0.0,98008,47.6007,-122.12700000000001,1550,8610,5680,0.8114285714285714,1742400,49000000,47257600
230000.0,6,3.0,2180,7220,2.0,0,0,2,7,2180,0,1980,0.0,98003,47.3046,-122.305,2260,7344,5040,0.6980609418282548,4752400,52128400,47376000
808000.0,4,2.25,2190,4104,2.0,0,0,4,8,1410,780,1928,0.0,98112,47.6419,-122.306,1990,3860,1914,0.46637426900584794,4796100,16842816,12046716
578500.0,3,1.0,1490,5700,1.5,0,0,2,7,1490,0,1916,0.0,98103,47.6549,-122.331,2290,5700,4210,0.7385964912280701,2220100,32490000,30269900
390000.0,3,2.0,1463,868,3.0,0,0,2,7,1463,0,2003,0.0,98115,47.6843,-122.31700000000001,1484,4320,-595,-0.6854838709677419,2140369,753424,-1386945
517500.0,3,2.5,1800,3933,2.0,0,0,2,8,1800,0,1989,0.0,98029,47.5746,-122.009,1800,4659,2133,0.5423340961098398,3240000,15468489,12228489
755000.0,4,2.75,2880,4000,1.5,0,0,2,9,2100,780,1912,2000.0,98144,47.5843,-122.29299999999999,2110,4000,1120,0.28,8294400,16000000,7705600
579500.0,3,1.75,1250,4120,1.0,0,0,3,7,980,270,1925,0.0,98117,47.685,-122.36,1250,4120,2870,0.6966019417475728,1562500,16974400,15411900
649950.0,3,2.75,1670,1350,3.0,0,0,2,9,1350,320,2014,0.0,98116,47.5764,-122.40799999999999,1520,4800,-320,-0.23703703703703705,2788900,1822500,-966400
228000.0,4,1.75,2000,6120,1.0,0,0,2,7,1100,900,1965,0.0,98178,47.5035,-122.258,1880,6120,4120,0.673202614379085,4000000,37454400,33454400
665000.0,4,1.75,2280,3680,1.5,0,0,4,7,1470,810,1926,0.0,98115,47.6754,-122.3,1850,3680,1400,0.3804347826086957,5198400,13542400,8344000
689000.0,4,2.5,2110,6069,2.0,0,0,2,9,2110,0,1999,0.0,98052,47.6374,-122.111,2180,9000,3959,0.6523315208436316,4452100,36832761,32380661
560000.0,4,2.5,2520,11240,1.0,0,0,2,8,1440,1080,1977,0.0,98052,47.6748,-122.14399999999999,2360,10345,8720,0.7758007117437722,6350400,126337600,119987200
529000.0,3,1.0,1590,6420,1.0,0,0,2,7,1590,0,1944,0.0,98136,47.5355,-122.39200000000001,1780,5900,4830,0.7523364485981309,2528100,41216400,38688300
375000.0,5,2.5,2100,14858,1.0,0,0,4,8,2100,0,1970,0.0,98059,47.4721,-122.12299999999999,1980,11730,12758,0.8586620002692152,4410000,220760164,216350164
325000.0,4,2.75,2090,9240,1.0,0,0,3,6,2090,0,1949,0.0,98146,47.4854,-122.34299999999999,1460,9240,7150,0.7738095238095238,4368100,85377600,81009500
583000.0,4,2.5,3390,10519,2.0,0,2,2,10,3390,0,1990,0.0,98003,47.332,-122.334,2830,10519,7129,0.6777260195836106,11492100,110649361,99157261
330000.0,2,1.0,790,9784,1.0,0,0,2,6,790,0,1932,0.0,98155,47.7634,-122.28399999999999,2350,10102,8994,0.919255928045789,624100,95726656,95102556
262000.0,3,2.5,1970,8727,2.0,0,0,2,7,1970,0,1995,0.0,98092,47.3263,-122.189,1670,9168,6757,0.7742637790764295,3880900,76160529,72279629
555000.0,4,2.5,2870,6776,2.0,0,0,2,8,2870,0,2004,0.0,98065,47.538999999999994,-121.87799999999999,2770,6658,3906,0.5764462809917356,8236900,45914176,37677276
585000.0,2,1.0,1110,6000,1.0,0,0,2,7,1010,100,1951,0.0,98118,47.5632,-122.28200000000001,1410,3500,4890,0.815,1232100,36000000,34767900
425590.0,3,2.75,1940,3088,2.0,0,3,2,8,1770,170,2008,0.0,98065,47.5185,-121.87799999999999,1410,2335,1148,0.37176165803108807,3763600,9535744,5772144
235000.0,2,1.0,720,4840,1.0,0,0,3,6,720,0,1947,0.0,98126,47.5534,-122.375,1510,4840,4120,0.8512396694214877,518400,23425600,22907200
362362.0,2,1.0,710,4000,1.0,0,0,2,6,710,0,1909,0.0,98118,47.5535,-122.26899999999999,960,4000,3290,0.8225,504100,16000000,15495900
252000.0,3,2.0,1370,7500,1.0,0,0,2,7,1370,0,1997,0.0,98038,47.3634,-122.046,1420,7500,6130,0.8173333333333334,1876900,56250000,54373100
439000.0,4,2.5,2690,9551,2.0,0,0,2,9,2690,0,1992,0.0,98058,47.4343,-122.156,2890,9121,6861,0.7183540990472201,7236100,91221601,83985501
465000.0,4,2.25,3360,10810,2.0,0,0,3,9,3360,0,1988,0.0,98092,47.3316,-122.20299999999999,2590,10810,7450,0.6891766882516188,11289600,116856100,105566500
249900.0,4,2.0,1500,7854,1.5,0,0,2,7,1500,0,1983,0.0,98023,47.3127,-122.354,1500,7334,6354,0.8090145148968678,2250000,61685316,59435316
665000.0,2,2.5,2600,5000,1.0,0,0,4,8,1300,1300,1926,0.0,98126,47.5806,-122.37899999999999,2260,5000,2400,0.48,6760000,25000000,18240000
370000.0,3,1.75,1160,8774,1.0,0,0,2,7,1160,0,1972,0.0,98034,47.7159,-122.165,1990,7908,7614,0.8677912012764988,1345600,76983076,75637476
620000.0,2,1.0,1430,3000,1.5,0,0,2,7,1300,130,1929,0.0,98112,47.6415,-122.303,1750,4000,1570,0.5233333333333333,2044900,9000000,6955100
375000.0,3,1.0,1870,7671,1.0,0,0,3,8,1720,150,1937,0.0,98177,47.7162,-122.36,1460,7679,5801,0.756224742536827,3496900,58844241,55347341
552625.0,4,2.0,2560,9390,1.0,0,0,4,8,1280,1280,1957,0.0,98133,47.7169,-122.329,1830,8169,6830,0.7273695420660277,6553600,88172100,81618500
315500.0,3,1.0,1160,10500,1.0,0,0,3,7,1160,0,1966,0.0,98034,47.7267,-122.227,1520,10500,9340,0.8895238095238095,1345600,110250000,108904400
620000.0,2,1.75,1680,8187,1.0,0,0,3,8,1680,0,1983,0.0,98027,47.5603,-122.081,2390,7801,6507,0.7947966288017588,2822400,67026969,64204569
510000.0,4,2.5,2010,9075,1.0,0,0,3,8,1310,700,1959,0.0,98006,47.553000000000004,-122.182,1850,9220,7065,0.7785123966942149,4040100,82355625,78315525
652500.0,4,2.5,2540,38677,2.0,0,0,2,9,2540,0,1987,0.0,98053,47.6694,-122.044,2560,36280,36137,0.9343278951314735,6451600,1495910329,1489458729
574000.0,4,2.5,3240,22795,2.0,0,0,2,8,3240,0,1998,0.0,98053,47.6329,-121.969,2570,29761,19555,0.8578635665716166,10497600,519612025,509114425
430000.0,3,2.5,2670,12806,2.0,0,0,2,9,2670,0,2010,0.0,98038,47.3686,-122.059,3010,7231,10136,0.7915039825081993,7128900,163993636,156864736
390000.0,3,2.0,1080,7236,1.0,0,0,4,7,1080,0,1947,0.0,98125,47.7143,-122.32,1120,8008,6156,0.8507462686567164,1166400,52359696,51193296
466500.0,3,1.0,1430,3840,1.0,0,0,2,7,950,480,1945,0.0,98117,47.6847,-122.381,1430,3840,2410,0.6276041666666666,2044900,14745600,12700700
315000.0,2,2.25,1290,2436,2.0,0,0,2,7,1290,0,1984,0.0,98052,47.6803,-122.156,1360,3088,1146,0.47044334975369456,1664100,5934096,4269996
220000.0,4,1.5,1240,9600,1.0,0,0,2,7,1240,0,1971,0.0,98023,47.3206,-122.397,1240,9592,8360,0.8708333333333333,1537600,92160000,90622400
325000.0,3,1.75,1840,17286,1.0,0,0,3,7,1440,400,1978,0.0,98030,47.371,-122.17299999999999,1840,14541,15446,0.8935554784218442,3385600,298805796,295420196
365000.0,3,1.0,1120,8443,1.0,0,0,2,7,1120,0,1953,0.0,98133,47.7715,-122.336,1450,8433,7323,0.8673457301906905,1254400,71284249,70029849
356000.0,3,3.5,2100,12384,2.0,0,0,2,9,2100,0,1980,0.0,98188,47.4687,-122.26299999999999,2400,7776,10284,0.8304263565891473,4410000,153363456,148953456
380000.0,4,1.75,2030,12518,1.0,0,0,2,8,1610,420,1950,0.0,98125,47.7278,-122.29700000000001,1650,7872,10488,0.8378335197315865,4120900,156700324,152579424
579000.0,4,2.25,2030,8764,2.0,0,0,3,8,2030,0,1983,0.0,98052,47.7214,-122.11,1950,8750,6734,0.768370607028754,4120900,76807696,72686796
682000.0,2,1.0,890,5000,1.0,0,0,2,7,890,0,1943,0.0,98105,47.6666,-122.279,1680,5000,4110,0.822,792100,25000000,24207900
499000.0,3,1.75,1750,12325,1.0,0,0,3,7,1470,280,1968,0.0,98052,47.6832,-122.118,1820,9750,10575,0.8580121703853956,3062500,151905625,148843125
333760.0,3,1.0,1300,5880,1.0,0,0,2,7,1300,0,1968,0.0,98052,47.6937,-122.113,1300,7700,4580,0.7789115646258503,1690000,34574400,32884400
745000.0,4,2.5,2650,18903,2.0,0,0,2,11,2650,0,1994,0.0,98075,47.5761,-121.98899999999999,3270,18843,16253,0.8598106120721578,7022500,357323409,350300909
380000.0,3,1.75,1750,10870,1.0,0,0,4,7,1750,0,1968,0.0,98056,47.4989,-122.18799999999999,1230,10868,9120,0.8390064397424103,3062500,118156900,115094400
435000.0,3,3.0,1440,1350,3.5,0,2,2,8,1440,0,2005,0.0,98103,47.6525,-122.345,1440,1350,-90,-0.06666666666666667,2073600,1822500,-251100
520000.0,3,2.75,1700,3264,1.0,0,0,2,7,1060,640,1919,0.0,98115,47.6767,-122.311,1880,4080,1564,0.4791666666666667,2890000,10653696,7763696
965000.0,4,2.5,3920,41206,2.0,0,0,3,10,3920,0,1988,0.0,98072,47.7325,-122.132,3780,36562,37286,0.9048682230743096,15366400,1697934436,1682568036
270000.0,3,2.25,1470,16728,1.0,0,0,3,7,1350,120,1959,0.0,98168,47.4968,-122.302,1540,9000,15258,0.9121233859397417,2160900,279825984,277665084
1100000.0,5,2.75,2520,4643,1.5,0,0,3,8,2120,400,1916,0.0,98112,47.6348,-122.301,2100,4564,2123,0.45724746930863663,6350400,21557449,15207049
577500.0,3,1.75,2140,13286,1.0,0,0,3,8,1220,920,1964,0.0,98006,47.5722,-122.12799999999999,2250,13286,11146,0.8389281950925787,4579600,176517796,171938196
650000.0,3,1.75,1550,5000,1.0,0,0,2,7,1250,300,1911,2011.0,98107,47.6722,-122.37200000000001,1110,5000,3450,0.69,2402500,25000000,22597500
1230000.0,4,2.5,3180,10319,2.0,0,0,3,11,3180,0,1986,0.0,98040,47.5372,-122.23200000000001,3130,12120,7139,0.6918306037406725,10112400,106481761,96369361
1900000.0,5,4.25,6510,16471,2.0,0,3,3,11,3250,3260,1980,0.0,98040,47.5758,-122.242,4480,16471,9961,0.604759881002975,42380100,271293841,228913741
475000.0,2,2.0,1440,3720,1.5,0,0,2,7,1440,0,1983,0.0,98115,47.6902,-122.325,1490,4308,2280,0.6129032258064516,2073600,13838400,11764800
200000.0,3,1.0,1150,10132,1.0,0,0,3,7,1150,0,1970,0.0,98023,47.3172,-122.37200000000001,1180,8713,8982,0.886498223450454,1322500,102657424,101334924
397000.0,4,2.5,2320,11717,2.0,0,0,2,8,2320,0,1997,0.0,98045,47.483999999999995,-121.78,2320,9714,9397,0.8019970982333362,5382400,137288089,131905689
383610.0,3,2.0,1230,8450,1.0,0,0,2,7,1230,0,1989,0.0,98155,47.7548,-122.305,2110,8536,7220,0.8544378698224852,1512900,71402500,69889600
275000.0,4,2.5,2060,5742,2.0,0,0,2,7,2060,0,1999,0.0,98030,47.3612,-122.185,1610,7298,3682,0.6412399860675723,4243600,32970564,28726964
840000.0,3,2.0,2783,11177,2.0,0,0,2,8,2783,0,1910,1999.0,98126,47.538000000000004,-122.38,1730,8018,8394,0.7510065312695714,7745089,124925329,117180240
365000.0,4,2.5,2140,7350,2.0,0,0,2,8,2140,0,1985,0.0,98058,47.4483,-122.124,2120,8395,5210,0.708843537414966,4579600,54022500,49442900
362000.0,3,2.75,1420,955,2.0,0,0,2,8,1160,260,2004,0.0,98029,47.5477,-122.00299999999999,1420,955,-465,-0.4869109947643979,2016400,912025,-1104375
350000.0,3,1.75,2090,6258,1.0,0,0,2,7,1390,700,1956,0.0,98108,47.5503,-122.301,1790,5793,4168,0.6660274848194311,4368100,39162564,34794464
200000.0,2,1.75,1320,13052,1.5,0,0,2,7,1320,0,1980,0.0,98014,47.711999999999996,-121.352,1320,13052,11732,0.898866074164879,1742400,170354704,168612304
299000.0,4,2.5,2300,8100,1.0,0,0,3,8,1360,940,1979,0.0,98023,47.2979,-122.37100000000001,1910,7630,5800,0.7160493827160493,5290000,65610000,60320000
555000.0,4,1.5,3050,82764,1.0,0,0,2,8,1650,1400,1966,0.0,98056,47.5266,-122.189,2930,10074,79714,0.963148228698468,9302500,6849879696,6840577196
1330000.0,3,2.25,2960,8330,1.0,0,3,3,10,2260,700,1953,0.0,98177,47.7035,-122.385,2960,8840,5370,0.6446578631452581,8761600,69388900,60627300
896000.0,5,2.75,2520,16100,1.0,0,3,3,8,1570,950,1960,0.0,98040,47.528,-122.22399999999999,2760,16988,13580,0.8434782608695652,6350400,259210000,252859600
550000.0,2,1.75,1740,7290,1.0,0,0,2,8,1280,0,1950,0.0,98199,47.6461,-122.397,1820,6174,5550,0.7613168724279835,3027600,53144100,50116500
324500.0,2,1.0,1300,6617,1.0,0,0,2,7,1300,0,1986,0.0,98125,47.7238,-122.302,1820,7800,5317,0.8035363457760314,1690000,43784689,42094689
312500.0,3,1.0,1170,7350,1.0,0,0,3,7,1170,0,1960,0.0,98008,47.625,-122.117,1170,7350,6180,0.8408163265306122,1368900,54022500,52653600
485000.0,4,3.25,1946,17786,2.0,0,1,3,7,1946,0,1990,0.0,98070,47.358999999999995,-122.45200000000001,1460,16661,15840,0.8905881030023614,3786916,316341796,312554880
511000.0,2,1.0,1250,5413,1.0,0,0,3,7,1250,0,1923,0.0,98115,47.6945,-122.315,1250,5413,4163,0.7690744503971919,1562500,29300569,27738069
139500.0,2,1.5,1230,1561,2.0,0,0,2,7,1230,0,1983,0.0,98042,47.3768,-122.149,1660,2243,331,0.21204356181934658,1512900,2436721,923821
464000.0,4,2.5,2180,7203,2.0,0,0,3,8,2180,0,1989,0.0,98059,47.5119,-122.15100000000001,2350,7334,5023,0.6973483270859364,4752400,51883209,47130809
255000.0,3,1.75,1740,8800,1.0,0,0,2,7,1140,600,1978,0.0,98023,47.2968,-122.37200000000001,1690,7920,7060,0.8022727272727272,3027600,77440000,74412400
679975.0,4,2.5,3830,4644,2.0,0,0,2,8,2900,930,2004,0.0,98065,47.5384,-121.88,3400,6163,814,0.1752799310938846,14668900,21566736,6897836
624800.0,3,2.0,2250,14274,1.0,0,0,3,8,1500,750,1964,0.0,98040,47.5762,-122.21700000000001,2820,13813,12024,0.8423707440100883,5062500,203747076,198684576
920000.0,3,2.75,2590,223027,2.0,0,0,2,9,2590,0,1983,0.0,98074,47.6145,-122.001,3410,212137,220437,0.9883870562756976,6708100,49741042729,49734334629
1370000.0,3,2.5,2090,6000,1.5,0,0,3,9,2090,0,1928,0.0,98105,47.6567,-122.281,2730,6000,3910,0.6516666666666666,4368100,36000000,31631900
510000.0,3,1.5,2400,10275,1.0,0,0,3,8,1540,860,1964,0.0,98052,47.6888,-122.126,2380,10125,7875,0.7664233576642335,5760000,105575625,99815625
289659.0,4,2.25,2260,7200,2.0,0,0,3,7,2260,0,1984,0.0,98031,47.4121,-122.18299999999999,1720,7200,4940,0.6861111111111111,5107600,51840000,46732400
585000.0,4,2.5,2910,6250,2.0,0,0,2,8,2910,0,1999,0.0,98065,47.538000000000004,-121.87,2550,6250,3340,0.5344,8468100,39062500,30594400
555000.0,5,3.0,3640,6930,2.0,0,0,2,8,3640,0,2004,0.0,98038,47.3521,-122.012,3740,7182,3290,0.47474747474747475,13249600,48024900,34775300
940000.0,4,2.75,3770,24897,2.0,0,2,3,8,2550,1220,1964,0.0,98075,47.5824,-122.07799999999999,2640,11502,21127,0.8485761336707234,14212900,619860609,605647709
460000.0,3,2.0,1600,7350,1.0,0,0,3,7,1600,0,1979,0.0,98052,47.6977,-122.126,1600,7200,5750,0.782312925170068,2560000,54022500,51462500
319000.0,3,2.5,2110,7434,2.0,0,0,3,7,2110,0,1978,0.0,98031,47.3935,-122.169,2100,7749,5324,0.7161689534570891,4452100,55264356,50812256
280000.0,3,2.5,1720,1916,2.0,0,0,2,7,1720,0,2005,0.0,98059,47.4895,-122.166,1760,1916,196,0.1022964509394572,2958400,3671056,712656
250000.0,3,1.0,1100,7470,1.0,0,0,3,5,1100,0,1917,0.0,98065,47.5242,-121.831,1280,7055,6370,0.8527443105756358,1210000,55800900,54590900
749950.0,4,2.5,2620,8312,2.0,0,0,2,9,2620,0,1990,0.0,98074,47.6272,-122.03299999999999,2260,8515,5692,0.6847930702598652,6864400,69089344,62224944
458000.0,5,2.5,3090,23265,1.0,0,0,2,8,2990,100,1957,0.0,98011,47.7709,-122.212,2560,18773,20175,0.8671824629271437,9548100,541260225,531712125
465000.0,3,2.5,1890,4808,2.0,0,0,2,8,1890,0,2000,0.0,98065,47.5348,-121.866,2460,5348,2918,0.6069051580698835,3572100,23116864,19544764
580000.0,3,1.75,1850,2797,1.0,0,0,2,8,1150,700,1977,0.0,98103,47.6871,-122.336,1450,4599,947,0.3385770468358956,3422500,7823209,4400709
700000.0,4,2.5,3100,36562,2.0,0,0,2,10,3100,0,1994,0.0,98077,47.7646,-122.065,3080,39351,33462,0.9152125157267108,9610000,1336779844,1327169844
350000.0,4,2.5,2506,7206,2.0,0,0,2,8,2506,0,2007,0.0,98023,47.3236,-122.337,2441,7220,4700,0.6522342492367471,6280036,51926436,45646400
456000.0,4,1.0,1700,7689,1.0,0,0,2,7,1080,620,1977,0.0,98052,47.6955,-122.116,1700,7333,5989,0.7789049291195214,2890000,59120721,56230721
290000.0,3,2.0,1550,18958,1.5,0,0,2,7,1550,0,1983,0.0,98198,47.3699,-122.319,1840,12826,17408,0.9182403207089356,2402500,359405764,357003264
475000.0,4,2.75,2200,16288,1.0,0,0,2,7,1290,910,1980,0.0,98059,47.4793,-122.12200000000001,2650,6620,14088,0.8649312377210217,4840000,265298944,260458944
285000.0,3,2.5,1890,3629,2.0,0,0,2,7,1890,0,2005,0.0,98038,47.3613,-122.041,1980,4000,1739,0.47919537062551665,3572100,13169641,9597541
309000.0,3,1.0,1140,6400,1.0,0,0,2,7,1140,0,1962,0.0,98168,47.4902,-122.331,1340,6650,5260,0.821875,1299600,40960000,39660400
860000.0,4,2.0,3740,32417,2.0,0,0,2,9,3740,0,2000,0.0,98053,47.6728,-122.012,3180,32417,28677,0.8846284356973193,13987600,1050861889,1036874289
219000.0,3,2.25,1940,6500,1.0,0,0,2,8,1440,500,1979,0.0,98042,47.3565,-122.149,1880,8991,4560,0.7015384615384616,3763600,42250000,38486400
546500.0,3,2.5,2130,7199,2.0,0,0,2,8,2130,0,1990,0.0,98074,47.6331,-122.027,1890,7546,5069,0.7041255729962494,4536900,51825601,47288701
338000.0,2,1.0,1470,5566,1.0,0,0,3,7,770,700,1919,0.0,98118,47.5348,-122.26899999999999,1410,5808,4096,0.735896514552641,2160900,30980356,28819456
505000.0,2,1.0,1070,8130,1.0,0,0,2,7,1070,0,1942,0.0,98117,47.696999999999996,-122.37,1360,7653,7060,0.8683886838868389,1144900,66096900,64952000
340000.0,4,1.75,1680,15084,1.0,0,0,3,7,840,840,1979,0.0,98014,47.6895,-121.912,1800,15092,13404,0.888623707239459,2822400,227527056,224704656
678000.0,3,2.25,2730,10675,2.0,0,0,2,9,2730,0,1990,0.0,98074,47.6289,-122.042,2770,10570,7945,0.7442622950819672,7452900,113955625,106502725
800000.0,3,1.75,1890,10292,1.0,0,0,3,8,1890,0,1969,0.0,98040,47.535,-122.234,2630,10625,8402,0.8163622230858919,3572100,105925264,102353164
112000.0,1,1.0,1080,3230,1.0,0,0,2,6,1080,0,1963,0.0,98002,47.3075,-122.21700000000001,1210,5760,2150,0.6656346749226006,1166400,10432900,9266500
252000.0,3,1.75,1440,16819,1.5,0,0,3,6,1440,0,1925,0.0,98023,47.3318,-122.37299999999999,1560,12376,15379,0.9143825435519353,2073600,282878761,280805161
335000.0,4,2.75,2540,7210,1.0,0,0,3,7,1600,940,1979,0.0,98058,47.4601,-122.165,1820,7766,4670,0.6477115117891817,6451600,51984100,45532500
610000.0,3,2.0,2300,13418,1.0,0,0,2,8,1430,870,1955,0.0,98004,47.6075,-122.2,2140,9380,11118,0.8285884632583097,5290000,180042724,174752724
245000.0,3,2.0,1690,6790,1.0,0,0,2,7,1360,330,1979,0.0,98023,47.2981,-122.38,1740,6790,5100,0.7511045655375552,2856100,46104100,43248000
493500.0,3,1.75,1800,16026,1.0,0,0,2,8,1390,410,1972,0.0,98008,47.5815,-122.12100000000001,2210,13959,14226,0.8876825159116436,3240000,256832676,253592676
596500.0,4,2.25,1770,8505,2.0,0,0,2,8,1770,0,1986,0.0,98052,47.6904,-122.102,1880,8939,6735,0.7918871252204586,3132900,72335025,69202125
245000.0,3,2.0,1190,4072,1.5,0,0,4,6,1190,0,1907,0.0,98118,47.5276,-122.274,1680,5850,2882,0.7077603143418467,1416100,16581184,15165084
333500.0,3,1.75,1320,7200,1.0,0,0,3,7,1320,0,1977,0.0,98028,47.7341,-122.23700000000001,1750,7260,5880,0.8166666666666667,1742400,51840000,50097600
373000.0,3,1.0,1290,8974,1.0,0,0,4,7,1290,0,1976,0.0,98072,47.74,-122.17299999999999,1540,7500,7684,0.8562513929128593,1664100,80532676,78868576
759900.0,4,2.5,3000,5639,2.0,0,0,2,8,3000,0,2008,0.0,98052,47.7066,-122.115,3000,4587,2639,0.46799077850682747,9000000,31798321,22798321
317000.0,3,2.25,1358,1204,3.0,0,0,2,7,1358,0,2007,0.0,98133,47.7054,-122.346,1358,1196,-154,-0.12790697674418605,1844164,1449616,-394548
670000.0,3,1.5,1220,4080,1.5,0,0,4,7,1220,0,1914,0.0,98144,47.5746,-122.289,1320,4080,2860,0.7009803921568627,1488400,16646400,15158000
985000.0,2,2.5,2720,26761,2.0,1,4,2,7,2720,0,1990,0.0,98166,47.4499,-122.376,1870,12396,24041,0.898359553080976,7398400,716151121,708752721
310000.0,3,1.5,1060,6954,1.0,0,0,3,6,1060,0,1983,0.0,98106,47.5497,-122.355,1560,6372,5894,0.8475697440322116,1123600,48358116,47234516
750000.0,4,2.5,3020,13122,2.0,0,0,2,9,2540,480,1997,0.0,98052,47.6989,-122.111,3020,10873,10102,0.7698521566834324,9120400,172186884,163066484
408000.0,3,2.0,1640,3440,2.0,0,0,2,7,1640,0,1987,0.0,98052,47.6829,-122.09700000000001,1070,3549,1800,0.5232558139534884,2689600,11833600,9144000
900000.0,5,3.75,3870,8225,2.0,0,0,2,10,3870,0,1998,0.0,98074,47.6078,-122.01,3600,9361,4355,0.5294832826747721,14976900,67650625,52673725
460000.0,4,2.25,2860,15054,1.0,0,0,2,8,1460,1400,1957,0.0,98155,47.7655,-122.3,1730,18525,12194,0.8100172711571675,8179600,226622916,218443316
339000.0,4,2.5,1740,6000,1.0,0,0,3,7,1740,0,1952,0.0,98178,47.5026,-122.236,1190,6000,4260,0.71,3027600,36000000,32972400
660000.0,3,2.0,1140,6000,1.0,0,0,2,7,1140,0,1909,0.0,98109,47.637,-122.355,1260,4000,4860,0.81,1299600,36000000,34700400
449950.0,4,3.0,3290,10783,2.0,0,0,2,9,3290,0,1990,0.0,98031,47.3904,-122.178,2810,10783,7493,0.694890104794584,10824100,116273089,105448989
235000.0,3,1.0,1210,6000,1.0,0,0,2,7,1210,0,1930,0.0,98178,47.4984,-122.22399999999999,1210,6000,4790,0.7983333333333333,1464100,36000000,34535900
769000.0,5,2.25,3320,13138,1.0,0,2,3,9,1900,0,1964,0.0,98028,47.75899999999999,-122.26899999999999,2820,13138,9818,0.7472979144466433,11022400,172607044,161584644
428000.0,2,2.0,1350,3900,1.0,0,0,2,8,1350,0,2003,0.0,98053,47.7094,-122.03,1440,3900,2550,0.6538461538461539,1822500,15210000,13387500
445000.0,3,2.25,1990,7340,2.0,0,0,2,8,1990,0,1984,0.0,98072,47.7579,-122.141,2180,11223,5350,0.728882833787466,3960100,53875600,49915500
462000.0,4,2.5,2060,6958,1.0,0,0,2,7,1220,840,1974,0.0,98034,47.7251,-122.16799999999999,1760,7350,4898,0.7039379131934463,4243600,48413764,44170164
775000.0,3,1.0,1460,6198,1.5,0,0,3,7,1460,0,1916,0.0,98107,47.6626,-122.361,2280,5160,4738,0.7644401419812843,2131600,38415204,36283604
605000.0,4,1.75,2250,10108,1.0,0,0,3,8,2250,0,1967,0.0,98008,47.5922,-122.118,2050,9750,7858,0.7774040364068064,5062500,102171664,97109164
193500.0,2,1.0,950,15996,1.0,0,0,3,7,950,0,1946,1995.0,98045,47.4987,-121.787,950,25510,15046,0.9406101525381345,902500,255872016,254969516
389950.0,4,2.5,3140,8060,2.0,0,0,2,9,3140,0,1991,0.0,98023,47.3091,-122.34299999999999,3000,8060,4920,0.6104218362282878,9859600,64963600,55104000
790000.0,4,3.5,3560,6098,2.0,0,0,2,10,3560,0,2006,0.0,98075,47.5828,-121.97200000000001,3660,6846,2538,0.41620203345359136,12673600,37185604,24512004
442000.0,2,1.0,1410,5000,1.0,0,2,3,7,940,470,1918,0.0,98126,47.5531,-122.37899999999999,1450,5000,3590,0.718,1988100,25000000,23011900
890000.0,4,2.25,2770,13500,2.0,0,0,2,8,2770,0,1974,0.0,98040,47.543,-122.23100000000001,2300,13500,10730,0.7948148148148149,7672900,182250000,174577100
235000.0,3,1.0,1864,6978,1.0,0,0,3,7,1864,0,1958,0.0,98002,47.285,-122.206,990,8000,5114,0.7328747492118085,3474496,48692484,45217988
495000.0,4,1.75,1930,6720,1.0,0,2,2,8,1130,800,1959,0.0,98115,47.6935,-122.31200000000001,1850,6380,4790,0.7127976190476191,3724900,45158400,41433500
600000.0,4,2.5,3870,50965,2.0,0,0,2,10,3870,0,2007,0.0,98010,47.3109,-122.045,2170,65843,47095,0.9240655351711959,14976900,2597431225,2582454325
1400000.0,3,2.0,2020,5500,1.5,0,3,2,10,1790,230,1937,0.0,98199,47.6388,-122.40899999999999,2580,5500,3480,0.6327272727272727,4080400,30250000,26169600
251000.0,3,2.0,1300,8400,1.0,0,0,3,7,1300,0,1967,0.0,98198,47.368,-122.315,1300,7500,7100,0.8452380952380952,1690000,70560000,68870000
471000.0,4,2.25,3410,57063,2.0,0,0,3,8,2410,1000,1978,0.0,98059,47.505,-122.11,2870,145490,53653,0.9402414874787516,11628100,3256185969,3244557869
597000.0,4,2.5,2370,41338,2.0,0,0,2,8,2370,0,1995,0.0,98077,47.7379,-122.052,2340,46661,38968,0.9426677633170448,5616900,1708830244,1703213344
804000.0,5,3.5,2770,9305,2.0,0,0,2,9,2770,0,1985,0.0,98006,47.5628,-122.11399999999999,2520,9773,6535,0.7023105857066093,7672900,86583025,78910125
357000.0,3,1.75,1250,17493,1.0,0,0,2,7,1250,0,1972,0.0,98155,47.7613,-122.274,2180,19553,16243,0.9285428457097125,1562500,306005049,304442549
419990.0,3,2.5,1690,1689,2.0,0,0,2,8,1150,540,2014,0.0,98029,47.5528,-121.999,1540,1689,-1,-0.0005920663114268798,2856100,2852721,-3379
725000.0,4,2.5,3040,35201,2.0,0,0,3,10,3040,0,1987,0.0,98027,47.4872,-122.066,2990,35416,32161,0.9136388170790603,9241600,1239110401,1229868801
275000.0,3,2.5,2710,5733,2.0,0,0,2,7,2710,0,2003,0.0,98092,47.3357,-122.171,2720,5733,3023,0.5272980987266701,7344100,32867289,25523189
445000.0,3,2.25,1190,13630,1.0,0,0,2,7,1190,0,1984,0.0,98045,47.4813,-121.735,1630,14405,12440,0.9126925898752751,1416100,185776900,184360800
510000.0,3,2.5,2300,27566,2.0,0,0,2,9,2300,0,1995,0.0,98019,47.7369,-121.96,2480,16650,25266,0.91656388304433,5290000,759884356,754594356
330000.0,4,1.0,1360,13372,1.0,0,0,2,7,1360,0,1955,0.0,98028,47.7622,-122.26299999999999,1540,10283,12012,0.8982949446604845,1849600,178810384,176960784
270000.0,3,1.0,1500,5605,1.0,0,0,4,6,750,750,1942,0.0,98106,47.5456,-122.359,1050,9100,4105,0.7323818019625334,2250000,31416025,29166025
495000.0,4,2.0,1610,4770,1.0,0,0,3,7,1230,380,1941,0.0,98126,47.5333,-122.381,1180,6120,3160,0.6624737945492662,2592100,22752900,20160800
225000.0,4,1.75,1420,10300,2.0,0,0,2,7,1420,0,1950,2001.0,98002,47.3121,-122.215,1420,10300,8880,0.8621359223300971,2016400,106090000,104073600
716528.0,3,1.5,1750,5400,1.0,0,0,3,7,1050,700,1952,0.0,98115,47.6799,-122.279,1750,5400,3650,0.6759259259259259,3062500,29160000,26097500
260000.0,3,2.5,1510,6095,2.0,0,0,3,7,1510,0,1991,0.0,98038,47.3498,-122.037,1520,6000,4585,0.7522559474979491,2280100,37149025,34868925
471000.0,4,2.5,2330,9928,2.0,0,0,2,8,2330,0,1998,0.0,98045,47.4836,-121.78299999999999,2430,8175,7598,0.765310233682514,5428900,98565184,93136284
690000.0,5,3.5,2690,4800,2.0,0,2,2,8,1930,760,1919,1984.0,98118,47.5592,-122.26899999999999,2080,4900,2110,0.4395833333333333,7236100,23040000,15803900
548000.0,5,1.5,1700,7200,1.5,0,0,2,7,1700,0,1937,0.0,98011,47.7614,-122.20299999999999,1460,7194,5500,0.7638888888888888,2890000,51840000,48950000
505000.0,3,1.0,1020,5410,1.0,0,0,3,7,880,140,1928,0.0,98115,47.6924,-122.31,1580,5376,4390,0.8114602587800369,1040400,29268100,28227700
325000.0,3,1.0,1160,11799,1.0,0,0,2,7,1160,0,1966,0.0,98034,47.7263,-122.229,1220,10500,10639,0.9016865836087804,1345600,139216401,137870801
682000.0,4,2.25,2450,34092,2.0,0,0,3,8,2450,0,1980,0.0,98075,47.5751,-122.04899999999999,2410,35378,31642,0.9281356329930776,6002500,1162264464,1156261964
605000.0,3,2.25,2010,10760,2.0,0,0,2,8,2010,0,1985,0.0,98052,47.7276,-122.103,2240,9357,8750,0.8131970260223048,4040100,115777600,111737500
276200.0,2,1.75,1370,4495,1.0,0,0,3,8,1370,0,1975,0.0,98198,47.3794,-122.31700000000001,1370,4686,3125,0.6952169076751946,1876900,20205025,18328125
530000.0,3,1.0,1370,4040,1.5,0,0,2,7,1370,0,1906,0.0,98103,47.6867,-122.354,1220,3030,2670,0.6608910891089109,1876900,16321600,14444700
245000.0,3,3.0,1990,9600,1.0,0,0,2,7,1440,550,1988,0.0,98003,47.3499,-122.296,1670,9600,7610,0.7927083333333333,3960100,92160000,88199900
654950.0,4,2.5,2790,45902,2.0,0,0,2,9,2790,0,1987,0.0,98077,47.7674,-122.086,2890,42421,43112,0.9392183347130844,7784100,2106993604,2099209504
221900.0,2,1.0,780,6727,1.0,0,0,2,6,780,0,1939,0.0,98168,47.4733,-122.281,1860,10124,5947,0.884049353352163,608400,45252529,44644129
466000.0,4,2.0,2240,4508,1.0,0,2,3,8,1340,900,1926,0.0,98178,47.5096,-122.25,1930,5250,2268,0.5031055900621118,5017600,20322064,15304464
383150.0,3,2.0,2210,6387,1.0,0,0,2,8,2210,0,2003,0.0,98003,47.265,-122.302,2570,6497,4177,0.6539846563331768,4884100,40793769,35909669
657100.0,4,1.0,1390,4240,1.0,0,0,2,7,1050,340,1924,0.0,98103,47.6596,-122.338,1810,4240,2850,0.6721698113207547,1932100,17977600,16045500
539000.0,3,2.0,1800,43995,2.0,0,0,2,8,1800,0,1988,0.0,98077,47.7585,-122.022,2290,51400,42195,0.9590862598022503,3240000,1935560025,1932320025
400000.0,6,3.0,3320,15600,1.0,0,0,3,8,1660,1660,1977,0.0,98092,47.2983,-122.166,2330,15360,12280,0.7871794871794872,11022400,243360000,232337600
215000.0,4,2.5,1960,11600,1.0,0,0,4,6,980,980,1931,0.0,98002,47.2898,-122.22200000000001,1160,7685,9640,0.8310344827586207,3841600,134560000,130718400
489000.0,2,1.0,850,2850,1.0,0,0,3,7,850,0,1927,0.0,98115,47.6875,-122.309,1450,4015,2000,0.7017543859649122,722500,8122500,7400000
649000.0,4,2.5,2980,12764,2.0,0,0,2,10,2980,0,1994,0.0,98075,47.5857,-122.027,3080,9810,9784,0.7665308680664369,8880400,162919696,154039296
700000.0,4,1.75,1980,10800,1.0,0,0,3,8,1320,660,1953,0.0,98005,47.5899,-122.17299999999999,2310,10800,8820,0.8166666666666667,3920400,116640000,112719600
268500.0,2,1.0,790,8424,1.0,0,0,3,6,790,0,1953,0.0,98133,47.7511,-122.352,1470,8424,7634,0.9062203228869895,624100,70963776,70339676
515000.0,3,2.5,1800,5001,2.0,0,0,2,7,1800,0,1996,0.0,98034,47.7126,-122.23100000000001,2106,5618,3201,0.6400719856028795,3240000,25010001,21770001
685000.0,4,2.0,2260,10800,1.0,0,0,2,9,2260,0,1978,0.0,98007,47.6124,-122.15299999999999,2650,9900,8540,0.7907407407407407,5107600,116640000,111532400
305000.0,2,1.5,800,2142,2.0,0,0,2,7,800,0,2006,0.0,98144,47.5917,-122.29700000000001,1320,2742,1342,0.6265172735760971,640000,4588164,3948164
950000.0,4,2.0,2490,4600,1.5,0,2,2,8,2090,400,1926,0.0,98105,47.6557,-122.27799999999999,2910,5000,2110,0.45869565217391306,6200100,21160000,14959900
292500.0,4,2.5,1610,4568,2.0,0,0,2,7,1610,0,2006,0.0,98001,47.3351,-122.289,1834,4604,2958,0.6475481611208407,2592100,20866624,18274524
270000.0,4,1.75,1850,7730,1.0,0,0,4,7,1100,750,1956,0.0,98133,47.7481,-122.355,2260,8581,5880,0.7606727037516171,3422500,59752900,56330400
450000.0,4,1.75,1850,7730,1.0,0,0,4,7,1100,750,1956,0.0,98133,47.7481,-122.355,2260,8581,5880,0.7606727037516171,3422500,59752900,56330400
535000.0,4,1.0,1920,6480,1.5,0,0,2,7,1920,0,1920,0.0,98117,47.6897,-122.374,1600,6470,4560,0.7037037037037037,3686400,41990400,38304000
550000.0,3,2.5,1740,3082,2.0,0,0,2,8,1740,0,2000,0.0,98029,47.5489,-122.006,1910,3075,1342,0.4354315379623621,3027600,9498724,6471124
457500.0,3,2.25,1430,2003,2.0,0,0,2,8,980,450,1996,0.0,98144,47.5908,-122.292,2210,4000,573,0.2860708936595107,2044900,4012009,1967109
136500.0,3,1.5,1420,8580,1.0,0,0,2,6,1420,0,1962,0.0,98023,47.3076,-122.36200000000001,1200,8580,7160,0.8344988344988346,2016400,73616400,71600000
224097.0,3,1.5,1420,8580,1.0,0,0,2,6,1420,0,1962,0.0,98023,47.3076,-122.36200000000001,1200,8580,7160,0.8344988344988346,2016400,73616400,71600000
254000.0,3,2.5,1560,10608,2.0,0,0,2,7,1560,0,1994,0.0,98042,47.3572,-122.161,1360,10608,9048,0.8529411764705882,2433600,112529664,110096064
335000.0,4,2.25,2030,13500,1.0,0,0,2,7,1230,800,1963,0.0,98059,47.4596,-122.066,1830,13800,11470,0.8496296296296296,4120900,182250000,178129100
594950.0,5,2.5,3280,6553,2.0,0,0,2,9,3280,0,2012,0.0,98045,47.475,-121.73700000000001,3360,7242,3273,0.4994658934839005,10758400,42941809,32183409
350000.0,3,1.75,1360,18123,1.0,0,0,2,8,1360,0,1983,0.0,98045,47.4716,-121.756,1570,16817,16763,0.924957236660597,1849600,328443129,326593529
169950.0,3,1.0,1180,9832,1.0,0,0,2,7,1180,0,1970,0.0,98042,47.3845,-122.085,1220,9894,8652,0.8799837266069975,1392400,96668224,95275824
432500.0,3,2.5,1940,10800,1.0,0,0,2,8,1340,600,1979,0.0,98077,47.7471,-122.075,2080,9600,8860,0.8203703703703704,3763600,116640000,112876400
440000.0,2,1.75,1300,4000,2.0,0,0,2,7,1300,0,1948,0.0,98105,47.6687,-122.288,1350,4013,2700,0.675,1690000,16000000,14310000
233703.0,3,2.25,1650,3788,2.0,0,0,2,7,1650,0,1985,0.0,98031,47.3908,-122.167,1510,3994,2138,0.5644139387539598,2722500,14348944,11626444
310000.0,3,1.5,1140,3292,2.0,0,0,2,7,1140,0,1988,0.0,98029,47.5701,-122.01700000000001,1150,3592,2152,0.6537059538274606,1299600,10837264,9537664
735000.0,3,2.5,2540,6762,2.0,0,0,2,10,2540,0,1998,0.0,98007,47.6239,-122.14399999999999,2870,6631,4222,0.624371487725525,6451600,45724644,39273044
730000.0,4,2.75,3440,8150,2.0,0,0,2,10,3440,0,2014,0.0,98056,47.5168,-122.189,2560,8315,4710,0.5779141104294478,11833600,66422500,54588900
257000.0,3,1.75,1800,9000,1.0,0,0,2,7,1200,600,1961,0.0,98178,47.4932,-122.27799999999999,980,6000,7200,0.8,3240000,81000000,77760000
485000.0,2,2.25,1260,1240,3.0,0,0,2,8,1260,0,2004,0.0,98103,47.6531,-122.352,1330,1300,-20,-0.016129032258064516,1587600,1537600,-50000
899000.0,4,2.25,2370,6000,1.0,0,2,2,8,1440,930,1959,0.0,98177,47.7023,-122.38799999999999,3280,8843,3630,0.605,5616900,36000000,30383100
279000.0,3,1.0,1520,8055,1.5,0,0,2,7,1520,0,1952,0.0,98125,47.7222,-122.305,1560,8160,6535,0.8112973308504035,2310400,64883025,62572625
225000.0,4,2.0,1750,7245,1.0,0,0,3,7,1050,700,1974,0.0,98092,47.3164,-122.196,1640,7245,5495,0.7584541062801933,3062500,52490025,49427525
1360000.0,3,1.5,2680,4775,2.0,0,2,4,8,1880,800,1913,0.0,98109,47.6333,-122.34700000000001,2280,5947,2095,0.4387434554973822,7182400,22800625,15618225
355000.0,3,2.5,1590,4242,2.0,0,0,2,7,1590,0,2000,0.0,98065,47.5309,-121.876,1590,3702,2652,0.6251768033946252,2528100,17994564,15466464
382500.0,4,1.75,1560,8700,1.0,0,0,3,7,1560,0,1967,0.0,98034,47.7274,-122.181,2080,8000,7140,0.8206896551724138,2433600,75690000,73256400
324360.0,3,2.5,2000,9669,2.0,0,0,3,8,2000,0,1992,0.0,98022,47.1964,-122.009,1930,9202,7669,0.7931533767711242,4000000,93489561,89489561
315000.0,3,1.75,2380,10450,1.5,0,0,2,8,2380,0,1966,0.0,98023,47.3143,-122.37,2320,8500,8070,0.7722488038277512,5664400,109202500,103538100
426000.0,2,1.0,2230,11472,2.0,0,0,2,7,2230,0,1951,0.0,98133,47.7372,-122.35,1870,8649,9242,0.8056136680613668,4972900,131606784,126633884
395000.0,5,2.5,2820,6305,2.0,0,0,2,8,2820,0,2003,0.0,98003,47.2616,-122.296,2610,6306,3485,0.5527359238699445,7952400,39753025,31800625
212644.0,3,1.0,1570,9650,1.5,0,0,4,5,1570,0,1922,0.0,98010,47.3531,-121.98200000000001,1330,9650,8080,0.8373056994818653,2464900,93122500,90657600
510000.0,3,3.0,1845,5100,2.0,0,2,4,8,1845,0,1947,0.0,98056,47.5204,-122.208,2100,7650,3255,0.638235294117647,3404025,26010000,22605975
85000.0,2,1.0,830,9000,1.0,0,0,2,6,830,0,1939,0.0,98032,47.3813,-122.243,1160,7680,8170,0.9077777777777778,688900,81000000,80311100
235000.0,2,1.0,830,9000,1.0,0,0,2,6,830,0,1939,0.0,98032,47.3813,-122.243,1160,7680,8170,0.9077777777777778,688900,81000000,80311100
295000.0,4,2.5,2030,5754,2.0,0,0,2,8,2030,0,2001,0.0,98042,47.3542,-122.137,2030,5784,3724,0.6472019464720195,4120900,33108516,28987616
720001.0,3,2.5,1430,2200,1.5,0,0,3,7,1430,0,1910,0.0,98103,47.6601,-122.331,1740,4275,770,0.35,2044900,4840000,2795100
313950.0,3,1.0,1510,6083,1.0,0,0,3,6,860,650,1940,0.0,98115,47.6966,-122.324,1510,5712,4573,0.7517672201216505,2280100,37002889,34722789
415000.0,3,1.0,1510,6083,1.0,0,0,3,6,860,650,1940,0.0,98115,47.6966,-122.324,1510,5712,4573,0.7517672201216505,2280100,37002889,34722789
305000.0,3,1.75,1610,12247,1.0,0,0,2,8,1610,0,1981,0.0,98058,47.4476,-122.124,2010,9271,10637,0.8685392340981465,2592100,149989009,147396909
625000.0,3,1.5,1600,4128,1.5,0,0,2,8,1250,350,1906,0.0,98122,47.6122,-122.29700000000001,1540,3976,2528,0.6124031007751938,2560000,17040384,14480384
490000.0,3,1.0,1420,11040,1.0,0,0,3,7,1420,0,1961,0.0,98007,47.5969,-122.14,1530,8208,9620,0.8713768115942029,2016400,121881600,119865200
269950.0,3,2.0,1660,8641,2.0,0,0,3,8,1660,0,1987,0.0,98042,47.3663,-122.088,1490,8641,6981,0.8078926050225669,2755600,74666881,71911281
2700000.0,5,4.0,4230,27295,2.0,1,4,2,8,3230,1000,1949,0.0,98033,47.6803,-122.214,2660,27295,23065,0.8450265616413263,17892900,745017025,727124125
829000.0,4,3.0,3310,4500,2.5,0,0,4,9,2910,400,1900,0.0,98103,47.6594,-122.345,1440,3750,1190,0.2644444444444444,10956100,20250000,9293900
635000.0,4,2.5,2470,77550,1.0,0,0,3,7,2470,0,1987,0.0,98075,47.5888,-122.01100000000001,2490,40894,75080,0.9681495809155384,6100900,6014002500,6007901600
217500.0,3,1.0,1040,9750,1.0,0,0,2,7,1040,0,1959,0.0,98188,47.4553,-122.274,1510,11100,8710,0.8933333333333333,1081600,95062500,93980900
270000.0,4,1.75,1850,7350,1.0,0,0,2,7,1050,800,1965,0.0,98001,47.3413,-122.277,1450,7250,5500,0.7482993197278912,3422500,54022500,50600000
1250000.0,3,3.0,4610,8400,2.0,0,2,2,8,2790,1820,1947,1999.0,98144,47.5854,-122.292,2160,5000,3790,0.4511904761904762,21252100,70560000,49307900
480000.0,4,2.5,2480,5100,2.0,0,0,2,8,2480,0,2007,0.0,98019,47.7383,-121.969,2270,5115,2620,0.5137254901960784,6150400,26010000,19859600
575000.0,3,1.75,2130,6500,1.0,0,2,2,8,1170,960,1954,0.0,98199,47.6424,-122.38600000000001,2020,5000,4370,0.6723076923076923,4536900,42250000,37713100
426950.0,4,2.75,2350,5589,2.0,0,0,2,7,2350,0,2001,0.0,98059,47.5098,-122.155,2014,6365,3239,0.5795312220432993,5522500,31236921,25714421
125000.0,3,1.0,920,7314,1.0,0,0,2,6,920,0,1960,0.0,98002,47.2892,-122.22,1010,7420,6394,0.8742138364779874,846400,53494596,52648196
208000.0,3,1.0,920,7314,1.0,0,0,2,6,920,0,1960,0.0,98002,47.2892,-122.22,1010,7420,6394,0.8742138364779874,846400,53494596,52648196
325000.0,4,2.0,1780,10622,1.0,0,0,3,7,900,880,1976,0.0,98058,47.4573,-122.15799999999999,1550,8900,8842,0.8324232724533986,3168400,112826884,109658484
597157.0,7,4.0,2690,10880,1.0,0,0,3,8,2690,0,1960,0.0,98033,47.6787,-122.16799999999999,1840,10836,8190,0.7527573529411765,7236100,118374400,111138300
728725.0,4,2.5,3010,3120,2.5,0,2,2,8,3010,0,2006,0.0,98029,47.5539,-121.99600000000001,2140,3840,110,0.035256410256410256,9060100,9734400,674300
708000.0,5,2.0,3180,10800,1.0,0,0,2,8,1910,1270,1968,0.0,98052,47.6354,-122.103,2440,9750,7620,0.7055555555555556,10112400,116640000,106527600
1300000.0,4,3.0,4120,14021,2.0,0,0,2,11,4120,0,2005,0.0,98075,47.5985,-122.02600000000001,4390,14684,9901,0.7061550531345838,16974400,196588441,179614041
405000.0,3,1.0,1280,11625,1.0,0,0,3,7,1280,0,1977,0.0,98053,47.6827,-122.059,1320,10875,10345,0.8898924731182796,1638400,135140625,133502225
550000.0,4,2.75,1690,6090,1.5,0,0,2,7,1400,290,1945,0.0,98115,47.6814,-122.26899999999999,1820,6090,4400,0.722495894909688,2856100,37088100,34232000
451000.0,4,2.5,2320,5375,2.0,0,0,2,7,2320,0,2006,0.0,98065,47.5415,-121.883,2060,5395,3055,0.5683720930232559,5382400,28890625,23508225
540500.0,5,3.75,3090,7415,2.0,0,0,2,8,3090,0,2014,0.0,98166,47.435,-122.329,2790,7425,4325,0.5832771409305462,9548100,54982225,45434125
1030000.0,5,3.5,5050,16500,2.0,0,2,2,11,5050,0,2001,0.0,98075,47.5863,-121.96700000000001,4570,16500,11450,0.693939393939394,25502500,272250000,246747500
218000.0,4,1.0,1640,10455,1.0,0,0,2,7,950,690,1963,0.0,98023,47.2974,-122.366,1360,9750,8815,0.8431372549019608,2689600,109307025,106617425
562000.0,4,2.25,2170,7007,1.0,0,0,2,8,1540,630,1974,0.0,98033,47.672,-122.169,2040,7700,4837,0.6903096903096904,4708900,49098049,44389149
401500.0,4,2.5,3140,94525,2.0,0,0,3,8,2280,860,1977,0.0,98042,47.4155,-122.163,1910,14300,91385,0.9667812747950277,9859600,8934975625,8925116025
196700.0,2,1.0,1090,9994,1.0,0,0,2,7,1090,0,1954,0.0,98168,47.4761,-122.287,1090,11700,8904,0.8909345607364418,1188100,99880036,98691936
583000.0,3,1.75,1930,10183,1.0,0,0,3,8,1480,450,1975,0.0,98006,47.5624,-122.135,2320,10000,8253,0.8104684277717765,3724900,103693489,99968589
309900.0,5,2.5,2100,17825,1.0,0,0,3,7,1400,700,1974,0.0,98092,47.3094,-122.191,2200,14602,15725,0.8821879382889201,4410000,317730625,313320625
485000.0,4,3.0,3110,18843,2.0,0,0,2,9,3110,0,1995,0.0,98058,47.4619,-122.154,3080,14735,15733,0.8349519715544234,9672100,355058649,345386549
465000.0,3,1.0,930,3348,1.0,0,0,3,6,930,0,1926,0.0,98118,47.5532,-122.277,1210,3348,2418,0.7222222222222222,864900,11209104,10344204
595000.0,4,2.25,2050,8372,2.0,0,0,3,8,2050,0,1984,0.0,98052,47.7234,-122.10700000000001,2010,8037,6322,0.7551361681796465,4202500,70090384,65887884
254000.0,3,1.0,1160,7560,1.0,0,0,3,6,1160,0,1958,0.0,98058,47.45,-122.179,1160,7560,6400,0.8465608465608465,1345600,57153600,55808000
488500.0,3,2.75,1820,9490,2.0,0,0,2,7,1820,0,1994,0.0,98011,47.7481,-122.178,1950,8851,7670,0.8082191780821918,3312400,90060100,86747700
260000.0,4,2.5,2110,8990,2.0,0,0,2,8,2110,0,1977,0.0,98058,47.4457,-122.12700000000001,2040,8800,6880,0.7652947719688543,4452100,80820100,76368000
166000.0,2,1.0,870,8487,1.0,0,0,3,6,870,0,1944,0.0,98178,47.4955,-122.23899999999999,1350,6850,7617,0.8974902792506186,756900,72029169,71272269
440000.0,2,1.5,1080,6760,1.0,0,2,2,6,1080,0,1923,0.0,98117,47.7008,-122.38600000000001,2080,5800,5680,0.8402366863905325,1166400,45697600,44531200
375000.0,3,2.0,1260,7560,2.0,0,0,4,6,1260,0,1943,0.0,98133,47.7225,-122.351,1260,7595,6300,0.8333333333333334,1587600,57153600,55566000
529500.0,2,1.0,900,4800,1.0,0,0,3,6,780,120,1944,0.0,98199,47.6575,-122.4,1270,5520,3900,0.8125,810000,23040000,22230000
338000.0,2,1.0,750,6439,1.0,0,0,3,6,750,0,1934,0.0,98103,47.6995,-122.354,1470,6374,5689,0.8835222860692654,562500,41460721,40898221
335620.0,3,2.25,1800,15903,1.0,0,0,2,8,1340,460,1986,0.0,98038,47.3813,-122.04299999999999,2000,15233,14103,0.8868138087153368,3240000,252905409,249665409
464000.0,4,2.25,2220,15232,1.0,0,0,2,9,1690,530,1978,0.0,98072,47.7449,-122.103,2110,15280,13012,0.8542542016806722,4928400,232013824,227085424
354000.0,2,1.0,1390,7740,1.0,0,0,3,6,1390,0,1925,0.0,98126,47.5232,-122.37100000000001,1290,7740,6350,0.8204134366925064,1932100,59907600,57975500
601000.0,4,3.5,2160,3600,2.0,0,0,2,8,1660,500,1998,0.0,98122,47.6103,-122.29700000000001,1230,3840,1440,0.4,4665600,12960000,8294400
285000.0,3,2.25,1840,9040,1.0,0,0,2,8,1370,470,1979,0.0,98023,47.3144,-122.339,1870,8992,7200,0.7964601769911505,3385600,81721600,78336000
462500.0,2,2.0,1690,4200,2.0,0,0,2,7,1690,0,1906,0.0,98112,47.621,-122.303,1540,4200,2510,0.5976190476190476,2856100,17640000,14783900
350000.0,4,2.5,2650,10459,2.0,0,0,3,8,2650,0,1989,0.0,98003,47.2739,-122.29299999999999,2340,8777,7809,0.7466296969117506,7022500,109390681,102368181
329000.0,4,1.0,1120,3844,1.0,0,0,2,7,1120,0,1972,0.0,98133,47.7038,-122.352,1480,3844,2724,0.708636836628512,1254400,14776336,13521936
312500.0,4,2.5,2500,11983,1.0,0,0,2,7,1320,1180,1984,2008.0,98058,47.4292,-122.148,1460,9005,9483,0.7913711090711841,6250000,143592289,137342289
370000.0,4,2.5,2220,5338,2.0,0,0,2,7,2220,0,2001,0.0,98059,47.4887,-122.15,2220,5338,3118,0.5841139003372049,4928400,28494244,23565844
399900.0,3,1.75,1260,12750,1.0,0,0,2,7,1260,0,1979,0.0,98034,47.7289,-122.23299999999999,1460,7865,11490,0.9011764705882352,1587600,162562500,160974900
398000.0,3,1.0,1480,6550,1.5,0,0,3,6,1480,0,1925,0.0,98126,47.5498,-122.381,1200,6550,5070,0.7740458015267175,2190400,42902500,40712100
550500.0,2,1.5,930,7400,1.0,0,2,3,7,830,100,1909,0.0,98116,47.5691,-122.40799999999999,1920,4152,6470,0.8743243243243243,864900,54760000,53895100
709000.0,3,2.75,2780,7200,1.5,0,0,3,8,1870,910,1913,0.0,98118,47.5632,-122.27,1700,7200,4420,0.6138888888888889,7728400,51840000,44111600
402000.0,5,2.75,2770,7620,1.0,0,0,2,7,1700,1070,1965,0.0,98106,47.5188,-122.348,1720,7620,4850,0.636482939632546,7672900,58064400,50391500
450000.0,3,1.5,1530,23660,1.0,0,0,2,7,1530,0,1952,0.0,98155,47.7467,-122.295,1800,11407,22130,0.9353338968723585,2340900,559795600,557454700
524000.0,3,2.25,2140,6720,1.0,0,0,2,8,1440,700,1961,0.0,98117,47.6949,-122.396,2060,6720,4580,0.6815476190476191,4579600,45158400,40578800
800000.0,4,2.75,4600,322188,1.0,0,4,2,10,2400,2200,1989,0.0,98045,47.4626,-121.73899999999999,3740,114562,317588,0.985722621574981,21160000,103805107344,103783947344
185000.0,4,1.0,1760,8906,1.0,0,0,2,7,1230,530,1966,0.0,98055,47.4288,-122.198,1180,10407,7146,0.8023804176959354,3097600,79316836,76219236
365000.0,4,1.0,1760,8906,1.0,0,0,2,7,1230,530,1966,0.0,98055,47.4288,-122.198,1180,10407,7146,0.8023804176959354,3097600,79316836,76219236
925000.0,4,2.5,3110,11422,2.0,0,0,2,9,3110,0,1989,0.0,98115,47.6833,-122.271,2850,7254,8312,0.7277184381019086,9672100,130462084,120789984
714000.0,3,1.75,2260,11781,1.0,0,0,3,8,1520,740,1968,0.0,98008,47.5982,-122.12799999999999,2530,10176,9521,0.8081656905186317,5107600,138791961,133684361
495000.0,3,2.0,1460,9759,1.0,0,0,4,7,1460,0,1972,0.0,98052,47.6644,-122.14399999999999,1620,8421,8299,0.850394507633979,2131600,95238081,93106481
535000.0,3,2.25,2050,6648,1.0,0,0,2,7,1230,820,1990,0.0,98133,47.7258,-122.33200000000001,1760,7200,4598,0.6916365824308063,4202500,44195904,39993404
880000.0,4,2.5,2340,10800,1.0,0,0,2,8,2340,0,1953,2007.0,98040,47.5715,-122.225,2650,13500,8460,0.7833333333333333,5475600,116640000,111164400
150000.0,3,1.5,1230,8056,1.0,0,0,3,6,1230,0,1949,0.0,98168,47.4878,-122.314,850,6714,6826,0.8473187686196624,1512900,64899136,63386236
554500.0,3,2.25,1880,6565,1.0,0,0,3,8,1420,460,1972,0.0,98008,47.6396,-122.113,2060,7280,4685,0.7136329017517137,3534400,43099225,39564825
520000.0,3,1.75,1280,3880,1.5,0,0,4,7,1280,0,1916,0.0,98117,47.6871,-122.391,980,3880,2600,0.6701030927835051,1638400,15054400,13416000
839990.0,4,2.75,3660,5637,2.0,0,0,2,9,3660,0,2014,0.0,98053,47.6845,-122.01700000000001,3625,5639,1977,0.35071846726982436,13395600,31775769,18380169
500000.0,3,2.5,1650,5683,2.0,0,0,2,7,1650,0,2003,0.0,98053,47.683,-122.035,1650,4193,4033,0.7096603906387472,2722500,32296489,29573989
305000.0,2,1.0,1960,186872,1.5,0,0,3,6,1960,0,1936,0.0,98001,47.2681,-122.26700000000001,1650,19200,184912,0.9895115373089601,3841600,34921144384,34917302784
247800.0,3,2.5,1580,2170,2.0,0,0,2,7,1580,0,2003,0.0,98118,47.5418,-122.289,1610,1917,590,0.271889400921659,2496400,4708900,2212500
344200.0,4,2.5,2490,5812,2.0,0,0,2,8,2490,0,2000,0.0,98042,47.3875,-122.155,2690,6012,3322,0.5715760495526497,6200100,33779344,27579244
459950.0,4,2.5,2000,6107,2.0,0,0,2,8,2000,0,2003,0.0,98011,47.7557,-122.221,2040,6520,4107,0.6725069592271165,4000000,37295449,33295449
229900.0,4,1.75,1550,9899,1.0,0,0,3,7,1550,0,1967,0.0,98030,47.3583,-122.18299999999999,1500,11272,8349,0.8434185271239519,2402500,97990201,95587701
750000.0,4,2.25,2820,9602,1.0,0,1,2,8,1950,870,1974,0.0,98008,47.5881,-122.113,2890,9602,6782,0.7063111851697563,7952400,92198404,84246004
509000.0,4,2.5,2600,9355,1.0,0,0,2,9,1840,760,1983,0.0,98028,47.7446,-122.249,2250,7691,6755,0.7220737573490112,6760000,87516025,80756025
680000.0,4,1.0,2200,12137,1.0,0,4,3,8,1640,560,1956,0.0,98028,47.7473,-122.26100000000001,3250,17153,9937,0.8187360962346544,4840000,147306769,142466769
661500.0,5,2.5,2500,7200,1.0,0,0,3,7,1490,1010,1977,0.0,98052,47.6964,-122.12,1960,8325,4700,0.6527777777777778,6250000,51840000,45590000
370000.0,2,1.0,1270,1399,3.0,0,0,2,7,1270,0,2000,0.0,98136,47.5552,-122.381,1140,1442,129,0.09220872051465333,1612900,1957201,344301
785000.0,4,2.75,2900,17400,1.0,0,0,3,8,2410,490,1978,0.0,98052,47.6431,-122.10799999999999,2620,12240,14500,0.8333333333333334,8410000,302760000,294350000
355000.0,2,1.0,840,6720,1.0,0,0,2,7,840,0,1952,0.0,98116,47.5707,-122.396,1250,6720,5880,0.875,705600,45158400,44452800
446000.0,4,2.0,1940,6350,1.0,0,0,3,7,970,970,1951,0.0,98103,47.6948,-122.35700000000001,960,6350,4410,0.694488188976378,3763600,40322500,36558900
830000.0,5,3.5,3490,21780,2.0,0,0,2,8,3490,0,1996,0.0,98052,47.6707,-122.14399999999999,3070,7829,18290,0.839761248852158,12180100,474368400,462188300
324000.0,3,2.5,1940,8347,2.0,0,0,2,8,1940,0,1990,0.0,98042,47.3654,-122.164,1940,7131,6407,0.7675811668863065,3763600,69672409,65908809
500000.0,4,2.25,2490,23478,2.0,0,0,2,8,2490,0,1981,0.0,98072,47.7547,-122.094,2030,12611,20988,0.8939432660362893,6200100,551216484,545016384
745000.0,3,1.0,1390,9112,1.0,0,0,3,7,1390,0,1951,0.0,98004,47.6071,-122.197,2290,9112,7722,0.8474539069359087,1932100,83028544,81096444
1200000.0,4,2.5,3940,4407,2.0,0,0,3,8,2620,1320,1921,0.0,98112,47.6374,-122.29899999999999,1790,4407,467,0.10596777853415021,15523600,19421649,3898049
385000.0,2,2.5,1760,3710,1.0,0,0,2,8,1130,630,1988,0.0,98072,47.7335,-122.16,1760,4200,1950,0.5256064690026954,3097600,13764100,10666500
565000.0,3,2.25,2560,8040,1.0,0,0,2,8,1510,1050,1958,0.0,98125,47.7124,-122.303,1980,8040,5480,0.681592039800995,6553600,64641600,58088000
465000.0,4,2.5,2300,7314,1.0,0,0,3,8,1420,880,1979,0.0,98133,47.7671,-122.33,2010,7314,5014,0.6855345911949685,5290000,53494596,48204596
401000.0,3,3.25,1770,1977,3.0,0,0,2,8,1770,0,2001,0.0,98125,47.7186,-122.314,1860,2210,207,0.1047040971168437,3132900,3908529,775629
385000.0,3,1.75,2310,11200,1.0,0,0,3,8,1630,680,1978,0.0,98030,47.3637,-122.21,2350,13300,8890,0.79375,5336100,125440000,120103900
395000.0,3,2.5,2310,4930,2.0,0,0,3,8,2310,0,1989,0.0,98055,47.4512,-122.208,2230,5324,2620,0.5314401622718052,5336100,24304900,18968800
245000.0,5,1.5,2000,8100,1.5,0,0,2,6,2000,0,1946,0.0,98168,47.4945,-122.304,960,9239,6100,0.7530864197530864,4000000,65610000,61610000
500000.0,3,2.0,1540,3600,1.0,0,0,2,7,890,650,1994,0.0,98122,47.6103,-122.296,1540,3600,2060,0.5722222222222222,2371600,12960000,10588400
334000.0,5,1.75,2590,6720,1.0,0,0,3,7,1750,840,1979,0.0,98055,47.435,-122.19200000000001,1820,7521,4130,0.6145833333333334,6708100,45158400,38450300
550000.0,3,1.0,980,10960,1.0,0,0,3,7,980,0,1953,0.0,98005,47.5908,-122.17299999999999,2100,10960,9980,0.9105839416058394,960400,120121600,119161200
216000.0,3,1.0,1730,7950,1.0,0,0,3,7,1180,550,1961,0.0,98198,47.3644,-122.31200000000001,1830,8890,6220,0.7823899371069183,2992900,63202500,60209600
340500.0,3,2.5,3070,5871,3.0,0,0,3,8,2510,560,1928,0.0,98178,47.5007,-122.223,2220,4000,2801,0.47709078521546583,9424900,34468641,25043741
375000.0,4,2.25,2100,12738,2.0,0,0,3,8,2100,0,1975,0.0,98059,47.4698,-122.118,2000,12090,10638,0.8351389543099388,4410000,162256644,157846644
600000.0,3,2.75,2080,16740,1.0,0,3,2,8,1580,500,1966,0.0,98198,47.3632,-122.324,2175,7568,14660,0.8757467144563919,4326400,280227600,275901200
375000.0,4,1.75,1890,8000,1.0,0,0,3,7,1250,640,1960,0.0,98133,47.7576,-122.333,1870,8270,6110,0.76375,3572100,64000000,60427900
536500.0,4,1.75,2000,4000,1.5,0,0,4,7,1450,550,1926,0.0,98126,47.5659,-122.375,1430,4000,2000,0.5,4000000,16000000,12000000
599900.0,3,3.0,3030,35123,2.0,0,0,3,8,1760,1270,1984,0.0,98027,47.4694,-122.006,2810,36205,32093,0.9137317427326823,9180900,1233625129,1224444229
750000.0,2,1.5,1110,3600,1.0,0,0,4,7,1110,0,1904,0.0,98119,47.6382,-122.359,1670,5400,2490,0.6916666666666667,1232100,12960000,11727900
355000.0,3,1.0,1650,10075,1.0,0,0,2,7,1170,480,1955,0.0,98177,47.7695,-122.359,1690,8125,8425,0.8362282878411911,2722500,101505625,98783125
590000.0,3,2.0,1410,6413,1.0,0,0,3,7,910,500,1947,0.0,98115,47.6826,-122.29799999999999,1330,6050,5003,0.7801341026040854,1988100,41126569,39138469
680000.0,2,1.0,2140,6000,1.0,0,0,3,7,1070,1070,1946,0.0,98199,47.651,-122.399,1560,6000,3860,0.6433333333333333,4579600,36000000,31420400
429000.0,3,2.5,1860,11122,2.0,0,0,2,8,1860,0,1994,0.0,98059,47.5062,-122.15100000000001,2420,8542,9262,0.8327638913864412,3459600,123698884,120239284
581000.0,2,1.0,1170,4080,1.0,0,0,3,7,1170,0,1909,0.0,98117,47.6784,-122.38600000000001,1560,4586,2910,0.7132352941176471,1368900,16646400,15277500
463800.0,3,1.5,980,7770,1.0,0,0,3,7,980,0,1968,0.0,98033,47.6923,-122.20100000000001,1470,7350,6790,0.8738738738738738,960400,60372900,59412500
2980000.0,5,5.5,7400,18898,2.0,0,3,2,13,6290,1110,2001,0.0,98006,47.5431,-122.11200000000001,6110,26442,11498,0.6084241718700392,54760000,357134404,302374404
443000.0,5,1.75,1650,3000,1.5,0,0,2,8,1650,0,1902,0.0,98144,47.5955,-122.306,1740,4000,1350,0.45,2722500,9000000,6277500
276200.0,3,2.5,1480,7210,1.0,0,0,2,7,1180,300,1986,0.0,98023,47.3124,-122.351,1690,7396,5730,0.7947295423023578,2190400,51984100,49793700
630000.0,5,3.5,4060,8309,2.0,0,0,2,9,2960,1100,2001,0.0,98028,47.757,-122.228,1730,11711,4249,0.5113732097725358,16483600,69039481,52555881
570000.0,3,1.75,1370,3300,2.0,0,0,4,7,1370,0,1927,0.0,98105,47.6714,-122.32,1560,3927,1930,0.5848484848484848,1876900,10890000,9013100
979700.0,4,2.25,2480,6000,2.0,0,2,2,10,2380,100,1929,0.0,98199,47.6392,-122.406,3030,5600,3520,0.5866666666666667,6150400,36000000,29849600
730000.0,4,2.5,2030,4080,1.5,0,0,3,8,1730,300,1921,0.0,98115,47.6753,-122.311,1980,4080,2050,0.5024509803921569,4120900,16646400,12525500
268450.0,5,2.25,2200,9600,1.0,0,0,3,7,1100,1100,1963,0.0,98023,47.3263,-122.36399999999999,1780,9680,7400,0.7708333333333334,4840000,92160000,87320000
490000.0,3,1.75,1770,7508,1.0,0,0,2,7,1270,500,1962,0.0,98133,47.7354,-122.34299999999999,1690,8880,5738,0.7642514651038892,3132900,56370064,53237164
808000.0,3,2.5,2550,6240,1.0,0,3,4,8,1750,800,1957,0.0,98117,47.6992,-122.387,2180,5200,3690,0.5913461538461539,6502500,38937600,32435100
350000.0,3,1.0,1250,9786,1.0,0,0,3,7,1250,0,1969,0.0,98072,47.7622,-122.163,1660,9621,8536,0.8722665031677908,1562500,95765796,94203296
695000.0,4,1.75,2390,5880,1.0,0,2,2,8,1390,1000,1957,0.0,98117,47.6956,-122.399,2210,6260,3490,0.5935374149659864,5712100,34574400,28862300
1230000.0,4,2.5,5730,44947,2.0,0,4,2,11,4280,1450,1991,0.0,98074,47.6052,-122.064,3310,17628,39217,0.8725165194562484,32832900,2020232809,1987399909
309950.0,1,1.0,1120,11800,1.5,0,0,2,7,1120,0,1950,0.0,98168,47.5123,-122.331,2330,9290,10680,0.9050847457627119,1254400,139240000,137985600
134000.0,3,1.0,1270,8508,1.0,0,0,3,6,650,620,1942,0.0,98168,47.4961,-122.322,1200,9415,7238,0.8507287259050306,1612900,72386064,70773164
645500.0,4,2.5,2390,9638,2.0,0,0,2,10,2390,0,1988,0.0,98029,47.5598,-122.01799999999999,2630,9258,7248,0.7520232413363769,5712100,92891044,87178944
750000.0,3,2.0,1760,5488,1.5,0,0,2,7,1540,220,1927,0.0,98119,47.6479,-122.367,1760,5943,3728,0.6793002915451894,3097600,30118144,27020544
1400000.0,3,2.5,2560,3600,2.0,0,0,2,9,2110,450,1967,0.0,98112,47.632,-122.279,2690,4800,1040,0.28888888888888886,6553600,12960000,6406400
344900.0,4,1.75,1820,7700,1.0,0,0,3,7,1100,720,1955,0.0,98177,47.7545,-122.35700000000001,1700,8500,5880,0.7636363636363637,3312400,59290000,55977600
601450.0,2,3.25,1840,1500,3.0,0,0,2,8,1840,0,2001,0.0,98103,47.6595,-122.354,1910,2500,-340,-0.22666666666666666,3385600,2250000,-1135600
575000.0,4,2.0,1810,4400,2.0,0,0,2,8,1700,110,1909,0.0,98122,47.6132,-122.292,1470,4400,2590,0.5886363636363636,3276100,19360000,16083900
405000.0,3,1.75,2470,9620,1.0,0,1,3,7,1570,900,1962,0.0,98198,47.3996,-122.32,2600,9620,7150,0.7432432432432432,6100900,92544400,86443500
518000.0,4,2.75,2520,14021,2.0,0,0,2,9,2520,0,1999,0.0,98019,47.7344,-121.95700000000001,2330,14007,11501,0.8202695956065901,6350400,196588441,190238041
265000.0,2,1.0,1600,7936,1.0,0,0,2,7,1600,0,1947,0.0,98155,47.7411,-122.322,1580,7440,6336,0.7983870967741935,2560000,62980096,60420096
180000.0,3,1.0,1280,4875,1.0,0,0,4,6,1280,0,1969,0.0,98042,47.3686,-122.081,1060,4875,3595,0.7374358974358974,1638400,23765625,22127225
285000.0,3,2.5,1590,9736,2.0,0,0,2,7,1590,0,1985,0.0,98001,47.33,-122.27799999999999,1580,7500,8146,0.8366885784716516,2528100,94789696,92261596
433000.0,3,2.75,2000,7200,1.0,0,0,2,7,1000,1000,1954,2014.0,98166,47.4531,-122.352,1440,7200,5200,0.7222222222222222,4000000,51840000,47840000
399000.0,3,1.75,1780,11440,1.0,0,0,2,8,1350,430,1977,0.0,98059,47.474,-122.139,2180,11440,9660,0.8444055944055944,3168400,130873600,127705200
565000.0,3,2.5,1700,7210,2.0,0,0,4,7,1700,0,1966,0.0,98052,47.6688,-122.161,1700,7566,5510,0.7642163661581137,2890000,51984100,49094100
406500.0,3,1.5,1970,10080,1.0,0,0,2,7,1970,0,1966,0.0,98168,47.4703,-122.27600000000001,2240,10080,8110,0.8045634920634921,3880900,101606400,97725500
420000.0,4,1.75,1940,11500,1.0,0,0,3,7,1090,850,1955,0.0,98006,47.5774,-122.147,1700,8360,9560,0.831304347826087,3763600,132250000,128486400
965000.0,4,3.5,3290,5559,1.5,0,0,2,8,2290,1000,1906,2004.0,98103,47.6788,-122.346,1790,6000,2269,0.4081669364993704,10824100,30902481,20078381
1380000.0,4,3.5,3500,9523,2.0,0,0,2,10,2460,1040,1996,0.0,98033,47.6848,-122.208,3160,5997,6023,0.6324687598445868,12250000,90687529,78437529
353950.0,5,2.25,3260,7969,2.0,0,0,3,8,3260,0,1982,0.0,98023,47.31399999999999,-122.344,2070,7962,4709,0.5909147948299661,10627600,63504961,52877361
847700.0,5,3.25,4230,10260,2.0,0,0,2,10,3860,370,1996,0.0,98027,47.5503,-122.081,2980,10997,6030,0.5877192982456141,17892900,105267600,87374700
185000.0,5,1.0,1590,6700,1.5,0,0,2,6,1090,500,1942,0.0,98146,47.5075,-122.35,1370,8040,5110,0.7626865671641792,2528100,44890000,42361900
269000.0,2,1.5,1010,6000,1.0,0,0,3,7,1010,0,1923,0.0,98178,47.49800000000001,-122.22200000000001,1290,6000,4990,0.8316666666666667,1020100,36000000,34979900
422800.0,3,1.75,1820,8400,1.0,0,0,2,7,1340,480,1976,0.0,98072,47.733999999999995,-122.17,1900,8112,6580,0.7833333333333333,3312400,70560000,67247600
379950.0,2,1.0,870,7500,1.0,0,0,2,7,870,0,1947,0.0,98136,47.5465,-122.384,1240,5709,6630,0.884,756900,56250000,55493100
525000.0,3,2.0,1620,7800,1.0,0,0,2,7,1200,420,1969,0.0,98034,47.7288,-122.171,1540,7565,6180,0.7923076923076923,2624400,60840000,58215600
810000.0,4,3.5,3980,209523,2.0,0,2,2,9,3980,0,2006,0.0,98024,47.5574,-121.89,2220,65775,205543,0.981004472062733,15840400,43899887529,43884047129
209950.0,4,1.0,1630,8400,1.0,0,0,2,6,1630,0,1962,0.0,98023,47.3052,-122.36200000000001,1190,8989,6770,0.805952380952381,2656900,70560000,67903100
439950.0,3,2.0,1230,1613,2.0,0,0,2,8,1010,220,2003,0.0,98107,47.6661,-122.37,1610,1873,383,0.23744575325480471,1512900,2601769,1088869
554820.0,4,2.0,3510,12905,1.0,0,2,2,8,2210,1300,1965,0.0,98166,47.4466,-122.36,2530,16143,9395,0.7280123982952345,12320100,166539025,154218925
359000.0,4,2.5,2160,4500,2.0,0,0,2,7,2160,0,2002,0.0,98056,47.4819,-122.182,2160,4496,2340,0.52,4665600,20250000,15584400
242500.0,3,1.0,1020,5870,1.0,0,0,2,6,1020,0,1941,0.0,98155,47.74100000000001,-122.314,1160,6901,4850,0.8262350936967632,1040400,34456900,33416500
330000.0,3,1.75,1590,9417,1.0,0,0,3,7,1590,0,1954,0.0,98177,47.7617,-122.36,1600,9272,7827,0.8311564192417967,2528100,88679889,86151789
740000.0,3,2.25,3440,44374,2.0,0,3,3,10,2190,1250,1979,0.0,98006,47.547,-122.111,3470,40185,40934,0.9224771262450985,11833600,1969051876,1957218276
630000.0,5,1.0,3020,4800,2.0,0,0,2,7,3020,0,1901,0.0,98122,47.6025,-122.31299999999999,1350,1307,1780,0.37083333333333335,9120400,23040000,13919600
750000.0,3,1.75,2280,7800,1.0,0,3,3,8,1360,920,1941,0.0,98117,47.6985,-122.387,2280,5200,5520,0.7076923076923077,5198400,60840000,55641600
695000.0,4,2.5,2790,6540,2.0,0,0,2,9,2790,0,1999,0.0,98074,47.6087,-122.016,2790,6270,3750,0.573394495412844,7784100,42771600,34987500
109000.0,2,0.5,580,6900,1.0,0,0,2,5,580,0,1941,0.0,98118,47.5135,-122.262,1570,5040,6320,0.9159420289855073,336400,47610000,47273600
389000.0,3,1.5,2030,10075,1.0,0,0,4,7,1080,950,1961,0.0,98055,47.4713,-122.197,2210,10075,8045,0.7985111662531017,4120900,101505625,97384725
447000.0,2,1.0,850,2700,1.0,0,0,4,6,850,0,1924,0.0,98105,47.6684,-122.316,1630,3000,1850,0.6851851851851852,722500,7290000,6567500
1200000.0,3,2.0,2480,13310,1.0,0,0,1,7,2480,0,1955,0.0,98052,47.6759,-122.11399999999999,2400,11340,10830,0.8136739293764087,6150400,177156100,171005700
315000.0,3,1.75,1010,12000,1.0,0,0,3,7,1010,0,1977,0.0,98011,47.77,-122.20700000000001,1080,10619,10990,0.9158333333333334,1020100,144000000,142979900
640000.0,3,2.5,2420,8244,2.0,0,0,2,10,2420,0,1988,0.0,98029,47.5595,-122.01899999999999,2500,9320,5824,0.7064531780688986,5856400,67963536,62107136
570000.0,3,2.25,2180,9246,2.0,0,0,2,9,2180,0,1984,0.0,98074,47.6215,-122.031,2300,9298,7066,0.764222366428726,4752400,85488516,80736116
495000.0,3,2.75,1830,208216,2.0,0,0,2,8,1830,0,1997,0.0,98070,47.4377,-122.464,1530,16988,206386,0.9912110500633957,3348900,43353902656,43350553756
449500.0,5,2.75,2040,7488,1.0,0,0,3,7,1200,840,1969,0.0,98034,47.7289,-122.17200000000001,1530,7488,5448,0.7275641025641025,4161600,56070144,51908544
1080000.0,4,2.75,2640,5000,2.0,0,0,2,9,1840,800,1943,0.0,98105,47.6619,-122.275,2010,5000,2360,0.472,6969600,25000000,18030400
294950.0,2,1.0,1060,7868,1.0,0,0,2,7,1060,0,1952,0.0,98155,47.7414,-122.295,1530,10728,6808,0.8652770716827657,1123600,61905424,60781824
170500.0,3,1.0,1640,13939,1.0,0,0,2,7,1040,600,1960,0.0,98198,47.3947,-122.31299999999999,2080,13000,12299,0.8823445010402468,2689600,194295721,191606121
312000.0,4,1.0,1190,7620,1.5,0,0,2,6,1190,0,1926,0.0,98106,47.5281,-122.348,1060,7320,6430,0.8438320209973753,1416100,58064400,56648300
350000.0,3,2.5,2180,15484,1.0,0,0,2,8,2180,0,1992,0.0,98003,47.2688,-122.309,2090,10775,13304,0.8592095065874451,4752400,239754256,235001856
690000.0,4,2.5,2120,8448,2.0,0,0,3,9,2120,0,1989,0.0,98029,47.5654,-122.01,2140,8122,6328,0.7490530303030303,4494400,71368704,66874304
375000.0,4,2.5,2210,9427,2.0,0,0,2,7,2210,0,1999,0.0,98148,47.4323,-122.32700000000001,1770,8770,7217,0.7655669884374668,4884100,88868329,83984229
575000.0,4,2.5,2510,47044,2.0,0,0,2,9,2510,0,1987,0.0,98077,47.7699,-122.085,2600,42612,44534,0.946645693393419,6300100,2213137936,2206837836
646000.0,4,2.25,2500,8500,1.0,0,0,3,8,1600,900,1978,0.0,98006,47.5615,-122.131,2290,8927,6000,0.7058823529411765,6250000,72250000,66000000
239950.0,3,2.5,1560,4800,2.0,0,0,3,7,1560,0,1974,0.0,98001,47.2653,-122.285,1510,12240,3240,0.675,2433600,23040000,20606400
400000.0,5,2.5,2510,7525,1.5,0,0,3,7,1710,800,1929,0.0,98106,47.5422,-122.359,1270,6741,5015,0.6664451827242525,6300100,56625625,50325525
455000.0,4,1.75,3060,94089,1.0,0,0,2,8,3060,0,1958,0.0,98072,47.744,-122.087,2180,43995,91029,0.9674776009948028,9363600,8852739921,8843376321
240000.0,3,2.0,1310,8069,1.0,0,0,2,7,1310,0,1990,0.0,98042,47.3694,-122.083,1310,8392,6759,0.8376502664518528,1716100,65108761,63392661
3400000.0,4,4.0,4260,11765,2.0,0,0,2,11,3280,980,1939,2010.0,98112,47.63800000000001,-122.288,4260,10408,7505,0.6379090522736932,18147600,138415225,120267625
695000.0,3,2.0,2500,4080,1.5,0,0,4,7,1680,820,1922,0.0,98103,47.6813,-122.346,1550,3060,1580,0.3872549019607843,6250000,16646400,10396400
304950.0,2,1.0,670,6720,1.0,0,0,4,6,670,0,1942,0.0,98126,47.5151,-122.37200000000001,710,6720,6050,0.9002976190476191,448900,45158400,44709500
650000.0,3,1.75,1840,2310,1.0,0,2,3,8,1140,700,1914,0.0,98109,47.6462,-122.351,1670,4000,470,0.20346320346320346,3385600,5336100,1950500
402500.0,3,1.75,1480,2211,2.0,0,0,2,7,1480,0,1995,0.0,98103,47.6966,-122.35,1480,2197,731,0.3306196291270918,2190400,4888521,2698121
482000.0,3,2.5,2420,7307,2.0,0,0,2,7,2420,0,1998,0.0,98065,47.5361,-121.87100000000001,2420,5577,4887,0.6688107294375256,5856400,53392249,47535849
655000.0,3,2.0,1820,4480,1.0,0,0,4,7,1120,700,1923,0.0,98105,47.6717,-122.295,1920,4480,2660,0.59375,3312400,20070400,16758000
577000.0,5,2.75,1940,5000,2.0,0,0,4,7,1940,0,1951,0.0,98107,47.6704,-122.36200000000001,1940,4230,3060,0.612,3763600,25000000,21236400
350000.0,3,2.5,1630,5996,2.0,0,0,2,7,1630,0,1986,0.0,98055,47.4738,-122.19,1660,4504,4366,0.728152101400934,2656900,35952016,33295116
415000.0,4,2.25,2520,8000,1.0,0,2,2,8,1680,840,1970,0.0,98023,47.3202,-122.383,2300,8000,5480,0.685,6350400,64000000,57649600
396400.0,4,2.5,2120,215186,2.0,0,0,1,7,2120,0,1983,0.0,98014,47.701,-121.85700000000001,2000,215186,213066,0.9901480579591609,4494400,46305014596,46300520196
654300.0,3,2.5,2490,8582,2.0,0,0,2,9,2490,0,2000,0.0,98074,47.625,-122.042,2870,7598,6092,0.709857841994873,6200100,73650724,67450624
774950.0,4,2.5,3410,179419,2.0,0,0,2,10,3410,0,2004,0.0,98010,47.3602,-121.986,3350,175421,176009,0.9809942090859942,11628100,32191177561,32179549461
855000.0,4,2.0,2380,10800,2.0,0,2,2,8,2380,0,1925,0.0,98118,47.5682,-122.275,2112,6600,8420,0.7796296296296297,5664400,116640000,110975600
1150000.0,3,2.5,2490,4000,2.0,0,0,4,8,1670,820,1918,0.0,98109,47.6403,-122.35,2310,4000,1510,0.3775,6200100,16000000,9799900
330000.0,2,2.5,1240,1546,2.0,0,0,2,7,1240,0,2007,0.0,98108,47.5634,-122.29799999999999,1520,2468,306,0.1979301423027167,1537600,2390116,852516
290000.0,4,2.25,1900,10950,1.0,0,0,3,7,1400,500,1959,0.0,98032,47.3582,-122.28399999999999,1700,11850,9050,0.8264840182648402,3610000,119902500,116292500
519500.0,3,3.0,2390,19454,1.5,0,0,2,8,2390,0,2008,0.0,98166,47.4545,-122.336,1540,26979,17064,0.8771460882080806,5712100,378458116,372746016
450000.0,3,1.75,1810,12600,1.0,0,0,2,7,1400,410,1977,0.0,98034,47.7143,-122.23299999999999,1934,12600,10790,0.8563492063492063,3276100,158760000,155483900
3120000.0,3,3.5,4490,56609,2.0,1,4,2,12,4490,0,1993,0.0,98034,47.6997,-122.24,2710,51330,52119,0.9206839901782402,20160100,3204578881,3184418781
265000.0,3,1.0,1620,9450,1.5,0,0,2,7,1620,0,1928,0.0,98168,47.5136,-122.31299999999999,2070,11970,7830,0.8285714285714286,2624400,89302500,86678100
359000.0,4,2.5,2640,7883,2.0,0,0,2,8,2640,0,1990,0.0,98092,47.3124,-122.18799999999999,2150,7683,5243,0.6651021184828111,6969600,62141689,55172089
2000000.0,4,3.75,2870,4500,2.0,0,3,2,10,2510,360,2012,0.0,98119,47.6291,-122.363,2870,6354,1630,0.3622222222222222,8236900,20250000,12013100
1050000.0,4,2.5,3250,48037,1.0,0,2,2,8,2030,1220,1985,0.0,98074,47.6326,-122.07,2970,48037,44787,0.9323438183067219,10562500,2307553369,2296990869
402500.0,2,1.0,800,2280,1.0,0,0,4,6,800,0,1946,0.0,98107,47.6588,-122.36200000000001,1310,4200,1480,0.6491228070175439,640000,5198400,4558400
450000.0,3,1.75,1360,5445,1.0,0,0,3,7,1360,0,1957,0.0,98008,47.6071,-122.12299999999999,1570,7840,4085,0.7502295684113865,1849600,29648025,27798425
262500.0,5,2.25,1950,8086,1.0,0,0,2,7,1130,820,1980,0.0,98003,47.3179,-122.331,1670,8550,6136,0.7588424437299035,3802500,65383396,61580896
285000.0,4,2.25,1970,7200,2.0,0,0,2,8,1970,0,1979,0.0,98092,47.3132,-122.182,1790,7500,5230,0.7263888888888889,3880900,51840000,47959100
290000.0,3,2.5,2020,4861,2.0,0,0,2,7,2020,0,2005,0.0,98058,47.4659,-122.14399999999999,2170,4600,2841,0.584447644517589,4080400,23629321,19548921
752500.0,2,2.5,2280,6230,1.0,0,0,2,8,2280,0,2005,0.0,98053,47.7065,-122.01299999999999,1640,5931,3950,0.6340288924558587,5198400,38812900,33614500
820000.0,4,2.75,3540,13515,2.0,0,0,2,10,3540,0,1998,0.0,98075,47.5945,-121.98200000000001,3540,11538,9975,0.7380688124306326,12531600,182655225,170123625
292000.0,3,2.5,1560,2740,2.0,0,0,2,8,1560,0,1999,0.0,98059,47.4909,-122.154,1310,2698,1180,0.4306569343065693,2433600,7507600,5074000
213000.0,2,1.0,750,6089,1.0,0,2,2,6,750,0,1937,0.0,98055,47.475,-122.199,1430,6451,5339,0.8768270651995401,562500,37075921,36513421
400000.0,4,3.0,2240,7035,2.0,0,0,2,7,2240,0,1942,1993.0,98146,47.5124,-122.374,1060,6300,4795,0.681592039800995,5017600,49491225,44473625
202000.0,1,0.75,590,5650,1.0,0,0,2,6,590,0,1944,0.0,98118,47.5181,-122.26700000000001,980,5650,5060,0.8955752212389381,348100,31922500,31574400
617450.0,3,2.0,1580,14398,1.0,0,0,2,7,1080,500,1981,0.0,98005,47.6328,-122.17399999999999,1650,14407,12818,0.8902625364633977,2496400,207302404,204806004
250000.0,3,1.0,1040,8000,1.0,0,0,3,7,1040,0,1956,0.0,98166,47.4711,-122.35,1170,9450,6960,0.87,1081600,64000000,62918400
405000.0,5,1.75,1880,10000,1.0,0,0,2,7,960,920,1963,0.0,98034,47.7182,-122.20100000000001,1580,10000,8120,0.812,3534400,100000000,96465600
325000.0,2,1.0,1070,8750,1.0,0,0,2,7,1070,0,1951,0.0,98055,47.4734,-122.198,1300,9670,7680,0.8777142857142857,1144900,76562500,75417600
301350.0,3,3.0,1860,7440,1.0,0,0,4,7,1040,820,1954,0.0,98178,47.5035,-122.255,1490,8160,5580,0.75,3459600,55353600,51894000
425000.0,2,1.75,1550,7800,1.0,0,0,2,7,1050,500,1940,0.0,98136,47.5436,-122.39,1370,5000,6250,0.8012820512820513,2402500,60840000,58437500
460000.0,3,1.0,1860,6360,1.0,0,0,2,8,1470,390,1954,0.0,98136,47.5327,-122.39200000000001,1770,6175,4500,0.7075471698113207,3459600,40449600,36990000
938000.0,3,2.5,3090,10940,2.0,0,2,2,10,3090,0,1992,0.0,98006,47.5492,-122.119,3410,12157,7850,0.7175502742230347,9548100,119683600,110135500
348000.0,3,1.75,1720,8867,1.0,0,0,2,8,1320,400,1985,0.0,98058,47.44,-122.13600000000001,2200,9170,7147,0.8060223299875945,2958400,78623689,75665289
435000.0,2,1.0,1260,4080,1.5,0,0,4,7,1260,0,1926,0.0,98115,47.687,-122.32,1720,4080,2820,0.6911764705882353,1587600,16646400,15058800
227950.0,3,1.5,1120,11430,1.0,0,0,3,7,1120,0,1963,0.0,98031,47.4105,-122.194,1790,8760,10310,0.9020122484689413,1254400,130644900,129390500
425000.0,2,1.0,1250,5880,1.0,0,0,2,6,900,350,1948,0.0,98117,47.6908,-122.391,1520,5020,4630,0.7874149659863946,1562500,34574400,33011900
550000.0,3,2.0,1810,4064,1.5,0,0,2,7,1810,0,1925,0.0,98103,47.6859,-122.339,1518,2945,2254,0.5546259842519685,3276100,16516096,13239996
347500.0,3,2.5,1890,7053,2.0,0,0,3,8,1890,0,1992,0.0,98031,47.3967,-122.18299999999999,2000,7226,5163,0.7320289238621863,3572100,49744809,46172709
397000.0,4,1.75,2020,6000,1.0,0,0,2,7,1620,400,1959,0.0,98144,47.577,-122.302,1870,4000,3980,0.6633333333333333,4080400,36000000,31919600
410000.0,4,1.75,1790,11875,1.0,0,0,3,7,1490,300,1969,0.0,98027,47.522,-122.04700000000001,1870,11760,10085,0.8492631578947368,3204100,141015625,137811525
780000.0,3,3.5,3190,6776,2.0,0,0,2,10,3190,0,1998,0.0,98074,47.6348,-122.064,3230,7189,3586,0.5292207792207793,10176100,45914176,35738076
1350000.0,4,3.25,3030,5164,1.5,0,0,4,9,2700,330,1925,0.0,98112,47.6394,-122.29899999999999,1890,4415,2134,0.41324554608830366,9180900,26666896,17485996
476000.0,3,2.25,1630,3070,2.0,0,0,2,7,1630,0,2004,0.0,98053,47.6785,-122.03,1690,3200,1440,0.46905537459283386,2656900,9424900,6768000
390000.0,3,1.75,1180,16552,1.0,0,0,3,7,1180,0,1967,0.0,98072,47.7426,-122.116,2780,45302,15372,0.9287095215079749,1392400,273968704,272576304
226500.0,3,2.0,1560,7000,1.0,0,0,3,7,1560,0,1968,0.0,98001,47.3355,-122.28399999999999,1560,7200,5440,0.7771428571428571,2433600,49000000,46566400
495000.0,3,2.0,1340,2550,2.0,0,0,2,7,1340,0,1984,0.0,98117,47.6793,-122.38,1370,5100,1210,0.4745098039215686,1795600,6502500,4706900
1500000.0,5,3.25,2590,11500,1.0,0,2,3,9,2590,0,1968,0.0,98040,47.545,-122.229,2780,11989,8910,0.7747826086956522,6708100,132250000,125541900
385000.0,3,1.0,1020,5950,1.0,0,0,2,6,880,140,1950,0.0,98106,47.5436,-122.35700000000001,1800,5950,4930,0.8285714285714286,1040400,35402500,34362100
535950.0,3,2.5,2370,5344,2.0,0,0,2,9,2370,0,2003,0.0,98065,47.54,-121.863,2990,5418,2974,0.5565119760479041,5616900,28558336,22941436
910000.0,4,2.5,3170,32430,2.5,0,0,2,10,3170,0,1989,0.0,98053,47.6903,-122.056,3360,35610,29260,0.9022510021584952,10048900,1051704900,1041656000
465000.0,2,1.0,1120,4000,1.0,0,0,2,7,1120,0,1926,0.0,98105,47.6567,-122.32700000000001,1620,4000,2880,0.72,1254400,16000000,14745600
495000.0,3,1.75,1440,11787,1.0,0,0,2,8,1440,0,1983,0.0,98074,47.6276,-122.03299999999999,2190,11787,10347,0.8778315092898956,2073600,138933369,136859769
250000.0,4,2.0,2170,5404,1.5,0,0,4,6,1470,700,1920,0.0,98002,47.3046,-122.22,1030,5477,3234,0.5984455958549223,4708900,29203216,24494316
1230000.0,4,2.25,3490,6906,2.0,0,0,3,10,2280,1210,1928,0.0,98199,47.6424,-122.40700000000001,2540,6223,3416,0.4946423399942079,12180100,47692836,35512736
400000.0,4,2.25,1970,8941,2.0,0,0,2,7,1970,0,1973,0.0,98034,47.7223,-122.17200000000001,1880,7793,6971,0.7796667039481042,3880900,79941481,76060581
715000.0,4,2.5,2780,13521,2.0,0,0,2,10,2780,0,1987,0.0,98074,47.6374,-122.042,2980,11454,10741,0.7943939057762,7728400,182817441,175089041
342000.0,3,2.0,2250,7757,1.0,0,0,2,8,2250,0,1992,0.0,98003,47.2684,-122.30799999999999,1970,6866,5507,0.7099394095655537,5062500,60171049,55108549
420000.0,4,1.75,1340,8400,1.0,0,0,4,7,1340,0,1967,0.0,98056,47.5382,-122.17299999999999,1980,8400,7060,0.8404761904761905,1795600,70560000,68764400
148226.0,3,1.0,1400,7360,1.0,0,0,3,7,1400,0,1968,0.0,98092,47.3123,-122.186,1600,8030,5960,0.8097826086956522,1960000,54169600,52209600
313000.0,3,1.0,1510,10369,1.0,0,0,3,7,1010,500,1968,0.0,98059,47.4808,-122.09899999999999,1510,16057,8859,0.8543736136560902,2280100,107516161,105236061
150000.0,3,1.0,1320,8220,1.0,0,0,2,7,1320,0,1959,0.0,98198,47.3697,-122.309,1320,7920,6900,0.8394160583941606,1742400,67568400,65826000
150000.0,2,1.0,820,10270,1.0,0,0,2,7,820,0,1954,0.0,98168,47.5119,-122.329,1670,10086,9450,0.9201557935735151,672400,105472900,104800500
230000.0,2,1.0,1080,9435,1.0,0,0,2,6,1080,0,1958,0.0,98058,47.458999999999996,-122.181,1200,9210,8355,0.8855325914149443,1166400,89019225,87852825
389100.0,2,1.0,840,5400,1.0,0,0,3,7,840,0,1948,0.0,98118,47.5489,-122.271,1340,5400,4560,0.8444444444444444,705600,29160000,28454400
645000.0,4,2.25,2070,8720,1.0,0,0,4,8,1360,710,1974,0.0,98033,47.6678,-122.182,2180,8510,6650,0.7626146788990825,4284900,76038400,71753500
310000.0,3,1.0,1520,6500,1.0,0,0,2,7,990,530,1958,0.0,98198,47.4164,-122.33200000000001,1500,7500,4980,0.7661538461538462,2310400,42250000,39939600
351358.0,2,1.75,1210,1189,2.0,0,0,2,8,1210,0,2014,0.0,98029,47.5526,-121.99799999999999,1540,1672,-21,-0.017661900756938603,1464100,1413721,-50379
1700000.0,5,2.75,3810,9360,2.0,0,0,2,10,3810,0,2014,0.0,98004,47.6039,-122.194,2110,9870,5550,0.592948717948718,14516100,87609600,73093500
1570000.0,4,3.5,5370,323215,2.0,0,0,2,10,5370,0,2002,0.0,98075,47.6003,-122.07600000000001,3780,9891,317845,0.9833856720758628,28836900,104467936225,104439099325
850000.0,3,2.0,1540,3600,2.0,0,0,2,8,1540,0,1900,1988.0,98112,47.6343,-122.28299999999999,2970,3600,2060,0.5722222222222222,2371600,12960000,10588400
470000.0,4,2.5,2310,14023,2.0,0,0,2,9,2310,0,1991,0.0,98019,47.7351,-121.964,2410,14007,11713,0.8352706268273551,5336100,196644529,191308429
770000.0,3,2.25,1870,1900,3.0,0,0,2,8,1870,0,2008,0.0,98103,47.6537,-122.34,1690,1694,30,0.015789473684210527,3496900,3610000,113100
366000.0,3,1.75,1840,11440,1.0,0,0,3,8,1340,500,1977,0.0,98059,47.474,-122.14,1940,11440,9600,0.8391608391608392,3385600,130873600,127488000
545000.0,3,2.5,2060,7184,2.0,0,0,2,8,2060,0,1987,0.0,98029,47.567,-122.012,2230,7788,5124,0.7132516703786191,4243600,51609856,47366256
205000.0,3,1.0,1010,8800,1.0,0,0,3,7,1010,0,1968,0.0,98002,47.2761,-122.208,1550,7700,7790,0.8852272727272728,1020100,77440000,76419900
405000.0,2,1.0,1020,8155,1.0,0,0,3,7,1020,0,1948,0.0,98177,47.7257,-122.361,1430,8157,7135,0.8749233599019006,1040400,66504025,65463625
467000.0,4,2.5,2220,7210,1.0,0,0,2,7,1270,950,1973,0.0,98011,47.7428,-122.18299999999999,2220,7313,4990,0.6920943134535368,4928400,51984100,47055700
392500.0,2,1.0,1050,4125,1.0,0,0,3,7,1050,0,1909,0.0,98144,47.5736,-122.307,1650,4125,3075,0.7454545454545455,1102500,17015625,15913125
901000.0,4,2.75,3030,18400,1.5,0,3,2,9,2360,670,1973,0.0,98034,47.7019,-122.243,3030,12486,15370,0.8353260869565218,9180900,338560000,329379100
500000.0,3,1.75,1800,7199,1.0,0,0,2,7,1300,500,1972,0.0,98125,47.7264,-122.307,1800,8100,5399,0.749965272954577,3240000,51825601,48585601
384950.0,3,2.5,1860,3690,2.0,0,0,2,7,1860,0,2000,0.0,98028,47.776,-122.23899999999999,1870,4394,1830,0.4959349593495935,3459600,13616100,10156500
1700000.0,4,3.5,4070,336283,2.0,0,0,2,11,4070,0,2006,0.0,98027,47.478,-122.038,3020,44613,332213,0.9878970985747124,16564900,113086256089,113069691189
245000.0,2,1.0,860,6120,1.0,0,0,2,7,860,0,1948,0.0,98155,47.7503,-122.32799999999999,1100,6860,5260,0.8594771241830066,739600,37454400,36714800
1170000.0,4,2.25,3080,10487,2.0,0,0,3,9,3080,0,1968,0.0,98040,47.5344,-122.22399999999999,2480,10607,7407,0.7063030418613522,9486400,109977169,100490769
184500.0,3,1.5,1280,3640,2.0,0,0,2,6,1280,0,1983,0.0,98002,47.333999999999996,-122.214,1150,4105,2360,0.6483516483516484,1638400,13249600,11611200
269000.0,2,2.0,1540,5000,1.5,0,0,2,8,1540,0,1986,0.0,98023,47.318999999999996,-122.39399999999999,1590,5000,3460,0.692,2371600,25000000,22628400
570000.0,3,2.5,1530,3296,2.0,0,0,2,8,1530,0,1998,0.0,98007,47.6181,-122.13799999999999,1530,4099,1766,0.5358009708737864,2340900,10863616,8522716
850000.0,4,1.75,2350,11914,1.0,0,0,3,8,2350,0,1961,0.0,98040,47.5392,-122.228,2240,10706,9564,0.8027530636226289,5522500,141943396,136420896
209000.0,3,1.0,920,5200,1.0,0,0,3,6,920,0,1969,0.0,98042,47.3647,-122.08200000000001,920,4875,4280,0.823076923076923,846400,27040000,26193600
327000.0,4,1.75,1840,5100,1.0,0,0,3,5,1840,0,1933,0.0,98056,47.5209,-122.205,2160,5400,3260,0.6392156862745098,3385600,26010000,22624400
369500.0,3,1.5,1650,9957,1.0,0,0,3,7,1100,550,1961,0.0,98125,47.7303,-122.29799999999999,1650,7957,8307,0.8342874359746911,2722500,99141849,96419349
440000.0,3,1.75,1760,8025,1.0,0,0,3,7,1230,530,1976,0.0,98034,47.7287,-122.19200000000001,1590,7543,6265,0.7806853582554517,3097600,64400625,61303025
947500.0,4,2.25,3290,12329,1.5,0,0,3,10,3290,0,1968,0.0,98040,47.5639,-122.21600000000001,3170,12329,9039,0.7331494849541731,10824100,152004241,141180141
510000.0,2,1.0,1270,4500,1.5,0,0,3,7,1270,0,1919,0.0,98122,47.6059,-122.295,2140,4550,3230,0.7177777777777777,1612900,20250000,18637100
385000.0,3,2.0,1600,10318,1.0,0,0,2,7,930,670,1941,0.0,98133,47.7466,-122.34700000000001,1590,7040,8718,0.8449311882147703,2560000,106461124,103901124
370000.0,5,3.0,2670,9920,1.0,0,0,2,8,1400,1270,1990,0.0,98001,47.3211,-122.277,1890,10341,7250,0.7308467741935484,7128900,98406400,91277500
660000.0,4,1.5,1960,4500,1.5,0,2,2,7,1960,0,1922,0.0,98117,47.6797,-122.359,1960,4500,2540,0.5644444444444444,3841600,20250000,16408400
729000.0,3,4.25,3300,308080,2.0,0,2,3,9,2520,780,1976,0.0,98070,47.3979,-122.416,2130,90604,304780,0.9892884964944171,10890000,94913286400,94902396400
440000.0,3,1.75,2000,11880,2.0,0,0,2,8,2000,0,1979,0.0,98075,47.5882,-122.052,1820,15120,9880,0.8316498316498316,4000000,141134400,137134400
445000.0,4,2.5,2360,81892,1.0,0,0,2,8,2360,0,2000,0.0,98042,47.369,-122.156,1730,18096,79532,0.9711815561959655,5569600,6706299664,6700730064
460000.0,2,1.0,1430,12092,1.0,0,0,3,7,1430,0,1938,0.0,98125,47.7023,-122.27600000000001,2320,10800,10662,0.8817399933840556,2044900,146216464,144171564
516000.0,3,3.0,2330,7304,1.0,0,0,2,9,1300,1030,1971,0.0,98005,47.5982,-122.17200000000001,2330,9518,4974,0.6809967141292442,5428900,53348416,47919516
343888.0,4,2.5,2060,5607,2.0,0,0,2,7,2060,0,2002,0.0,98058,47.4365,-122.14399999999999,2060,5367,3547,0.6326021045122169,4243600,31438449,27194849
500000.0,4,1.75,2240,9886,1.5,0,0,3,7,2240,0,1965,0.0,98008,47.6294,-122.116,1540,8040,7646,0.7734169532672466,5017600,97732996,92715396
465000.0,5,1.75,2330,6450,1.0,0,1,2,8,1330,1000,1958,0.0,98146,47.4959,-122.367,2330,8258,4120,0.6387596899224807,5428900,41602500,36173600
302000.0,5,2.25,2180,7813,2.0,0,0,2,7,2180,0,1986,0.0,98038,47.3651,-122.051,1880,8649,5633,0.7209778574171253,4752400,61042969,56290569
195000.0,2,1.0,1280,7861,1.0,0,0,3,6,1280,0,1913,0.0,98002,47.3007,-122.228,1020,6480,6581,0.837170843404147,1638400,61795321,60156921
640000.0,3,2.5,2140,8925,2.0,0,0,2,8,2140,0,1991,0.0,98074,47.6314,-122.027,2310,8956,6785,0.7602240896358543,4579600,79655625,75076025
502000.0,6,2.5,2890,8122,1.0,0,0,2,8,1630,1260,1977,0.0,98008,47.5886,-122.113,2730,9915,5232,0.6441763112533858,8352100,65966884,57614784
360000.0,3,2.5,1480,3851,2.0,0,0,2,8,1480,0,1998,0.0,98072,47.7732,-122.163,1650,4716,2371,0.615684237860296,2190400,14830201,12639801
290500.0,4,2.5,1680,3000,2.0,0,0,2,7,1680,0,2003,0.0,98178,47.494,-122.279,1420,5500,1320,0.44,2822400,9000000,6177600
248000.0,4,3.0,2163,5883,2.0,0,0,2,7,2163,0,2006,0.0,98001,47.2734,-122.251,1700,10143,3720,0.6323304436511984,4678569,34609689,29931120
433000.0,4,2.5,2280,7568,2.0,0,0,3,7,2280,0,2001,0.0,98056,47.5115,-122.194,2280,5312,5288,0.6987315010570825,5198400,57274624,52076224
480000.0,2,1.0,820,4200,1.0,0,0,2,7,820,0,1980,0.0,98112,47.6249,-122.29799999999999,1290,4000,3380,0.8047619047619048,672400,17640000,16967600
410000.0,3,1.0,1330,5000,1.0,0,0,2,7,1120,210,1957,0.0,98125,47.7211,-122.30799999999999,1920,7790,3670,0.734,1768900,25000000,23231100
309950.0,4,2.75,2310,5000,2.0,0,0,2,7,2310,0,2006,0.0,98038,47.3614,-122.035,1980,5000,2690,0.538,5336100,25000000,19663900
253000.0,3,2.0,1290,7372,1.0,0,0,4,7,1290,0,1990,0.0,98042,47.3658,-122.085,1290,7366,6082,0.8250135648399349,1664100,54346384,52682284
280000.0,3,1.75,1630,11800,1.0,0,0,3,7,1630,0,1971,0.0,98045,47.4863,-121.73,2090,57428,10170,0.861864406779661,2656900,139240000,136583100
440000.0,3,1.0,1410,8925,1.0,0,0,2,7,1410,0,1958,0.0,98052,47.6782,-122.162,1330,8925,7515,0.8420168067226891,1988100,79655625,77667525
333000.0,5,1.75,1240,8936,1.0,0,0,2,7,1240,0,1954,0.0,98006,47.5738,-122.13600000000001,1600,9341,7696,0.8612354521038496,1537600,79852096,78314496
759950.0,3,2.5,3100,23790,2.0,0,0,2,9,3100,0,2002,0.0,98075,47.5882,-122.01100000000001,2250,40854,20690,0.869693148381673,9610000,565964100,556354100
345000.0,3,2.25,2020,9000,2.0,0,0,2,7,2020,0,1979,0.0,98045,47.4487,-121.775,1460,9680,6980,0.7755555555555556,4080400,81000000,76919600
350000.0,4,2.5,2500,5831,2.0,0,0,2,8,2500,0,2007,0.0,98038,47.3454,-122.039,2500,5188,3331,0.5712570742582748,6250000,34000561,27750561
198000.0,2,1.0,790,14200,1.0,0,0,2,7,790,0,1951,0.0,98188,47.458999999999996,-122.285,1430,10000,13410,0.9443661971830986,624100,201640000,201015900
730000.0,3,1.75,2040,11294,1.0,0,0,3,7,1340,700,1952,0.0,98004,47.5923,-122.197,2120,9587,9254,0.8193731184699841,4161600,127554436,123392836
266200.0,3,1.5,1430,9600,1.0,0,0,3,7,1430,0,1966,0.0,98059,47.4737,-122.15,1590,10240,8170,0.8510416666666667,2044900,92160000,90115100
1060000.0,4,2.5,2250,10160,2.0,0,0,4,8,2250,0,1967,0.0,98040,47.5645,-122.219,2660,10125,7910,0.7785433070866141,5062500,103225600,98163100
95000.0,2,1.0,1070,20450,1.0,0,0,1,6,1070,0,1948,0.0,98058,47.4338,-122.18299999999999,1360,15581,19380,0.9476772616136919,1144900,418202500,417057600
430000.0,3,1.75,1300,12731,1.0,0,0,2,8,1300,0,1981,0.0,98074,47.6236,-122.04,1700,13556,11431,0.8978870473647004,1690000,162078361,160388361
650000.0,4,2.25,2560,9731,2.0,0,0,3,7,2560,0,1973,0.0,98034,47.7261,-122.24600000000001,1860,9731,7171,0.7369232350220943,6553600,94692361,88138761
379900.0,3,2.5,2190,5071,2.0,0,0,2,8,2190,0,2004,0.0,98038,47.3506,-122.04,2300,5654,2881,0.5681325182409781,4796100,25715041,20918941
325000.0,2,1.5,940,1222,2.0,0,0,2,7,860,80,2004,0.0,98125,47.7178,-122.318,1302,1840,282,0.23076923076923078,883600,1493284,609684
455000.0,4,2.25,1740,8449,1.0,0,0,3,7,1170,570,1958,0.0,98008,47.6079,-122.12299999999999,1980,11175,6709,0.7940584684578057,3027600,71385601,68358001
392000.0,4,3.75,2220,3797,1.5,0,0,3,6,1330,890,1917,0.0,98108,47.5574,-122.315,1490,4340,1577,0.41532789043982093,4928400,14417209,9488809
373000.0,3,1.75,1310,7811,1.0,0,0,2,7,1310,0,1976,0.0,98034,47.7319,-122.167,1530,7800,6501,0.8322877992574574,1716100,61011721,59295621
951250.0,5,3.0,2710,8227,1.0,0,2,2,8,1910,800,1953,0.0,98199,47.6505,-122.39,2060,5400,5517,0.6705968153640453,7344100,67683529,60339429
502000.0,3,2.0,1300,14350,1.0,0,0,2,7,1300,0,1955,0.0,98006,47.5736,-122.152,1520,10670,13050,0.9094076655052264,1690000,205922500,204232500
362500.0,3,2.0,1940,40588,1.0,0,0,2,7,1940,0,2000,0.0,98058,47.4252,-122.15899999999999,1860,9657,38648,0.9522026214644722,3763600,1647385744,1643622144
525000.0,2,1.0,1080,3500,1.0,0,3,2,7,1080,0,1924,0.0,98103,47.6667,-122.35600000000001,1790,4000,2420,0.6914285714285714,1166400,12250000,11083600
580000.0,4,2.5,2110,11680,1.0,0,0,3,7,1420,690,1977,0.0,98052,47.6964,-122.118,1890,9600,9570,0.8193493150684932,4452100,136422400,131970300
278000.0,3,2.25,1590,9425,1.0,0,0,2,7,1170,420,1985,0.0,98058,47.4291,-122.16,1590,9394,7835,0.8312997347480106,2528100,88830625,86302525
422500.0,2,1.0,910,4800,1.0,0,0,3,7,910,0,1923,0.0,98126,47.5536,-122.37700000000001,1450,5000,3890,0.8104166666666667,828100,23040000,22211900
783200.0,4,2.0,1590,5400,1.0,0,2,2,7,990,600,1900,0.0,98119,47.637,-122.367,2190,4800,3810,0.7055555555555556,2528100,29160000,26631900
715000.0,4,2.5,3290,6628,2.0,0,0,2,9,3290,0,2003,0.0,98075,47.5994,-121.975,3240,5831,3338,0.503621001810501,10824100,43930384,33106284
472217.0,3,2.5,2010,2212,2.0,0,0,2,8,1390,0,2014,0.0,98029,47.5523,-121.99799999999999,1690,1619,202,0.09132007233273057,4040100,4892944,852844
244615.0,3,2.5,2060,4030,2.0,0,0,2,7,2060,0,1999,0.0,98032,47.3909,-122.238,2060,4029,1970,0.48883374689826303,4243600,16240900,11997300
385000.0,3,1.75,1560,14288,1.0,0,0,2,6,780,780,1944,0.0,98125,47.7183,-122.306,1320,8928,12728,0.8908174692049272,2433600,204146944,201713344
549995.0,3,1.0,1120,6600,1.0,0,0,2,7,1120,0,1943,0.0,98105,47.6712,-122.26700000000001,1300,6600,5480,0.8303030303030303,1254400,43560000,42305600
959900.0,4,3.75,3550,15151,2.0,0,0,2,11,3550,0,2004,0.0,98075,47.5888,-121.971,4340,15151,11601,0.76569203352914,12602500,229552801,216950301
510000.0,6,4.5,3300,7200,2.0,0,0,2,8,3300,0,1980,0.0,98052,47.6798,-122.104,2470,7561,3900,0.5416666666666666,10890000,51840000,40950000
367000.0,3,1.75,2000,12669,1.0,0,3,3,7,1200,800,1965,0.0,98070,47.3579,-122.446,1580,12055,10669,0.8421343436735338,4000000,160503561,156503561
375000.0,5,3.0,2680,8410,2.0,0,0,2,8,1810,870,1990,0.0,98058,47.4401,-122.126,1860,8410,5730,0.6813317479191439,7182400,70728100,63545700
500000.0,2,2.25,1290,1334,3.0,0,0,2,8,1290,0,2007,0.0,98107,47.6719,-122.382,1350,1334,44,0.03298350824587706,1664100,1779556,115456
489000.0,2,2.25,1290,1334,3.0,0,0,2,8,1290,0,2007,0.0,98107,47.6719,-122.382,1350,1334,44,0.03298350824587706,1664100,1779556,115456
340000.0,3,2.0,1150,700,2.0,0,0,2,7,800,350,2000,0.0,98136,47.5552,-122.381,1060,1910,-450,-0.6428571428571429,1322500,490000,-832500
562000.0,3,1.75,1880,5978,1.0,0,0,4,7,940,940,1957,0.0,98144,47.5793,-122.294,1930,4770,4098,0.6855135496821679,3534400,35736484,32202084
489950.0,3,2.5,2400,7478,2.0,0,0,2,9,2400,0,2002,0.0,98019,47.7362,-121.97399999999999,2980,8182,5078,0.6790585718106446,5760000,55920484,50160484
652000.0,3,2.25,1920,9600,1.0,0,0,3,8,1560,360,1968,0.0,98052,47.6341,-122.103,2040,9600,7680,0.8,3686400,92160000,88473600
472000.0,4,3.25,4350,7090,2.0,0,0,2,8,2870,1480,1999,0.0,98042,47.3747,-122.156,2490,7266,2740,0.38645980253878703,18922500,50268100,31345600
333000.0,4,2.5,1910,9244,1.0,0,0,3,6,1910,0,1963,0.0,98059,47.4918,-122.141,2590,9286,7334,0.7933794893985288,3648100,85451536,81803436
560000.0,3,1.5,2000,7350,1.0,0,0,2,8,2000,0,1953,0.0,98177,47.7061,-122.368,1890,6960,5350,0.7278911564625851,4000000,54022500,50022500
799000.0,4,3.5,3290,20107,2.0,0,4,2,10,2220,1070,1990,0.0,98198,47.355,-122.319,2990,16988,16817,0.8363753916546476,10824100,404291449,393467349
860000.0,5,2.25,3480,9200,2.0,0,0,2,8,3480,0,1979,0.0,98006,47.5585,-122.15299999999999,3130,9200,5720,0.6217391304347826,12110400,84640000,72529600
449500.0,4,2.5,2410,55931,2.0,0,0,2,9,2410,0,1989,0.0,98092,47.3109,-122.09700000000001,2780,55931,53521,0.9569111941499348,5808100,3128276761,3122468661
692500.0,4,3.0,2820,11500,2.0,0,0,2,10,2820,0,1991,0.0,98075,47.5826,-122.02799999999999,2770,9694,8680,0.7547826086956522,7952400,132250000,124297600
925000.0,4,1.75,2710,11400,1.0,0,0,3,9,1430,1280,1976,0.0,98006,47.56100000000001,-122.15299999999999,2640,11000,8690,0.762280701754386,7344100,129960000,122615900
267500.0,3,2.25,2080,2856,1.5,0,0,2,7,1550,530,2003,0.0,98042,47.4198,-122.15799999999999,2080,2275,776,0.27170868347338933,4326400,8156736,3830336
396800.0,4,2.5,2200,6018,2.0,0,0,2,8,2200,0,2010,0.0,98019,47.7338,-121.96600000000001,2480,5899,3818,0.6344300432037222,4840000,36216324,31376324
220000.0,4,1.5,1180,8058,1.0,0,0,4,7,1180,0,1969,0.0,98092,47.2966,-122.19,1800,9348,6878,0.8535616778356913,1392400,64931364,63538964
892500.0,3,1.75,2120,56192,1.0,0,1,2,9,1720,400,1959,0.0,98177,47.7665,-122.37200000000001,2240,20500,54072,0.9622722095671982,4494400,3157540864,3153046464
455500.0,3,2.0,1460,10311,1.0,0,0,3,7,1460,0,1975,0.0,98052,47.6771,-122.156,1690,9679,8851,0.8584036465910193,2131600,106316721,104185121
743000.0,3,1.75,2110,11250,1.0,0,0,3,8,2110,0,1961,0.0,98040,47.5402,-122.21600000000001,2560,10992,9140,0.8124444444444444,4452100,126562500,122110400
338000.0,4,1.5,1790,17925,1.0,0,0,3,6,1790,0,1951,0.0,98155,47.7501,-122.302,1660,15165,16135,0.900139470013947,3204100,321305625,318101525
332000.0,3,1.75,1340,13115,1.0,0,0,2,7,1340,0,1978,0.0,98045,47.5021,-121.77,1370,10800,11775,0.8978269157453298,1795600,172003225,170207625
563225.0,3,1.0,2460,4000,1.5,0,0,3,7,1370,1090,1918,0.0,98112,47.6268,-122.29700000000001,1680,4000,1540,0.385,6051600,16000000,9948400
1150000.0,4,3.5,3760,20609,2.0,0,0,2,11,3760,0,1990,0.0,98077,47.7255,-122.059,3360,15761,16849,0.817555436945024,14137600,424730881,410593281
645000.0,2,1.0,1240,5000,1.0,0,0,2,7,1000,240,1920,0.0,98103,47.6634,-122.351,1480,3500,3760,0.752,1537600,25000000,23462400
739000.0,3,2.5,2750,16000,2.0,0,0,3,9,2560,190,1981,0.0,98033,47.69300000000001,-122.18700000000001,2370,11279,13250,0.828125,7562500,256000000,248437500
435000.0,3,2.5,2530,13446,2.0,0,0,2,9,2530,0,1993,0.0,98019,47.7345,-121.961,2450,13446,10916,0.8118399524022014,6400900,180794916,174394016
995000.0,3,2.25,3200,3800,2.0,0,0,4,9,2650,550,1914,0.0,98102,47.63800000000001,-122.31700000000001,2400,3900,600,0.15789473684210525,10240000,14440000,4200000
520000.0,4,2.75,2020,7357,1.0,0,0,2,7,1350,670,1986,0.0,98034,47.7145,-122.225,1690,7804,5337,0.7254315617778986,4080400,54125449,50045049
400000.0,4,2.5,3030,180263,2.0,0,0,2,7,2030,1000,1987,0.0,98092,47.2953,-122.09700000000001,2600,182509,177233,0.9831912261528988,9180900,32494749169,32485568269
440000.0,3,1.75,2350,7641,1.0,0,0,2,7,1510,840,1978,0.0,98034,47.7307,-122.219,2190,7500,5291,0.692448632377961,5522500,58384881,52862381
440000.0,3,1.5,1690,6010,1.0,0,0,2,7,1230,460,1946,0.0,98115,47.6955,-122.291,1690,5418,4320,0.718801996672213,2856100,36120100,33264000
738000.0,3,1.0,1280,3900,1.0,0,0,3,7,1280,0,1921,0.0,98103,47.6545,-122.336,2020,4560,2620,0.6717948717948717,1638400,15210000,13571600
250000.0,3,1.5,1170,9848,1.0,0,0,2,7,1170,0,1963,0.0,98028,47.7612,-122.234,2220,5542,8678,0.8811941510966693,1368900,96983104,95614204
338150.0,4,2.25,2700,8580,2.0,0,0,2,8,2700,0,1992,0.0,98022,47.2087,-122.009,2420,8580,5880,0.6853146853146853,7290000,73616400,66326400
425000.0,3,2.25,1800,7371,1.0,0,0,2,7,1280,520,1979,0.0,98072,47.7584,-122.145,1960,7675,5571,0.7557997557997558,3240000,54331641,51091641
883000.0,4,2.5,3670,54450,2.0,0,0,2,10,3670,0,1999,0.0,98074,47.6211,-122.016,2900,49658,50780,0.9325987144168962,13468900,2964802500,2951333600
510000.0,3,2.0,2350,266151,1.5,0,0,2,7,2350,0,1983,0.0,98014,47.6609,-121.89200000000001,2270,222156,263801,0.9911704258109119,5522500,70836354801,70830832301
950000.0,4,1.75,3100,21303,1.0,0,1,3,9,3100,0,1962,0.0,98075,47.5847,-122.081,3480,9697,18203,0.8544805895883208,9610000,453817809,444207809
435000.0,3,1.0,1120,9656,1.0,0,0,4,7,1120,0,1955,0.0,98006,47.567,-122.139,1720,9908,8536,0.884009942004971,1254400,93238336,91983936
415000.0,5,1.5,1900,10226,1.0,0,0,2,7,1130,770,1961,0.0,98034,47.7226,-122.227,1690,10227,8326,0.8141991003324858,3610000,104571076,100961076
439000.0,2,2.5,1350,944,2.0,0,0,2,9,870,480,2004,0.0,98116,47.5591,-122.385,1440,1350,-406,-0.4300847457627119,1822500,891136,-931364
295832.0,5,1.0,1410,6400,1.0,0,0,4,7,960,450,1955,0.0,98198,47.4207,-122.334,1400,6500,4990,0.7796875,1988100,40960000,38971900
285000.0,3,1.75,1560,9514,1.0,0,0,3,7,1560,0,1967,0.0,98031,47.4088,-122.21,1550,9600,7954,0.8360311120454068,2433600,90516196,88082596
350000.0,3,1.5,1090,5003,1.0,0,0,2,7,1090,0,1962,0.0,98125,47.703,-122.321,1540,5279,3913,0.7821307215670598,1188100,25030009,23841909
489000.0,2,2.75,1465,972,2.0,0,0,2,7,1050,415,2006,0.0,98112,47.621,-122.29799999999999,1480,1430,-493,-0.507201646090535,2146225,944784,-1201441
304500.0,3,2.25,1790,6930,1.0,0,0,2,7,1390,400,1974,0.0,98003,47.3536,-122.31700000000001,1810,7420,5140,0.7417027417027418,3204100,48024900,44820800
288000.0,3,1.5,1300,7313,1.0,0,0,3,7,1300,0,1968,0.0,98055,47.4568,-122.21,1770,8075,6013,0.8222343771366061,1690000,53479969,51789969
417000.0,3,1.75,1920,9512,1.0,0,0,2,8,1440,480,1980,0.0,98011,47.7606,-122.167,1820,9512,7592,0.7981497056349874,3686400,90478144,86791744
615000.0,3,3.0,1420,991,2.0,0,0,2,8,1040,380,2005,0.0,98102,47.6408,-122.32700000000001,1500,1301,-429,-0.4328960645812311,2016400,982081,-1034319
730000.0,5,3.5,3760,4857,2.0,0,3,2,9,2820,940,2004,0.0,98072,47.7398,-122.167,3000,5693,1097,0.22585958410541487,14137600,23590449,9452849
178500.0,2,1.0,930,3447,1.0,0,0,3,8,930,0,1978,0.0,98198,47.3822,-122.318,1160,3447,2517,0.7302001740644039,864900,11881809,11016909
300000.0,4,2.0,1580,9600,1.0,0,0,4,7,1050,530,1965,0.0,98198,47.4091,-122.31299999999999,1710,9600,8020,0.8354166666666667,2496400,92160000,89663600
415000.0,4,2.5,2170,8518,1.0,0,3,2,7,1350,820,1955,0.0,98178,47.5073,-122.234,1880,7680,6348,0.7452453627612116,4708900,72556324,67847424
452500.0,3,1.75,2040,15695,1.0,0,0,3,8,2040,0,1959,0.0,98166,47.4155,-122.339,2280,14400,13655,0.8700223000955718,4161600,246333025,242171425
1010000.0,4,2.75,3430,15877,1.0,0,4,2,11,3430,0,2005,0.0,98065,47.5364,-121.85600000000001,4080,14577,12447,0.7839642249795301,11764900,252079129,240314229
653000.0,4,2.5,2160,7000,2.0,0,0,3,9,2160,0,1989,0.0,98029,47.5659,-122.01299999999999,2300,7440,4840,0.6914285714285714,4665600,49000000,44334400
715000.0,4,2.25,2060,5649,1.0,0,0,4,8,1360,700,1941,0.0,98199,47.6496,-122.40700000000001,2060,5626,3589,0.6353336873782971,4243600,31911201,27667601
541000.0,3,1.75,1410,4080,1.5,0,0,3,7,1410,0,1927,0.0,98105,47.6695,-122.32,1820,4080,2670,0.6544117647058824,1988100,16646400,14658300
245000.0,4,1.5,1850,7547,1.5,0,0,3,7,1850,0,1960,0.0,98198,47.3714,-122.309,1730,7577,5697,0.7548694845634026,3422500,56957209,53534709
547000.0,2,1.0,1370,10038,1.5,0,0,3,7,1370,0,1922,0.0,98133,47.718999999999994,-122.339,1610,8822,8668,0.8635186292090058,1876900,100761444,98884544
750000.0,5,2.75,3330,12408,1.0,0,0,2,10,1740,1590,1976,0.0,98074,47.6318,-122.05799999999999,2780,12000,9078,0.7316247582205029,11088900,153958464,142869564
575000.0,5,2.5,1970,12375,1.0,0,0,2,8,1570,400,1959,0.0,98133,47.7412,-122.354,1970,8941,10405,0.8408080808080808,3880900,153140625,149259725
216000.0,3,1.75,1310,8670,1.0,0,0,3,6,1310,0,1984,0.0,98092,47.3156,-122.186,2622,7191,7360,0.8489042675893888,1716100,75168900,73452800
443000.0,3,1.75,1640,4579,1.0,0,0,3,6,1640,0,1916,0.0,98133,47.7061,-122.352,1580,5040,2939,0.6418431972046298,2689600,20967241,18277641
257700.0,4,2.25,1600,6202,2.0,0,0,3,7,1600,0,1986,0.0,98038,47.3784,-122.046,1530,6298,4602,0.7420187036439858,2560000,38464804,35904804
278000.0,3,1.0,1230,9440,1.0,0,0,2,7,1230,0,1978,0.0,98045,47.4657,-121.74700000000001,1230,10296,8210,0.8697033898305084,1512900,89113600,87600700
300000.0,3,2.5,2240,3691,2.0,0,0,2,7,2240,0,2003,0.0,98092,47.3364,-122.169,2619,3691,1451,0.39311839609861826,5017600,13623481,8605881
269100.0,3,2.5,2190,7904,2.0,0,0,2,8,2190,0,1995,0.0,98092,47.2617,-122.21,2190,7669,5714,0.7229251012145749,4796100,62473216,57677116
402500.0,3,1.0,990,10752,1.5,0,0,3,7,990,0,1929,0.0,98133,47.7648,-122.35,1820,7600,9762,0.9079241071428571,980100,115605504,114625404
306888.0,2,1.5,1010,7719,2.0,0,0,2,7,1010,0,1981,0.0,98056,47.5128,-122.189,1210,7719,6709,0.869154035496826,1020100,59582961,58562861
795000.0,4,2.5,2920,14210,2.0,0,0,3,10,2920,0,1978,0.0,98007,47.6196,-122.15,2840,13702,11290,0.7945109078114004,8526400,201924100,193397700
525000.0,4,2.5,2310,5573,2.0,0,0,3,9,2310,0,2003,0.0,98056,47.5197,-122.2,2310,6189,3263,0.585501525210838,5336100,31058329,25722229
1050000.0,3,2.5,3470,12076,2.0,0,3,2,10,2560,910,1988,0.0,98040,47.5319,-122.238,3590,17677,8606,0.7126531964226565,12040900,145829776,133788876
452000.0,2,1.0,1220,6000,1.0,0,0,2,6,880,340,1938,0.0,98118,47.5647,-122.27,1220,6840,4780,0.7966666666666666,1488400,36000000,34511600
350000.0,3,2.25,1550,5401,2.0,0,0,2,7,1550,0,2000,0.0,98019,47.736999999999995,-121.96700000000001,1740,4485,3851,0.7130161081281244,2402500,29170801,26768301
410000.0,4,2.5,2070,6180,2.0,0,0,2,8,2070,0,2007,0.0,98056,47.4915,-122.18299999999999,1250,6018,4110,0.6650485436893204,4284900,38192400,33907500
595000.0,3,1.75,2060,3600,1.5,0,0,2,7,1180,880,1905,1985.0,98119,47.6389,-122.37100000000001,1730,2475,1540,0.42777777777777776,4243600,12960000,8716400
499000.0,3,2.5,1690,4851,2.0,0,0,2,7,1690,0,2004,0.0,98053,47.6795,-122.03399999999999,2330,4851,3161,0.6516182230467945,2856100,23532201,20676101
340000.0,4,2.5,2550,7555,2.0,0,0,2,8,2550,0,2001,0.0,98001,47.2614,-122.29,2550,6800,5005,0.6624751819986764,6502500,57078025,50575525
1070000.0,5,3.25,3370,7947,2.0,0,0,2,10,3370,0,2001,0.0,98033,47.6906,-122.20200000000001,2040,7900,4577,0.5759406065181829,11356900,63154809,51797909
460000.0,4,3.0,2230,52983,2.0,0,0,2,8,2230,0,1991,0.0,98030,47.3577,-122.195,2060,8755,50753,0.9579110280656059,4972900,2807198289,2802225389
345000.0,4,2.5,2382,5899,2.0,0,0,2,8,2382,0,2011,0.0,98003,47.2793,-122.295,2382,5897,3517,0.5962027462281743,5673924,34798201,29124277
280500.0,3,2.25,1620,7566,2.0,0,0,2,7,1620,0,1990,0.0,98038,47.3566,-122.039,1470,7566,5946,0.7858842188739096,2624400,57244356,54619956
704000.0,3,1.0,1140,6120,1.5,0,0,2,7,1140,0,1926,0.0,98115,47.6822,-122.309,1800,4080,4980,0.8137254901960784,1299600,37454400,36154800
545000.0,3,2.5,2140,40173,2.0,0,0,3,8,2140,0,1990,0.0,98027,47.4786,-122.066,2380,43016,38033,0.9467303910586713,4579600,1613869929,1609290329
335000.0,3,1.5,1900,7584,1.0,0,0,4,7,1900,0,1962,0.0,98056,47.5091,-122.19,1410,7584,5684,0.7494725738396625,3610000,57517056,53907056
1330000.0,4,3.0,3370,7920,1.0,0,3,2,10,1860,0,1988,0.0,98117,47.6773,-122.40299999999999,2730,7380,4550,0.5744949494949495,11356900,62726400,51369500
420000.0,3,2.75,2300,8000,1.0,0,0,2,7,1430,870,1965,0.0,98003,47.3293,-122.306,2070,10200,5700,0.7125,5290000,64000000,58710000
705000.0,4,2.0,2040,5050,1.0,0,0,4,7,1160,880,1937,0.0,98115,47.6885,-122.324,2040,5050,3010,0.596039603960396,4161600,25502500,21340900
274900.0,4,1.75,1840,10528,1.0,0,0,2,7,1210,630,1990,0.0,98023,47.2987,-122.385,1620,9331,8688,0.8252279635258358,3385600,110838784,107453184
499950.0,4,2.5,2860,3345,2.0,0,0,2,8,2190,670,2004,0.0,98072,47.7735,-122.15799999999999,2860,3596,485,0.14499252615844543,8179600,11189025,3009425
415250.0,3,1.5,1400,7550,1.0,0,0,3,7,1400,0,1953,0.0,98133,47.7566,-122.337,1730,7562,6150,0.8145695364238411,1960000,57002500,55042500
222000.0,3,1.0,990,7520,1.0,0,0,3,7,990,0,1958,0.0,98002,47.285,-122.20700000000001,990,7440,6530,0.8683510638297872,980100,56550400,55570300
375000.0,3,2.0,3120,42247,1.0,0,0,3,7,2150,970,1980,0.0,98042,47.3925,-122.137,2100,43416,39127,0.9261486022676166,9734400,1784809009,1775074609
300000.0,3,2.5,1640,5707,2.0,0,0,2,7,1640,0,1995,0.0,98031,47.4016,-122.209,1850,5827,4067,0.7126336078500087,2689600,32569849,29880249
456700.0,3,1.75,2820,8879,1.0,0,0,4,7,1540,1280,1920,1957.0,98146,47.5094,-122.376,1640,7850,6059,0.6823966662912491,7952400,78836641,70884241
925500.0,3,2.75,1970,5200,1.5,0,3,2,8,1970,0,1915,2002.0,98136,47.5374,-122.38799999999999,2140,5200,3230,0.6211538461538462,3880900,27040000,23159100
375000.0,5,2.5,2840,15598,1.0,0,0,3,8,1470,1370,1975,0.0,98059,47.4693,-122.117,2570,14930,12758,0.817925375048083,8065600,243297604,235232004
420000.0,3,2.5,2370,15375,2.0,0,2,2,9,2370,0,1993,0.0,98042,47.3803,-122.147,2450,9800,13005,0.8458536585365853,5616900,236390625,230773725
575000.0,3,2.5,2610,7301,2.0,0,0,2,8,2610,0,2004,0.0,98072,47.7614,-122.139,2460,7181,4691,0.6425147240104095,6812100,53304601,46492501
335000.0,3,2.0,1340,1951,1.0,0,0,2,6,670,670,1915,0.0,98144,47.5763,-122.309,1520,2248,611,0.3131727319323424,1795600,3806401,2010801
428000.0,4,2.0,1300,7200,1.0,0,0,2,7,1300,0,1958,0.0,98122,47.6169,-122.294,1540,6600,5900,0.8194444444444444,1690000,51840000,50150000
655000.0,4,2.5,3340,34238,1.0,0,0,3,8,2060,1280,1977,0.0,98077,47.7654,-122.07600000000001,2400,36590,30898,0.9024475728722472,11155600,1172240644,1161085044
738000.0,3,3.0,2630,4896,2.0,0,0,2,9,2630,0,2006,0.0,98052,47.6932,-122.133,2880,4972,2266,0.46282679738562094,6916900,23970816,17053916
415000.0,5,1.75,1960,3748,1.0,0,0,2,7,980,980,1965,0.0,98133,47.7027,-122.34899999999999,1410,3844,1788,0.47705442902881534,3841600,14047504,10205904
392000.0,3,1.0,1090,6125,1.0,0,0,3,6,790,300,1945,0.0,98126,47.5343,-122.37,1050,6125,5035,0.8220408163265306,1188100,37515625,36327525
555000.0,2,1.0,1550,4600,1.0,0,0,3,7,1050,500,1941,0.0,98117,47.68600000000001,-122.384,1550,4600,3050,0.6630434782608695,2402500,21160000,18757500
260000.0,3,2.5,1770,2677,2.0,0,0,2,7,1770,0,2005,0.0,98055,47.4339,-122.194,1550,1798,907,0.3388121031004856,3132900,7166329,4033429
392500.0,3,1.0,1390,10500,1.5,0,0,2,6,1390,0,1940,0.0,98024,47.567,-121.89299999999999,1350,9800,9110,0.8676190476190476,1932100,110250000,108317900
912000.0,3,2.5,2979,17313,2.0,0,2,2,11,2979,0,1993,0.0,98006,47.5503,-122.118,3890,14797,14334,0.8279327672846993,8874441,299739969,290865528
135000.0,2,1.0,830,7609,1.0,0,0,2,6,830,0,1943,0.0,98146,47.5057,-122.348,1170,7609,6779,0.890918648968327,688900,57896881,57207981
500000.0,3,2.75,1560,77536,1.0,0,0,2,7,1400,160,1978,0.0,98072,47.7695,-122.126,2210,41449,75976,0.9798803136607511,2433600,6011831296,6009397696
238000.0,3,1.5,1360,7488,1.0,0,0,3,7,1050,310,1975,0.0,98001,47.3314,-122.275,1580,7508,6128,0.8183760683760684,1849600,56070144,54220544
251000.0,4,2.0,1650,5974,1.0,0,0,4,7,860,790,1972,0.0,98178,47.5008,-122.257,1940,6001,4324,0.7238031469702042,2722500,35688676,32966176
406500.0,2,1.75,1510,5319,2.0,0,0,3,8,1510,0,1978,0.0,98052,47.6647,-122.13,1740,6160,3809,0.7161120511374318,2280100,28291761,26011661
433495.0,4,2.25,3010,10925,2.0,0,0,3,9,3010,0,1988,0.0,98092,47.3326,-122.20100000000001,2690,10925,7915,0.7244851258581235,9060100,119355625,110295525
265000.0,3,2.25,1510,6071,1.0,0,0,3,7,1150,360,1985,0.0,98042,47.3619,-122.07700000000001,1510,7271,4561,0.7512765606984022,2280100,36857041,34576941
360000.0,3,1.75,1950,7260,1.0,0,0,2,8,1520,430,1957,0.0,98133,47.7187,-122.33,1950,7548,5310,0.731404958677686,3802500,52707600,48905100
425000.0,4,1.0,1800,12485,1.0,0,0,4,7,950,850,1955,0.0,98006,47.5729,-122.147,1290,9840,10685,0.855826992390869,3240000,155875225,152635225
450000.0,2,2.75,2810,11205,1.0,0,0,2,7,1510,1300,1968,0.0,98178,47.4869,-122.243,2520,13000,8395,0.749219098616689,7896100,125552025,117655925
449900.0,3,1.75,1760,8266,1.0,0,0,4,7,1760,0,1954,0.0,98133,47.7708,-122.339,1400,8519,6506,0.787079603193806,3097600,68326756,65229156
345000.0,4,2.5,2040,5875,2.0,0,0,2,8,2040,0,2004,0.0,98056,47.5051,-122.17,2230,5459,3835,0.6527659574468085,4161600,34515625,30354025
612500.0,4,2.0,1690,35346,1.0,0,0,2,7,1690,0,1967,0.0,98008,47.6149,-122.124,2050,37846,33656,0.952186951847451,2856100,1249339716,1246483616
317000.0,3,1.75,1530,7650,1.0,0,0,3,8,1530,0,1977,0.0,98058,47.4435,-122.12799999999999,1850,6804,6120,0.8,2340900,58522500,56181600
585000.0,3,1.5,1810,3880,1.5,0,0,3,8,1310,500,1929,0.0,98117,47.6835,-122.39200000000001,1400,3880,2070,0.5335051546391752,3276100,15054400,11778300
455000.0,3,1.75,1180,14292,1.0,0,0,2,7,1180,0,1981,0.0,98045,47.4818,-121.73299999999999,1480,14400,13112,0.9174363280156731,1392400,204261264,202868864
1040000.0,4,4.0,4090,51908,2.0,0,0,2,11,4090,0,1991,0.0,98077,47.7226,-122.039,4290,41655,47818,0.9212067504045619,16728100,2694440464,2677712364
497000.0,4,2.25,2250,3463,2.0,0,0,3,8,2250,0,1968,0.0,98052,47.6324,-122.10600000000001,1850,2811,1213,0.35027432861680624,5062500,11992369,6929869
226750.0,3,1.75,1070,6315,1.0,0,0,2,7,1070,0,1992,0.0,98023,47.2803,-122.35600000000001,1520,5707,5245,0.8305621536025336,1144900,39879225,38734325
385000.0,4,2.0,1820,7102,1.0,0,0,2,7,1220,600,1950,0.0,98155,47.7447,-122.324,1650,8184,5282,0.7437341593917206,3312400,50438404,47126004
205000.0,3,0.75,1080,5025,1.0,0,0,2,5,1080,0,1948,0.0,98146,47.4936,-122.335,1370,6000,3945,0.7850746268656716,1166400,25250625,24084225
745000.0,4,2.5,2760,13093,2.0,0,0,3,9,2760,0,1989,0.0,98075,47.5845,-122.06,2810,13545,10333,0.7892003360574352,7617600,171426649,163809049
371000.0,4,2.5,2550,4770,2.0,0,0,2,8,2550,0,2005,0.0,98038,47.3526,-122.0,2380,4590,2220,0.46540880503144655,6502500,22752900,16250400
545000.0,4,2.5,2080,8504,2.0,0,0,2,8,2080,0,1991,0.0,98029,47.5703,-121.99799999999999,2000,6773,6424,0.7554092191909689,4326400,72318016,67991616
443000.0,3,1.0,1280,5460,1.5,0,0,3,7,1280,0,1931,0.0,98133,47.7321,-122.334,1390,5500,4180,0.7655677655677655,1638400,29811600,28173200
287000.0,2,1.0,950,6350,1.0,0,0,2,7,950,0,1951,0.0,98106,47.528,-122.352,1080,7620,5400,0.8503937007874016,902500,40322500,39420000
194000.0,3,1.0,1050,7577,1.0,0,0,2,7,1050,0,1983,0.0,98023,47.2891,-122.35700000000001,1430,7245,6527,0.8614227266728257,1102500,57410929,56308429
265000.0,3,1.0,1800,7650,1.0,0,0,4,7,1800,0,1957,0.0,98056,47.4922,-122.178,1230,7650,5850,0.7647058823529411,3240000,58522500,55282500
1140000.0,4,2.75,3840,10004,1.0,0,2,3,9,2110,1730,1963,0.0,98040,47.5606,-122.225,3500,12118,6164,0.6161535385845661,14745600,100080016,85334416
699950.0,4,3.25,3674,12793,2.0,0,1,2,9,3674,0,1987,0.0,98166,47.4357,-122.34299999999999,3220,13100,9119,0.7128116938950989,13498276,163660849,150162573
433000.0,4,1.0,1710,7000,1.5,0,0,2,7,1710,0,1950,0.0,98125,47.7037,-122.29299999999999,2030,7938,5290,0.7557142857142857,2924100,49000000,46075900
200000.0,2,1.75,910,2693,1.0,0,0,2,6,910,0,2003,0.0,98038,47.3493,-122.025,1360,2693,1783,0.662086891942072,828100,7252249,6424149
289571.0,3,1.5,1340,25160,1.0,0,0,2,7,1340,0,1968,0.0,98059,47.475,-122.111,1440,23680,23820,0.9467408585055644,1795600,633025600,631230000
440000.0,4,2.75,2340,11034,1.0,0,0,2,8,1720,620,1967,0.0,98155,47.7686,-122.27799999999999,2370,11941,8694,0.7879282218597063,5475600,121749156,116273556
400000.0,3,1.5,1510,8360,1.0,0,0,2,7,1120,390,1960,0.0,98007,47.6119,-122.133,1700,8360,6850,0.819377990430622,2280100,69889600,67609500
589000.0,4,2.5,2630,15000,2.0,0,0,4,8,2630,0,1962,0.0,98027,47.5262,-122.02799999999999,1770,8700,12370,0.8246666666666667,6916900,225000000,218083100
850000.0,5,2.25,3100,97661,2.0,0,0,2,9,3100,0,1986,0.0,98053,47.6624,-122.06200000000001,2370,53993,94561,0.9682575439530621,9610000,9537670921,9528060921
520000.0,3,1.0,940,3000,1.5,0,0,2,7,940,0,1903,0.0,98122,47.6033,-122.3,1210,3500,2060,0.6866666666666666,883600,9000000,8116400
555000.0,2,2.25,1370,1248,2.0,0,0,2,7,1200,170,2000,0.0,98102,47.6399,-122.32,1800,3360,-122,-0.09775641025641026,1876900,1557504,-319396
470000.0,3,2.5,2480,5082,2.0,0,0,2,7,2480,0,2004,0.0,98065,47.5297,-121.846,2480,5874,2602,0.5120031483667847,6150400,25826724,19676324
207000.0,2,1.5,1068,1158,2.0,0,0,2,7,1068,0,1990,0.0,98028,47.753,-122.244,1078,1278,90,0.07772020725388601,1140624,1340964,200340
379750.0,4,2.75,2390,9650,1.0,0,2,2,8,1620,770,1976,0.0,98003,47.3438,-122.322,2390,10000,7260,0.7523316062176166,5712100,93122500,87410400
709000.0,4,1.75,2170,4600,1.0,0,0,2,7,1270,900,1950,0.0,98117,47.6894,-122.384,1750,4000,2430,0.5282608695652173,4708900,21160000,16451100
240000.0,3,2.5,1520,9864,1.0,0,0,2,7,1160,360,1993,0.0,98092,47.3186,-122.171,1580,7425,8344,0.845904298459043,2310400,97298496,94988096
445500.0,4,1.5,2210,10497,1.0,0,0,3,8,1650,560,1953,0.0,98166,47.4321,-122.34700000000001,1840,12697,8287,0.7894636562827475,4884100,110187009,105302909
1310000.0,5,2.5,3200,7863,1.0,0,3,4,8,1600,1600,1959,0.0,98199,47.6398,-122.39,2640,7680,4663,0.593030649879181,10240000,61826769,51586769
210000.0,3,1.5,1160,10125,1.0,0,0,3,7,1160,0,1959,0.0,98059,47.4919,-122.15100000000001,1440,10018,8965,0.885432098765432,1345600,102515625,101170025
603000.0,4,2.5,2670,5895,2.0,0,0,2,8,2670,0,1999,0.0,98074,47.6066,-122.016,2820,6531,3225,0.5470737913486005,7128900,34751025,27622125
720000.0,3,2.5,2520,10012,2.0,0,0,2,10,2520,0,1987,0.0,98074,47.6295,-122.051,2680,10071,7492,0.7483020375549341,6350400,100240144,93889744
92000.0,2,1.0,760,5500,1.5,0,0,2,5,760,0,1947,0.0,98168,47.5045,-122.329,1040,5515,4740,0.8618181818181818,577600,30250000,29672400
600000.0,3,1.75,1310,5000,2.0,0,0,3,7,1310,0,1901,0.0,98107,47.6722,-122.37899999999999,1270,4750,3690,0.738,1716100,25000000,23283900
725000.0,4,2.5,2750,13950,1.0,0,3,3,8,1380,1370,1948,0.0,98146,47.4938,-122.36399999999999,2460,13950,11200,0.8028673835125448,7562500,194602500,187040000
409950.0,5,2.25,1790,10300,1.0,0,0,2,7,1270,520,1961,0.0,98155,47.7718,-122.292,1790,10300,8510,0.8262135922330097,3204100,106090000,102885900
515000.0,3,2.5,1790,7167,2.0,0,0,2,8,1790,0,1989,0.0,98074,47.6176,-122.045,1680,7418,5377,0.7502441746895493,3204100,51365889,48161789
495000.0,4,2.5,2400,11640,1.0,0,0,4,8,1800,600,1968,0.0,98058,47.4485,-122.139,2440,10823,9240,0.7938144329896907,5760000,135489600,129729600
998000.0,4,2.25,2420,10200,2.0,0,0,3,9,2420,0,1973,0.0,98040,47.5336,-122.225,2390,10200,7780,0.7627450980392156,5856400,104040000,98183600
630000.0,3,1.75,1710,8767,1.0,0,0,3,8,1710,0,1986,0.0,98033,47.6945,-122.18799999999999,2050,9200,7057,0.8049503821147485,2924100,76860289,73936189
410000.0,3,1.75,2000,7480,1.0,0,0,2,8,1320,680,1972,0.0,98177,47.7734,-122.359,2000,8610,5480,0.732620320855615,4000000,55950400,51950400
602000.0,3,2.25,1580,11580,1.0,0,0,3,8,1580,0,1979,0.0,98006,47.5503,-122.155,2630,10009,10000,0.8635578583765112,2496400,134096400,131600000
750000.0,4,2.75,2310,10232,1.0,0,0,4,8,1310,1000,1980,0.0,98006,47.5515,-122.15299999999999,2820,9886,7922,0.7742376856919468,5336100,104693824,99357724
711600.0,4,3.0,3580,9316,2.5,0,0,2,10,2370,1210,1991,0.0,98007,47.595,-122.133,2580,9242,5736,0.6157148990983254,12816400,86787856,73971456
1050000.0,4,4.0,4320,8709,2.0,0,0,2,11,3190,1130,2006,0.0,98027,47.5369,-122.07,4010,8321,4389,0.503961419221495,18662400,75846681,57184281
700500.0,3,2.5,2560,35265,2.0,0,0,2,9,2560,0,1981,0.0,98072,47.7354,-122.095,2820,35496,32705,0.9274067772579044,6553600,1243620225,1237066625
710000.0,4,2.5,3220,18618,2.0,0,1,2,10,3220,0,1991,0.0,98056,47.5326,-122.181,2650,11896,15398,0.8270490922762918,10368400,346629924,336261524
250000.0,3,2.0,1660,13085,1.0,0,0,2,7,1010,650,1985,0.0,98001,47.3298,-122.277,1660,7778,11425,0.873137179977073,2755600,171217225,168461625
350000.0,4,1.75,2420,8400,1.0,0,0,4,7,1620,800,1964,0.0,98056,47.5017,-122.165,1660,8400,5980,0.7119047619047619,5856400,70560000,64703600
475000.0,7,3.5,2870,29699,1.0,0,0,2,7,1520,1350,1961,0.0,98125,47.7153,-122.32700000000001,1380,7555,26829,0.9033637496211994,8236900,882030601,873793701
200000.0,2,1.0,830,7200,1.0,0,0,1,6,830,0,1920,0.0,98118,47.5604,-122.275,1150,6600,6370,0.8847222222222222,688900,51840000,51151100
450000.0,4,2.25,1710,7000,1.0,0,0,3,7,1040,670,1972,0.0,98034,47.718999999999994,-122.21700000000001,1780,6500,5290,0.7557142857142857,2924100,49000000,46075900
316000.0,5,2.5,2600,4641,2.0,0,0,2,7,2600,0,2005,0.0,98058,47.4325,-122.146,2330,4589,2041,0.43977591036414565,6760000,21538881,14778881
310000.0,1,1.0,670,4920,1.0,0,0,2,5,670,0,1920,0.0,98126,47.5342,-122.37299999999999,1050,4920,4250,0.8638211382113821,448900,24206400,23757500
392000.0,3,1.5,1500,11975,1.0,0,0,3,7,1500,0,1970,0.0,98045,47.4658,-121.758,1510,13875,10475,0.8747390396659708,2250000,143400625,141150625
521000.0,3,3.25,1460,1254,3.0,0,0,2,8,1460,0,2000,0.0,98103,47.6535,-122.353,1400,1255,-206,-0.16427432216905902,2131600,1572516,-559084
495000.0,2,2.0,1540,7110,1.0,0,0,2,7,960,580,1949,0.0,98117,47.6932,-122.395,1860,7065,5570,0.7834036568213784,2371600,50552100,48180500
209000.0,3,1.75,1250,8084,1.0,0,0,3,7,1250,0,1967,0.0,98001,47.3364,-122.27600000000001,1340,7680,6834,0.8453735774369124,1562500,65351056,63788556
809950.0,4,2.0,2230,9900,1.5,0,0,4,9,2230,0,1959,0.0,98005,47.5979,-122.17299999999999,2510,11041,7670,0.7747474747474747,4972900,98010000,93037100
400000.0,2,1.75,1800,224769,1.0,0,0,2,7,1420,380,1950,2008.0,98038,47.4327,-122.06,1620,112384,222969,0.991991778225645,3240000,50521103361,50517863361
415000.0,4,2.5,2400,7292,1.0,0,0,2,8,1530,870,1980,0.0,98133,47.7749,-122.339,1710,7909,4892,0.6708721886999451,5760000,53173264,47413264
411000.0,4,2.0,2370,76665,2.0,0,0,3,8,2370,0,1978,0.0,98001,47.2831,-122.279,2110,19334,74295,0.9690862844844453,5616900,5877522225,5871905325
825000.0,2,2.0,1830,3600,1.0,0,0,3,7,1230,600,1926,0.0,98109,47.6359,-122.351,2020,3600,1770,0.49166666666666664,3348900,12960000,9611100
436000.0,3,2.25,1480,1384,3.0,0,0,2,8,1480,0,2008,0.0,98103,47.691,-122.34200000000001,1310,1329,-96,-0.06936416184971098,2190400,1915456,-274944
460000.0,4,2.5,2620,8331,2.0,0,0,2,9,2620,0,1991,0.0,98058,47.4357,-122.15899999999999,2760,8174,5711,0.6855119433441363,6864400,69405561,62541161
281000.0,3,1.0,1300,5782,1.0,0,0,3,6,1300,0,1959,0.0,98065,47.523999999999994,-121.821,1020,7200,4482,0.7751643030093394,1690000,33431524,31741524
976000.0,4,1.5,3120,7680,1.0,0,3,2,8,1660,1460,1956,0.0,98199,47.646,-122.39,2900,7680,4560,0.59375,9734400,58982400,49248000
485000.0,4,2.5,2400,10364,2.0,0,0,2,8,2400,0,1995,0.0,98045,47.4832,-121.79899999999999,2390,9918,7964,0.7684291779235817,5760000,107412496,101652496
429000.0,3,2.5,1430,9240,2.0,0,0,2,7,1430,0,1984,0.0,98074,47.6258,-122.05799999999999,1480,8125,7810,0.8452380952380952,2044900,85377600,83332700
729000.0,3,2.5,2480,7428,2.0,0,0,2,9,2480,0,1990,0.0,98006,47.5489,-122.185,2600,8322,4948,0.6661281637049004,6150400,55175184,49024784
625000.0,3,2.5,2280,4757,2.0,0,0,2,8,2280,0,2003,0.0,98075,47.5901,-122.01799999999999,2280,4534,2477,0.5207063275173429,5198400,22629049,17430649
218500.0,3,1.75,1390,9328,1.0,0,0,3,7,1390,0,1987,0.0,98092,47.2766,-122.146,1550,8374,7938,0.8509862778730704,1932100,87011584,85079484
175000.0,3,1.0,1030,8395,1.0,0,0,3,7,1030,0,1960,0.0,98023,47.3322,-122.337,1370,9380,7365,0.8773079213817748,1060900,70476025,69415125
442500.0,3,1.0,1120,8200,1.0,0,0,3,7,1120,0,1938,0.0,98125,47.7254,-122.29,1820,7205,7080,0.8634146341463415,1254400,67240000,65985600
480000.0,3,2.0,1300,3000,2.0,0,0,2,7,1300,0,1986,0.0,98115,47.6728,-122.325,1670,4500,1700,0.5666666666666667,1690000,9000000,7310000
715500.0,3,2.25,2410,9668,1.0,0,1,3,8,1540,870,1965,0.0,98117,47.6996,-122.391,2510,5250,7258,0.7507240380637153,5808100,93470224,87662124
432500.0,3,1.75,1470,7350,1.0,0,0,2,8,1470,0,1963,0.0,98052,47.6687,-122.154,1470,7350,5880,0.8,2160900,54022500,51861600
875000.0,5,4.25,4720,18741,2.0,0,0,2,11,3210,1510,2005,0.0,98053,47.6347,-122.01299999999999,3880,37328,14021,0.7481457766394536,22278400,351225081,328946681
605000.0,5,2.75,2910,13332,2.0,0,0,3,8,2910,0,1940,1991.0,98146,47.4977,-122.359,1760,8900,10422,0.7817281728172817,8468100,177742224,169274124
1690000.0,4,4.0,5000,12941,3.0,0,2,2,12,5000,0,2002,0.0,98006,47.55,-122.103,4560,12941,7941,0.6136310949694769,25000000,167469481,142469481
318000.0,3,2.25,1690,12662,1.0,0,0,4,7,1090,600,1982,0.0,98178,47.4972,-122.264,1950,9642,10972,0.86652977412731,2856100,160326244,157470144
311300.0,2,1.0,1000,7228,1.0,0,0,3,7,1000,0,1947,0.0,98133,47.7294,-122.352,1100,7228,6228,0.8616491422246818,1000000,52243984,51243984
325000.0,5,2.75,2400,7904,1.0,0,0,2,7,1450,950,1992,0.0,98188,47.4683,-122.26299999999999,2400,7475,5504,0.6963562753036437,5760000,62473216,56713216
795000.0,5,3.5,3330,3705,2.0,0,0,2,9,2610,720,2008,0.0,98006,47.5567,-122.124,2810,3971,375,0.10121457489878542,11088900,13727025,2638125
558000.0,4,2.25,2060,10358,1.0,0,0,3,8,1320,740,1962,0.0,98006,47.5478,-122.17399999999999,2060,9676,8298,0.8011199073180151,4243600,107288164,103044564
370000.0,4,2.5,3090,18645,2.0,0,0,2,9,3090,0,1995,0.0,98023,47.2902,-122.34200000000001,3610,20114,15555,0.834271922767498,9548100,347636025,338087925
598850.0,4,2.5,2350,7245,2.0,0,0,2,8,2350,0,1993,0.0,98074,47.6318,-122.023,2350,9419,4895,0.6756383712905452,5522500,52490025,46967525
515700.0,3,2.5,2180,9722,2.0,0,0,2,8,2180,0,1994,0.0,98056,47.527,-122.17299999999999,2440,9722,7542,0.7757663032297881,4752400,94517284,89764884
458000.0,3,2.5,1870,5013,2.0,0,0,2,8,1870,0,2003,0.0,98011,47.7552,-122.221,2040,5555,3143,0.6269698783163774,3496900,25130169,21633269
583500.0,3,2.25,3530,13000,2.5,0,0,3,10,3530,0,1985,0.0,98042,47.3823,-122.15899999999999,2960,13000,9470,0.7284615384615385,12460900,169000000,156539100
653750.0,4,2.5,2460,4166,2.0,0,0,2,9,2460,0,2003,0.0,98034,47.7072,-122.23200000000001,2460,4964,1706,0.40950552088334136,6051600,17355556,11303956
299000.0,3,2.5,1650,4725,2.0,0,0,2,8,1650,0,2011,0.0,98038,47.3548,-122.055,2000,4725,3075,0.6507936507936508,2722500,22325625,19603125
532000.0,5,3.0,3480,57499,1.0,0,0,3,8,2340,1140,1976,0.0,98027,47.4574,-122.024,2020,40946,54019,0.9394772082992747,12110400,3306135001,3294024601
819000.0,3,2.75,3176,13391,2.0,0,3,3,9,2726,450,1985,0.0,98198,47.3429,-122.33,3470,12779,10215,0.7628257785079531,10086976,179318881,169231905
945000.0,4,2.25,2420,9000,1.0,0,4,4,9,2000,420,1967,0.0,98146,47.4884,-122.363,2400,9035,6580,0.7311111111111112,5856400,81000000,75143600
608700.0,4,2.5,2260,9696,1.0,0,0,2,9,2260,0,1983,0.0,98074,47.643,-122.066,2400,12111,7436,0.766914191419142,5107600,94012416,88904816
812000.0,4,2.0,2380,6122,1.0,0,2,3,8,1310,1070,1949,0.0,98199,47.6506,-122.405,1810,5202,3742,0.6112381574648807,5664400,37478884,31814484
464000.0,5,2.5,3400,8970,1.0,0,0,3,8,1700,1700,1959,0.0,98133,47.7358,-122.335,1890,8475,5570,0.620958751393534,11560000,80460900,68900900
950000.0,4,2.5,3770,35081,2.0,0,0,2,10,3770,0,1989,0.0,98053,47.6908,-122.051,4000,35492,31311,0.8925344203414954,14212900,1230676561,1216463661
700000.0,4,2.5,2672,4297,2.0,0,0,2,8,2020,652,2005,0.0,98115,47.6955,-122.289,1720,6120,1625,0.3781708168489644,7139584,18464209,11324625
435000.0,3,1.0,1180,4219,1.0,0,0,2,7,1060,120,1939,0.0,98117,47.6867,-122.37799999999999,1630,4219,3039,0.7203128703484238,1392400,17799961,16407561
229500.0,3,1.5,1810,14400,1.0,0,0,3,7,1810,0,1954,0.0,98001,47.2887,-122.26899999999999,1710,12000,12590,0.8743055555555556,3276100,207360000,204083900
1580000.0,3,3.0,2610,22672,1.5,1,4,3,8,2610,0,1952,0.0,98166,47.4414,-122.354,2810,22672,20062,0.8848800282286521,6812100,514019584,507207484
265000.0,3,2.25,1450,13439,1.0,0,0,3,7,1180,270,1963,0.0,98003,47.2811,-122.29899999999999,1520,12348,11989,0.89210506734132,2102500,180606721,178504221
995000.0,2,2.0,1600,64468,1.0,0,0,2,7,1600,0,1950,0.0,98072,47.7344,-122.14299999999999,1950,64468,62868,0.9751814853880996,2560000,4156123024,4153563024
590000.0,3,2.5,2650,9380,1.0,0,0,4,8,1680,970,1975,0.0,98155,47.7756,-122.273,2310,9600,6730,0.7174840085287847,7022500,87984400,80961900
740000.0,4,2.75,2490,17833,2.0,0,2,2,9,1490,1000,1979,0.0,98125,47.7206,-122.28399999999999,2640,16943,15343,0.860371221891998,6200100,318015889,311815789
360000.0,2,0.75,850,7710,1.0,0,2,4,6,550,300,1909,0.0,98108,47.5588,-122.301,2500,6022,6860,0.8897535667963683,722500,59444100,58721600
548500.0,4,2.0,1820,7200,1.0,0,0,2,7,1300,520,1976,0.0,98136,47.5161,-122.38799999999999,1770,8149,5380,0.7472222222222222,3312400,51840000,48527600
599000.0,3,1.75,1960,4788,1.0,0,0,3,7,1090,870,1920,0.0,98115,47.6746,-122.31200000000001,1960,3960,2828,0.5906432748538012,3841600,22924944,19083344
615000.0,3,1.75,2350,20820,1.0,0,0,3,8,1800,550,1978,0.0,98074,47.6095,-122.059,2040,10800,18470,0.8871277617675313,5522500,433472400,427949900
292000.0,3,1.75,1320,6600,1.0,0,0,2,7,1320,0,1988,0.0,98168,47.4838,-122.33,1070,6594,5280,0.8,1742400,43560000,41817600
899000.0,4,2.5,3720,30649,2.0,0,0,2,10,3720,0,1988,0.0,98053,47.6651,-122.056,3220,29434,26929,0.8786257300401318,13838400,939361201,925522801
500000.0,3,1.5,2210,6500,1.0,0,0,3,7,1030,1180,1912,0.0,98136,47.5434,-122.38799999999999,1750,6370,4290,0.66,4884100,42250000,37365900
580000.0,3,2.5,1910,11550,1.5,0,0,2,8,1910,0,2003,0.0,98074,47.6213,-122.064,2230,11550,9640,0.8346320346320346,3648100,133402500,129754400
580000.0,4,2.5,2840,6268,2.0,0,0,2,9,2840,0,1998,0.0,98028,47.7386,-122.235,2790,6526,3428,0.5469049138481175,8065600,39287824,31222224
594000.0,3,1.0,1320,5000,1.0,0,0,3,7,1090,230,1920,0.0,98107,47.6674,-122.365,1700,5000,3680,0.736,1742400,25000000,23257600
500000.0,3,2.5,2440,7600,1.0,0,0,2,7,1420,1020,1981,0.0,98052,47.6966,-122.12700000000001,2060,7700,5160,0.6789473684210526,5953600,57760000,51806400
550000.0,4,2.5,2420,8056,1.0,0,0,2,8,1680,740,1988,0.0,98029,47.5748,-122.01299999999999,2160,6807,5636,0.6996027805362462,5856400,64899136,59042736
275000.0,3,1.75,1180,6260,1.0,0,0,3,8,1180,0,1993,0.0,98038,47.3531,-122.04799999999999,1580,7272,5080,0.8115015974440895,1392400,39187600,37795200
390000.0,3,2.25,1820,7420,2.0,0,0,3,8,1820,0,1983,0.0,98058,47.4368,-122.162,1900,7526,5600,0.7547169811320755,3312400,55056400,51744000
1250000.0,3,3.0,3760,8500,2.5,0,3,3,10,3060,700,1910,0.0,98116,47.5815,-122.398,2610,5500,4740,0.5576470588235294,14137600,72250000,58112400
250000.0,3,2.25,1560,15340,2.0,0,0,2,7,1560,0,1997,0.0,98168,47.4989,-122.322,1560,8260,13780,0.8983050847457628,2433600,235315600,232882000
405000.0,2,2.5,1790,5400,2.0,0,0,3,8,1790,0,1979,0.0,98052,47.6606,-122.12799999999999,1700,5760,3610,0.6685185185185185,3204100,29160000,25955900
213950.0,3,1.0,1430,7000,1.0,0,0,2,6,1430,0,1968,0.0,98023,47.3018,-122.369,1050,7700,5570,0.7957142857142857,2044900,49000000,46955100
232000.0,3,1.5,1390,11340,1.0,0,0,3,7,1390,0,1963,0.0,98031,47.3984,-122.186,1740,11340,9950,0.8774250440917107,1932100,128595600,126663500
207000.0,3,1.0,990,10800,1.0,0,0,3,6,990,0,1959,0.0,98002,47.293,-122.215,1060,10364,9810,0.9083333333333333,980100,116640000,115659900
310000.0,3,1.75,1880,30346,1.0,0,0,2,8,1880,0,1988,0.0,98001,47.3515,-122.291,2260,5883,28466,0.9380478481513215,3534400,920879716,917345316
540000.0,3,2.5,2520,5000,3.0,0,0,2,9,2520,0,1990,0.0,98106,47.5664,-122.359,1130,5000,2480,0.496,6350400,25000000,18649600
750000.0,4,1.5,2060,4000,1.5,0,2,2,7,1580,480,1920,1990.0,98103,47.6857,-122.353,1160,4000,1940,0.485,4243600,16000000,11756400
392500.0,4,2.5,2150,7303,2.0,0,0,2,8,2150,0,2005,0.0,98056,47.5109,-122.18299999999999,1940,9569,5153,0.705600438176092,4622500,53333809,48711309
305000.0,5,2.5,2500,12220,1.0,0,0,2,8,1690,810,1962,0.0,98003,47.3335,-122.325,2130,12000,9720,0.795417348608838,6250000,149328400,143078400
735000.0,3,2.5,2390,9157,2.0,0,0,2,9,2390,0,1984,0.0,98052,47.6617,-122.15,2360,8250,6767,0.7389974882603473,5712100,83850649,78138549
575000.0,4,2.5,2400,6137,2.0,0,0,2,8,2400,0,1990,0.0,98074,47.6187,-122.04,2120,7468,3737,0.6089294443539188,5760000,37662769,31902769
175000.0,2,1.0,660,5000,1.0,0,0,2,6,660,0,1915,0.0,98106,47.5664,-122.36399999999999,1000,5000,4340,0.868,435600,25000000,24564400
291000.0,4,2.5,1580,6633,2.0,0,0,3,7,1580,0,1984,0.0,98042,47.3768,-122.118,1590,6633,5053,0.761797075229911,2496400,43996689,41500289
791500.0,4,2.5,3250,8970,2.0,0,0,2,10,3250,0,1994,0.0,98075,47.5862,-122.037,3240,8449,5720,0.6376811594202898,10562500,80460900,69898400
475000.0,3,2.0,1880,9659,1.0,0,0,2,8,1180,700,1951,0.0,98155,47.7497,-122.28399999999999,1780,9659,7779,0.80536287400352,3534400,93296281,89761881
238950.0,2,1.0,1190,11400,1.0,0,0,2,7,1190,0,1951,0.0,98178,47.5012,-122.265,1410,11400,10210,0.8956140350877193,1416100,129960000,128543900
470000.0,3,3.5,1280,1257,2.0,0,0,2,8,1040,240,2000,0.0,98107,47.6721,-122.374,1280,1249,-23,-0.018297533810660304,1638400,1580049,-58351
420000.0,4,1.75,2380,15324,1.0,0,0,2,8,1610,770,1978,0.0,98074,47.6262,-122.04899999999999,2540,12608,12944,0.844688070999739,5664400,234824976,229160576
440000.0,3,2.5,2040,7605,2.0,0,0,2,8,2040,0,1996,0.0,98045,47.4876,-121.779,2150,7545,5565,0.7317554240631163,4161600,57836025,53674425
656000.0,4,1.75,1440,4300,1.5,0,0,3,8,1290,150,1929,0.0,98117,47.6846,-122.37200000000001,1640,5000,2860,0.6651162790697674,2073600,18490000,16416400
559950.0,3,2.5,2120,4310,2.0,0,0,2,7,2120,0,2001,0.0,98053,47.687,-122.037,2280,4380,2190,0.5081206496519721,4494400,18576100,14081700
600000.0,2,2.0,990,5416,1.0,0,0,2,6,990,0,1935,0.0,98122,47.604,-122.311,1650,3360,4426,0.8172082717872969,980100,29333056,28352956
255000.0,3,1.0,1710,12000,1.0,0,0,3,7,1710,0,1972,0.0,98001,47.2616,-122.281,1310,9600,10290,0.8575,2924100,144000000,141075900
210750.0,4,1.5,1840,7076,1.5,0,0,2,7,1840,0,1957,0.0,98106,47.5185,-122.345,1510,7320,5236,0.7399660825325043,3385600,50069776,46684176
485000.0,4,1.0,1150,2560,1.5,0,0,2,7,1150,0,1909,0.0,98109,47.6368,-122.355,1890,3000,1410,0.55078125,1322500,6553600,5231100
390000.0,3,2.5,2250,8076,2.0,0,0,2,8,2250,0,1995,0.0,98038,47.3667,-122.041,2180,7244,5826,0.7213967310549777,5062500,65221776,60159276
405000.0,3,2.5,2460,12600,1.0,0,0,3,8,1810,650,1970,0.0,98059,47.473,-122.118,1820,11180,10140,0.8047619047619048,6051600,158760000,152708400
462500.0,4,1.0,1540,4500,1.5,0,0,1,7,1540,0,1905,0.0,98116,47.586999999999996,-122.384,1920,6000,2960,0.6577777777777778,2371600,20250000,17878400
435000.0,4,2.25,2210,14073,1.0,0,0,2,8,1630,580,1978,0.0,98059,47.4774,-122.14200000000001,2340,11340,11863,0.842961699708662,4884100,198049329,193165229
440000.0,3,2.5,1440,5434,2.0,0,0,2,7,1440,0,2003,0.0,98053,47.6818,-122.03399999999999,1560,3770,3994,0.7350018402649982,2073600,29528356,27454756
299950.0,3,1.75,1790,7650,1.0,0,3,2,9,1790,0,1978,0.0,98023,47.3213,-122.385,2540,7600,5860,0.7660130718954249,3204100,58522500,55318400
440000.0,2,1.5,1120,1024,2.0,0,0,2,8,1120,0,1970,1998.0,98122,47.6175,-122.29799999999999,1120,1549,-96,-0.09375,1254400,1048576,-205824
312620.0,3,2.5,1260,11877,1.0,0,0,2,7,1260,0,1975,0.0,98045,47.4442,-121.762,1430,9790,10617,0.893912604192978,1587600,141063129,139475529
372500.0,3,1.5,1180,12324,1.0,0,0,2,7,800,380,1981,0.0,98074,47.6337,-122.03200000000001,1280,11371,11144,0.9042518662771827,1392400,151880976,150488576
297262.0,3,2.5,1730,8076,2.0,0,0,2,8,1730,0,1994,0.0,98003,47.2619,-122.30799999999999,1780,6930,6346,0.7857850421000495,2992900,65221776,62228876
735000.0,4,3.0,2250,7245,1.0,0,0,3,7,1250,1000,1963,0.0,98005,47.6045,-122.169,1960,7245,4995,0.6894409937888198,5062500,52490025,47427525
430000.0,3,1.5,1550,5034,2.0,0,0,3,7,1550,0,1922,0.0,98177,47.7072,-122.36,1820,7200,3484,0.6920937624155741,2402500,25341156,22938656
241000.0,2,1.75,1070,9750,1.5,0,0,2,7,1070,0,1995,0.0,98014,47.7131,-121.319,970,9750,8680,0.8902564102564102,1144900,95062500,93917600
201000.0,3,1.0,1460,9750,1.0,0,0,3,7,1460,0,1969,0.0,98042,47.3242,-122.14399999999999,1270,9750,8290,0.8502564102564103,2131600,95062500,92930900
570000.0,2,1.0,1060,4000,1.0,0,0,3,7,1060,0,1910,0.0,98115,47.6731,-122.315,1770,4000,2940,0.735,1123600,16000000,14876400
538000.0,4,1.75,1840,9600,1.0,0,0,2,7,1220,620,1967,0.0,98052,47.6579,-122.125,1770,9720,7760,0.8083333333333333,3385600,92160000,88774400
729000.0,3,2.5,2440,4244,2.0,0,0,2,8,2440,0,2011,0.0,98052,47.7057,-122.11200000000001,2690,4556,1804,0.42507068803016024,5953600,18011536,12057936
331500.0,4,1.75,1700,14756,1.0,0,0,2,7,850,850,1955,0.0,98006,47.5762,-122.14299999999999,1680,10250,13056,0.8847926267281107,2890000,217739536,214849536
110700.0,2,1.0,680,8064,1.0,0,0,2,6,680,0,1941,0.0,98188,47.468999999999994,-122.29799999999999,1340,10800,7384,0.9156746031746031,462400,65028096,64565696
245000.0,3,2.0,1700,8448,1.0,0,0,2,7,1700,0,1996,0.0,98022,47.2077,-122.01100000000001,1350,8587,6748,0.7987689393939394,2890000,71368704,68478704
427000.0,3,1.75,2000,7111,1.0,0,0,3,7,1360,640,1956,0.0,98177,47.7676,-122.37299999999999,1830,9000,5111,0.7187456054000844,4000000,50566321,46566321
650500.0,4,1.75,2340,5940,1.0,0,0,2,8,1290,1050,1953,0.0,98115,47.6789,-122.281,1930,5940,3600,0.6060606060606061,5475600,35283600,29808000
335900.0,2,1.0,1120,7440,1.0,0,0,3,7,1120,0,1939,0.0,98155,47.7405,-122.323,1170,7440,6320,0.8494623655913979,1254400,55353600,54099200
535000.0,2,2.0,1510,5133,1.5,0,0,2,7,1510,0,1939,0.0,98199,47.6415,-122.40100000000001,1470,6000,3623,0.7058250535749074,2280100,26347689,24067589
360000.0,5,2.0,2120,2400,1.0,0,0,3,6,1080,1040,1906,0.0,98144,47.5979,-122.29700000000001,1690,4400,280,0.11666666666666667,4494400,5760000,1265600
294900.0,3,2.25,1500,8100,1.0,0,0,2,7,1210,290,1968,0.0,98055,47.4632,-122.19,1600,7896,6600,0.8148148148148148,2250000,65610000,63360000
460000.0,2,1.0,1030,5934,1.0,0,0,3,7,1030,0,1928,0.0,98115,47.6828,-122.287,1420,5588,4904,0.8264239973036738,1060900,35212356,34151456
1770000.0,4,3.5,5440,38900,2.0,0,0,2,12,5440,0,1990,0.0,98053,47.6605,-122.069,4830,41313,33460,0.8601542416452442,29593600,1513210000,1483616400
463000.0,2,1.0,1150,4400,1.0,0,0,3,7,1150,0,1905,0.0,98112,47.6226,-122.292,1240,4400,3250,0.7386363636363636,1322500,19360000,18037500
332000.0,5,1.5,2420,43560,1.0,0,2,2,8,1500,920,1962,0.0,98022,47.208,-121.963,1620,17331,41140,0.9444444444444444,5856400,1897473600,1891617200
199500.0,4,2.0,1750,8116,1.0,0,0,3,5,1750,0,1943,0.0,98056,47.5097,-122.181,1440,7865,6366,0.7843765401675702,3062500,65869456,62806956
247000.0,4,2.0,1750,8116,1.0,0,0,3,5,1750,0,1943,0.0,98056,47.5097,-122.181,1440,7865,6366,0.7843765401675702,3062500,65869456,62806956
442500.0,4,2.5,2170,14024,2.0,0,0,2,8,2170,0,1992,0.0,98019,47.7346,-121.97,2240,14029,11854,0.8452652595550485,4708900,196672576,191963676
600000.0,3,2.0,2540,237402,1.0,0,0,2,9,2540,0,2007,0.0,98022,47.2688,-122.024,2200,229125,234862,0.989300848350056,6451600,56359709604,56353258004
449000.0,3,2.5,1690,3827,2.0,0,0,2,7,1690,0,2005,0.0,98053,47.6768,-122.029,1690,3129,2137,0.5584008361640972,2856100,14645929,11789829
725000.0,4,1.0,1600,4500,1.5,0,0,3,7,1600,0,1926,0.0,98115,47.6804,-122.316,1720,4500,2900,0.6444444444444445,2560000,20250000,17690000
215000.0,3,1.0,1060,7900,1.0,0,0,2,7,1060,0,1961,2001.0,98058,47.4604,-122.18,1310,7900,6840,0.8658227848101265,1123600,62410000,61286400
582500.0,2,1.75,1990,6549,1.0,0,0,2,7,1170,820,1948,0.0,98115,47.7,-122.296,1640,7202,4559,0.6961368147808826,3960100,42889401,38929301
305000.0,4,2.25,2210,9371,2.0,0,0,3,8,2210,0,1968,0.0,98032,47.3634,-122.279,2300,11584,7161,0.7641660441788496,4884100,87815641,82931541
734000.0,4,2.75,3090,7650,2.0,0,2,2,8,2340,750,1959,1989.0,98042,47.3622,-122.15700000000001,2760,10370,4560,0.596078431372549,9548100,58522500,48974400
300000.0,3,2.0,1050,10072,1.0,0,0,2,7,1050,0,1986,0.0,98019,47.7341,-121.976,1130,10087,9022,0.8957505957108817,1102500,101445184,100342684
525888.0,5,1.75,2550,71874,1.0,0,0,4,7,1810,740,1960,0.0,98027,47.4845,-122.08,2170,51400,69324,0.964521245512981,6502500,5165871876,5159369376
711000.0,4,2.5,2095,4400,1.5,0,0,4,8,1295,800,1910,0.0,98116,47.5838,-122.39,1980,4400,2305,0.5238636363636363,4389025,19360000,14970975
360000.0,3,1.75,1520,12282,1.0,0,0,2,8,1220,300,1978,0.0,98155,47.7516,-122.29899999999999,1860,13500,10762,0.8762416544536721,2310400,150847524,148537124
357000.0,5,2.5,2750,12350,2.0,0,0,2,8,2750,0,1987,0.0,98031,47.419,-122.206,1650,9810,9600,0.7773279352226721,7562500,152522500,144960000
235000.0,3,1.75,1200,9266,1.0,0,0,3,7,1200,0,1960,0.0,98002,47.31399999999999,-122.208,1200,9266,8066,0.8704942801640406,1440000,85858756,84418756
550000.0,3,1.75,1830,9720,1.0,0,1,2,7,1150,680,1928,0.0,98040,47.5511,-122.23,3380,10854,7890,0.8117283950617284,3348900,94478400,91129500
324000.0,3,1.0,1160,7202,1.0,0,0,3,7,1160,0,1957,0.0,98133,47.7675,-122.334,1620,8598,6042,0.838933629547348,1345600,51868804,50523204
420000.0,3,2.0,1750,9239,1.0,0,0,2,8,1410,340,1989,0.0,98133,47.7583,-122.339,1720,7874,7489,0.8105855612079229,3062500,85359121,82296621
450000.0,4,2.5,2400,7693,2.0,0,0,2,8,2400,0,2003,0.0,98059,47.4881,-122.14200000000001,2400,8038,5293,0.6880280774730274,5760000,59182249,53422249
825000.0,5,3.5,4140,6770,2.0,0,0,2,9,3030,1110,2004,0.0,98027,47.5381,-122.069,3960,5431,2630,0.38847858197932056,17139600,45832900,28693300
272000.0,4,2.25,2115,6234,2.0,0,0,2,7,2115,0,1998,0.0,98002,47.285,-122.20100000000001,2440,6366,4119,0.6607314725697786,4473225,38862756,34389531
481000.0,3,2.0,2580,15653,1.5,0,0,2,9,2580,0,1990,0.0,98166,47.4561,-122.361,1920,9840,13073,0.8351753657445857,6656400,245016409,238360009
500000.0,3,1.0,1220,3400,1.0,0,0,2,7,1060,160,1927,0.0,98117,47.6775,-122.363,1350,3750,2180,0.6411764705882353,1488400,11560000,10071600
448000.0,2,1.5,1630,3780,1.0,0,0,3,7,890,740,1940,0.0,98107,47.6711,-122.40299999999999,1770,6400,2150,0.5687830687830688,2656900,14288400,11631500
480000.0,2,2.0,1350,4220,1.0,0,0,2,8,1350,0,2004,0.0,98053,47.718,-122.03399999999999,1350,4409,2870,0.6800947867298578,1822500,17808400,15985900
475000.0,3,2.5,1690,2890,2.0,0,0,2,7,1690,0,2004,0.0,98053,47.6802,-122.031,1690,2730,1200,0.41522491349480967,2856100,8352100,5496000
472500.0,2,2.25,1700,2383,2.0,0,0,2,8,1700,0,2005,0.0,98029,47.547,-121.99700000000001,1700,2700,683,0.28661351237935373,2890000,5678689,2788689
291000.0,4,2.25,1890,7616,1.0,0,0,3,8,1260,630,1979,0.0,98003,47.3275,-122.329,1890,7420,5726,0.7518382352941176,3572100,58003456,54431356
294000.0,2,1.0,850,5250,1.0,0,0,3,7,850,0,1950,0.0,98133,47.731,-122.34200000000001,1440,5250,4400,0.8380952380952381,722500,27562500,26840000
1010000.0,4,2.5,2480,12688,1.0,0,0,3,9,1820,660,1967,0.0,98004,47.6344,-122.205,2910,11979,10208,0.8045397225725095,6150400,160985344,154834944
442500.0,3,2.5,1690,3129,2.0,0,0,2,7,1690,0,2002,0.0,98053,47.6875,-122.04299999999999,1690,3129,1439,0.45989133908596996,2856100,9790641,6934541
170000.0,2,1.0,810,8424,1.0,0,0,3,6,810,0,1959,0.0,98023,47.3286,-122.346,820,8424,7614,0.9038461538461539,656100,70963776,70307676
1580000.0,4,2.5,3980,16304,1.0,0,1,2,10,2480,1500,1968,0.0,98004,47.638999999999996,-122.21,3980,16304,12324,0.7558881256133464,15840400,265820416,249980016
665000.0,3,2.25,2580,6000,2.0,0,0,2,8,1780,800,1925,0.0,98144,47.5778,-122.289,2300,5995,3420,0.57,6656400,36000000,29343600
1610000.0,5,4.5,6085,142725,3.0,0,0,2,11,6085,0,2000,0.0,98014,47.6085,-121.95200000000001,4830,128457,136640,0.9573655631459099,37027225,20370425625,20333398400
675000.0,2,1.75,2140,5000,1.0,0,0,2,7,1000,1140,1930,1991.0,98112,47.6284,-122.291,2250,4000,2860,0.572,4579600,25000000,20420400
279900.0,2,1.75,1360,10000,1.0,0,0,2,6,1360,0,1957,1989.0,98019,47.7421,-121.98200000000001,1430,10000,8640,0.864,1849600,100000000,98150400
875000.0,4,1.5,1800,3245,1.5,0,0,3,8,1800,0,1929,0.0,98103,47.6605,-122.331,1800,4275,1445,0.4453004622496148,3240000,10530025,7290025
571000.0,3,2.5,1920,3867,2.0,0,0,2,8,1920,0,2005,0.0,98029,47.5538,-121.994,2190,3841,1947,0.5034910783553141,3686400,14953689,11267289
320000.0,3,1.0,860,5060,1.5,0,0,2,7,860,0,1927,0.0,98133,47.7062,-122.34100000000001,880,5060,4200,0.8300395256916996,739600,25603600,24864000
525000.0,3,2.5,2340,35021,1.0,0,0,2,9,2340,0,1986,0.0,98038,47.3988,-122.02799999999999,2630,35190,32681,0.9331829473744325,5475600,1226470441,1220994841
1650000.0,8,2.75,4040,20666,1.0,0,0,3,9,2020,2020,1962,0.0,98004,47.63399999999999,-122.221,3670,20500,16626,0.8045098228975128,16321600,427083556,410761956
137900.0,3,1.75,1160,5082,1.0,0,0,2,6,580,580,1942,0.0,98178,47.503,-122.262,1730,6000,3922,0.7717434081070444,1345600,25826724,24481124
440000.0,3,2.25,1680,57063,2.0,0,0,3,8,1680,0,1989,0.0,98045,47.4669,-121.765,1910,57063,55383,0.9705588560012618,2822400,3256185969,3253363569
360000.0,3,1.0,1280,3870,1.0,0,0,2,7,640,640,1945,0.0,98122,47.6163,-122.294,1280,4800,2590,0.6692506459948321,1638400,14976900,13338500
271000.0,4,1.5,1800,9576,1.0,0,0,3,7,1800,0,1977,0.0,98045,47.4664,-121.74700000000001,1370,9576,7776,0.8120300751879699,3240000,91699776,88459776
465000.0,6,3.25,4250,23326,1.0,0,3,2,10,2150,2100,1967,0.0,98003,47.34,-122.32700000000001,3370,15983,19076,0.8177998799622739,18062500,544102276,526039776
280000.0,4,2.5,2400,4596,2.0,0,0,2,8,2400,0,2004,0.0,98001,47.3358,-122.265,2230,4763,2196,0.47780678851174935,5760000,21123216,15363216
283000.0,2,1.0,940,6350,1.0,0,0,3,5,940,0,1942,0.0,98103,47.698,-122.35700000000001,1490,6350,5410,0.8519685039370078,883600,40322500,39438900
411500.0,3,1.0,1110,7208,1.0,0,0,2,7,1110,0,1980,0.0,98052,47.6979,-122.124,1440,7210,6098,0.8460044395116537,1232100,51955264,50723164
282000.0,3,2.25,2420,7548,1.0,0,0,3,8,1370,1050,1967,0.0,98023,47.3112,-122.376,2150,8000,5128,0.6793852676205617,5856400,56972304,51115904
535000.0,3,2.5,1850,1499,2.5,0,0,2,9,1790,60,2005,0.0,98199,47.6475,-122.396,1770,1539,-351,-0.2341561040693796,3422500,2247001,-1175499
554729.0,4,2.5,2020,4350,2.0,0,0,4,9,1730,290,1943,0.0,98199,47.6503,-122.41,1620,5800,2330,0.535632183908046,4080400,18922500,14842100
868000.0,4,2.5,2020,4350,2.0,0,0,4,9,1730,290,1943,0.0,98199,47.6503,-122.41,1620,5800,2330,0.535632183908046,4080400,18922500,14842100
427000.0,3,2.5,1830,65340,1.0,0,0,2,8,1520,310,1991,0.0,98045,47.4553,-121.75,2100,84942,63510,0.9719926538108357,3348900,4269315600,4265966700
455000.0,4,1.75,1920,6000,1.0,0,0,3,7,960,960,1954,0.0,98125,47.7137,-122.315,1850,7200,4080,0.68,3686400,36000000,32313600
595000.0,2,1.75,1280,8500,1.0,0,0,2,7,1280,0,1953,2010.0,98033,47.6553,-122.19,1950,10356,7220,0.8494117647058823,1638400,72250000,70611600
400000.0,4,2.5,3130,5240,2.0,0,0,2,8,3130,0,2004,0.0,98038,47.3446,-122.042,2470,5240,2110,0.4026717557251908,9796900,27457600,17660700
770000.0,4,2.5,3920,12415,2.0,0,0,2,10,3920,0,1997,0.0,98075,47.5658,-122.03200000000001,3639,12805,8495,0.6842529198550141,15366400,154132225,138765825
742500.0,4,2.75,3100,3773,2.0,0,0,2,8,2000,1100,1919,1996.0,98122,47.6158,-122.291,2130,3777,673,0.17837264776040287,9610000,14235529,4625529
1250000.0,4,2.5,3220,15600,1.0,0,0,4,9,1680,1540,1973,0.0,98006,47.5697,-122.182,2990,15600,12380,0.7935897435897435,10368400,243360000,232991600
375000.0,3,2.0,1670,13775,1.0,0,0,2,8,1670,0,1968,0.0,98045,47.4873,-121.78299999999999,2130,14500,12105,0.8787658802177858,2788900,189750625,186961725
1560000.0,4,2.5,2700,17853,2.0,0,0,3,9,2700,0,1960,0.0,98004,47.6463,-122.219,3790,16672,15153,0.8487649134599227,7290000,318729609,311439609
545000.0,4,2.0,5461,22880,1.0,0,0,3,9,3265,2196,1964,0.0,98032,47.3557,-122.29,1940,10995,17419,0.76131993006993,29822521,523494400,493671879
1050000.0,4,3.25,4400,16625,2.0,0,0,2,11,4400,0,2003,0.0,98075,47.5868,-121.96799999999999,4440,15523,12225,0.7353383458646616,19360000,276390625,257030625
1570000.0,3,1.75,2190,8500,1.0,0,0,3,9,2190,0,1957,0.0,98112,47.64,-122.285,2850,8868,6310,0.7423529411764705,4796100,72250000,67453900
178000.0,4,1.5,1200,11163,1.5,0,0,3,6,1200,0,1970,0.0,98092,47.3024,-122.10600000000001,1200,11163,9963,0.8925020155872078,1440000,124612569,123172569
262500.0,3,1.75,1470,10390,1.0,0,0,2,7,1470,0,1989,0.0,98031,47.4192,-122.20100000000001,1770,7507,8920,0.8585178055822906,2160900,107952100,105791200
730000.0,3,1.75,1650,5000,1.5,0,0,3,8,1650,0,1900,0.0,98107,47.6743,-122.37100000000001,1630,5000,3350,0.67,2722500,25000000,22277500
395000.0,5,1.75,1840,10453,1.0,0,2,2,8,1360,480,1948,0.0,98166,47.4508,-122.368,2250,11250,8613,0.8239739787620779,3385600,109265209,105879609
355000.0,3,1.0,1210,6650,1.0,0,0,2,6,1210,0,1959,0.0,98008,47.6214,-122.12,990,7590,5440,0.8180451127819549,1464100,44222500,42758400
299990.0,3,2.5,1870,8541,2.0,0,0,2,8,1870,0,1989,0.0,98023,47.2925,-122.346,2150,7789,6671,0.7810560824259455,3496900,72948681,69451781
1130000.0,4,3.25,3890,422096,1.5,0,0,2,9,3150,740,2001,0.0,98038,47.4125,-121.98200000000001,2180,229996,418206,0.9907840870323339,15132100,178165033216,178149901116
425000.0,4,2.25,2660,11200,2.0,0,0,3,8,2660,0,1972,0.0,98059,47.4722,-122.131,2090,11120,8540,0.7625,7075600,125440000,118364400
349000.0,2,1.0,1150,7552,1.0,0,0,2,7,1150,0,1951,0.0,98125,47.7215,-122.323,1150,7346,6402,0.8477224576271186,1322500,57032704,55710204
554950.0,4,1.75,1740,4816,1.0,0,0,4,7,870,870,1942,0.0,98116,47.5758,-122.382,1210,5074,3076,0.6387043189368771,3027600,23193856,20166256
326000.0,6,3.0,2580,8064,1.5,0,0,2,7,1880,700,1913,0.0,98118,47.5549,-122.287,1510,6084,5484,0.6800595238095238,6656400,65028096,58371696
580000.0,4,1.75,1720,6975,1.0,0,0,2,8,1420,300,1975,0.0,98052,47.6506,-122.12100000000001,2210,7875,5255,0.753405017921147,2958400,48650625,45692225
699000.0,3,2.5,2740,18455,2.0,0,1,3,10,1510,1230,1977,0.0,98040,47.5585,-122.215,2840,16438,15715,0.8515307504741263,7507600,340587025,333079425
757000.0,3,2.75,2610,11290,1.0,0,0,2,7,1630,980,1985,0.0,98033,47.6632,-122.20100000000001,2570,9125,8680,0.7688219663418955,6812100,127464100,120652000
335000.0,3,1.75,1400,7920,1.0,0,0,2,7,1400,0,1965,0.0,98034,47.7312,-122.20200000000001,1310,7876,6520,0.8232323232323232,1960000,62726400,60766400
660000.0,3,2.0,2570,28500,1.0,0,0,2,9,1970,600,1983,0.0,98052,47.7318,-122.13799999999999,3070,32400,25930,0.9098245614035088,6604900,812250000,805645100
540000.0,4,2.75,2830,7334,2.0,0,0,2,8,2830,0,2005,0.0,98059,47.4868,-122.141,2830,7378,4504,0.6141259885464958,8008900,53787556,45778656
320000.0,5,2.25,2630,8625,2.0,0,0,2,8,2630,0,1966,0.0,98032,47.3619,-122.287,1880,8670,5995,0.6950724637681159,6916900,74390625,67473725
280000.0,3,2.5,1580,7918,2.0,0,0,2,7,1580,0,1994,0.0,98055,47.4431,-122.19,1650,7916,6338,0.8004546602677444,2496400,62694724,60198324
324000.0,3,2.0,1540,10931,1.0,0,3,2,7,1540,0,1989,0.0,98045,47.495,-121.77600000000001,1570,10485,9391,0.8591162748147471,2371600,119486761,117115161
300000.0,3,1.0,2120,7735,1.0,0,0,3,7,1060,1060,1967,0.0,98059,47.4869,-122.12299999999999,1010,8570,5615,0.7259211376858435,4494400,59830225,55335825
360000.0,3,1.75,1830,10000,2.0,0,0,3,7,1830,0,1913,1964.0,98019,47.74100000000001,-121.979,1480,10000,8170,0.817,3348900,100000000,96651100
600000.0,3,2.5,2260,10153,2.0,0,0,2,10,2260,0,1987,0.0,98074,47.64100000000001,-122.068,2740,10153,7893,0.7774056928986507,5107600,103083409,97975809
950000.0,4,1.75,2500,92347,1.0,0,0,3,8,1500,1000,1970,0.0,98040,47.5345,-122.21600000000001,3750,20267,89847,0.9729281947437383,6250000,8527968409,8521718409
599950.0,3,3.25,1830,1804,3.0,0,0,2,8,1830,0,2014,0.0,98117,47.6945,-122.37700000000001,1830,1804,-26,-0.014412416851441241,3348900,3254416,-94484
190000.0,4,1.0,1190,7920,1.0,0,0,2,6,890,300,1951,0.0,98126,47.5305,-122.37100000000001,1140,7920,6730,0.8497474747474747,1416100,62726400,61310300
350000.0,4,1.75,2310,9002,1.0,0,0,2,7,1780,530,1970,0.0,98034,47.731,-122.166,2090,8814,6692,0.7433903576982893,5336100,81036004,75699904
522000.0,3,1.0,1230,4600,1.5,0,0,2,7,1230,0,1929,0.0,98116,47.5616,-122.39200000000001,1230,4600,3370,0.7326086956521739,1512900,21160000,19647100
850000.0,3,2.5,2940,10809,2.0,0,0,2,10,2940,0,1992,0.0,98006,47.5418,-122.13600000000001,3090,10348,7869,0.7280044407438246,8643600,116834481,108190881
308000.0,3,1.0,1010,8800,1.0,0,0,3,7,1010,0,1954,0.0,98118,47.5483,-122.27799999999999,1400,4095,7790,0.8852272727272728,1020100,77440000,76419900
1020000.0,6,2.25,2550,5000,2.0,0,0,3,7,2550,0,1907,0.0,98117,47.6785,-122.396,1480,5000,2450,0.49,6502500,25000000,18497500
397500.0,3,1.0,1480,5100,1.5,0,0,2,7,1480,0,1938,1959.0,98103,47.6915,-122.348,1300,5100,3620,0.7098039215686275,2190400,26010000,23819600
186000.0,3,1.75,1460,7967,1.0,0,0,2,7,1040,420,1977,0.0,98023,47.3199,-122.374,1460,6835,6507,0.8167440692858039,2131600,63473089,61341489
436500.0,5,3.0,3110,12429,1.0,0,0,2,8,1790,1320,1977,0.0,98011,47.7463,-122.213,3050,11902,9319,0.7497787432617266,9672100,154480041,144807941
710000.0,3,2.0,2140,4923,1.0,0,0,3,8,1070,1070,1928,0.0,98103,47.6902,-122.339,1470,4923,2783,0.565305707901686,4579600,24235929,19656329
1380000.0,5,3.25,3450,6360,2.0,0,0,4,9,1860,1590,1905,0.0,98122,47.6133,-122.287,2310,5000,2910,0.45754716981132076,11902500,40449600,28547100
450000.0,3,2.25,1960,10682,1.0,0,0,2,7,1960,0,1957,0.0,98008,47.6319,-122.124,1540,10682,8722,0.8165137614678899,3841600,114105124,110263524
375000.0,4,2.75,1890,5240,1.0,0,0,2,7,980,910,1981,0.0,98106,47.5528,-122.35600000000001,1600,5240,3350,0.6393129770992366,3572100,27457600,23885500
315000.0,2,1.0,2080,14659,1.0,0,0,2,7,1040,1040,1960,0.0,98178,47.4858,-122.23100000000001,1920,15208,12579,0.8581076471792073,4326400,214886281,210559881
467500.0,3,1.0,1700,4165,1.5,0,0,2,7,1700,0,1918,0.0,98118,47.5569,-122.277,1400,4165,2465,0.5918367346938775,2890000,17347225,14457225
330000.0,3,1.0,1140,7316,1.0,0,0,2,6,1140,0,1959,0.0,98106,47.527,-122.36200000000001,1140,7440,6176,0.8441771459814106,1299600,53523856,52224256
665000.0,3,2.5,3136,54450,1.5,0,0,4,8,3136,0,1910,0.0,98070,47.3999,-122.47200000000001,2300,54450,51314,0.9424058769513315,9834496,2964802500,2954968004
760000.0,4,3.25,2590,3889,3.0,0,0,2,9,2590,0,2013,0.0,98007,47.6259,-122.14200000000001,2590,4062,1299,0.3340190280277706,6708100,15124321,8416221
469000.0,3,1.75,1480,800,2.0,0,0,2,8,1000,480,2014,0.0,98136,47.5493,-122.387,1480,1143,-680,-0.85,2190400,640000,-1550400
408000.0,3,3.0,1500,1473,2.0,0,0,2,8,1120,380,2000,0.0,98122,47.6063,-122.305,1720,1976,-27,-0.018329938900203666,2250000,2169729,-80271
851000.0,3,2.75,2660,10350,1.0,0,4,3,8,1330,1330,1971,0.0,98008,47.5868,-122.116,2820,10043,7690,0.7429951690821256,7075600,107122500,100046900
410000.0,2,2.0,1350,3926,1.0,0,0,2,8,1350,0,2007,0.0,98053,47.7192,-122.024,1440,3926,2576,0.6561385634233317,1822500,15413476,13590976
235000.0,2,1.0,860,10500,1.0,0,0,2,6,860,0,1943,0.0,98024,47.5662,-121.88600000000001,950,10500,9640,0.9180952380952381,739600,110250000,109510400
207100.0,2,1.0,1000,4500,1.0,0,0,2,6,1000,0,1916,0.0,98055,47.4896,-122.204,980,4837,3500,0.7777777777777778,1000000,20250000,19250000
560000.0,4,2.5,2480,16360,1.0,0,0,4,7,1510,970,1959,0.0,98028,47.7638,-122.265,1770,15205,13880,0.8484107579462102,6150400,267649600,261499200
903000.0,3,2.75,3860,12786,2.0,0,0,3,10,3860,0,1984,0.0,98006,47.549,-122.141,2820,14636,8926,0.6981073048646957,14899600,163481796,148582196
998500.0,3,1.75,2140,4800,2.0,0,0,2,8,1690,450,1905,0.0,98112,47.6311,-122.31200000000001,2440,4800,2660,0.5541666666666667,4579600,23040000,18460400
268500.0,4,1.75,1820,13600,1.5,0,0,2,7,1120,700,1959,0.0,98032,47.3743,-122.295,1810,11970,11780,0.8661764705882353,3312400,184960000,181647600
494950.0,2,1.75,2220,33000,1.0,0,0,3,8,2220,0,1970,0.0,98072,47.7403,-122.12899999999999,2220,33000,30780,0.9327272727272727,4928400,1089000000,1084071600
1130000.0,4,2.5,2660,11200,2.0,0,0,2,9,2660,0,1999,0.0,98004,47.5894,-122.197,3290,11275,8540,0.7625,7075600,125440000,118364400
250000.0,3,2.0,1470,12096,1.0,0,0,3,6,1470,0,1942,0.0,98030,47.3734,-122.193,1470,10966,10626,0.8784722222222222,2160900,146313216,144152316
449000.0,4,1.75,2350,54450,1.0,0,0,3,7,1250,1100,1971,0.0,98027,47.4816,-122.005,2180,50529,52100,0.9568411386593205,5522500,2964802500,2959280000
1230000.0,3,2.25,2980,7700,1.0,0,0,2,9,2530,450,1964,0.0,98112,47.6336,-122.29,3020,8234,4720,0.612987012987013,8880400,59290000,50409600
325000.0,4,2.0,1870,7700,1.0,0,0,2,8,1870,0,1966,0.0,98055,47.4619,-122.196,2270,8580,5830,0.7571428571428571,3496900,59290000,55793100
506000.0,5,3.0,2430,8000,1.0,0,0,3,7,1370,1060,1957,0.0,98008,47.603,-122.12,1770,8000,5570,0.69625,5904900,64000000,58095100
751000.0,4,2.5,2790,6538,2.0,0,0,2,9,2790,0,2003,0.0,98027,47.5349,-122.066,2990,6538,3748,0.5732639951055368,7784100,42745444,34961344
280000.0,3,2.5,1370,22326,2.0,0,0,2,7,1370,0,1993,0.0,98045,47.4469,-121.775,1580,10920,20956,0.9386365672310311,1876900,498450276,496573376
1120000.0,4,2.25,4470,60373,2.0,0,0,2,11,4470,0,1988,0.0,98072,47.7289,-122.12700000000001,3210,40450,55903,0.9259602802577311,19980900,3644899129,3624918229
580000.0,3,1.75,2040,81021,1.0,0,0,2,8,2040,0,1980,0.0,98053,47.6536,-122.045,2260,39280,78981,0.9748213426148776,4161600,6564402441,6560240841
665000.0,4,2.25,2340,5300,1.0,0,0,4,8,1700,640,1963,0.0,98008,47.6202,-122.11200000000001,1890,8250,2960,0.5584905660377358,5475600,28090000,22614400
450000.0,4,2.5,2520,8515,2.0,0,0,2,7,2520,0,1999,0.0,98019,47.7233,-121.959,2130,6930,5995,0.7040516735173223,6350400,72505225,66154825
389900.0,4,1.0,1710,117176,1.5,0,0,3,6,1710,0,1942,0.0,98055,47.4497,-122.212,1940,12223,115466,0.9854065678978631,2924100,13730214976,13727290876
427000.0,3,1.0,1200,5252,1.0,0,0,2,7,1200,0,1962,0.0,98007,47.6075,-122.134,1800,7920,4052,0.7715156130997716,1440000,27583504,26143504
265000.0,3,1.75,1330,12618,1.0,0,3,2,7,1330,0,1983,0.0,98188,47.4403,-122.271,1870,8429,11288,0.8945950229830401,1768900,159213924,157445024
398000.0,3,1.5,1310,2996,2.0,0,0,2,7,1310,0,1998,0.0,98144,47.5879,-122.29899999999999,1310,2997,1686,0.5627503337783711,1716100,8976016,7259916
354000.0,6,3.5,3020,4500,2.0,0,0,2,7,3020,0,1941,1992.0,98178,47.49800000000001,-122.225,900,6000,1480,0.3288888888888889,9120400,20250000,11129600
339950.0,4,2.5,2260,6086,2.0,0,0,2,8,2260,0,1999,0.0,98030,47.3642,-122.17399999999999,2260,6218,3826,0.6286559316464015,5107600,37039396,31931796
399000.0,2,1.0,790,4000,1.0,0,0,2,6,790,0,1948,0.0,98115,47.6844,-122.289,990,5000,3210,0.8025,624100,16000000,15375900
325000.0,2,2.0,970,5000,1.0,0,0,2,7,970,0,1983,0.0,98034,47.7223,-122.16,1540,5000,4030,0.806,940900,25000000,24059100
998800.0,3,2.0,2250,8000,1.0,0,2,3,9,2250,0,1955,0.0,98177,47.7077,-122.37799999999999,2880,10960,5750,0.71875,5062500,64000000,58937500
350000.0,4,2.5,1530,2248,1.5,0,0,2,7,1530,0,1914,0.0,98144,47.5766,-122.309,1340,3700,718,0.3193950177935943,2340900,5053504,2712604
1000000.0,4,1.75,1780,11436,1.0,0,0,4,9,1780,0,1967,0.0,98004,47.6273,-122.194,2100,12052,9656,0.84435117173837,3168400,130782096,127613696
561000.0,3,2.5,2120,5277,2.0,0,0,2,7,2120,0,2005,0.0,98053,47.6811,-122.03399999999999,2370,5257,3157,0.598256585180974,4494400,27846729,23352329
245000.0,2,1.0,1500,6685,1.0,0,0,2,7,1190,310,1926,0.0,98133,47.7186,-122.354,1420,6561,5185,0.7756170531039641,2250000,44689225,42439225
570000.0,2,1.0,1500,6685,1.0,0,0,2,7,1190,310,1926,0.0,98133,47.7186,-122.354,1420,6561,5185,0.7756170531039641,2250000,44689225,42439225
845000.0,4,3.0,2390,4000,1.5,0,0,4,8,1460,930,1931,0.0,98103,47.6857,-122.331,1670,4000,1610,0.4025,5712100,16000000,10287900
314500.0,4,2.5,2390,9600,2.0,0,0,2,7,2390,0,1996,0.0,98010,47.3289,-122.001,1900,9603,7210,0.7510416666666667,5712100,92160000,86447900
650000.0,3,1.75,2920,9370,1.0,0,0,3,8,1620,1300,1981,0.0,98006,47.5491,-122.15100000000001,2890,9609,6450,0.688367129135539,8526400,87796900,79270500
298000.0,2,1.0,850,5000,1.0,0,0,2,5,850,0,1907,0.0,98055,47.4874,-122.20700000000001,910,4815,4150,0.83,722500,25000000,24277500
500000.0,2,1.0,930,3200,1.0,0,0,2,7,930,0,1904,0.0,98122,47.608999999999995,-122.314,1690,3840,2270,0.709375,864900,10240000,9375100
870000.0,4,2.5,3340,12248,2.0,0,1,2,9,2470,870,1998,0.0,98126,47.5858,-122.37899999999999,2110,5679,8908,0.7273024167210973,11155600,150013504,138857904
299000.0,2,1.0,710,6732,1.0,0,0,4,6,710,0,1942,0.0,98126,47.5151,-122.37200000000001,710,6720,6022,0.8945335710041592,504100,45319824,44815724
527000.0,3,2.25,2240,6450,1.0,0,0,2,7,1440,800,1979,0.0,98125,47.7034,-122.315,1390,6450,4210,0.6527131782945736,5017600,41602500,36584900
420000.0,3,1.0,1060,7638,1.0,0,0,4,7,1060,0,1966,0.0,98007,47.5941,-122.14200000000001,1470,8097,6578,0.8612202147158942,1123600,58339044,57215444
290000.0,3,2.5,2360,8764,2.0,0,0,2,8,2360,0,1991,0.0,98022,47.2114,-122.009,2360,8746,6404,0.7307165677772707,5569600,76807696,71238096
1660000.0,4,2.75,3520,19200,1.0,1,4,3,9,1950,1570,1951,0.0,98136,47.525,-122.39299999999999,2450,7000,15680,0.8166666666666667,12390400,368640000,356249600
499990.0,3,1.75,1730,9334,1.0,0,0,2,8,1220,510,1977,0.0,98052,47.6478,-122.113,2020,10000,7604,0.8146560959931434,2992900,87123556,84130656
315000.0,3,1.75,1170,4000,1.0,0,0,2,6,720,450,1943,2013.0,98106,47.5306,-122.354,1130,4000,2830,0.7075,1368900,16000000,14631100
425000.0,4,2.25,3680,26266,2.0,0,0,3,9,3680,0,1981,0.0,98042,47.3219,-122.085,2340,19939,22586,0.8598949211908932,13542400,689902756,676360356
630000.0,3,2.5,2900,46609,2.0,0,0,2,9,2900,0,1987,0.0,98077,47.7731,-122.086,2570,42188,43709,0.9377802570319037,8410000,2172398881,2163988881
365000.0,3,1.75,1290,7205,1.5,0,0,2,7,1290,0,1971,0.0,98034,47.7329,-122.23700000000001,1340,7214,5915,0.8209576682859125,1664100,51912025,50247925
774000.0,4,2.75,2010,7000,2.0,0,0,4,8,2010,0,1901,0.0,98199,47.6607,-122.396,1420,4400,4990,0.7128571428571429,4040100,49000000,44959900
368888.0,3,1.5,1490,12186,1.0,0,0,3,7,1490,0,1950,0.0,98155,47.7739,-122.322,1180,14285,10696,0.8777285409486296,2220100,148498596,146278496
339500.0,4,2.5,1930,7862,2.0,0,0,2,7,1930,0,1994,0.0,98038,47.3644,-122.04,1640,9145,5932,0.7545153904858815,3724900,61811044,58086144
344950.0,4,1.75,2240,7500,1.0,0,0,3,7,1120,1120,1956,0.0,98133,47.7466,-122.34,1440,7500,5260,0.7013333333333334,5017600,56250000,51232400
450000.0,3,2.0,2320,17688,1.0,0,0,2,8,2320,0,1952,1994.0,98166,47.4519,-122.363,1610,14482,15368,0.8688376300316599,5382400,312865344,307482944
814950.0,4,2.75,2990,6626,2.0,0,0,2,9,2990,0,2014,0.0,98052,47.7107,-122.11,2910,5533,3636,0.5487473588892242,8940100,43903876,34963776
299900.0,4,2.5,2200,5730,2.0,0,0,2,8,2200,0,2003,0.0,98042,47.3482,-122.15299999999999,2200,5772,3530,0.6160558464223386,4840000,32832900,27992900
315000.0,3,2.0,1500,7828,1.0,0,0,3,7,1500,0,1967,0.0,98058,47.4484,-122.15799999999999,1500,7700,6328,0.8083801737353091,2250000,61277584,59027584
880000.0,3,1.75,3860,9000,1.0,0,2,2,9,1930,1930,1970,0.0,98155,47.7431,-122.29,2960,9000,5140,0.5711111111111111,14899600,81000000,66100400
195000.0,3,1.5,1430,5200,1.0,0,0,3,7,1030,400,1977,0.0,98042,47.3644,-122.094,1190,5200,3770,0.725,2044900,27040000,24995100
910000.0,5,2.75,3750,8279,2.0,0,0,2,9,3750,0,2001,0.0,98074,47.6039,-122.06,3450,8279,4529,0.5470467447759392,14062500,68541841,54479341
540000.0,5,2.5,3100,10189,2.0,0,0,2,8,3100,0,2002,0.0,98019,47.738,-121.965,2840,10189,7089,0.6957503189714398,9610000,103815721,94205721
306000.0,3,2.5,1870,5874,2.0,0,0,2,7,1870,0,2005,0.0,98042,47.3992,-122.163,2090,4060,4004,0.6816479400749064,3496900,34503876,31006976
272000.0,4,2.25,2040,7600,1.0,0,0,3,8,1580,460,1978,0.0,98023,47.3169,-122.365,2130,7200,5560,0.7315789473684211,4161600,57760000,53598400
1300000.0,5,3.5,3700,8504,2.0,0,0,2,8,2750,950,1950,2014.0,98105,47.669,-122.275,2370,6246,4804,0.5649106302916275,13690000,72318016,58628016
450000.0,3,1.75,3150,9258,1.0,0,1,2,8,2370,780,1970,0.0,98027,47.5571,-122.08,2740,10274,6108,0.659753726506805,9922500,85710564,75788064
450000.0,3,2.5,1990,12793,2.0,0,0,2,8,1990,0,1993,0.0,98028,47.7347,-122.226,2290,9035,10803,0.8444461815055109,3960100,163660849,159700749
310000.0,4,1.0,1740,11075,1.5,0,0,2,7,1740,0,1965,0.0,98133,47.7458,-122.334,1580,7684,9335,0.8428893905191873,3027600,122655625,119628025
530000.0,2,2.25,2080,11285,1.0,0,0,3,8,1180,900,1954,0.0,98042,47.3628,-122.147,2590,13048,9205,0.8156845369960124,4326400,127351225,123024825
435000.0,4,2.5,2060,10125,2.0,0,0,3,7,1560,500,1979,0.0,98028,47.763999999999996,-122.262,1760,9876,8065,0.7965432098765433,4243600,102515625,98272025
485000.0,3,2.0,1590,11222,1.0,0,0,3,7,1590,0,1948,0.0,98177,47.7762,-122.367,2160,16300,9632,0.8583140260203173,2528100,125933284,123405184
690000.0,3,1.5,1760,4000,2.0,0,0,2,8,1760,0,1922,0.0,98102,47.6401,-122.32,1760,4000,2240,0.56,3097600,16000000,12902400
305000.0,4,2.5,1620,4000,2.0,0,0,2,7,1620,0,2008,0.0,98038,47.3661,-122.02,1580,3780,2380,0.595,2624400,16000000,13375600
300000.0,3,1.75,1210,7000,1.0,0,0,2,7,1210,0,1975,0.0,98058,47.4572,-122.169,1670,7000,5790,0.8271428571428572,1464100,49000000,47535900
289950.0,4,3.0,2040,5050,1.0,0,0,2,8,1490,550,1993,0.0,98092,47.3266,-122.175,2020,6118,3010,0.596039603960396,4161600,25502500,21340900
575000.0,3,2.5,2270,9600,2.0,0,0,2,9,2270,0,1990,0.0,98011,47.7388,-122.206,2580,9617,7330,0.7635416666666667,5152900,92160000,87007100
1820000.0,4,4.5,6640,53330,2.0,0,0,2,12,6640,0,1993,0.0,98077,47.7283,-122.046,4620,68625,46690,0.8754922182636414,44089600,2844088900,2799999300
219000.0,3,1.5,1060,9600,1.0,0,0,3,7,1060,0,1962,0.0,98023,47.3229,-122.348,1440,9600,8540,0.8895833333333333,1123600,92160000,91036400
265000.0,4,3.0,1940,8170,1.0,0,0,3,7,1940,0,1948,0.0,98155,47.7381,-122.302,1310,8169,6230,0.762545899632803,3763600,66748900,62985300
1110000.0,5,3.25,3070,5000,2.0,0,0,2,9,2050,1020,2006,0.0,98103,47.6742,-122.35600000000001,2070,5000,1930,0.386,9424900,25000000,15575100
200000.0,3,1.0,930,7590,1.0,0,0,2,6,820,110,1943,0.0,98166,47.4802,-122.335,1220,7590,6660,0.8774703557312253,864900,57608100,56743200
545000.0,4,2.75,2180,8480,1.0,0,3,3,7,1210,970,1959,0.0,98146,47.4961,-122.366,2240,8497,6300,0.7429245283018868,4752400,71910400,67158000
378000.0,3,2.5,2130,8404,2.0,0,0,2,8,2130,0,1991,0.0,98058,47.4623,-122.13,2130,8404,6274,0.7465492622560685,4536900,70627216,66090316
388000.0,2,1.75,800,4800,1.0,0,0,3,6,800,0,1922,0.0,98136,47.5559,-122.396,1090,5000,4000,0.8333333333333334,640000,23040000,22400000
425000.0,4,2.25,2200,8384,1.0,0,0,2,7,1250,950,1959,0.0,98155,47.753,-122.31700000000001,1750,8384,6184,0.7375954198473282,4840000,70291456,65451456
536000.0,2,1.5,1130,746,2.0,0,0,2,8,1030,100,2009,0.0,98107,47.6684,-122.363,1520,1519,-384,-0.514745308310992,1276900,556516,-720384
1180000.0,3,2.5,1970,23180,1.0,1,4,2,8,1100,870,1937,1998.0,98136,47.5495,-122.398,3030,34689,21210,0.9150129421915444,3880900,537312400,533431500
629950.0,3,2.5,1680,1620,2.0,0,0,2,9,1120,560,2014,0.0,98119,47.6425,-122.374,1610,1618,-60,-0.037037037037037035,2822400,2624400,-198000
465000.0,4,1.75,1470,5350,1.0,0,0,2,7,980,490,1955,0.0,98125,47.7048,-122.315,1970,6138,3880,0.7252336448598131,2160900,28622500,26461600
545000.0,4,2.25,2390,40510,1.0,0,0,3,8,2390,0,1969,0.0,98072,47.7566,-122.113,3200,36989,38120,0.9410022216736609,5712100,1641060100,1635348000
592000.0,4,2.5,2300,11165,2.0,0,0,3,8,2300,0,1979,0.0,98008,47.5794,-122.118,2170,11165,8865,0.793999104343932,5290000,124657225,119367225
446000.0,4,2.0,2280,43692,1.0,0,0,2,7,1140,1140,1957,1984.0,98038,47.4067,-122.03,2580,37938,41412,0.9478165339192529,5198400,1908990864,1903792464
375000.0,3,2.5,1330,816,3.0,0,0,2,8,1330,0,2004,0.0,98117,47.6836,-122.387,1330,1113,-514,-0.6299019607843137,1768900,665856,-1103044
632500.0,5,2.5,2640,7096,2.0,0,0,2,7,2640,0,2003,0.0,98053,47.6827,-122.038,2640,4850,4456,0.6279594137542277,6969600,50353216,43383616
459950.0,4,1.75,2430,9747,1.0,0,0,2,8,1780,650,1974,0.0,98155,47.7687,-122.27600000000001,2340,10296,7317,0.7506925207756233,5904900,95004009,89099109
485000.0,4,2.5,2470,35073,2.0,0,0,2,9,2470,0,1989,0.0,98092,47.3064,-122.10799999999999,2990,35259,32603,0.9295754569041713,6100900,1230115329,1224014429
255000.0,3,1.0,1440,11330,1.0,0,0,2,7,1440,0,1965,0.0,98168,47.4742,-122.265,1580,10100,9890,0.8729037952338923,2073600,128368900,126295300
251750.0,3,2.0,1320,7200,1.0,0,0,4,7,1320,0,1975,0.0,98031,47.3947,-122.17399999999999,1540,7200,5880,0.8166666666666667,1742400,51840000,50097600
725000.0,3,2.5,2810,6300,2.0,0,0,2,8,2810,0,2001,0.0,98074,47.6077,-122.02,2860,6630,3490,0.553968253968254,7896100,39690000,31793900
460000.0,3,3.25,1370,1194,3.0,0,0,2,8,1370,0,2005,0.0,98107,47.6704,-122.391,1320,1217,-176,-0.1474036850921273,1876900,1425636,-451264
625000.0,3,2.5,2000,6341,1.0,0,0,4,8,1040,960,1981,0.0,98116,47.5639,-122.40100000000001,2030,6341,4341,0.6845923355937549,4000000,40208281,36208281
530000.0,3,1.75,1980,6760,1.0,0,0,3,8,1980,0,1973,0.0,98008,47.6398,-122.113,2120,7280,4780,0.7071005917159763,3920400,45697600,41777200
394950.0,3,2.5,2050,8172,2.0,0,0,2,8,2050,0,2002,0.0,98168,47.4808,-122.28,2140,5664,6122,0.7491434165442976,4202500,66781584,62579084
324950.0,4,1.75,2320,9240,1.0,0,0,2,7,1160,1160,1959,2014.0,98178,47.4909,-122.257,2130,7320,6920,0.7489177489177489,5382400,85377600,79995200
330000.0,3,2.25,1960,1985,2.0,0,0,2,7,1750,210,2003,0.0,98118,47.5417,-122.289,1760,1985,25,0.012594458438287154,3841600,3940225,98625
220000.0,4,1.75,1910,8171,1.0,0,0,2,7,1910,0,1986,0.0,98030,47.35,-122.16799999999999,1910,7542,6261,0.7662464814588178,3648100,66765241,63117141
685000.0,3,3.25,2030,11070,2.0,0,0,3,8,2030,0,1980,0.0,98052,47.6478,-122.117,2450,11070,9040,0.8166214995483289,4120900,122544900,118424000
500000.0,3,2.25,2210,7680,1.0,0,2,2,8,1730,480,1972,0.0,98177,47.7729,-122.389,2390,7680,5470,0.7122395833333334,4884100,58982400,54098300
368000.0,4,2.75,2610,9426,1.0,0,0,2,7,1360,1250,1965,0.0,98188,47.4435,-122.279,1600,9426,6816,0.7231063017186505,6812100,88849476,82037376
825000.0,3,2.25,2520,7975,2.0,0,0,3,9,1550,970,1990,0.0,98033,47.6704,-122.18299999999999,2520,9900,5455,0.684012539184953,6350400,63600625,57250225
660000.0,6,1.75,1840,2774,1.0,0,0,2,7,1060,780,1900,0.0,98122,47.6041,-122.31,1680,4292,934,0.33669790915645276,3385600,7695076,4309476
253000.0,3,1.75,1570,7416,1.0,0,0,3,7,1570,0,1971,0.0,98031,47.4117,-122.17399999999999,1900,7416,5846,0.7882955771305286,2464900,54997056,52532156
392500.0,4,2.75,2400,19923,1.0,0,0,4,7,1320,1080,1953,0.0,98042,47.3616,-122.14399999999999,2470,10736,17523,0.8795362144255383,5760000,396925929,391165929
605000.0,3,1.75,1930,5400,2.0,0,2,2,9,1930,0,1978,0.0,98177,47.77,-122.391,2100,6840,3470,0.6425925925925926,3724900,29160000,25435100
215000.0,3,1.0,1160,10384,1.0,0,0,3,6,1160,0,1969,0.0,98038,47.3634,-122.027,1200,9880,9224,0.8882896764252697,1345600,107827456,106481856
650000.0,4,2.5,2820,15000,2.0,0,0,3,9,2820,0,1985,0.0,98052,47.7255,-122.101,2440,15000,12180,0.812,7952400,225000000,217047600
877500.0,4,2.0,3060,8000,2.0,0,0,3,8,2040,1020,1922,0.0,98144,47.5795,-122.29,2730,5800,4940,0.6175,9363600,64000000,54636400
232500.0,3,1.0,1320,8450,1.0,0,0,2,6,880,440,1961,0.0,98023,47.3278,-122.337,1320,8450,7130,0.8437869822485207,1742400,71402500,69660100
234000.0,2,2.0,1200,3624,2.0,0,0,2,6,1200,0,2003,0.0,98038,47.349,-122.025,1360,2693,2424,0.6688741721854304,1440000,13133376,11693376
380000.0,3,1.75,1560,104108,1.0,0,0,2,7,1250,310,1970,0.0,98042,47.4016,-122.131,2000,110957,102548,0.9850155607638222,2433600,10838475664,10836042064
420000.0,5,2.25,3070,64033,1.0,0,0,2,9,2730,340,1983,0.0,98001,47.3238,-122.292,1560,28260,60963,0.952055971139881,9424900,4100225089,4090800189
399950.0,3,1.0,1040,9600,1.0,0,0,2,7,1040,0,1978,0.0,98053,47.6738,-122.06299999999999,1370,10889,8560,0.8916666666666667,1081600,92160000,91078400
256750.0,3,2.5,1990,8991,1.0,0,0,2,7,1570,420,1969,0.0,98042,47.3939,-122.164,1920,8991,7001,0.7786675564453343,3960100,80838081,76877981
535000.0,3,2.5,1690,9626,2.0,0,0,2,8,1690,0,1984,0.0,98027,47.5647,-122.09200000000001,1860,8958,7936,0.8244338250571369,2856100,92659876,89803776
515000.0,3,2.0,1810,2738,2.0,0,0,3,9,1810,0,1979,0.0,98008,47.6112,-122.115,1760,2754,928,0.3389335281227173,3276100,7496644,4220544
770000.0,4,1.75,2520,8442,1.0,0,0,3,7,1640,880,1953,0.0,98004,47.6317,-122.205,2110,8442,5922,0.7014925373134329,6350400,71267364,64916964
256000.0,3,2.5,1570,5113,1.0,0,0,2,7,1090,480,1996,0.0,98001,47.3327,-122.29,1570,5150,3543,0.6929395658126345,2464900,26142769,23677869
489900.0,3,1.0,1680,8910,1.0,0,0,3,7,1680,0,1940,0.0,98117,47.7011,-122.375,1620,7182,7230,0.8114478114478114,2822400,79388100,76565700
165000.0,3,1.5,1250,7200,1.0,0,0,3,7,1250,0,1978,0.0,98032,47.3678,-122.28200000000001,1250,7560,5950,0.8263888888888888,1562500,51840000,50277500
220000.0,3,1.5,1280,7742,1.0,0,0,3,7,1280,0,1962,0.0,98031,47.3947,-122.197,1450,8316,6462,0.834668044432963,1638400,59938564,58300164
575000.0,4,2.5,4620,20793,2.0,0,0,3,11,4620,0,1991,0.0,98023,47.2929,-122.34200000000001,3640,20793,16173,0.7778098398499494,21344400,432348849,411004449
375000.0,3,2.5,1580,5725,2.0,0,0,2,7,1580,0,2004,0.0,98072,47.7611,-122.161,1510,5725,4145,0.7240174672489083,2496400,32775625,30279225
422250.0,3,1.75,1650,7145,2.0,0,0,4,8,1300,350,1977,0.0,98155,47.7733,-122.324,1760,7206,5495,0.7690692792162351,2722500,51051025,48328525
420000.0,3,1.75,1660,9600,1.0,0,0,2,8,1380,0,1981,0.0,98011,47.7601,-122.167,2030,9500,7940,0.8270833333333333,2755600,92160000,89404400
608000.0,4,2.5,2410,7140,2.0,0,0,2,8,2410,0,1993,0.0,98074,47.6329,-122.021,2350,7140,4730,0.6624649859943977,5808100,50979600,45171500
620000.0,3,2.25,1720,4000,1.5,0,0,3,7,1450,270,1921,0.0,98105,47.6683,-122.286,1410,4000,2280,0.57,2958400,16000000,13041600
850000.0,3,2.5,3120,12406,2.0,0,2,2,9,1940,1180,1983,0.0,98006,47.5507,-122.141,3240,13141,9286,0.7485087860712558,9734400,153908836,144174436
463000.0,4,2.5,2680,9928,1.0,0,0,3,8,1340,1340,1974,0.0,98027,47.5219,-122.052,2180,10478,7248,0.7300564061240935,7182400,98565184,91382784
750000.0,5,1.75,2640,13290,1.0,1,4,3,8,1400,1240,1954,0.0,98178,47.5022,-122.223,2400,11942,10650,0.801354401805869,6969600,176624100,169654500
1070000.0,3,3.25,3730,13264,2.0,0,0,2,9,3730,0,1989,0.0,98077,47.7246,-122.059,3730,14933,9534,0.7187876960193004,13912900,175933696,162020796
290000.0,3,2.0,1700,6498,1.0,0,0,2,7,1700,0,1986,0.0,98038,47.3781,-122.044,1700,6654,4798,0.7383810403200985,2890000,42224004,39334004
525000.0,4,1.75,2280,5959,1.0,0,0,2,7,1250,1030,1947,0.0,98116,47.5655,-122.395,1640,5911,3679,0.6173854673602953,5198400,35509681,30311281
319000.0,3,2.25,1220,2980,2.0,0,0,2,7,1220,0,1986,0.0,98034,47.7151,-122.20299999999999,1220,2140,1760,0.5906040268456376,1488400,8880400,7392000
592500.0,6,4.5,3500,8504,2.0,0,0,2,7,3500,0,1980,0.0,98155,47.7349,-122.295,1550,8460,5004,0.5884289746001882,12250000,72318016,60068016
350000.0,3,2.5,2010,14298,2.0,0,0,2,7,2010,0,1977,0.0,98070,47.5069,-122.47200000000001,2010,14298,12288,0.8594208980276962,4040100,204432804,200392704
454900.0,3,1.75,2130,9775,1.0,0,0,3,8,1430,700,1973,0.0,98027,47.5326,-122.04899999999999,2130,11250,7645,0.7820971867007672,4536900,95550625,91013725
272000.0,4,2.25,1800,9018,2.0,0,0,2,7,1800,0,1992,0.0,98022,47.2126,-121.984,1670,9380,7218,0.8003992015968064,3240000,81324324,78084324
357500.0,3,1.0,1070,10125,1.0,0,0,2,7,1070,0,1961,0.0,98033,47.7012,-122.167,1540,10200,9055,0.894320987654321,1144900,102515625,101370725
285000.0,3,1.75,1020,5000,1.0,0,0,4,6,1020,0,1954,0.0,98118,47.5332,-122.29,1360,5000,3980,0.796,1040400,25000000,23959600
280000.0,4,2.0,1600,6861,1.0,0,0,2,7,1600,0,1994,0.0,98003,47.2701,-122.31299999999999,1870,7455,5261,0.7667978428800466,2560000,47073321,44513321
477000.0,4,1.5,1380,7800,1.0,0,0,2,7,1080,300,1928,0.0,98125,47.7093,-122.306,1770,7503,6420,0.823076923076923,1904400,60840000,58935600
750000.0,3,2.25,3270,168000,2.0,0,0,3,10,3270,0,1982,0.0,98056,47.5197,-122.191,3220,7963,164730,0.9805357142857143,10692900,28224000000,28213307100
595000.0,4,2.5,2100,3125,2.0,0,2,2,7,1400,700,1907,0.0,98107,47.6634,-122.35799999999999,2060,5040,1025,0.328,4410000,9765625,5355625
525000.0,3,2.25,2110,2850,3.0,0,0,2,8,2110,0,2001,0.0,98103,47.6915,-122.339,1340,5001,740,0.2596491228070175,4452100,8122500,3670400
319000.0,3,1.75,1640,53400,1.0,0,0,3,7,1640,0,1966,0.0,98070,47.3944,-122.506,1850,380279,51760,0.9692883895131086,2689600,2851560000,2848870400
225000.0,3,2.0,1320,5665,1.0,0,0,2,7,1320,0,1986,0.0,98023,47.3096,-122.35700000000001,1336,7080,4345,0.7669902912621359,1742400,32092225,30349825
485000.0,4,2.5,2420,10603,1.0,0,0,4,7,1210,1210,1958,0.0,98028,47.7397,-122.259,1750,10800,8183,0.7717627086673583,5856400,112423609,106567209
341000.0,3,1.0,1390,4814,1.5,0,0,2,6,1390,0,1908,0.0,98115,47.6881,-122.32,1730,3990,3424,0.7112588284171167,1932100,23174596,21242496
674000.0,3,3.25,2320,6744,2.0,0,0,2,9,1930,390,2014,0.0,98125,47.7132,-122.29299999999999,1700,6744,4424,0.6559905100830368,5382400,45481536,40099136
442250.0,3,2.5,2170,8169,2.0,0,0,2,8,2170,0,2003,0.0,98059,47.4833,-122.139,2240,6733,5999,0.7343616109682948,4708900,66732561,62023661
591000.0,4,2.25,2710,38180,2.0,0,0,3,8,2710,0,1977,0.0,98077,47.77,-122.09700000000001,2590,38180,35470,0.929020429544264,7344100,1457712400,1450368300
276000.0,3,2.0,1450,8928,1.0,0,0,2,7,1450,0,1998,0.0,98042,47.3637,-122.075,2050,8523,7478,0.837589605734767,2102500,79709184,77606684
394000.0,3,2.5,1370,4400,1.0,0,0,2,8,1370,0,1988,0.0,98034,47.7139,-122.20299999999999,1630,4400,3030,0.6886363636363636,1876900,19360000,17483100
355000.0,3,2.5,1810,3192,1.0,0,0,2,7,1070,740,2001,0.0,98019,47.7364,-121.969,1740,3720,1382,0.43295739348370926,3276100,10188864,6912764
260000.0,3,2.5,1420,14850,1.0,0,0,3,7,1020,400,1963,0.0,98032,47.3661,-122.29,2060,8800,13430,0.9043771043771044,2016400,220522500,218506100
300000.0,3,2.75,2090,9620,1.0,0,0,2,8,1340,750,1987,0.0,98023,47.2741,-122.337,2150,9660,7530,0.7827442827442828,4368100,92544400,88176300
310000.0,3,2.75,2090,9620,1.0,0,0,2,8,1340,750,1987,0.0,98023,47.2741,-122.337,2150,9660,7530,0.7827442827442828,4368100,92544400,88176300
209000.0,3,1.0,1330,6900,1.0,0,0,2,7,1330,0,1976,0.0,98023,47.3033,-122.381,1530,7000,5570,0.8072463768115942,1768900,47610000,45841100
344950.0,3,2.0,1330,7419,1.0,0,0,2,7,1330,0,1985,0.0,98034,47.7322,-122.236,1330,7297,6089,0.8207305566787977,1768900,55041561,53272661
230000.0,5,2.0,1910,7200,1.0,0,0,3,6,1110,800,1951,0.0,98178,47.4975,-122.26100000000001,1150,5948,5290,0.7347222222222223,3648100,51840000,48191900
336950.0,3,1.75,2310,7680,1.0,0,0,3,8,1410,900,1978,0.0,98032,47.3743,-122.285,2080,7680,5370,0.69921875,5336100,58982400,53646300
700000.0,3,2.75,2500,7378,1.0,0,0,4,7,1390,1110,1948,0.0,98177,47.7032,-122.37,2040,7140,4878,0.661154784494443,6250000,54434884,48184884
230000.0,3,2.0,1310,7332,1.0,0,0,2,7,1310,0,1987,0.0,98038,47.3597,-122.051,1530,7362,6022,0.8213311511183852,1716100,53758224,52042124
443500.0,4,2.5,2040,21781,2.0,0,0,2,8,2040,0,1994,0.0,98014,47.6458,-121.904,2410,21781,19741,0.9063403884119187,4161600,474411961,470250361
471000.0,4,2.5,2040,21781,2.0,0,0,2,8,2040,0,1994,0.0,98014,47.6458,-121.904,2410,21781,19741,0.9063403884119187,4161600,474411961,470250361
595000.0,3,2.25,2400,16301,1.0,0,0,2,8,1400,1000,1962,0.0,98115,47.6901,-122.28200000000001,1720,9828,13901,0.8527697687258451,5760000,265722601,259962601
470000.0,3,1.0,1400,4914,1.5,0,0,2,7,1400,0,1929,0.0,98117,47.681000000000004,-122.36399999999999,1400,3744,3514,0.7150997150997151,1960000,24147396,22187396
600000.0,4,1.75,1700,7800,1.0,0,0,3,8,1700,0,1975,0.0,98052,47.651,-122.119,2430,8342,6100,0.782051282051282,2890000,60840000,57950000
1380000.0,4,3.75,3160,9525,2.5,0,0,2,10,3160,0,1997,0.0,98040,47.5623,-122.221,2400,9525,6365,0.668241469816273,9985600,90725625,80740025
427800.0,3,1.75,1340,13241,1.0,0,2,2,7,1340,0,1985,0.0,98034,47.7268,-122.213,2090,9704,11901,0.8987991843516351,1795600,175324081,173528481
445000.0,4,2.0,1470,8395,1.0,0,0,3,7,1470,0,1965,0.0,98008,47.631,-122.117,1760,7976,6925,0.824895771292436,2160900,70476025,68315125
382000.0,3,1.75,1790,7679,1.0,0,0,3,7,1790,0,1953,0.0,98133,47.7442,-122.338,1560,7680,5889,0.7668967313452273,3204100,58967041,55762941
577000.0,3,1.5,1560,20251,1.0,0,0,4,7,1200,360,1989,0.0,98074,47.619,-122.054,1560,19119,18691,0.922966767073231,2433600,410103001,407669401
427000.0,3,2.5,2620,108464,2.0,0,0,3,8,2620,0,1990,0.0,98038,47.4583,-122.036,3190,105850,105844,0.9758445198406844,6864400,11764439296,11757574896
255000.0,3,1.0,1580,8206,1.0,0,0,2,7,1100,0,1962,0.0,98198,47.3676,-122.31200000000001,1600,8196,6626,0.8074579575920059,2496400,67338436,64842036
240000.0,3,1.0,1090,10000,1.0,0,0,2,6,1090,0,1961,0.0,98014,47.6503,-121.911,1040,7500,8910,0.891,1188100,100000000,98811900
1230000.0,5,3.25,3240,6551,1.5,0,4,3,9,2500,740,1939,0.0,98115,47.6792,-122.273,2740,9300,3311,0.505419019996947,10497600,42915601,32418001
435000.0,4,1.75,2520,7200,1.0,0,2,4,7,1260,1260,1955,0.0,98056,47.4835,-122.19200000000001,2360,7300,4680,0.65,6350400,51840000,45489600
1450000.0,3,1.75,2230,13529,1.0,0,0,2,9,2230,0,1949,0.0,98004,47.6204,-122.21700000000001,2230,11900,11299,0.8351688964446744,4972900,183033841,178060941
425000.0,4,3.0,2430,5502,2.0,0,0,2,8,2430,0,2002,0.0,98038,47.356,-122.014,2000,5702,3072,0.5583424209378408,5904900,30272004,24367104
393000.0,2,1.0,1020,4200,1.0,0,0,4,6,1020,0,1923,0.0,98136,47.5319,-122.391,1660,4200,3180,0.7571428571428571,1040400,17640000,16599600
264950.0,4,1.0,1810,7500,1.0,0,0,1,7,1410,400,1959,0.0,98168,47.4935,-122.333,1250,6255,5690,0.7586666666666667,3276100,56250000,52973900
746500.0,4,2.5,3460,9699,2.0,0,0,2,10,3460,0,1987,0.0,98074,47.637,-122.04,3140,10631,6239,0.6432621919785545,11971600,94070601,82099001
450000.0,3,1.0,2020,8100,1.0,0,0,2,7,1170,850,1956,0.0,98125,47.7136,-122.288,1480,7620,6080,0.7506172839506173,4080400,65610000,61529600
229950.0,3,2.0,1410,7466,1.0,0,0,2,7,1410,0,1983,0.0,98058,47.427,-122.147,1410,7610,6056,0.8111438521296545,1988100,55741156,53753056
425000.0,2,1.0,750,4000,1.0,0,0,1,6,750,0,1933,0.0,98108,47.54,-122.32,1160,4000,3250,0.8125,562500,16000000,15437500
2560000.0,4,2.5,5300,26211,2.0,1,2,1,10,4570,730,1923,0.0,98105,47.661,-122.26899999999999,3890,19281,20911,0.7977948189691351,28090000,687016521,658926521
1400000.0,4,3.5,4380,66613,1.5,0,0,2,11,4380,0,1993,0.0,98077,47.7279,-122.04799999999999,4010,70109,62233,0.9342470688904568,19184400,4437291769,4418107369
753000.0,3,2.25,2290,9047,2.0,0,0,3,8,2290,0,1984,0.0,98006,47.5545,-122.163,2120,9275,6757,0.7468774179285951,5244100,81848209,76604109
310000.0,2,1.0,720,5750,1.0,0,0,1,6,720,0,1943,0.0,98136,47.5535,-122.39299999999999,980,6125,5030,0.8747826086956522,518400,33062500,32544100
395000.0,2,1.0,1200,6014,1.0,0,0,3,6,600,600,1949,0.0,98118,47.5357,-122.28,1270,4652,4814,0.800465580312604,1440000,36168196,34728196
725000.0,3,2.5,2620,28703,1.0,0,0,2,10,2620,0,1985,0.0,98052,47.7238,-122.11399999999999,2950,30290,26083,0.9087203428213079,6864400,823862209,816997809
295000.0,4,3.0,2120,7650,2.0,0,0,2,8,2120,0,1964,0.0,98007,47.6214,-122.14,2260,7885,5530,0.722875816993464,4494400,58522500,54028100
225000.0,3,1.75,1580,8820,1.0,0,0,3,7,1580,0,1967,0.0,98003,47.317,-122.325,1280,8500,7240,0.8208616780045351,2496400,77792400,75296000
1700000.0,3,3.25,4160,35153,3.0,0,2,2,12,3690,470,2001,0.0,98040,47.5749,-122.214,3290,11533,30993,0.8816601712513868,17305600,1235733409,1218427809
431000.0,3,2.25,1830,8831,1.0,0,0,2,7,1460,370,1979,0.0,98034,47.7286,-122.215,2330,8064,7001,0.7927754501188994,3348900,77986561,74637661
358500.0,3,2.5,2000,8057,1.0,0,0,2,8,1360,640,1998,0.0,98042,47.3724,-122.10700000000001,2530,8964,6057,0.7517686483802904,4000000,64915249,60915249
595000.0,2,1.0,980,3600,1.0,0,0,2,6,980,0,1907,0.0,98119,47.6366,-122.365,1690,3600,2620,0.7277777777777777,960400,12960000,11999600
468000.0,4,2.5,3040,20682,2.0,0,0,2,7,3040,0,2000,0.0,98019,47.7245,-121.959,2670,9742,17642,0.8530122812107146,9241600,427745124,418503524
260000.0,4,1.0,1740,8100,1.0,0,0,3,7,1020,720,1962,0.0,98058,47.467,-122.185,1600,8949,6360,0.7851851851851852,3027600,65610000,62582400
375000.0,3,2.0,1450,7300,1.5,0,0,4,7,1450,0,1955,0.0,98133,47.7517,-122.34200000000001,1660,9069,5850,0.8013698630136986,2102500,53290000,51187500
295000.0,3,2.5,1560,4200,2.0,0,0,2,7,1560,0,2003,0.0,98038,47.3838,-122.02600000000001,1560,4200,2640,0.6285714285714286,2433600,17640000,15206400
403900.0,4,2.5,2050,8909,1.0,0,2,3,8,1690,360,1986,0.0,98198,47.398,-122.31,2190,8912,6859,0.769895611179706,4202500,79370281,75167781
269950.0,3,1.75,1760,12823,1.0,0,0,3,7,1460,300,1956,0.0,98002,47.2868,-122.21,1450,10800,11063,0.862746627154332,3097600,164429329,161331729
640000.0,3,3.5,1740,1975,2.0,0,3,2,8,1310,430,1998,0.0,98122,47.6085,-122.311,1740,1975,235,0.1189873417721519,3027600,3900625,873025
221000.0,3,1.0,910,8789,1.0,0,0,2,7,910,0,1966,0.0,98148,47.4345,-122.32600000000001,1160,8789,7879,0.8964614859483445,828100,77246521,76418421
255000.0,3,1.75,1700,7532,1.0,0,0,2,7,1700,0,1987,0.0,98030,47.355,-122.176,1690,7405,5832,0.7742963356346256,2890000,56731024,53841024
300000.0,4,2.5,2620,4469,2.0,0,0,2,7,2620,0,2008,0.0,98042,47.3663,-122.115,2250,4500,1849,0.41373909151935556,6864400,19971961,13107561
270000.0,3,2.25,1500,7410,1.0,0,0,3,7,1500,0,1973,0.0,98058,47.4597,-122.162,1750,7990,5910,0.7975708502024291,2250000,54908100,52658100
575000.0,4,1.75,1630,5750,1.0,0,0,2,7,1160,470,1947,0.0,98116,47.5674,-122.384,1640,5750,4120,0.7165217391304348,2656900,33062500,30405600
246900.0,3,1.5,1370,9800,1.0,0,0,4,7,1370,0,1968,0.0,98001,47.3068,-122.27,1370,9800,8430,0.860204081632653,1876900,96040000,94163100
635000.0,2,2.5,1390,1132,2.0,0,0,2,8,1130,260,2006,0.0,98102,47.6228,-122.319,1400,1237,-258,-0.22791519434628976,1932100,1281424,-650676
450000.0,3,2.0,1540,67756,1.0,0,0,2,7,1540,0,1900,1973.0,98077,47.721000000000004,-122.07799999999999,2060,67756,66216,0.9772713855599504,2371600,4590875536,4588503936
215000.0,3,1.0,1190,7500,1.0,0,0,4,7,1190,0,1968,0.0,98042,47.3248,-122.14200000000001,1200,9750,6310,0.8413333333333334,1416100,56250000,54833900
785000.0,3,3.5,4500,21870,2.0,0,0,2,10,4500,0,2004,0.0,98092,47.3043,-122.15899999999999,4670,23058,17370,0.7942386831275721,20250000,478296900,458046900
522500.0,4,3.0,2370,8154,1.0,0,0,2,7,1380,990,1977,0.0,98125,47.7258,-122.306,2100,8148,5784,0.7093451066961001,5616900,66487716,60870816
150000.0,2,1.5,1360,1934,2.0,0,0,3,7,1360,0,1978,0.0,98092,47.2857,-122.189,1360,1898,574,0.296794208893485,1849600,3740356,1890756
199950.0,2,1.75,870,18537,1.0,0,0,3,6,870,0,1946,0.0,98001,47.275,-122.27799999999999,1300,22800,17667,0.9530668392943842,756900,343620369,342863469
3000000.0,4,4.25,4850,12445,2.0,1,4,4,10,3850,1000,1989,0.0,98034,47.7011,-122.244,3350,12210,7595,0.6102852551225392,23522500,154878025,131355525
379900.0,3,2.0,3110,44967,2.0,0,0,2,9,3020,90,1999,0.0,98058,47.4343,-122.08200000000001,2150,44967,41857,0.9308381702137123,9672100,2022031089,2012358989
950000.0,4,2.5,3700,7051,2.0,0,0,2,11,3700,0,2006,0.0,98029,47.5427,-121.995,3580,6175,3351,0.475251737342221,13690000,49716601,36026601
865000.0,6,2.75,3500,5150,2.0,0,0,4,8,2430,1070,1909,0.0,98117,47.6842,-122.363,1430,3860,1650,0.32038834951456313,12250000,26522500,14272500
785000.0,3,1.75,1670,9600,1.0,0,0,4,8,1670,0,1961,0.0,98040,47.5754,-122.23299999999999,1900,9600,7930,0.8260416666666667,2788900,92160000,89371100
245700.0,3,2.25,1640,8400,1.0,0,0,2,8,1180,460,1968,0.0,98032,47.3733,-122.289,1600,8120,6760,0.8047619047619048,2689600,70560000,67870400
951000.0,3,2.25,3400,12825,1.0,0,1,2,9,3400,0,1961,0.0,98118,47.5435,-122.26,2510,11574,9425,0.7348927875243665,11560000,164480625,152920625
499950.0,3,1.75,2060,3500,1.0,0,0,4,7,1030,1030,1951,0.0,98118,47.5635,-122.28200000000001,1110,6000,1440,0.4114285714285714,4243600,12250000,8006400
257000.0,3,1.75,1330,36537,1.0,0,0,3,7,1330,0,1989,0.0,98092,47.3126,-122.12899999999999,1650,35100,35207,0.9635985439417577,1768900,1334952369,1333183469
549000.0,3,2.0,2330,3600,1.5,0,0,3,7,1580,750,1900,0.0,98122,47.6025,-122.303,1750,3600,1270,0.3527777777777778,5428900,12960000,7531100
1600000.0,3,2.75,3040,21052,2.0,0,0,3,10,3040,0,1980,0.0,98004,47.63800000000001,-122.225,2950,21052,18012,0.855595667870036,9241600,443186704,433945104
1400000.0,5,3.75,3700,7920,3.0,0,4,2,9,2900,800,1983,0.0,98115,47.6865,-122.266,2860,6360,4220,0.5328282828282829,13690000,62726400,49036400
619000.0,3,2.0,1990,3000,1.5,0,2,4,8,1430,560,1927,0.0,98144,47.5891,-122.29299999999999,1780,5000,1010,0.33666666666666667,3960100,9000000,5039900
311000.0,5,3.0,2020,5917,1.0,0,0,2,7,1220,800,1993,0.0,98108,47.5482,-122.294,2130,5529,3897,0.6586107824911273,4080400,35010889,30930489
600000.0,5,2.25,2980,7781,1.0,0,0,2,9,1580,1400,1960,0.0,98125,47.7048,-122.279,2310,7781,4801,0.6170158077367948,8880400,60543961,51663561
1080000.0,4,3.5,3990,5267,2.0,0,0,2,10,3990,0,2008,0.0,98006,47.5641,-122.124,3230,6481,1277,0.24245300930320865,15920100,27741289,11821189
436000.0,2,1.0,790,6600,1.0,0,0,2,6,790,0,1949,0.0,98122,47.6149,-122.29299999999999,1520,4400,5810,0.8803030303030303,624100,43560000,42935900
205000.0,2,1.0,1060,8000,1.0,0,0,2,6,1060,0,1941,0.0,98168,47.5088,-122.333,1390,8000,6940,0.8675,1123600,64000000,62876400
514000.0,3,2.25,2260,54014,1.0,0,0,2,7,1450,810,1962,0.0,98072,47.7657,-122.131,2140,44431,51754,0.9581589958158996,5107600,2917512196,2912404596
530000.0,2,2.5,1900,2983,2.0,0,0,2,8,1900,0,2006,0.0,98053,47.7029,-122.015,1510,3876,1083,0.3630573248407643,3610000,8898289,5288289
511000.0,5,2.5,3361,6983,2.0,0,0,2,10,3361,0,2006,0.0,98092,47.3427,-122.169,3112,6920,3622,0.5186882428755549,11296321,48762289,37465968
2100000.0,4,1.75,3550,19865,2.0,0,0,2,9,3550,0,1962,2002.0,98039,47.6236,-122.235,3000,19862,16315,0.8212937326956959,12602500,394618225,382015725
370000.0,5,2.5,2740,5460,2.0,0,0,2,8,2740,0,2005,0.0,98031,47.4042,-122.204,2900,5971,2720,0.4981684981684982,7507600,29811600,22304000
500000.0,4,1.75,2040,6000,1.0,0,0,4,7,1020,1020,1943,0.0,98136,47.5507,-122.383,1440,6000,3960,0.66,4161600,36000000,31838400
710000.0,4,2.5,4070,129808,2.0,0,0,2,10,4070,0,1998,0.0,98038,47.4433,-122.016,4070,102366,125738,0.9686460002465179,16564900,16850116864,16833551964
270000.0,1,1.0,720,5196,1.0,0,0,2,7,720,0,1911,0.0,98103,47.6928,-122.337,1580,5762,4476,0.8614318706697459,518400,26998416,26480016
415000.0,3,1.75,2000,8400,1.5,0,0,3,8,2000,0,1959,0.0,98133,47.7535,-122.334,2000,8400,6400,0.7619047619047619,4000000,70560000,66560000
1800000.0,5,4.5,4400,15580,2.0,0,0,2,11,3390,1010,2003,0.0,98004,47.6232,-122.20700000000001,2150,14249,11180,0.7175866495507061,19360000,242736400,223376400
236000.0,3,1.75,1300,8976,1.0,0,0,2,7,1300,0,1967,0.0,98003,47.3357,-122.305,1430,9750,7676,0.8551693404634582,1690000,80568576,78878576
278000.0,2,2.5,1420,2229,2.0,0,0,2,7,1420,0,2004,0.0,98059,47.4871,-122.165,1500,2230,809,0.36294302377747867,2016400,4968441,2952041
312000.0,3,2.25,1540,5338,1.0,0,0,4,7,770,770,1954,0.0,98115,47.6942,-122.304,1680,6525,3798,0.7115024353690521,2371600,28494244,26122644
539000.0,3,2.25,1540,5338,1.0,0,0,4,7,770,770,1954,0.0,98115,47.6942,-122.304,1680,6525,3798,0.7115024353690521,2371600,28494244,26122644
498000.0,3,3.0,2360,2750,2.0,0,1,2,7,1780,580,1983,0.0,98125,47.7142,-122.281,1970,5800,390,0.14181818181818182,5569600,7562500,1992900
857000.0,4,3.0,3720,29043,2.0,0,0,2,9,3720,0,1991,0.0,98033,47.6907,-122.161,1610,23000,25323,0.8719140584650346,13838400,843495849,829657449
780000.0,3,1.75,1690,13500,1.0,0,0,3,7,1690,0,1978,0.0,98040,47.5897,-122.23299999999999,1950,10500,11810,0.8748148148148148,2856100,182250000,179393900
650000.0,3,2.0,2300,5000,1.0,0,0,3,8,1150,1150,1938,0.0,98199,47.6521,-122.413,2300,5000,2700,0.54,5290000,25000000,19710000
559500.0,4,1.75,1650,7088,1.0,0,0,2,8,1650,0,1973,0.0,98027,47.5688,-122.087,1850,7523,5438,0.7672121896162528,2722500,50239744,47517244
219950.0,2,1.0,990,6448,1.0,0,0,2,7,990,0,1948,0.0,98178,47.5031,-122.245,1130,7200,5458,0.8464640198511166,980100,41576704,40596604
671500.0,4,2.25,2130,8410,2.0,0,0,3,8,2130,0,1977,0.0,98006,47.5589,-122.12799999999999,2170,8400,6280,0.746730083234245,4536900,70728100,66191200
813000.0,4,2.5,3320,52707,2.0,0,0,2,10,3320,0,1999,0.0,98074,47.6247,-122.016,3040,54450,49387,0.9370102642912707,11022400,2778027849,2767005449
182000.0,3,2.25,1960,8875,1.0,0,0,2,7,1290,670,1965,0.0,98003,47.3344,-122.301,1890,8700,6915,0.7791549295774648,3841600,78765625,74924025
203700.0,2,1.0,770,2500,1.0,0,0,2,6,770,0,1913,1960.0,98072,47.7534,-122.17200000000001,1500,8286,1730,0.692,592900,6250000,5657100
740000.0,4,1.75,2010,3600,1.5,0,0,2,7,2010,0,1902,0.0,98119,47.6337,-122.37100000000001,2010,3600,1590,0.44166666666666665,4040100,12960000,8919900
230000.0,2,1.0,800,17965,1.0,0,0,3,5,800,0,1942,0.0,98058,47.4693,-122.161,1500,8925,17165,0.9554689674366824,640000,322741225,322101225
128000.0,3,1.0,910,11117,1.0,0,0,2,7,910,0,1955,0.0,98003,47.3432,-122.309,1490,8416,10207,0.9181433840064765,828100,123587689,122759589
345000.0,3,1.0,1200,6628,1.0,0,0,3,7,1200,0,1952,0.0,98155,47.7367,-122.319,1330,6768,5428,0.8189499094749547,1440000,43930384,42490384
663000.0,4,2.5,3570,6246,2.0,0,0,2,7,3570,0,2005,0.0,98075,47.5927,-122.006,2260,5231,2676,0.42843419788664744,12744900,39012516,26267616
329950.0,3,2.5,1820,8085,2.0,0,0,2,7,1820,0,1983,0.0,98055,47.4575,-122.204,1860,8625,6265,0.7748917748917749,3312400,65367225,62054825
1050000.0,3,2.25,2930,7005,3.0,0,2,2,9,2670,260,1999,0.0,98117,47.6763,-122.404,2450,6460,4075,0.5817273376159886,8584900,49070025,40485125
402300.0,3,1.75,1480,4050,1.0,0,0,2,7,870,610,1926,0.0,98115,47.681000000000004,-122.304,1350,4500,2570,0.6345679012345679,2190400,16402500,14212100
492000.0,4,2.5,3305,16164,1.5,0,0,4,7,2245,1060,1922,1956.0,98133,47.7563,-122.338,1620,8883,12859,0.7955332838406335,10923025,261274896,250351871
448000.0,4,2.5,2230,5000,1.0,0,0,2,7,1650,580,2006,0.0,98059,47.4799,-122.12899999999999,2090,4637,2770,0.554,4972900,25000000,20027100
273000.0,3,1.0,1560,7800,1.0,0,0,2,7,1560,0,1955,0.0,98188,47.4549,-122.287,1468,9375,6240,0.8,2433600,60840000,58406400
335000.0,3,1.0,1030,7200,1.0,0,0,2,6,880,150,1948,0.0,98126,47.5255,-122.376,1030,7200,6170,0.8569444444444444,1060900,51840000,50779100
695000.0,3,3.75,2380,3600,1.5,0,0,2,7,1690,690,1927,0.0,98112,47.6374,-122.307,1990,3520,1220,0.3388888888888889,5664400,12960000,7295600
279000.0,3,1.0,1010,7903,1.0,0,0,2,6,1010,0,1948,0.0,98155,47.76600000000001,-122.32,1010,7903,6893,0.8722004302163735,1020100,62457409,61437309
485000.0,2,1.75,2060,2700,1.0,0,0,2,7,1030,1030,1929,0.0,98115,47.6856,-122.31200000000001,1390,2700,640,0.23703703703703705,4243600,7290000,3046400
383000.0,4,2.5,2370,10580,2.0,0,0,2,8,2370,0,1966,0.0,98055,47.464,-122.19200000000001,1590,8584,8210,0.775992438563327,5616900,111936400,106319500
490000.0,4,2.5,2242,37451,2.0,0,0,2,8,2242,0,1995,0.0,98028,47.7443,-122.228,2242,13125,35209,0.9401351098769059,5026564,1402577401,1397550837
240000.0,2,1.5,1078,1263,2.0,0,0,2,7,1078,0,1990,0.0,98028,47.7532,-122.244,1078,1263,185,0.14647664291369755,1162084,1595169,433085
285000.0,2,1.0,890,7250,1.0,0,0,2,7,890,0,1943,0.0,98125,47.7118,-122.314,900,7000,6360,0.8772413793103448,792100,52562500,51770400
524950.0,3,1.5,2700,24539,2.0,0,0,2,7,2120,580,1977,2014.0,98019,47.7348,-121.984,1830,11000,21839,0.8899710664656262,7290000,602162521,594872521
729000.0,4,2.5,2450,27081,2.0,0,0,2,8,2450,0,1985,0.0,98052,47.7177,-122.104,2630,12025,24631,0.9095306672574868,6002500,733380561,727378061
460000.0,3,1.75,1420,8250,1.0,0,0,3,7,1420,0,1960,0.0,98007,47.6112,-122.133,2020,8250,6830,0.8278787878787879,2016400,68062500,66046100
687500.0,3,1.5,1280,2114,1.5,0,0,2,8,1280,0,1904,0.0,98122,47.6174,-122.30799999999999,1540,1456,834,0.3945127719962157,1638400,4468996,2830596
1170000.0,5,2.75,2910,15118,1.0,0,0,4,9,1780,1130,1972,0.0,98006,47.5696,-122.18299999999999,2880,15253,12208,0.8075142214578648,8468100,228553924,220085824
825000.0,4,2.25,2430,10050,2.0,0,0,3,8,2430,0,1979,0.0,98006,47.5563,-122.163,2390,10250,7620,0.7582089552238805,5904900,101002500,95097600
314950.0,2,2.5,1860,6359,2.0,0,0,2,7,1860,0,2003,0.0,98038,47.3847,-122.029,1860,6359,4499,0.7075011794307281,3459600,40436881,36977281
470000.0,3,2.0,1800,12669,1.0,0,0,2,7,1800,0,1956,1990.0,98033,47.6935,-122.17299999999999,1970,9775,10869,0.8579209093061805,3240000,160503561,157263561
500000.0,3,1.5,1960,8815,1.0,0,0,3,7,1020,940,1958,0.0,98006,47.5765,-122.15899999999999,1760,9534,6855,0.7776517300056721,3841600,77704225,73862625
313000.0,3,1.5,1550,7260,1.5,0,0,1,6,1550,0,1925,0.0,98166,47.4693,-122.34899999999999,1190,7620,5710,0.7865013774104683,2402500,52707600,50305100
445000.0,2,1.0,840,3840,1.0,0,0,3,7,840,0,1926,0.0,98117,47.684,-122.37799999999999,1310,3840,3000,0.78125,705600,14745600,14040000
300000.0,4,1.75,2080,8750,1.0,0,0,3,8,1330,750,1967,0.0,98032,47.3749,-122.291,1790,8750,6670,0.7622857142857142,4326400,76562500,72236100
619500.0,4,2.5,2210,5077,1.5,0,0,3,8,1480,730,1912,0.0,98126,47.5719,-122.37700000000001,1740,5000,2867,0.5647035650974985,4884100,25775929,20891829
305000.0,3,1.5,1210,5240,1.0,0,0,3,7,610,0,1983,0.0,98106,47.5524,-122.35600000000001,1560,5240,4030,0.7690839694656488,1464100,27457600,25993500
874000.0,3,2.5,1350,941,3.0,0,0,2,9,1350,0,2007,0.0,98119,47.6265,-122.36399999999999,1640,1369,-409,-0.434643995749203,1822500,885481,-937019
477500.0,3,2.0,1860,5146,2.0,0,0,2,8,1860,0,1991,0.0,98029,47.5706,-121.999,1950,5146,3286,0.6385542168674698,3459600,26481316,23021716
700000.0,3,2.0,1940,4500,1.0,0,3,2,7,1090,850,1926,0.0,98107,47.6659,-122.359,1700,4500,2560,0.5688888888888889,3763600,20250000,16486400
515000.0,4,3.5,3400,5222,2.0,0,0,2,9,3400,0,2005,0.0,98038,47.3559,-122.0,3190,5326,1822,0.3489084641899655,11560000,27269284,15709284
590000.0,4,2.5,2240,9385,2.0,0,0,2,8,2240,0,1991,0.0,98133,47.7125,-122.33200000000001,2010,9000,7145,0.7613212573255195,5017600,88078225,83060625
205000.0,3,1.75,1170,8239,1.0,0,0,2,7,1170,0,1981,0.0,98042,47.3679,-122.088,1180,7866,7069,0.8579924748149047,1368900,67881121,66512221
310000.0,3,3.25,3130,9302,2.0,0,0,2,8,2190,940,1987,0.0,98023,47.3078,-122.338,2350,7949,6172,0.6635132229628037,9796900,86527204,76730304
442500.0,2,2.25,1510,7280,2.0,0,0,2,7,1510,0,1987,0.0,98074,47.6264,-122.05799999999999,1510,8120,5770,0.7925824175824175,2280100,52998400,50718300
1080000.0,4,3.5,3740,41458,2.0,0,2,2,11,3740,0,2000,0.0,98072,47.7375,-122.139,3750,38325,37718,0.9097882194027691,13987600,1718765764,1704778164
530000.0,4,2.5,2690,46609,2.0,0,0,2,8,2690,0,1980,0.0,98038,47.3843,-122.006,1500,34800,43919,0.9422858246261452,7236100,2172398881,2165162781
343500.0,4,1.75,1760,6204,1.0,0,2,3,7,1180,580,1950,0.0,98178,47.5045,-122.24,1990,6240,4444,0.7163120567375887,3097600,38489616,35392016
334900.0,4,1.75,2180,4066,1.5,0,0,2,6,1270,910,1911,0.0,98118,47.5487,-122.277,1400,1343,1886,0.46384653221839645,4752400,16532356,11779956
544300.0,4,1.75,1560,9000,1.0,0,0,4,7,1560,0,1969,0.0,98052,47.6707,-122.149,1510,8848,7440,0.8266666666666667,2433600,81000000,78566400
370000.0,3,2.5,1780,4050,2.0,0,0,2,7,1780,0,2001,0.0,98155,47.7346,-122.30799999999999,1571,4976,2270,0.5604938271604938,3168400,16402500,13234100
245000.0,3,1.75,1260,6908,1.0,0,0,2,7,1260,0,1994,0.0,98038,47.385,-122.031,1810,7159,5648,0.8176027793862188,1587600,47720464,46132864
535000.0,4,1.75,1570,3250,1.5,0,0,4,8,1570,0,1928,0.0,98136,47.5405,-122.39299999999999,1570,5720,1680,0.5169230769230769,2464900,10562500,8097600
202000.0,2,1.0,740,6550,1.0,0,0,3,5,740,0,1946,0.0,98168,47.4807,-122.33200000000001,1080,8515,5810,0.8870229007633588,547600,42902500,42354900
490000.0,4,2.25,2020,4960,2.0,0,0,2,7,1710,310,1938,0.0,98117,47.6867,-122.369,1590,4550,2940,0.592741935483871,4080400,24601600,20521200
651500.0,4,1.5,1500,3075,2.0,0,0,4,7,1420,80,1929,0.0,98103,47.6893,-122.35,1480,3774,1575,0.5121951219512195,2250000,9455625,7205625
270000.0,4,2.5,1670,8056,1.0,0,0,2,7,1170,500,1961,0.0,98168,47.4884,-122.319,1360,8056,6386,0.7927010923535254,2788900,64899136,62110236
1160000.0,3,3.5,3620,8072,2.0,0,0,2,10,2920,700,1999,0.0,98006,47.5646,-122.12700000000001,3680,9624,4452,0.5515361744301288,13104400,65157184,52052784
289000.0,2,1.5,1010,1309,2.0,0,0,2,7,860,150,2007,0.0,98118,47.5659,-122.286,1190,3060,299,0.22841864018334607,1020100,1713481,693381
240000.0,3,1.5,1460,13503,1.0,0,0,3,6,1460,0,1977,0.0,98010,47.3119,-122.015,1460,13394,12043,0.8918758794341998,2131600,182331009,180199409
790000.0,3,1.75,1790,6117,1.0,0,2,2,8,1350,440,1940,0.0,98199,47.6366,-122.40100000000001,1960,5554,4327,0.7073728952100703,3204100,37417689,34213589
350000.0,3,2.25,1760,9621,2.0,0,0,2,7,1760,0,1995,0.0,98019,47.7466,-121.979,1810,6589,7861,0.8170668329695457,3097600,92563641,89466041
246950.0,3,3.5,1790,1682,2.0,0,0,2,7,1480,310,2006,0.0,98108,47.542,-122.321,1150,4000,-108,-0.06420927467300833,3204100,2829124,-374976
400000.0,3,1.0,1050,6000,1.0,0,0,2,7,1050,0,1952,0.0,98116,47.5709,-122.40100000000001,1720,6000,4950,0.825,1102500,36000000,34897500
533000.0,4,2.5,2590,6394,2.0,0,0,2,8,2590,0,2003,0.0,98028,47.7599,-122.23299999999999,2500,5328,3804,0.5949327494526119,6708100,40883236,34175136
198400.0,3,1.0,1040,8645,1.0,0,0,3,7,1040,0,1962,0.0,98042,47.3631,-122.116,1290,8645,7605,0.8796992481203008,1081600,74736025,73654425
495000.0,4,2.5,4060,8547,2.0,0,0,2,9,2790,1270,2007,0.0,98038,47.3694,-122.056,2810,8313,4487,0.5249795249795249,16483600,73051209,56567609
862000.0,4,2.5,3190,14565,2.0,0,0,2,11,3190,0,1990,0.0,98077,47.713,-122.072,3420,20475,11375,0.7809818056985925,10176100,212139225,201963125
870000.0,4,2.5,3190,14565,2.0,0,0,2,11,3190,0,1990,0.0,98077,47.713,-122.072,3420,20475,11375,0.7809818056985925,10176100,212139225,201963125
875000.0,4,1.75,2180,9726,1.0,0,0,3,9,2180,0,1966,0.0,98040,47.5359,-122.23299999999999,2560,10244,7546,0.7758585235451367,4752400,94595076,89842676
317000.0,6,3.5,2120,5840,2.0,0,0,4,7,2120,0,1979,0.0,98055,47.4788,-122.227,1860,8000,3720,0.636986301369863,4494400,34105600,29611200
325000.0,4,2.75,2110,6838,2.0,0,0,3,8,2110,0,1991,0.0,98031,47.3877,-122.171,2100,7280,4728,0.6914302427610413,4452100,46758244,42306144
615000.0,2,1.5,1210,5000,1.5,0,0,4,6,1210,0,1907,0.0,98117,47.6793,-122.397,1570,5000,3790,0.758,1464100,25000000,23535900
334950.0,4,2.5,2410,7846,2.0,0,0,2,8,2410,0,1992,0.0,98003,47.2641,-122.31200000000001,2380,7914,5436,0.6928371144532246,5808100,61559716,55751616
775000.0,3,2.5,1980,7807,2.0,0,0,3,9,1980,0,1989,0.0,98033,47.6884,-122.204,1590,7579,5827,0.74638145254259,3920400,60949249,57028849
600000.0,4,2.5,2370,9135,1.0,0,0,3,8,1600,770,1967,0.0,98006,47.5564,-122.177,2050,9468,6765,0.7405582922824302,5616900,83448225,77831325
565000.0,3,1.75,1720,2218,1.5,0,0,2,7,1270,450,1931,2003.0,98103,47.648999999999994,-122.335,1130,1600,498,0.22452660054102797,2958400,4919524,1961124
292500.0,2,1.0,750,5026,1.0,0,0,3,6,750,0,1942,0.0,98126,47.5368,-122.374,1260,5040,4276,0.8507759649820931,562500,25260676,24698176
825000.0,3,2.25,2510,10418,1.0,0,0,2,8,1810,700,1968,0.0,98115,47.7003,-122.285,2510,9435,7908,0.7590708389326166,6300100,108534724,102234624
495000.0,3,2.5,2577,156816,2.0,0,0,2,8,2577,0,2000,0.0,98092,47.2935,-122.10799999999999,2090,156816,154239,0.9835667278849097,6640929,24591257856,24584616927
525000.0,3,1.5,1540,4773,2.0,0,0,2,8,1540,0,1941,2009.0,98126,47.5678,-122.37799999999999,1540,5750,3233,0.6773517703750261,2371600,22781529,20409929
438600.0,1,1.0,720,2500,1.0,0,0,2,7,720,0,1910,0.0,98103,47.6597,-122.345,1520,3750,1780,0.712,518400,6250000,5731600
507000.0,3,2.25,1810,8158,1.0,0,0,2,8,1450,360,1984,0.0,98074,47.6258,-122.038,1740,9532,6348,0.7781318950723216,3276100,66552964,63276864
275900.0,3,1.75,1380,8400,1.0,0,0,2,7,1380,0,1967,0.0,98003,47.3117,-122.321,1540,8400,7020,0.8357142857142857,1904400,70560000,68655600
1170000.0,4,2.5,2570,6251,2.0,0,0,2,9,2570,0,2000,0.0,98004,47.593,-122.197,2570,9588,3681,0.588865781474964,6604900,39075001,32470101
275000.0,4,1.75,1690,6000,1.0,0,0,2,7,1690,0,1957,0.0,98178,47.497,-122.227,1350,6000,4310,0.7183333333333334,2856100,36000000,33143900
355000.0,3,0.75,1420,3060,1.0,0,0,3,7,860,560,1923,0.0,98103,47.6872,-122.346,1350,4000,1640,0.5359477124183006,2016400,9363600,7347200
233000.0,4,2.0,2130,9579,1.0,0,0,3,7,1250,880,1968,0.0,98001,47.3069,-122.271,1590,9800,7449,0.7776385844033824,4536900,91757241,87220341
666000.0,3,2.5,3000,5000,1.5,0,0,3,7,2110,0,1918,0.0,98144,47.5781,-122.29299999999999,1970,5000,2000,0.4,9000000,25000000,16000000
317500.0,4,2.5,2150,9000,1.0,0,0,3,7,1360,790,1979,0.0,98059,47.4785,-122.16,1620,8400,6850,0.7611111111111111,4622500,81000000,76377500
420000.0,4,2.0,2280,10319,1.0,0,3,3,8,1270,1010,1989,0.0,98198,47.3594,-122.322,2280,9767,8039,0.7790483573989728,5198400,106481761,101283361
290000.0,4,2.0,1560,8800,2.0,0,0,4,6,1560,0,1942,1967.0,98168,47.4927,-122.31200000000001,1480,10000,7240,0.8227272727272728,2433600,77440000,75006400
320000.0,3,2.0,1880,10758,1.0,0,0,4,6,940,940,1952,0.0,98059,47.5091,-122.14399999999999,2060,21000,8878,0.825246328313813,3534400,115734564,112200164
650000.0,3,2.5,2320,5284,2.0,0,0,2,8,2320,0,2004,0.0,98075,47.591,-122.01700000000001,2320,4383,2964,0.5609386828160484,5382400,27920656,22538256
325000.0,3,1.75,1010,7171,1.0,0,0,3,7,1010,0,1967,0.0,98034,47.7317,-122.23100000000001,1250,7560,6161,0.8591549295774648,1020100,51423241,50403141
165000.0,3,1.0,1120,5000,1.0,0,0,2,6,1120,0,1917,0.0,98146,47.5109,-122.35700000000001,1050,5000,3880,0.776,1254400,25000000,23745600
500000.0,3,1.75,1560,16194,1.0,0,0,2,8,1560,0,1961,0.0,98005,47.5966,-122.175,2430,16193,14634,0.9036680251945165,2433600,262245636,259812036
443000.0,4,1.5,1860,12197,1.0,0,0,2,7,1860,0,1964,0.0,98034,47.729,-122.235,1510,11761,10337,0.8475034844633926,3459600,148766809,145307209
213400.0,3,1.5,1150,8686,1.0,0,0,3,7,1150,0,1963,0.0,98055,47.4417,-122.194,1760,8798,7536,0.8676030393737049,1322500,75446596,74124096
480000.0,4,1.75,1920,9380,1.0,0,0,2,7,1920,0,1964,0.0,98008,47.6344,-122.118,1580,8580,7460,0.7953091684434968,3686400,87984400,84298000
275000.0,4,2.25,2490,7233,1.0,0,0,2,8,1460,1030,1978,0.0,98023,47.3115,-122.396,2000,8000,4743,0.6557445043550394,6200100,52316289,46116189
299880.0,3,2.5,1460,3044,2.0,0,0,2,7,1460,0,2000,0.0,98108,47.544,-122.296,1490,3044,1584,0.5203679369250985,2131600,9265936,7134336
499950.0,3,3.5,1820,1501,2.0,0,0,2,8,1430,390,2014,0.0,98144,47.596000000000004,-122.29799999999999,1550,1501,-319,-0.21252498334443704,3312400,2253001,-1059399
1710000.0,5,3.0,4290,17100,1.0,0,3,2,9,2480,1810,1972,2007.0,98040,47.5473,-122.211,3550,16988,12810,0.7491228070175439,18404100,292410000,274005900
550000.0,4,2.75,2230,9460,1.0,0,0,4,7,1480,750,1960,0.0,98027,47.5246,-122.044,1760,10878,7230,0.7642706131078224,4972900,89491600,84518700
300000.0,4,2.5,2070,7476,2.0,0,0,2,8,2070,0,2003,0.0,98092,47.3352,-122.189,2430,5500,5406,0.7231139646869984,4284900,55890576,51605676
920000.0,3,1.75,2480,4000,1.0,0,0,2,8,1240,1240,1948,2014.0,98122,47.615,-122.288,2450,4000,1520,0.38,6150400,16000000,9849600
2300000.0,4,3.25,4110,15929,2.0,1,4,2,12,2720,1390,2001,0.0,98115,47.6934,-122.271,2640,15929,11819,0.7419800364115764,16892100,253733041,236840941
620000.0,4,2.75,2290,3060,1.5,0,0,4,7,1550,740,1928,0.0,98115,47.6793,-122.316,1460,3060,770,0.25163398692810457,5244100,9363600,4119500
253500.0,3,1.0,1220,20400,1.0,0,0,4,6,1220,0,1959,0.0,98022,47.2063,-122.023,1640,53578,19180,0.9401960784313725,1488400,416160000,414671600
978000.0,4,2.75,2620,13777,1.5,0,2,3,9,1720,900,1926,0.0,98144,47.58,-122.285,3530,9287,11157,0.8098279741598317,6864400,189805729,182941329
387500.0,4,2.5,3190,9856,2.0,0,0,2,8,3190,0,1979,0.0,98058,47.4445,-122.126,2260,7996,6666,0.6763392857142857,10176100,97140736,86964636
325000.0,3,1.0,850,6906,1.0,0,0,2,6,850,0,1948,0.0,98155,47.7441,-122.314,1150,6907,6056,0.8769186214885607,722500,47692836,46970336
568000.0,3,2.5,1740,1308,3.0,0,0,2,8,1740,0,2008,0.0,98116,47.5892,-122.387,1740,1280,-432,-0.3302752293577982,3027600,1710864,-1316736
525000.0,4,2.5,2140,7754,2.0,0,0,2,8,2140,0,1996,0.0,98133,47.7173,-122.338,1690,7775,5614,0.724013412432293,4579600,60124516,55544916
560000.0,3,2.5,2070,12708,2.0,0,0,2,8,2070,0,1996,0.0,98056,47.5295,-122.18,2620,9617,10638,0.8371104815864022,4284900,161493264,157208364
394000.0,3,2.5,1680,4075,2.0,0,0,2,7,1680,0,2008,0.0,98053,47.6964,-122.024,1710,4075,2395,0.5877300613496933,2822400,16605625,13783225
484950.0,2,1.0,1000,4956,1.0,0,2,3,7,1000,0,1916,0.0,98107,47.6753,-122.36,1830,4959,3956,0.7982243744955609,1000000,24561936,23561936
1300000.0,3,2.75,3340,12690,1.0,0,0,2,10,2550,790,1956,1988.0,98105,47.6665,-122.27,3340,9480,9350,0.7368006304176516,11155600,161036100,149880500
315000.0,3,2.5,1260,2767,2.0,0,0,2,8,1260,0,1999,0.0,98059,47.4914,-122.155,1310,2767,1507,0.5446331767256957,1587600,7656289,6068689
590000.0,4,2.25,2430,32496,1.0,0,0,2,9,2430,0,1993,0.0,98077,47.7642,-122.04799999999999,2750,35506,30066,0.9252215657311669,5904900,1055990016,1050085116
106000.0,1,1.0,560,5700,1.0,0,0,2,5,560,0,1947,0.0,98146,47.511,-122.359,1120,5000,5140,0.9017543859649123,313600,32490000,32176400
751000.0,3,2.5,3380,9528,2.0,0,0,2,10,3380,0,1994,0.0,98059,47.5275,-122.148,3630,14089,6148,0.6452560873215785,11424400,90782784,79358384
474000.0,2,1.0,1100,3500,1.0,0,0,4,7,1100,0,1908,0.0,98115,47.6741,-122.323,2050,4000,2400,0.6857142857142857,1210000,12250000,11040000
189000.0,2,2.0,1700,3171,1.0,0,0,4,5,850,850,1927,0.0,98002,47.3025,-122.22399999999999,1380,5906,1471,0.4638915168716493,2890000,10055241,7165241
440500.0,3,2.5,1600,3172,2.0,0,0,2,7,1600,0,2002,0.0,98053,47.6868,-122.042,1690,3698,1572,0.49558638083228246,2560000,10061584,7501584
1020000.0,3,2.5,2605,2216,2.0,0,2,3,9,2090,515,1979,0.0,98033,47.6529,-122.20200000000001,2605,1979,-389,-0.17554151624548736,6786025,4910656,-1875369
589000.0,2,2.0,1850,4667,1.0,0,0,2,8,1850,0,2010,0.0,98053,47.7101,-122.014,1860,6008,2817,0.6035997428755089,3422500,21780889,18358389
273000.0,3,2.25,1830,7651,2.0,0,0,2,8,1830,0,1986,0.0,98092,47.2642,-122.219,2160,8442,5821,0.7608155796627892,3348900,58537801,55188901
950000.0,3,3.25,3050,18892,1.0,1,4,3,8,1650,1400,1962,0.0,98198,47.3881,-122.32600000000001,1170,70973,15842,0.838556002540758,9302500,356907664,347605164
277700.0,2,1.5,1240,1055,2.0,0,0,2,8,1200,40,1967,0.0,98008,47.6104,-122.11200000000001,1410,1340,-185,-0.17535545023696683,1537600,1113025,-424575
299900.0,3,2.25,2100,8163,2.0,0,0,2,7,2100,0,1984,0.0,98001,47.3336,-122.26899999999999,1410,7515,6063,0.7427416391032708,4410000,66634569,62224569
235000.0,3,1.0,1250,15603,1.0,0,0,3,7,1250,0,1959,0.0,98056,47.5093,-122.17200000000001,1720,10220,14353,0.9198872011792604,1562500,243453609,241891109
464000.0,2,2.0,1230,4800,2.0,0,0,2,7,1230,0,1952,2004.0,98133,47.7145,-122.35,1560,7200,3570,0.74375,1512900,23040000,21527100
281000.0,3,1.75,1690,9826,1.0,0,0,3,7,1690,0,1988,0.0,98023,47.31399999999999,-122.365,1980,9826,8136,0.8280073274984734,2856100,96550276,93694176
320000.0,3,1.0,1520,8870,1.5,0,0,3,7,1520,0,1951,0.0,98155,47.7638,-122.31700000000001,1520,7800,7350,0.8286358511837655,2310400,78676900,76366500
282000.0,4,2.0,1890,6302,2.0,0,0,2,7,1890,0,1997,0.0,98030,47.3846,-122.205,1690,5369,4412,0.7000952078705173,3572100,39715204,36143104
745000.0,4,1.75,1990,8900,1.0,0,0,3,8,1990,0,1972,0.0,98006,47.5639,-122.149,2620,8925,6910,0.7764044943820225,3960100,79210000,75249900
245000.0,3,1.75,1480,3900,1.0,0,0,3,7,1480,0,1980,0.0,98023,47.2977,-122.367,1830,6956,2420,0.6205128205128205,2190400,15210000,13019600
250000.0,3,1.75,1480,3900,1.0,0,0,3,7,1480,0,1980,0.0,98023,47.2977,-122.367,1830,6956,2420,0.6205128205128205,2190400,15210000,13019600
470000.0,3,2.5,2120,2374,2.0,0,0,2,8,1770,350,2005,0.0,98052,47.674,-122.14200000000001,2480,3043,254,0.10699241786015164,4494400,5635876,1141476
216650.0,3,3.5,1480,1077,2.0,0,0,2,7,1300,180,2007,0.0,98109,47.5421,-122.322,1140,2003,-403,-0.37418755803156917,2190400,1159929,-1030471
440000.0,3,1.0,1250,8412,1.0,0,0,3,7,1250,0,1975,0.0,98052,47.7012,-122.131,1840,8976,7162,0.8514027579648121,1562500,70761744,69199244
590000.0,4,2.5,2010,7972,2.0,0,0,3,8,2010,0,1989,0.0,98029,47.5782,-122.01799999999999,2100,8511,5962,0.7478675363773206,4040100,63552784,59512684
935000.0,5,2.5,3150,35283,1.0,0,0,2,10,1800,1350,1975,0.0,98005,47.6368,-122.15700000000001,3280,35283,32133,0.9107218773913783,9922500,1244890089,1234967589
848000.0,3,3.5,3010,5717,2.0,0,0,2,10,3010,0,2000,0.0,98007,47.5943,-122.15,2780,5138,2707,0.47350008745845723,9060100,32684089,23623989
827500.0,5,4.25,3920,5823,2.0,0,0,2,9,3000,920,2000,0.0,98029,47.5492,-122.008,3000,5297,1903,0.32680748754937317,15366400,33907329,18540929
1130000.0,6,3.0,2880,3192,2.0,0,0,3,8,2180,700,1919,0.0,98103,47.6506,-122.33200000000001,1870,4533,312,0.09774436090225563,8294400,10188864,1894464
630000.0,2,2.25,2550,5663,1.0,0,0,2,10,1720,830,2011,0.0,98056,47.5304,-122.20200000000001,2560,3828,3113,0.549708634999117,6502500,32069569,25567069
340000.0,5,1.0,1120,9022,1.5,0,0,3,7,1120,0,1962,0.0,98034,47.7296,-122.24,1310,7500,7902,0.8758590113056972,1254400,81396484,80142084
570000.0,4,2.75,3140,10918,1.0,0,0,2,8,1900,1240,1968,1986.0,98034,47.7086,-122.243,3170,10918,7778,0.7124015387433595,9859600,119202724,109343124
2750000.0,4,4.0,4130,5575,2.0,1,4,3,10,2860,1270,1993,0.0,98075,47.5968,-122.083,2980,5575,1445,0.2591928251121076,17056900,31080625,14023725
514500.0,4,2.5,2990,9614,1.0,0,2,3,9,1740,1250,1976,0.0,98003,47.3424,-122.329,3370,12085,6624,0.6889952153110048,8940100,92428996,83488896
360000.0,2,1.0,1120,12625,1.0,0,3,2,7,1120,0,1940,0.0,98136,47.5397,-122.385,1880,6828,11505,0.9112871287128713,1254400,159390625,158136225
228900.0,4,1.5,1570,8775,1.0,0,0,2,7,1570,0,1943,0.0,98166,47.4789,-122.335,980,8775,7205,0.8210826210826211,2464900,77000625,74535725
660000.0,3,2.75,2210,4000,2.0,0,0,2,8,2210,0,2008,0.0,98053,47.6954,-122.01700000000001,2230,4674,1790,0.4475,4884100,16000000,11115900
647000.0,4,2.5,2390,5800,2.0,0,0,2,9,2390,0,2000,0.0,98075,47.5965,-122.038,2590,6507,3410,0.5879310344827586,5712100,33640000,27927900
366000.0,3,1.75,1520,8625,1.0,0,0,2,8,1520,0,1976,0.0,98011,47.7687,-122.223,2080,9200,7105,0.823768115942029,2310400,74390625,72080225
354000.0,5,1.75,1830,7986,1.0,0,0,3,7,1060,770,1962,0.0,98106,47.5208,-122.35,1410,7260,6156,0.7708489857250188,3348900,63776196,60427296
850000.0,4,3.5,2640,5900,2.0,0,2,2,8,2640,0,1937,1998.0,98136,47.5421,-122.383,1700,5900,3260,0.5525423728813559,6969600,34810000,27840400
496700.0,3,2.5,1740,5782,2.0,0,0,3,8,1740,0,1989,0.0,98029,47.5783,-122.001,2080,5782,4042,0.699066067104808,3027600,33431524,30403924
300000.0,3,2.0,1550,8300,1.0,0,0,3,8,1550,0,1965,0.0,98055,47.4654,-122.195,1860,8000,6750,0.8132530120481928,2402500,68890000,66487500
390000.0,3,1.0,1040,8075,1.0,0,0,3,7,1040,0,1961,0.0,98033,47.6701,-122.176,1450,8075,7035,0.8712074303405573,1081600,65205625,64124025
350000.0,3,2.25,1640,7200,2.0,0,0,3,8,1640,0,1985,0.0,98007,47.5948,-122.15299999999999,1830,8372,5560,0.7722222222222223,2689600,51840000,49150400
561000.0,3,2.25,1640,7200,2.0,0,0,3,8,1640,0,1985,0.0,98007,47.5948,-122.15299999999999,1830,8372,5560,0.7722222222222223,2689600,51840000,49150400
475000.0,3,1.75,1260,10065,1.0,0,0,2,7,1260,0,1954,2014.0,98006,47.5727,-122.13799999999999,1320,10278,8805,0.8748137108792846,1587600,101304225,99716625
275000.0,3,1.5,1170,1174,2.0,0,0,2,7,840,330,2007,0.0,98126,47.5459,-122.376,1170,2537,4,0.0034071550255536627,1368900,1378276,9376
290000.0,3,1.75,1590,13500,1.0,0,0,3,7,1090,500,1980,0.0,98038,47.3621,-122.031,1540,10375,11910,0.8822222222222222,2528100,182250000,179721900
199000.0,3,2.5,1750,6725,1.0,0,0,2,7,1330,420,1993,0.0,98038,47.352,-122.05799999999999,1670,7744,4975,0.7397769516728625,3062500,45225625,42163125
279900.0,4,2.5,1770,4338,2.0,0,0,2,7,1770,0,2001,0.0,98042,47.3672,-122.09899999999999,1770,6606,2568,0.5919778699861687,3132900,18818244,15685344
1660000.0,4,2.25,3530,5500,2.0,0,0,2,8,2860,670,1940,0.0,98105,47.6618,-122.273,2840,5500,1970,0.35818181818181816,12460900,30250000,17789100
405000.0,3,2.5,2160,10200,1.0,0,0,2,7,1360,800,1978,0.0,98133,47.7295,-122.331,2010,7850,8040,0.788235294117647,4665600,104040000,99374400
615000.0,4,2.25,2360,15860,1.0,0,0,2,9,2360,0,1977,0.0,98074,47.6307,-122.051,2650,11798,13500,0.8511979823455234,5569600,251539600,245970000
268000.0,3,1.75,1980,12543,1.0,0,0,2,8,1180,800,1978,0.0,98023,47.3104,-122.39399999999999,2090,8539,10563,0.842143027983736,3920400,157326849,153406449
451000.0,4,1.5,1620,5444,1.5,0,0,2,8,1620,0,1955,0.0,98125,47.7065,-122.29700000000001,1620,6912,3824,0.7024246877296105,2624400,29637136,27012736
850000.0,2,2.75,2700,9854,1.0,0,0,2,9,2700,0,2012,0.0,98053,47.7187,-122.024,1440,4168,7154,0.7259995940734727,7290000,97101316,89811316
1180000.0,5,2.25,3270,16553,2.0,0,2,4,9,2470,800,1968,0.0,98040,47.5428,-122.236,3690,17916,13283,0.8024527276022473,10692900,274001809,263308909
245000.0,2,1.0,870,6150,1.0,0,0,2,6,870,0,1941,0.0,98106,47.5256,-122.34700000000001,1120,6150,5280,0.8585365853658536,756900,37822500,37065600
450000.0,2,1.75,840,3340,1.0,0,0,2,6,700,140,1912,0.0,98107,47.6692,-122.359,1700,3980,2500,0.7485029940119761,705600,11155600,10450000
370350.0,3,3.5,1340,1168,2.0,0,2,2,8,1080,260,2002,0.0,98133,47.71100000000001,-122.35600000000001,1650,1378,-172,-0.14726027397260275,1795600,1364224,-431376
543000.0,3,2.5,1540,1256,3.0,0,0,2,8,1540,0,2004,0.0,98103,47.6498,-122.346,1500,1350,-284,-0.22611464968152867,2371600,1577536,-794064
265000.0,2,2.0,1650,8975,1.0,0,0,4,6,1650,0,1942,0.0,98146,47.5073,-122.36,1260,8668,7325,0.8161559888579387,2722500,80550625,77828125
497000.0,3,2.5,2630,4611,2.0,0,0,2,8,2630,0,2001,0.0,98065,47.5322,-121.868,2220,5250,1981,0.42962481023639126,6916900,21261321,14344421
419000.0,4,2.25,1880,9727,1.0,0,0,2,7,1100,780,1979,0.0,98028,47.7731,-122.257,1790,10274,7847,0.806723552996813,3534400,94614529,91080129
545800.0,4,2.5,1980,4500,2.0,0,0,2,8,1980,0,1989,0.0,98029,47.57899999999999,-122.001,1770,4595,2520,0.56,3920400,20250000,16329600
403000.0,3,1.0,1500,10730,1.0,0,0,2,7,1000,500,1977,0.0,98053,47.6385,-121.96600000000001,1570,12210,9230,0.8602050326188257,2250000,115132900,112882900
195000.0,3,2.0,1230,8235,1.5,0,0,2,6,1230,0,1959,0.0,98168,47.4853,-122.304,1080,10281,7005,0.8506375227686703,1512900,67815225,66302325
1130000.0,4,2.5,2520,2600,2.0,0,0,4,8,1670,850,1925,0.0,98119,47.6434,-122.35799999999999,2290,3600,80,0.03076923076923077,6350400,6760000,409600
255000.0,5,1.75,1970,8925,1.0,0,0,4,7,1170,800,1977,0.0,98002,47.2925,-122.196,1910,8025,6955,0.7792717086834734,3880900,79655625,75774725
500000.0,2,1.5,1520,8040,1.0,0,0,4,7,1520,0,1951,0.0,98125,47.7131,-122.306,1440,8040,6520,0.8109452736318408,2310400,64641600,62331200
855000.0,4,2.75,2600,5390,1.0,0,0,3,8,1300,1300,1960,0.0,98199,47.6382,-122.397,2550,5600,2790,0.5176252319109462,6760000,29052100,22292100
390000.0,4,2.0,2290,9200,1.5,0,0,2,7,2290,0,1920,0.0,98166,47.4678,-122.363,2140,9200,6910,0.7510869565217392,5244100,84640000,79395900
339000.0,3,2.0,1979,8470,1.0,0,2,3,7,1329,650,1956,0.0,98198,47.3912,-122.301,1650,8591,6491,0.7663518299881936,3916441,71740900,67824459
1330000.0,4,3.5,2170,3672,2.0,0,0,2,9,2170,0,1905,1989.0,98115,47.6828,-122.329,1950,3450,1502,0.409041394335512,4708900,13483584,8774684
429900.0,4,1.5,1820,17918,1.0,0,0,3,8,1190,0,1962,0.0,98056,47.521,-122.179,1890,15241,16098,0.8984261636343341,3312400,321054724,317742324
370900.0,3,1.5,1200,8560,1.0,0,0,3,7,1200,0,1975,0.0,98011,47.7392,-122.194,1550,7800,7360,0.8598130841121495,1440000,73273600,71833600
457500.0,3,1.0,1210,7636,1.0,0,0,3,7,1210,0,1952,0.0,98118,47.5377,-122.266,1530,5900,6426,0.8415400733368256,1464100,58308496,56844396
499000.0,4,2.5,1970,2601,2.0,0,0,2,7,1440,530,1999,0.0,98144,47.5949,-122.30799999999999,1760,3025,631,0.24259900038446752,3880900,6765201,2884301
225000.0,2,1.0,1040,11500,1.0,0,0,4,7,1040,0,1947,0.0,98003,47.2791,-122.3,1300,11954,10460,0.9095652173913044,1081600,132250000,131168400
615000.0,3,1.75,1920,4000,1.0,0,0,2,7,1070,850,1950,0.0,98102,47.6392,-122.318,2280,4000,2080,0.52,3686400,16000000,12313600
455000.0,2,1.5,1020,1146,3.0,0,0,2,7,1020,0,2001,0.0,98115,47.6774,-122.325,1138,1156,126,0.1099476439790576,1040400,1313316,272916
458000.0,3,1.0,1660,7500,1.0,0,0,3,7,1060,600,1940,0.0,98125,47.7105,-122.306,1450,7500,5840,0.7786666666666666,2755600,56250000,53494400
580000.0,3,2.25,1670,7416,1.0,0,0,3,7,1220,450,1974,0.0,98005,47.6028,-122.17200000000001,1710,7416,5746,0.7748112189859763,2788900,54997056,52208156
966000.0,5,4.5,3810,8019,2.0,0,0,2,10,3810,0,2008,0.0,98074,47.5915,-122.05799999999999,3390,7713,4209,0.5248784137673027,14516100,64304361,49788261
240000.0,4,1.75,2020,10332,1.0,0,0,2,7,1010,1010,1954,0.0,98168,47.5059,-122.303,2240,8379,8312,0.8044909020518777,4080400,106750224,102669824
229050.0,1,1.0,420,3298,1.0,0,0,3,4,420,0,1949,0.0,98136,47.5375,-122.391,1460,4975,2878,0.8726500909642207,176400,10876804,10700404
328500.0,3,2.25,1390,1407,3.0,0,0,2,7,1390,0,2004,0.0,98125,47.7227,-122.296,1390,1628,17,0.012082444918265814,1932100,1979649,47549
319000.0,3,1.5,2010,10100,1.0,0,0,3,7,1110,900,1964,0.0,98168,47.4738,-122.266,1900,10100,8090,0.800990099009901,4040100,102010000,97969900
650000.0,4,2.0,1820,5000,1.5,0,1,2,7,1640,180,1945,0.0,98115,47.6815,-122.26899999999999,2060,5000,3180,0.636,3312400,25000000,21687600
398500.0,3,2.5,1630,1971,2.0,0,0,2,8,1630,0,1996,0.0,98177,47.7753,-122.375,1630,3451,341,0.17300862506341957,2656900,3884841,1227941
250000.0,1,1.0,800,16306,1.0,0,0,1,6,680,120,1931,0.0,98168,47.4916,-122.30799999999999,1270,8666,15506,0.9509383049184349,640000,265885636,265245636
815000.0,3,2.0,2270,11989,1.0,0,0,3,9,2270,0,1968,0.0,98040,47.5434,-122.229,2880,12439,9719,0.810659771457169,5152900,143736121,138583221
1070000.0,3,2.75,2290,5002,2.0,0,0,3,9,1950,340,1995,0.0,98033,47.6811,-122.20700000000001,2290,5100,2712,0.5421831267493002,5244100,25020004,19775904
510000.0,3,2.25,2750,219542,2.0,0,0,2,7,1870,880,1981,0.0,98014,47.6367,-121.948,2430,219542,216792,0.9874739229851236,7562500,48198689764,48191127264
156000.0,2,1.75,590,6138,1.0,0,0,1,5,590,0,1947,0.0,98118,47.545,-122.27799999999999,1360,7112,5548,0.9038774845226458,348100,37675044,37326944
254500.0,4,2.75,2570,7264,2.0,0,0,2,8,1720,850,1998,0.0,98092,47.258,-122.208,2420,7911,4694,0.6462004405286343,6604900,52765696,46160796
760000.0,3,2.5,2050,15020,1.0,0,2,2,9,1600,450,1960,0.0,98177,47.75899999999999,-122.37100000000001,2930,15050,12970,0.8635153129161118,4202500,225600400,221397900
210000.0,3,2.5,1610,6732,2.0,0,0,2,7,1610,0,1994,0.0,98030,47.3658,-122.17200000000001,1680,7414,5122,0.7608437314319667,2592100,45319824,42727724
349950.0,3,2.5,2140,7715,2.0,0,0,2,7,2140,0,1991,0.0,98198,47.38399999999999,-122.322,1990,7628,5575,0.7226182760855476,4579600,59521225,54941625
676000.0,3,2.0,1730,6784,2.5,0,0,3,7,1730,0,1942,0.0,98199,47.6462,-122.40299999999999,1210,6784,5054,0.7449882075471698,2992900,46022656,43029756
475000.0,4,3.5,2440,3052,2.0,0,0,2,8,1940,500,2006,0.0,98108,47.555,-122.309,2390,4600,612,0.20052424639580602,5953600,9314704,3361104
880000.0,4,2.75,3220,4392,1.5,0,0,3,9,2320,900,1931,0.0,98105,47.6713,-122.27600000000001,2310,5795,1172,0.2668488160291439,10368400,19289664,8921264
1210000.0,4,3.25,4330,26162,2.0,0,0,2,11,4330,0,1997,0.0,98074,47.6009,-122.01100000000001,5110,26319,21832,0.834492775781668,18748900,684450244,665701344
420000.0,3,1.5,1780,5000,1.0,0,4,3,7,1030,750,1958,0.0,98118,47.5168,-122.256,1780,7500,3220,0.644,3168400,25000000,21831600
607000.0,3,1.0,1230,8114,1.0,0,0,3,7,1230,0,1951,0.0,98004,47.5822,-122.196,2220,8114,6884,0.848410155287158,1512900,65836996,64324096
475000.0,4,1.75,2160,19283,2.0,0,0,2,8,2160,0,1981,0.0,98011,47.7603,-122.169,1990,9744,17123,0.8879842348182336,4665600,371834089,367168489
395000.0,2,1.75,1400,2500,1.0,0,0,4,7,710,690,1916,0.0,98116,47.5628,-122.391,1250,5700,1100,0.44,1960000,6250000,4290000
650000.0,4,1.75,1900,10454,1.0,0,0,3,7,1180,720,1954,0.0,98004,47.5933,-122.195,2060,11325,8554,0.8182513870288884,3610000,109286116,105676116
625000.0,5,2.75,2910,85377,1.0,0,0,3,8,1510,1400,1966,0.0,98027,47.48,-122.03,2160,66120,82467,0.9659158789838013,8468100,7289232129,7280764029
849000.0,3,3.0,2960,42159,2.0,0,0,2,10,2960,0,1995,0.0,98052,47.7183,-122.1,2640,25209,39199,0.9297896060153229,8761600,1777381281,1768619681
429950.0,3,1.5,2010,9480,1.0,0,0,2,8,1570,440,1951,0.0,98125,47.7102,-122.281,1920,8791,7470,0.7879746835443038,4040100,89870400,85830300
825000.0,3,2.5,3760,5260,2.0,0,0,2,9,3230,530,2002,0.0,98029,47.5489,-122.007,3080,5312,1500,0.28517110266159695,14137600,27667600,13530000
505000.0,2,1.0,1020,5000,1.0,0,0,3,7,1020,0,1916,0.0,98117,47.6781,-122.363,1480,5000,3980,0.796,1040400,25000000,23959600
265000.0,2,1.0,1290,2828,2.0,0,0,2,7,1290,0,2008,0.0,98053,47.6968,-122.025,1290,2628,1538,0.5438472418670438,1664100,7997584,6333484
283000.0,3,1.0,890,8400,1.0,0,0,3,6,890,0,1954,0.0,98056,47.5168,-122.204,1850,5565,7510,0.8940476190476191,792100,70560000,69767900
560000.0,3,2.75,1620,7500,1.0,0,0,4,7,1140,480,1979,0.0,98074,47.6175,-122.065,1900,7500,5880,0.784,2624400,56250000,53625600
765000.0,4,2.5,3360,13636,2.0,0,0,2,10,3360,0,1987,0.0,98074,47.6373,-122.042,2980,10615,10276,0.7535934291581109,11289600,185940496,174650896
610000.0,5,2.75,2930,31411,1.0,0,0,3,9,1520,1410,1975,0.0,98006,47.5576,-122.186,3070,12378,28481,0.9067205755945369,8584900,986650921,978066021
589000.0,3,2.5,2940,4799,1.0,0,0,2,9,1710,1230,1996,0.0,98033,47.6681,-122.184,2540,4616,1859,0.3873723692435924,8643600,23030401,14386801
192500.0,3,1.0,1080,8580,1.5,0,0,2,6,1080,0,1900,0.0,98168,47.4716,-122.262,1800,12672,7500,0.8741258741258742,1166400,73616400,72450000
3200000.0,3,3.25,4560,13363,1.0,0,4,2,11,2760,1800,1995,0.0,98004,47.6205,-122.214,4060,13362,8803,0.6587592606450647,20793600,178569769,157776169
550000.0,3,1.0,1010,6120,1.0,0,0,2,7,860,150,1940,0.0,98115,47.6861,-122.296,1930,6120,5110,0.8349673202614379,1020100,37454400,36434300
460000.0,2,1.5,1790,3760,1.5,0,0,3,8,1280,510,1928,0.0,98117,47.6871,-122.37299999999999,1540,5080,1970,0.523936170212766,3204100,14137600,10933500
264500.0,4,2.25,2060,11385,1.0,0,0,3,7,1200,860,1962,0.0,98023,47.31399999999999,-122.363,2110,11385,9325,0.8190601668862538,4243600,129618225,125374625
339000.0,3,1.0,1150,2496,1.0,0,0,2,6,1010,140,1947,0.0,98126,47.5194,-122.376,1340,1203,1346,0.5392628205128205,1322500,6230016,4907516
950000.0,4,3.5,4030,4200,3.0,0,0,2,9,4030,0,1992,0.0,98199,47.6416,-122.38600000000001,2130,5000,170,0.04047619047619048,16240900,17640000,1399100
677500.0,3,1.75,2020,9718,1.0,0,0,2,8,2020,0,1956,0.0,98040,47.574,-122.21,2370,8604,7698,0.7921383000617411,4080400,94439524,90359124
690000.0,4,2.5,2740,8120,2.0,0,0,2,9,2740,0,1999,0.0,98074,47.6123,-122.006,2780,8344,5380,0.6625615763546798,7507600,65934400,58426800
312000.0,4,2.25,1930,7452,1.0,0,0,2,7,1430,500,1984,0.0,98031,47.4098,-122.189,1714,7200,5522,0.741009125067096,3724900,55532304,51807404
840000.0,5,1.75,2500,11617,1.0,0,0,3,9,1560,940,1966,0.0,98040,47.5361,-122.21700000000001,3370,11617,9117,0.7847981406559352,6250000,134954689,128704689
357500.0,3,3.5,2080,5100,2.0,0,0,2,8,2080,0,2004,0.0,98038,47.35,-122.005,2080,5100,3020,0.592156862745098,4326400,26010000,21683600
675000.0,3,1.5,1460,6480,1.0,0,2,3,7,980,480,1940,0.0,98117,47.6962,-122.397,2180,6912,5020,0.7746913580246914,2131600,41990400,39858800
515000.0,3,2.75,3290,11441,2.0,0,0,3,10,3290,0,1988,0.0,98023,47.3052,-122.34,2600,12070,8151,0.712437723975177,10824100,130896481,120072381
491234.0,4,2.5,1540,1860,2.0,0,0,2,8,1540,0,2014,0.0,98029,47.5521,-121.999,1210,1090,320,0.17204301075268819,2371600,3459600,1088000
290000.0,3,2.0,1310,6265,1.0,0,0,2,7,1310,0,1988,0.0,98038,47.3893,-122.051,1100,6360,4955,0.790901835594573,1716100,39250225,37534125
490000.0,4,2.5,2120,7820,1.0,0,0,2,8,1280,840,1975,0.0,98052,47.6743,-122.145,2350,8605,5700,0.7289002557544757,4494400,61152400,56658000
810000.0,4,2.0,2920,10424,1.0,0,0,4,8,1520,1400,1964,0.0,98005,47.5876,-122.17200000000001,2360,10696,7504,0.7198772064466615,8526400,108659776,100133376
252000.0,3,1.5,1150,13200,1.0,0,0,2,7,1150,0,1956,0.0,98166,47.4752,-122.345,1220,13066,12050,0.9128787878787878,1322500,174240000,172917500
299999.0,3,2.5,2380,9719,2.0,0,0,2,8,2380,0,2001,0.0,98001,47.2932,-122.28299999999999,2830,11505,7339,0.7551188393867682,5664400,94458961,88794561
400000.0,3,2.75,2220,5000,2.0,0,0,2,7,2220,0,1993,0.0,98108,47.5515,-122.324,960,5000,2780,0.556,4928400,25000000,20071600
530000.0,5,2.0,3020,6000,1.5,0,0,4,7,1860,1160,1925,0.0,98126,47.5207,-122.37799999999999,1380,6000,2980,0.49666666666666665,9120400,36000000,26879600
357000.0,3,2.0,2460,53882,1.0,1,4,2,7,2460,0,1955,0.0,98198,47.3811,-122.325,2660,32625,51422,0.9543446791136186,6051600,2903269924,2897218324
365000.0,3,1.75,1820,5555,1.0,0,0,3,7,1030,790,1939,0.0,98103,47.6867,-122.352,1420,4000,3735,0.6723672367236724,3312400,30858025,27545625
804000.0,4,2.5,2620,5060,2.0,0,0,2,9,2620,0,2005,0.0,98116,47.5634,-122.39399999999999,900,5060,2440,0.48221343873517786,6864400,25603600,18739200
808250.0,3,2.0,1750,2640,1.0,0,0,2,8,1010,740,1914,2005.0,98119,47.6419,-122.368,1750,4560,890,0.3371212121212121,3062500,6969600,3907100
360000.0,4,2.5,2020,7289,2.0,0,0,2,7,2020,0,1994,0.0,98031,47.401,-122.171,2090,7259,5269,0.7228700782000275,4080400,53129521,49049121
240000.0,3,1.75,1240,10956,1.0,0,0,2,6,1240,0,1987,0.0,98042,47.3705,-122.15,1240,8137,9716,0.886820007301935,1537600,120033936,118496336
335000.0,2,2.0,1380,5840,1.0,0,0,2,7,1380,0,1988,0.0,98011,47.7732,-122.17200000000001,1810,5035,4460,0.7636986301369864,1904400,34105600,32201200
380000.0,3,1.75,1920,8775,1.0,0,0,2,7,1920,0,1953,0.0,98166,47.4544,-122.351,1560,8100,6855,0.7811965811965812,3686400,77000625,73314225
350000.0,3,1.75,1680,250470,1.0,0,0,3,7,1070,610,1940,0.0,98019,47.7624,-121.93,1680,360000,248790,0.9932926098934004,2822400,62735220900,62732398500
194000.0,3,1.0,1400,7955,1.0,0,0,2,7,1400,0,1964,0.0,98055,47.4848,-122.221,1160,14959,6555,0.8240100565681961,1960000,63282025,61322025
310000.0,3,1.0,1240,7194,1.0,0,0,2,6,1090,150,1936,0.0,98011,47.7636,-122.20200000000001,2090,8514,5954,0.827634139560745,1537600,51753636,50216036
315000.0,3,1.75,1410,15134,1.0,0,0,2,7,1410,0,1980,0.0,98014,47.6931,-121.921,1770,15337,13724,0.906832298136646,1988100,229037956,227049856
258950.0,3,1.75,1440,8050,1.0,0,0,2,8,1440,0,1985,0.0,98023,47.3187,-122.39,1790,7488,6610,0.8211180124223603,2073600,64802500,62728900
479000.0,2,2.25,1230,932,2.0,0,0,2,8,1020,210,2004,0.0,98112,47.6192,-122.301,1230,1064,-298,-0.3197424892703863,1512900,868624,-644276
510000.0,5,1.5,1550,9750,1.0,0,0,3,7,1550,0,1966,0.0,98033,47.6811,-122.169,1970,9750,8200,0.841025641025641,2402500,95062500,92660000
400000.0,3,2.0,1760,6875,1.0,0,0,3,8,1760,0,1967,0.0,98072,47.74,-122.09299999999999,1670,13650,5115,0.744,3097600,47265625,44168025
1450000.0,4,3.5,5000,38012,2.0,0,0,2,11,3610,1390,2004,0.0,98029,47.553999999999995,-122.036,3850,18054,33012,0.8684625907608123,25000000,1444912144,1419912144
680000.0,5,2.0,2140,5000,1.5,0,0,3,7,2020,120,1913,0.0,98122,47.6044,-122.29899999999999,1810,4400,2860,0.572,4579600,25000000,20420400
1750000.0,6,3.0,3510,5760,2.5,0,0,3,10,3510,0,1906,0.0,98112,47.6263,-122.31200000000001,3450,5760,2250,0.390625,12320100,33177600,20857500
335000.0,3,1.75,2010,9417,1.0,0,0,3,8,1500,510,1967,0.0,98030,47.37300000000001,-122.185,1200,8250,7407,0.7865562280981204,4040100,88679889,84639789
460000.0,5,2.5,3390,9760,1.0,0,0,4,8,1750,0,1978,0.0,98058,47.4462,-122.137,2360,9600,6370,0.6526639344262295,11492100,95257600,83765500
440000.0,4,2.25,2160,8119,1.0,0,0,2,8,1080,1080,1966,0.0,98006,47.5443,-122.177,1850,9000,5959,0.7339573839142751,4665600,65918161,61252561
412250.0,2,2.0,1300,2983,1.0,0,0,2,8,1300,0,2006,0.0,98053,47.703,-122.015,1510,3876,1683,0.5641971169963125,1690000,8898289,7208289
185000.0,3,1.5,1280,4031,2.0,0,0,3,6,1280,0,1985,0.0,98002,47.3342,-122.215,1150,4500,2751,0.6824609278094765,1638400,16248961,14610561
286500.0,3,2.0,1840,8140,1.0,0,0,3,7,1040,800,1975,0.0,98003,47.3106,-122.325,1600,6720,6300,0.773955773955774,3385600,66259600,62874000
422000.0,4,2.5,3200,6691,2.0,0,0,2,7,3200,0,2002,0.0,98038,47.367,-122.031,2610,6510,3491,0.5217456284561351,10240000,44769481,34529481
408000.0,3,2.25,2800,35362,2.0,0,0,2,9,2800,0,1985,0.0,98042,47.3507,-122.089,2800,37058,32562,0.9208189582037215,7840000,1250471044,1242631044
306500.0,2,1.0,1390,19988,1.0,0,2,3,7,1390,0,1949,0.0,98198,47.3985,-122.321,2580,10490,18598,0.930458274964979,1932100,399520144,397588044
359900.0,4,2.5,2600,5188,2.0,0,0,2,8,2600,0,2005,0.0,98038,47.3451,-122.04,2610,5188,2588,0.49884348496530456,6760000,26915344,20155344
560000.0,3,2.5,1960,6058,2.0,0,0,2,8,1960,0,2002,0.0,98053,47.6319,-122.007,2480,6656,4098,0.6764608781776164,3841600,36699364,32857764
259875.0,3,1.0,1250,21303,1.0,0,0,2,6,1250,0,1970,0.0,98053,47.6625,-122.059,1250,17920,20053,0.9413228183823874,1562500,453817809,452255309
385000.0,3,1.0,1250,21303,1.0,0,0,2,6,1250,0,1970,0.0,98053,47.6625,-122.059,1250,17920,20053,0.9413228183823874,1562500,453817809,452255309
188000.0,1,1.0,550,16345,1.0,0,0,2,4,550,0,1945,0.0,98106,47.5181,-122.339,1100,9240,15795,0.9663505659223004,302500,267159025,266856525
1140000.0,4,3.25,2500,5801,1.5,0,0,2,8,1960,540,1926,0.0,98112,47.632,-122.29,3670,7350,3301,0.5690398207205655,6250000,33651601,27401601
255000.0,3,1.0,1250,10094,1.0,0,0,3,6,1250,0,1927,0.0,98045,47.4987,-121.781,1300,10094,8844,0.8761640578561521,1562500,101888836,100326336
1190000.0,4,2.75,3020,8622,2.0,0,0,2,9,3020,0,1976,2003.0,98004,47.5866,-122.20100000000001,3060,14303,5602,0.6497332405474368,9120400,74338884,65218484
635200.0,4,1.75,1640,4240,1.0,0,0,4,7,920,720,1921,0.0,98117,47.6766,-122.368,1300,4240,2600,0.6132075471698113,2689600,17977600,15288000
355000.0,3,1.75,1870,8250,2.0,0,0,2,7,1870,0,1956,1979.0,98188,47.445,-122.285,1350,8714,6380,0.7733333333333333,3496900,68062500,64565600
544000.0,3,2.5,1760,1755,3.5,0,0,2,8,1760,0,1998,0.0,98105,47.6688,-122.279,1700,1721,-5,-0.002849002849002849,3097600,3080025,-17575
402000.0,3,1.5,1320,3145,2.0,0,0,2,7,1320,0,1998,0.0,98144,47.5909,-122.29700000000001,1320,3002,1825,0.5802861685214626,1742400,9891025,8148625
575000.0,4,1.5,1430,4163,1.5,0,0,2,7,1430,0,1910,0.0,98199,47.6606,-122.397,1500,4000,2733,0.6564977179918328,2044900,17330569,15285669
216000.0,3,1.75,1580,9705,1.0,0,0,3,7,1580,0,1977,0.0,98042,47.3819,-122.09,1580,9942,8125,0.8371973209685729,2496400,94187025,91690625
1200000.0,4,3.5,4170,9748,2.0,0,0,2,11,4170,0,2004,0.0,98059,47.528,-122.132,4560,10589,5578,0.5722199425523185,17388900,95023504,77634604
850000.0,4,3.25,3090,6744,2.0,0,4,2,9,3090,0,1923,2015.0,98177,47.768,-122.38799999999999,2020,6656,3654,0.541814946619217,9548100,45481536,35933436
238000.0,3,2.0,1020,1204,2.0,0,0,2,7,720,300,2004,0.0,98126,47.5445,-122.376,1360,1506,184,0.15282392026578073,1040400,1449616,409216
625000.0,4,1.75,2180,4431,1.5,0,0,2,8,2020,160,1912,0.0,98112,47.636,-122.302,1890,4400,2251,0.5080117354998872,4752400,19633761,14881361
1110000.0,5,3.25,3350,4000,2.0,0,0,3,8,2510,840,1997,0.0,98105,47.6645,-122.291,1620,4000,650,0.1625,11222500,16000000,4777500
820000.0,3,2.5,2510,5503,2.0,0,2,2,9,2510,0,1995,0.0,98136,47.5419,-122.383,1790,6099,2993,0.5438851535526077,6300100,30283009,23982909
355000.0,3,2.5,1880,5290,1.0,0,0,2,8,1250,630,1974,0.0,98108,47.5401,-122.3,2030,5092,3410,0.6446124763705104,3534400,27984100,24449700
495000.0,4,1.5,1810,7998,1.0,0,0,2,8,1210,600,1960,0.0,98125,47.726000000000006,-122.29700000000001,1830,7763,6188,0.7736934233558389,3276100,63968004,60691904
1300000.0,5,2.5,4170,33310,2.0,0,0,3,11,4170,0,1991,0.0,98006,47.5455,-122.126,4670,37960,29140,0.8748123686580607,17388900,1109556100,1092167200
398750.0,3,2.5,2230,4000,2.0,0,0,2,7,2230,0,1954,0.0,98144,47.5801,-122.306,1310,4000,1770,0.4425,4972900,16000000,11027100
835000.0,4,2.5,3650,7784,2.0,0,0,2,9,3650,0,2006,0.0,98052,47.7066,-122.101,3150,6442,4134,0.5310894141829393,13322500,60590656,47268156
705000.0,6,2.75,2830,10579,1.0,0,0,3,8,1430,1400,1967,0.0,98005,47.636,-122.171,2060,10745,7749,0.7324888930900841,8008900,111915241,103906341
625000.0,4,1.5,2120,5000,2.0,0,0,3,8,2120,0,1900,0.0,98122,47.6024,-122.296,1830,5000,2880,0.576,4494400,25000000,20505600
550000.0,4,2.5,2090,6926,2.0,0,0,2,8,2090,0,1990,0.0,98074,47.6339,-122.022,2000,7151,4836,0.6982385215131389,4368100,47969476,43601376
540000.0,3,1.5,2600,5085,1.0,0,0,3,7,1400,1200,1940,0.0,98126,47.5659,-122.376,1320,4000,2485,0.4886922320550639,6760000,25857225,19097225
519000.0,2,1.0,830,2820,1.0,0,0,3,7,830,0,1920,0.0,98103,47.68899999999999,-122.34700000000001,1460,3150,1990,0.7056737588652482,688900,7952400,7263500
311000.0,4,2.5,1975,8734,2.0,0,0,2,7,1975,0,1996,0.0,98038,47.363,-122.03399999999999,1975,8538,6759,0.7738722234943898,3900625,76282756,72382131
305000.0,4,2.5,1900,7000,1.0,0,0,1,7,1420,480,1968,0.0,98023,47.3092,-122.376,1600,7600,5100,0.7285714285714285,3610000,49000000,45390000
395000.0,4,2.75,2640,35070,1.5,0,0,2,8,2640,0,1963,0.0,98058,47.4242,-122.181,2520,34986,32430,0.9247219846022241,6969600,1229904900,1222935300
275000.0,4,1.5,1610,6923,1.0,0,0,2,6,1010,600,1969,0.0,98198,47.3747,-122.306,1320,7684,5313,0.7674418604651163,2592100,47927929,45335829
450000.0,3,3.25,1770,1863,2.0,0,0,2,8,1430,340,2003,0.0,98029,47.5478,-122.005,1410,1375,93,0.0499194847020934,3132900,3470769,337869
324000.0,2,1.0,1070,6000,1.0,0,0,2,7,1070,0,1955,0.0,98133,47.7307,-122.33200000000001,1490,7622,4930,0.8216666666666667,1144900,36000000,34855100
2800000.0,5,3.25,4590,12793,2.0,0,2,4,11,3590,1000,1928,0.0,98199,47.6453,-122.41,2920,8609,8203,0.6412100367388416,21068100,163660849,142592749
565000.0,4,1.0,1540,2452,1.5,0,0,3,7,1540,0,1906,0.0,98103,47.6522,-122.348,1290,3360,912,0.3719412724306688,2371600,6012304,3640704
373000.0,4,1.75,1590,7920,2.0,0,0,3,7,1590,0,1960,0.0,98133,47.7456,-122.336,1720,7998,6330,0.7992424242424242,2528100,62726400,60198300
613000.0,2,2.0,1170,1890,1.5,0,1,3,8,1170,0,1927,0.0,98119,47.6402,-122.37100000000001,2160,4000,720,0.38095238095238093,1368900,3572100,2203200
614000.0,4,2.25,2880,9996,1.0,0,0,3,8,1920,960,1981,0.0,98072,47.7584,-122.14299999999999,2410,10584,7116,0.7118847539015606,8294400,99920016,91625616
595000.0,4,1.75,2510,8989,1.0,0,0,3,8,1680,830,1964,0.0,98006,47.5569,-122.17200000000001,2510,8931,6479,0.7207698297919679,6300100,80802121,74502021
440000.0,2,1.0,1280,12086,1.0,0,0,2,7,850,430,1983,0.0,98074,47.63399999999999,-122.03299999999999,1280,10452,10806,0.8940923382425947,1638400,146071396,144432996
425000.0,3,1.5,1570,12412,1.0,0,3,2,8,1570,0,1954,0.0,98166,47.438,-122.34899999999999,2130,12412,10842,0.8735095069287786,2464900,154057744,151592844
407000.0,2,1.0,740,6380,1.0,0,0,2,6,740,0,1912,0.0,98115,47.6929,-122.318,1800,6380,5640,0.8840125391849529,547600,40704400,40156800
472000.0,3,1.5,1740,9038,1.0,0,0,3,7,1740,0,1955,0.0,98007,47.5897,-122.13600000000001,1390,9770,7298,0.8074795308696614,3027600,81685444,78657844
472000.0,3,2.5,1180,1262,3.0,0,0,2,8,1180,0,2010,0.0,98119,47.6381,-122.375,1180,2632,82,0.06497622820919176,1392400,1592644,200244
1250000.0,5,2.75,2960,28300,1.0,0,3,3,9,2160,800,1959,0.0,98177,47.7606,-122.37,2940,23250,25340,0.8954063604240282,8761600,800890000,792128400
412000.0,3,1.75,1880,5752,1.0,0,0,3,7,940,940,1945,0.0,98126,47.5354,-122.37799999999999,1110,5201,3872,0.6731571627260083,3534400,33085504,29551104
717000.0,3,1.0,1150,5000,1.0,0,0,2,8,1150,0,1959,2015.0,98117,47.6805,-122.369,1160,5000,3850,0.77,1322500,25000000,23677500
425000.0,3,1.0,1320,7076,1.0,0,0,3,7,1320,0,1959,0.0,98008,47.6131,-122.12299999999999,1510,9000,5756,0.8134539287733182,1742400,50069776,48327376
299999.0,4,2.0,1640,7200,1.0,0,0,4,6,820,820,1944,0.0,98166,47.4791,-122.34700000000001,1640,8200,5560,0.7722222222222223,2689600,51840000,49150400
254000.0,3,2.0,1470,7694,1.0,0,0,3,7,1470,0,1992,0.0,98038,47.3539,-122.054,1580,7480,6224,0.8089420327527944,2160900,59197636,57036736
178500.0,3,1.0,900,10511,1.0,0,0,3,6,900,0,1961,0.0,98001,47.2883,-122.272,1460,10643,9611,0.9143754162306156,810000,110481121,109671121
800000.0,3,1.75,1510,3600,1.0,0,0,4,8,1230,280,1910,0.0,98119,47.6387,-122.363,1300,3600,2090,0.5805555555555556,2280100,12960000,10679900
420000.0,3,1.0,1440,5623,1.0,0,0,3,6,720,720,1922,0.0,98115,47.69600000000001,-122.319,1280,5623,4183,0.7439089454028099,2073600,31618129,29544529
319900.0,2,1.0,1380,9251,1.0,0,0,2,7,1380,0,1940,0.0,98028,47.7486,-122.249,1870,12158,7871,0.8508269376283645,1904400,85581001,83676601
350000.0,2,1.5,1150,7552,1.0,0,1,2,7,1150,0,1944,0.0,98125,47.7298,-122.286,1910,8145,6402,0.8477224576271186,1322500,57032704,55710204
968000.0,6,2.75,3610,17580,1.0,0,4,4,9,2070,1540,1959,0.0,98075,47.5739,-122.069,2890,14060,13970,0.7946530147895335,13032100,309056400,296024300
491000.0,3,2.0,1250,1306,3.0,0,0,2,7,1250,0,2000,0.0,98107,47.6705,-122.39,1320,1306,56,0.042879019908116385,1562500,1705636,143136
948000.0,3,2.5,3510,9824,2.0,0,0,2,9,3510,0,2002,0.0,98075,47.5635,-122.03200000000001,3510,10588,6314,0.6427117263843648,12320100,96510976,84190876
900000.0,3,2.5,2260,9577,2.0,0,0,2,8,1700,560,1925,2004.0,98117,47.6928,-122.399,1740,10240,7317,0.7640179596951029,5107600,91718929,86611329
270000.0,3,1.75,2840,9800,1.0,0,0,3,7,1420,1420,1977,0.0,98042,47.3516,-122.119,1650,9590,6960,0.710204081632653,8065600,96040000,87974400
198000.0,3,1.5,1430,7347,1.0,0,0,2,7,820,610,1980,0.0,98023,47.2927,-122.369,1430,8723,5917,0.8053627330883354,2044900,53978409,51933509
250000.0,2,1.0,1420,21158,1.0,0,0,2,7,1420,0,1953,0.0,98166,47.4594,-122.359,1220,8625,19738,0.9328859060402684,2016400,447660964,445644564
615000.0,4,2.5,2120,3720,2.0,0,0,2,8,2120,0,2004,0.0,98029,47.5526,-121.994,2170,3720,1600,0.43010752688172044,4494400,13838400,9344000
550000.0,3,2.5,2080,7749,2.0,0,0,2,8,2080,0,1988,0.0,98029,47.5723,-122.021,2210,7471,5669,0.731578268163634,4326400,60047001,55720601
190000.0,2,2.5,1370,3438,2.0,0,0,2,7,1370,0,1987,0.0,98188,47.4606,-122.28299999999999,1370,2308,2068,0.6015125072716696,1876900,11819844,9942944
629000.0,4,2.25,1900,11171,1.0,0,0,2,8,1280,620,1984,0.0,98006,47.56100000000001,-122.126,2330,9934,9271,0.8299167487243756,3610000,124791241,121181241
434000.0,3,1.75,1660,8301,1.0,0,0,4,7,1660,0,1955,0.0,98028,47.7647,-122.26299999999999,1660,9489,6641,0.800024093482713,2755600,68906601,66151001
415885.0,3,1.0,1310,4163,1.0,0,0,3,7,1310,0,1964,0.0,98126,47.5301,-122.381,1120,4166,2853,0.6853230843141965,1716100,17330569,15614469
550000.0,3,2.5,1840,3035,1.0,0,0,2,7,920,0,1926,0.0,98105,47.6557,-122.32700000000001,1780,4000,1195,0.39373970345963755,3385600,9211225,5825625
272000.0,1,0.75,1040,6034,1.0,0,1,2,7,580,460,1991,0.0,98178,47.5078,-122.251,1560,5650,4994,0.8276433543254889,1081600,36409156,35327556
665000.0,3,2.5,2610,35000,2.0,0,0,2,10,2610,0,1988,0.0,98072,47.7377,-122.101,3060,35427,32390,0.9254285714285714,6812100,1225000000,1218187900
510000.0,3,2.0,1990,7405,1.0,0,0,4,7,1990,0,1971,0.0,98006,47.5421,-122.17200000000001,2120,6462,5415,0.7312626603646185,3960100,54834025,50873925
530000.0,3,2.0,3080,17700,1.0,0,0,3,8,1740,1340,1965,0.0,98166,47.4695,-122.366,2100,15100,14620,0.8259887005649718,9486400,313290000,303803600
355000.0,3,1.0,1200,16000,1.0,0,0,2,7,1200,0,1970,0.0,98072,47.7452,-122.101,1960,15500,14800,0.925,1440000,256000000,254560000
255000.0,4,1.0,1250,9102,1.0,0,0,2,7,1250,0,1955,0.0,98148,47.4258,-122.32700000000001,1260,9180,7852,0.8626675455943749,1562500,82846404,81283904
790000.0,4,2.75,2640,9000,2.0,0,0,2,10,2640,0,1990,0.0,98052,47.6481,-122.125,2980,9137,6360,0.7066666666666667,6969600,81000000,74030400
695000.0,5,1.75,1790,9335,2.0,0,0,4,8,1790,0,1952,0.0,98004,47.5945,-122.20100000000001,1840,9612,7545,0.8082485270487413,3204100,87142225,83938125
255000.0,2,2.0,1140,8400,1.0,0,0,1,7,1140,0,1954,0.0,98148,47.4351,-122.335,1130,9375,7260,0.8642857142857143,1299600,70560000,69260400
410000.0,3,2.25,1790,5794,1.5,0,0,2,7,1380,410,1985,0.0,98072,47.7477,-122.171,2140,7769,4004,0.6910597169485675,3204100,33570436,30366336
650000.0,4,2.75,1910,16532,1.0,0,0,3,7,1420,490,1940,0.0,98117,47.6952,-122.39,2300,8250,14622,0.8844664892330026,3648100,273307024,269658924
675000.0,4,1.75,1530,3615,1.5,0,0,3,7,1530,0,1913,0.0,98103,47.6529,-122.334,1650,4200,2085,0.5767634854771784,2340900,13068225,10727325
332888.0,2,2.5,1050,1029,2.0,0,0,2,8,950,100,2007,0.0,98122,47.6018,-122.29899999999999,1350,3600,-21,-0.02040816326530612,1102500,1058841,-43659
300000.0,3,1.75,1730,6900,1.0,0,0,3,7,1130,600,1976,0.0,98031,47.3915,-122.18799999999999,1950,7200,5170,0.7492753623188406,2992900,47610000,44617100
320000.0,4,1.5,1100,11824,1.0,0,0,3,7,1100,0,1954,0.0,98006,47.5704,-122.141,1380,11796,10724,0.9069688768606224,1210000,139806976,138596976
342500.0,5,2.25,2100,10726,1.0,0,0,3,7,1050,1050,1963,0.0,98059,47.4922,-122.134,2100,10726,8626,0.8042140592951706,4410000,115047076,110637076
752875.0,4,2.5,2800,72309,2.0,0,0,2,9,2800,0,1992,0.0,98072,47.7432,-122.11200000000001,2280,36420,69509,0.9612772960489012,7840000,5228591481,5220751481
1730000.0,5,3.5,5000,26540,2.0,0,3,2,10,3410,1590,2008,0.0,98040,47.5665,-122.21,3360,17398,21540,0.8116051243406179,25000000,704371600,679371600
255000.0,1,0.5,880,1642,1.0,0,0,2,6,500,380,1910,0.0,98126,47.5732,-122.37200000000001,1410,2992,762,0.464068209500609,774400,2696164,1921764
244000.0,3,2.5,1470,9337,2.0,0,0,2,7,1470,0,1991,0.0,98155,47.7651,-122.323,1360,8684,7867,0.8425618507015101,2160900,87179569,85018669
1420000.0,5,3.25,3950,11438,2.0,0,2,2,10,3430,520,2006,0.0,98033,47.6898,-122.189,2070,10751,7488,0.6546599055778982,15602500,130827844,115225344
218000.0,3,1.0,980,12812,1.0,0,0,2,7,980,0,1956,0.0,98168,47.4892,-122.306,1430,8986,11832,0.9235092101155167,960400,164147344,163186944
359000.0,4,1.0,2180,10617,1.5,0,0,2,7,2180,0,1950,0.0,98155,47.7522,-122.307,1360,9519,8437,0.7946689271922389,4752400,112720689,107968289
840000.0,4,2.75,3040,13559,2.0,0,0,2,11,3040,0,2003,0.0,98059,47.522,-122.149,3830,12202,10519,0.7757946751235342,9241600,183846481,174604881
900000.0,5,3.75,4130,226076,2.0,0,0,2,9,3170,960,1985,0.0,98077,47.715,-122.065,4130,55321,221946,0.9817318070029547,17056900,51110357776,51093300876
205000.0,4,1.75,1850,65340,1.5,0,0,3,7,1850,0,1972,0.0,98042,47.3468,-122.11,1750,40946,63490,0.9716865625956536,3422500,4269315600,4265893100
205000.0,3,2.5,1600,7295,2.0,0,0,1,7,1600,0,1993,0.0,98042,47.3904,-122.165,1410,9000,5695,0.7806716929403701,2560000,53217025,50657025
500000.0,2,1.5,2070,5432,2.0,0,0,2,7,1370,700,1951,0.0,98108,47.5571,-122.29899999999999,2070,5505,3362,0.6189248895434463,4284900,29506624,25221724
510000.0,4,2.5,3180,5405,2.0,0,0,2,7,3180,0,2001,0.0,98059,47.4905,-122.14,2610,5403,2225,0.4116558741905643,10112400,29214025,19101625
1140000.0,6,4.25,6900,244716,2.0,0,0,3,9,4820,2080,2002,0.0,98077,47.7506,-122.012,4170,266587,237816,0.9718040504094543,47610000,59885920656,59838310656
1550000.0,4,2.25,2640,3000,2.0,0,0,2,7,2080,560,1908,0.0,98109,47.6313,-122.344,1910,3000,360,0.12,6969600,9000000,2030400
210000.0,3,1.5,1920,61014,1.0,0,0,2,6,1920,0,1953,0.0,98038,47.4446,-122.074,1616,61014,59094,0.9685318123709312,3686400,3722708196,3719021796
597500.0,3,1.75,2030,32565,1.0,0,0,2,8,1600,430,1981,0.0,98052,47.7112,-122.098,2910,34190,30535,0.9376631352679257,4120900,1060479225,1056358325
400000.0,2,1.0,1140,101529,1.5,0,0,2,6,1140,0,1932,0.0,98092,47.2592,-122.228,1580,101529,100389,0.9887716809975475,1299600,10308137841,10306838241
412000.0,3,1.0,1660,6992,1.0,0,0,4,7,1260,400,1952,0.0,98155,47.7576,-122.318,1390,7359,5332,0.7625858123569794,2755600,48888064,46132464
299950.0,2,1.5,1390,1756,3.0,0,0,2,7,1390,0,2005,0.0,98133,47.7274,-122.35700000000001,1340,1756,366,0.20842824601366744,1932100,3083536,1151436
1080000.0,4,3.0,2490,4325,1.5,0,0,2,8,1690,800,1922,2003.0,98105,47.6628,-122.32600000000001,1960,4284,1835,0.42427745664739885,6200100,18705625,12505525
422500.0,4,2.5,2550,8824,2.0,0,0,2,9,2550,0,1990,0.0,98031,47.3979,-122.212,2630,11237,6274,0.7110154125113327,6502500,77862976,71360476
410000.0,3,2.0,1270,10227,1.0,0,0,3,6,1270,0,1968,0.0,98033,47.6876,-122.16799999999999,1470,9750,8957,0.8758189107265083,1612900,104591529,102978629
1400000.0,4,3.25,2980,7000,2.0,0,3,2,10,2140,840,1900,2014.0,98144,47.5933,-122.292,2200,4800,4020,0.5742857142857143,8880400,49000000,40119600
245000.0,3,2.0,1470,8000,1.0,0,0,3,8,1470,0,1974,0.0,98023,47.3191,-122.385,1980,8000,6530,0.81625,2160900,64000000,61839100
720000.0,4,3.0,3550,12327,1.5,0,0,3,10,2180,1370,1990,0.0,98011,47.7533,-122.205,3170,12937,8777,0.7120142776020119,12602500,151954929,139352429
315000.0,2,1.0,780,7200,1.0,0,0,1,6,780,0,1935,0.0,98118,47.5609,-122.279,1750,7200,6420,0.8916666666666667,608400,51840000,51231600
191950.0,2,2.5,1390,1302,2.0,0,0,2,7,1390,0,1987,0.0,98003,47.3081,-122.329,1390,2052,-88,-0.06758832565284179,1932100,1695204,-236896
455000.0,4,2.5,2440,5001,2.0,0,0,2,8,2440,0,2005,0.0,98056,47.5108,-122.193,2260,5001,2561,0.5120975804839032,5953600,25010001,19056401
523000.0,3,1.5,1260,3135,1.5,0,0,2,8,1260,0,1931,0.0,98116,47.5755,-122.38799999999999,1700,4180,1875,0.5980861244019139,1587600,9828225,8240625
250000.0,3,2.25,1640,4420,2.0,0,0,3,7,1640,0,1918,0.0,98002,47.31100000000001,-122.21,1230,6632,2780,0.6289592760180995,2689600,19536400,16846800
294000.0,3,3.0,1670,4120,1.5,0,0,2,7,1140,530,1929,2012.0,98055,47.4881,-122.199,1010,4120,2450,0.5946601941747572,2788900,16974400,14185500
490000.0,3,2.25,2380,6000,1.0,0,0,2,8,2040,340,1961,0.0,98115,47.6955,-122.275,1680,7200,3620,0.6033333333333334,5664400,36000000,30335600
310000.0,4,1.0,1030,5750,1.0,0,0,2,7,1030,0,1971,0.0,98126,47.553000000000004,-122.37,1250,5750,4720,0.8208695652173913,1060900,33062500,32001600
265000.0,3,1.5,1560,10489,1.0,0,0,4,7,1560,0,1961,0.0,98022,47.2048,-121.999,1400,10489,8929,0.8512727619410811,2433600,110019121,107585521
402000.0,4,1.75,1640,10500,1.0,0,0,3,7,1010,630,1968,0.0,98052,47.6933,-122.116,1680,7650,8860,0.8438095238095238,2689600,110250000,107560400
705000.0,2,2.5,2200,188200,1.0,0,3,2,8,2200,0,2007,0.0,98022,47.2458,-122.00200000000001,2700,84942,186000,0.9883103081827843,4840000,35419240000,35414400000
589450.0,4,2.5,3190,7941,2.0,0,0,2,10,3190,0,2005,0.0,98038,47.353,-122.00200000000001,3190,7255,4751,0.5982873693489486,10176100,63059481,52883381
219950.0,3,1.5,1200,8404,1.0,0,0,2,7,1200,0,1964,0.0,98188,47.4482,-122.26899999999999,2120,12000,7204,0.8572108519752499,1440000,70627216,69187216
750000.0,3,2.25,2250,5301,2.0,0,0,3,8,1510,740,1975,0.0,98115,47.6741,-122.271,2240,7200,3051,0.5755517826825127,5062500,28100601,23038101
478000.0,2,1.75,1960,6000,1.0,0,0,3,7,980,980,1904,0.0,98199,47.6531,-122.40100000000001,1650,6000,4040,0.6733333333333333,3841600,36000000,32158400
170000.0,3,1.0,1250,7015,1.0,0,0,2,7,1250,0,1958,0.0,98188,47.4548,-122.29,1510,11460,5765,0.8218104062722738,1562500,49210225,47647725
489950.0,4,2.25,2640,31941,1.0,0,0,3,9,2640,0,1986,0.0,98092,47.3099,-122.116,2780,35365,29301,0.9173476096553019,6969600,1020227481,1013257881
1370000.0,2,2.25,2460,16940,1.5,0,4,3,9,1930,530,1936,0.0,98117,47.6792,-122.404,2260,6851,14480,0.8547815820543093,6051600,286963600,280912000
319950.0,3,2.5,1700,7000,2.0,0,0,2,7,1700,0,1996,0.0,98038,47.3798,-122.025,1950,7000,5300,0.7571428571428571,2890000,49000000,46110000
208417.0,2,1.0,840,4200,1.0,0,0,2,5,840,0,1938,0.0,98108,47.5292,-122.316,830,5000,3360,0.8,705600,17640000,16934400
410000.0,4,2.0,1900,5100,1.0,0,0,2,6,950,950,1914,1973.0,98117,47.6767,-122.38,1230,5100,3200,0.6274509803921569,3610000,26010000,22400000
590000.0,4,2.75,2160,4205,1.0,0,3,2,7,1080,1080,1969,0.0,98125,47.7081,-122.27600000000001,2450,6014,2045,0.4863258026159334,4665600,17682025,13016425
648000.0,3,1.75,1610,10229,1.0,0,0,4,8,1610,0,1961,0.0,98006,47.553000000000004,-122.17399999999999,2270,8800,8619,0.8426043601525076,2592100,104632441,102040341
255000.0,3,2.5,1720,6194,2.0,0,0,2,8,1720,0,1998,0.0,98092,47.2624,-122.221,1720,6211,4474,0.7223119147562157,2958400,38365636,35407236
465000.0,4,2.75,2190,3267,2.0,0,0,2,8,2190,0,2004,0.0,98072,47.7751,-122.16799999999999,2190,3619,1077,0.32966023875114786,4796100,10673289,5877189
622000.0,4,1.75,3020,10714,1.0,0,0,4,8,1510,1510,1958,0.0,98006,47.56,-122.181,2230,14400,7694,0.718125816688445,9120400,114789796,105669396
306000.0,3,1.75,1980,9800,1.0,0,0,2,7,1980,0,1991,0.0,98030,47.3745,-122.22399999999999,1630,7650,7820,0.7979591836734694,3920400,96040000,92119600
617000.0,3,2.5,1880,5500,2.0,0,0,3,7,1880,0,1947,2007.0,98199,47.657,-122.39299999999999,1230,5500,3620,0.6581818181818182,3534400,30250000,26715600
438750.0,3,1.75,1610,6480,1.0,0,0,3,7,1610,0,1947,0.0,98125,47.7137,-122.307,1230,8040,4870,0.7515432098765432,2592100,41990400,39398300
1280000.0,4,3.0,3260,4500,2.0,0,0,2,9,2300,960,1930,2014.0,98109,47.6314,-122.353,2410,4995,1240,0.27555555555555555,10627600,20250000,9622400
995000.0,5,3.25,3970,8029,2.0,0,2,2,9,2970,1000,1979,0.0,98177,47.7764,-122.385,2520,8214,4059,0.5055424087682152,15760900,64464841,48703941
1580000.0,4,2.5,4570,74487,2.0,0,4,4,12,4570,0,1948,1985.0,98177,47.7282,-122.37200000000001,3810,74487,69917,0.9386470122303221,20884900,5548313169,5527428269
635000.0,5,2.75,2620,5500,1.5,0,0,2,7,1710,910,1911,0.0,98117,47.6806,-122.38799999999999,1790,5500,2880,0.5236363636363637,6864400,30250000,23385600
215000.0,3,1.0,1180,9000,1.0,0,0,3,7,1180,0,1970,0.0,98031,47.39,-122.166,1290,8316,7820,0.8688888888888889,1392400,81000000,79607600
530000.0,3,2.5,1365,1090,3.0,0,0,2,7,1315,50,2003,0.0,98115,47.6776,-122.324,1360,1124,-275,-0.25229357798165136,1863225,1188100,-675125
295000.0,2,1.0,720,4125,1.0,0,0,3,6,720,0,1943,0.0,98106,47.5245,-122.354,1000,6100,3405,0.8254545454545454,518400,17015625,16497225
245000.0,3,2.25,1350,6775,1.0,0,0,2,7,930,420,1981,0.0,98032,47.3593,-122.289,1460,7210,5425,0.8007380073800738,1822500,45900625,44078125
400000.0,6,2.5,3060,17112,1.0,0,0,3,8,1530,0,1967,0.0,98058,47.4379,-122.146,2690,16038,14052,0.8211781206171108,9363600,292820544,283456944
303000.0,3,2.75,1850,8820,2.0,0,0,3,8,1850,0,1993,0.0,98022,47.1928,-122.01,1850,8651,6970,0.7902494331065759,3422500,77792400,74369900
330000.0,3,1.75,1320,9675,1.5,0,0,3,7,1320,0,1970,0.0,98024,47.5695,-121.902,1160,9675,8355,0.8635658914728682,1742400,93605625,91863225
700000.0,3,1.75,1990,13000,2.0,0,3,2,9,1990,0,1980,0.0,98028,47.7439,-122.262,2880,11340,11010,0.8469230769230769,3960100,169000000,165039900
126000.0,1,1.0,610,4400,1.0,0,0,2,5,610,0,1922,0.0,98055,47.4865,-122.197,1090,4930,3790,0.8613636363636363,372100,19360000,18987900
850000.0,4,1.0,2500,35802,1.5,0,0,2,7,2500,0,1955,0.0,98005,47.6488,-122.15299999999999,2880,40510,33302,0.9301714987989498,6250000,1281783204,1275533204
405000.0,3,2.0,1440,7425,1.0,0,0,3,7,1440,0,1965,0.0,98034,47.7243,-122.185,1800,8344,5985,0.806060606060606,2073600,55130625,53057025
869900.0,6,4.5,2750,4400,2.0,0,0,2,8,1770,980,1987,0.0,98103,47.6883,-122.335,1860,4400,1650,0.375,7562500,19360000,11797500
485000.0,3,1.75,1790,6775,1.0,0,2,2,8,1790,0,1951,0.0,98126,47.5412,-122.37700000000001,1310,6028,4985,0.7357933579335794,3204100,45900625,42696525
400000.0,2,2.0,1050,1173,2.0,0,0,2,8,720,330,2004,0.0,98122,47.6181,-122.302,1340,1317,123,0.10485933503836317,1102500,1375929,273429
299950.0,3,2.5,1780,4650,2.0,0,0,2,7,1780,0,2011,0.0,98038,47.386,-122.04700000000001,3050,3848,2870,0.6172043010752688,3168400,21622500,18454100
585000.0,4,2.5,2200,9099,2.0,0,0,2,8,2200,0,1994,0.0,98034,47.733000000000004,-122.225,2270,8900,6899,0.7582151884822508,4840000,82791801,77951801
495000.0,4,2.0,1720,5413,2.0,0,0,2,7,1470,250,1938,1980.0,98115,47.6929,-122.321,1510,5413,3693,0.6822464437465361,2958400,29300569,26342169
2200000.0,5,4.5,5840,17168,2.0,0,0,2,12,4570,1270,2006,0.0,98029,47.5457,-121.991,4850,15017,11328,0.6598322460391426,34105600,294740224,260634624
447000.0,3,2.25,1520,14080,2.0,0,0,2,7,1520,0,1984,0.0,98074,47.6273,-122.059,1530,9758,12560,0.8920454545454546,2310400,198246400,195936000
206000.0,3,1.0,1320,9239,1.0,0,0,3,7,1320,0,1968,0.0,98092,47.312,-122.18299999999999,1320,8415,7919,0.8571273947396905,1742400,85359121,83616721
500000.0,3,1.0,1070,4600,1.0,0,0,2,7,950,120,1930,0.0,98116,47.5627,-122.383,1090,4600,3530,0.7673913043478261,1144900,21160000,20015100
302500.0,4,2.5,1990,5511,2.0,0,0,2,8,1990,0,1994,0.0,98030,47.3585,-122.191,1850,6031,3521,0.6389040101614952,3960100,30371121,26411021
1250000.0,4,4.25,4980,13000,2.0,0,3,2,9,3080,1900,1982,0.0,98052,47.6406,-122.101,2840,11308,8020,0.6169230769230769,24800400,169000000,144199600
391000.0,2,1.0,890,5423,1.0,0,0,2,6,890,0,1946,0.0,98117,47.6966,-122.368,1690,5993,4533,0.8358841969389637,792100,29408929,28616829
250000.0,3,2.0,1440,5457,2.0,0,0,2,7,1440,0,1986,0.0,98038,47.3784,-122.046,1480,6286,4017,0.7361187465640462,2073600,29778849,27705249
435000.0,4,2.5,2440,5350,2.0,0,0,2,7,2440,0,2003,0.0,98059,47.4891,-122.149,2440,5090,2910,0.5439252336448598,5953600,28622500,22668900
160000.0,4,2.25,1800,14722,1.0,0,0,2,7,1440,360,1962,0.0,98055,47.4874,-122.223,2400,10000,12922,0.8777340035321288,3240000,216737284,213497284
451000.0,5,3.0,2260,6508,1.0,0,0,2,7,1330,930,2003,0.0,98155,47.7508,-122.322,1940,9450,4248,0.6527350952673633,5107600,42354064,37246464
206000.0,2,1.0,810,7158,1.0,0,0,4,6,810,0,1944,0.0,98168,47.4882,-122.325,1090,7158,6348,0.8868398994132439,656100,51236964,50580864
590000.0,4,2.75,2240,5400,2.0,0,0,3,7,1540,700,1940,0.0,98116,47.5785,-122.402,1830,5000,3160,0.5851851851851851,5017600,29160000,24142400
695000.0,3,2.5,4560,17622,2.0,0,0,3,9,3800,0,1986,0.0,98074,47.621,-122.03,2360,15000,13062,0.7412325502213143,20793600,310534884,289741284
350000.0,3,1.5,1550,40752,1.0,0,0,4,7,1550,0,1954,0.0,98031,47.394,-122.20200000000001,1550,8000,39202,0.9619650569297212,2402500,1660725504,1658323004
1240000.0,5,3.5,3180,4628,2.0,0,0,2,10,2420,760,2001,0.0,98199,47.6423,-122.39399999999999,2060,4640,1448,0.31287813310285223,10112400,21418384,11305984
395000.0,6,2.25,2950,11200,1.0,0,0,3,7,1700,1250,1970,0.0,98072,47.7476,-122.087,1790,11200,8250,0.7366071428571429,8702500,125440000,116737500
419000.0,5,3.0,2190,9652,2.0,0,0,2,7,2190,0,1999,0.0,98178,47.5049,-122.23899999999999,1440,6710,7462,0.7731040198922503,4796100,93161104,88365004
592350.0,2,2.0,1570,4665,1.0,0,0,2,8,1570,0,2006,0.0,98053,47.708999999999996,-122.01700000000001,2165,6262,3095,0.6634512325830654,2464900,21762225,19297325
855000.0,5,3.25,3420,5669,2.0,0,0,2,9,2620,800,2003,0.0,98027,47.5366,-122.06700000000001,3310,6006,2249,0.3967189980596225,11696400,32137561,20441161
771000.0,4,2.5,2420,7200,2.0,0,0,2,9,2420,0,1991,0.0,98033,47.6893,-122.197,2650,7800,4780,0.6638888888888889,5856400,51840000,45983600
325000.0,3,2.25,1570,43350,1.0,0,3,3,7,1570,0,1967,0.0,98022,47.2377,-122.016,1570,220849,41780,0.9637831603229527,2464900,1879222500,1876757600
1850000.0,5,3.25,3680,6060,2.0,0,0,4,9,2630,1050,1925,0.0,98112,47.6341,-122.304,3050,5850,2380,0.3927392739273927,13542400,36723600,23181200
545000.0,4,1.75,1910,6731,1.0,0,0,3,7,1210,700,1953,0.0,98116,47.5693,-122.391,1780,6350,4821,0.7162383004011291,3648100,45306361,41658261
615000.0,3,1.75,1780,5175,1.0,0,0,3,7,990,790,1927,0.0,98116,47.5696,-122.38600000000001,1780,5175,3395,0.6560386473429952,3168400,26780625,23612225
625500.0,2,1.0,2160,7439,1.0,0,0,3,6,1300,860,1953,0.0,98115,47.6981,-122.286,1680,7439,5279,0.7096383922570237,4665600,55338721,50673121
232000.0,3,1.5,1460,15000,1.0,0,0,2,7,1460,0,1966,0.0,98001,47.3182,-122.271,1510,15000,13540,0.9026666666666666,2131600,225000000,222868400
168000.0,3,1.5,1370,7439,1.0,0,0,3,6,1370,0,1963,0.0,98055,47.4499,-122.189,2350,3370,6069,0.8158354617556123,1876900,55338721,53461821
238000.0,3,1.5,1370,7439,1.0,0,0,3,6,1370,0,1963,0.0,98055,47.4499,-122.189,2350,3370,6069,0.8158354617556123,1876900,55338721,53461821
260000.0,3,2.5,1500,7401,2.0,0,0,2,8,1500,0,1998,0.0,98092,47.2625,-122.221,1720,7171,5901,0.7973246858532631,2250000,54774801,52524801
460000.0,3,1.75,1210,7500,1.0,0,0,2,7,1210,0,1951,0.0,98027,47.5294,-122.03299999999999,1250,6000,6290,0.8386666666666667,1464100,56250000,54785900
900000.0,3,2.5,2850,11535,1.0,0,1,2,8,1680,1170,1952,2008.0,98155,47.74800000000001,-122.288,2670,9942,8685,0.752925877763329,8122500,133056225,124933725
289950.0,3,1.0,1090,8280,1.0,0,0,2,6,1090,0,1947,2006.0,98155,47.7562,-122.318,1060,7609,7190,0.8683574879227053,1188100,68558400,67370300
265000.0,3,1.75,1450,5858,1.0,0,0,3,7,1450,0,1991,0.0,98038,47.3482,-122.037,1520,6573,4408,0.7524752475247525,2102500,34316164,32213664
465000.0,4,2.25,1820,20349,1.0,0,0,4,8,1340,480,1977,0.0,98072,47.7415,-122.096,1270,12800,18529,0.9105607155142759,3312400,414081801,410769401
370000.0,3,1.5,1320,7201,1.0,0,0,2,7,1320,0,1971,0.0,98034,47.7126,-122.211,1380,7201,5881,0.8166921260935981,1742400,51854401,50112001
240000.0,2,1.5,1670,9880,1.0,0,0,3,7,1670,0,1941,1963.0,98146,47.4864,-122.348,1670,9807,8210,0.8309716599190283,2788900,97614400,94825500
232000.0,4,2.0,1440,5911,1.0,0,0,4,5,1440,0,1943,0.0,98056,47.5072,-122.181,1500,11089,4471,0.7563863982405684,2073600,34939921,32866321
237502.0,3,1.0,980,7560,1.0,0,0,2,7,980,0,1951,0.0,98126,47.5256,-122.375,1300,7560,6580,0.8703703703703703,960400,57153600,56193200
1280000.0,4,3.5,4340,5500,2.0,0,0,2,10,2850,1490,2008,0.0,98199,47.6427,-122.397,1290,5500,1160,0.2109090909090909,18835600,30250000,11414400
957000.0,4,2.25,2860,11545,1.0,0,0,3,8,1430,1430,1966,0.0,98005,47.588,-122.16799999999999,2190,11396,8685,0.7522737115634474,8179600,133287025,125107425
218000.0,3,1.5,1140,4875,1.0,0,0,4,6,1140,0,1970,0.0,98042,47.3684,-122.08,980,5070,3735,0.7661538461538462,1299600,23765625,22466025
205000.0,3,1.5,1120,8366,1.0,0,0,2,7,1120,0,1968,0.0,98042,47.3632,-122.11,1260,9000,7246,0.8661247908199856,1254400,69989956,68735556
350000.0,3,3.25,1460,1592,2.0,0,0,2,8,1130,330,2006,0.0,98126,47.5481,-122.374,1560,1701,132,0.0829145728643216,2131600,2534464,402864
256000.0,4,2.5,2050,5787,2.0,0,0,2,7,2050,0,2002,0.0,98198,47.3527,-122.315,2030,6615,3737,0.6457577328494902,4202500,33489369,29286869
275000.0,3,1.0,1250,7654,1.0,0,0,2,7,1000,250,1952,0.0,98125,47.7289,-122.291,1310,7350,6404,0.8366866997648289,1562500,58583716,57021216
372000.0,4,2.5,2520,9604,2.0,0,0,2,9,2520,0,1990,0.0,98031,47.3893,-122.21600000000001,2540,9793,7084,0.7376093294460642,6350400,92236816,85886416
688888.0,3,3.25,2580,9825,1.5,0,1,3,9,1760,820,1978,0.0,98027,47.5314,-122.054,2140,10270,7245,0.7374045801526717,6656400,96530625,89874225
170000.0,2,1.0,1200,24792,2.0,0,0,1,7,1200,0,1976,0.0,98053,47.6337,-121.961,2150,24792,23592,0.9515972894482091,1440000,614643264,613203264
530000.0,5,2.25,2140,7910,1.0,0,0,2,7,1070,1070,1962,0.0,98007,47.6071,-122.137,1680,8700,5770,0.729456384323641,4579600,62568100,57988500
905000.0,4,3.25,3440,7661,2.0,0,0,2,11,3440,0,2006,0.0,98029,47.5429,-121.995,3580,6478,4221,0.5509724579036679,11833600,58690921,46857321
365000.0,4,2.5,1800,5070,1.0,0,0,4,7,1080,720,1979,0.0,98118,47.5303,-122.28,1870,5365,3270,0.6449704142011834,3240000,25704900,22464900
312000.0,4,2.5,1790,10584,1.0,0,0,3,7,1290,500,1981,0.0,98031,47.4061,-122.18799999999999,1730,9120,8794,0.8308767951625095,3204100,112021056,108816956
400000.0,2,1.75,1250,7680,1.0,0,0,2,7,1250,0,1922,1968.0,98126,47.5242,-122.37100000000001,1250,7680,6430,0.8372395833333334,1562500,58982400,57419900
278750.0,2,2.0,800,5765,1.0,0,0,3,6,800,0,1936,0.0,98133,47.7024,-122.346,1160,3844,4965,0.8612315698178664,640000,33235225,32595225
510000.0,3,2.0,1410,11995,1.0,0,0,3,8,1410,0,1965,0.0,98006,47.5718,-122.12700000000001,2690,12650,10585,0.8824510212588579,1988100,143880025,141891925
527700.0,2,2.25,1330,806,3.0,0,0,2,8,1330,0,2009,0.0,98117,47.6904,-122.395,1320,1389,-524,-0.6501240694789082,1768900,649636,-1119264
740000.0,4,2.75,2890,4000,1.5,0,0,3,9,2190,700,1931,0.0,98109,47.6419,-122.351,2280,4000,1110,0.2775,8352100,16000000,7647900
512000.0,4,2.5,2550,17209,2.0,0,0,2,9,2550,0,1996,0.0,98059,47.4836,-122.13600000000001,2840,12560,14659,0.8518217211923993,6502500,296149681,289647181
362000.0,5,2.5,2880,8216,2.0,0,0,2,8,2880,0,2001,0.0,98030,47.3747,-122.185,1960,7200,5336,0.6494644595910418,8294400,67502656,59208256
225000.0,3,1.0,660,6600,1.0,0,0,3,5,660,0,1940,0.0,98168,47.4842,-122.33,1320,6600,5940,0.9,435600,43560000,43124400
491500.0,3,2.25,1470,4322,2.0,0,0,2,7,1470,0,1985,0.0,98029,47.5672,-122.01799999999999,1610,4322,2852,0.6598796853308654,2160900,18679684,16518784
429950.0,4,1.75,1700,10230,1.0,0,0,2,8,1320,380,1959,0.0,98133,47.7453,-122.351,2000,8006,8530,0.833822091886608,2890000,104652900,101762900
375000.0,3,1.0,1040,9800,1.0,0,0,3,7,1040,0,1955,0.0,98006,47.5765,-122.155,1280,8880,8760,0.8938775510204081,1081600,96040000,94958400
199400.0,2,1.0,880,4000,1.0,0,0,3,6,880,0,1916,0.0,98106,47.5331,-122.352,1430,4000,3120,0.78,774400,16000000,15225600
364900.0,4,2.5,2490,9346,2.0,0,2,2,9,2490,0,1996,0.0,98042,47.3831,-122.147,2650,9454,6856,0.7335758613310507,6200100,87347716,81147616
324950.0,3,1.5,1210,7560,1.0,0,0,2,7,1210,0,1941,0.0,98126,47.5255,-122.374,980,7560,6350,0.83994708994709,1464100,57153600,55689500
467000.0,5,2.0,2080,4000,1.0,0,0,3,6,1040,1040,1909,0.0,98144,47.5858,-122.30799999999999,1940,6000,1920,0.48,4326400,16000000,11673600
380000.0,3,1.0,1380,5400,1.0,0,0,3,7,1380,0,1954,0.0,98125,47.7134,-122.288,1190,6075,4020,0.7444444444444445,1904400,29160000,27255600
250000.0,3,2.25,1620,10850,1.0,0,0,2,7,1620,0,1966,0.0,98055,47.4437,-122.194,1910,10568,9230,0.8506912442396314,2624400,117722500,115098100
700000.0,4,1.0,1680,4021,1.5,0,0,2,7,1680,0,1921,0.0,98103,47.6663,-122.33200000000001,1710,4021,2341,0.5821934842079085,2822400,16168441,13346041
206990.0,3,1.0,1330,9620,1.0,0,0,4,6,1330,0,1976,0.0,98092,47.3174,-122.12700000000001,1300,10360,8290,0.8617463617463618,1768900,92544400,90775500
670000.0,3,1.75,1730,3400,1.0,0,0,4,7,970,760,1928,0.0,98107,47.6662,-122.36399999999999,1640,5000,1670,0.49117647058823527,2992900,11560000,8567100
315000.0,2,1.0,790,6969,1.0,0,0,2,6,790,0,1955,1984.0,98052,47.6978,-122.164,1380,12196,6179,0.8866408379968431,624100,48566961,47942861
319950.0,3,2.5,2240,7500,2.0,0,0,2,8,2240,0,1985,0.0,98092,47.265,-122.22,2190,7506,5260,0.7013333333333334,5017600,56250000,51232400
419000.0,3,1.5,1500,8272,1.0,0,0,3,7,1500,0,1958,0.0,98177,47.7741,-122.38,1630,8270,6772,0.8186653771760155,2250000,68425984,66175984
205000.0,3,2.0,1800,11419,1.0,0,0,2,8,1800,0,1989,0.0,98092,47.2623,-122.21700000000001,2220,11406,9619,0.8423679831859182,3240000,130393561,127153561
335000.0,4,2.5,1980,4745,2.0,0,0,2,7,1980,0,2004,0.0,98038,47.3495,-122.04,1980,4878,2765,0.5827186512118019,3920400,22515025,18594625
397000.0,3,1.75,1340,5100,1.0,0,0,2,7,1340,0,1953,0.0,98103,47.693999999999996,-122.348,1550,5100,3760,0.7372549019607844,1795600,26010000,24214400
370000.0,2,1.0,750,2020,1.0,0,0,2,7,750,0,1908,0.0,98122,47.6175,-122.301,1630,2383,1270,0.6287128712871287,562500,4080400,3517900
330000.0,4,2.25,1790,9920,1.0,0,0,3,7,1170,620,1969,0.0,98059,47.5126,-122.149,1990,9648,8130,0.8195564516129032,3204100,98406400,95202300
1790000.0,4,3.5,5490,14300,1.0,0,4,2,12,2910,2580,1996,0.0,98006,47.5511,-122.11399999999999,4290,13822,8810,0.6160839160839161,30140100,204490000,174349900
399000.0,3,2.0,1940,16300,1.0,0,0,2,7,1140,800,1978,0.0,98155,47.773999999999994,-122.28299999999999,1940,11250,14360,0.8809815950920246,3763600,265690000,261926400
400000.0,4,1.75,2670,189486,2.0,0,4,2,8,2670,0,1972,0.0,98092,47.2585,-122.061,2190,218610,186816,0.9859092492321333,7128900,35904944196,35897815296
249900.0,3,2.0,1220,6404,1.0,0,0,2,7,1220,0,1994,0.0,98038,47.3523,-122.059,1570,7000,5184,0.8094940662086196,1488400,41011216,39522816
717000.0,3,1.5,1310,3880,1.0,0,0,2,7,1090,220,1956,0.0,98117,47.6821,-122.39200000000001,1570,3880,2570,0.6623711340206185,1716100,15054400,13338300
319000.0,4,2.5,1930,8336,2.0,0,0,2,8,1930,0,1995,0.0,98031,47.4016,-122.166,2280,7959,6406,0.7684740882917467,3724900,69488896,65763996
635000.0,4,3.0,2100,3800,2.0,0,0,2,8,2100,0,1972,0.0,98115,47.6807,-122.291,1320,3800,1700,0.4473684210526316,4410000,14440000,10030000
355000.0,3,1.0,1180,7573,1.0,0,0,3,7,1180,0,1977,0.0,98155,47.7372,-122.294,1320,7573,6393,0.8441832827149083,1392400,57350329,55957929
1600000.0,5,3.25,4320,32840,2.0,0,0,2,12,4320,0,1990,0.0,98006,47.5461,-122.12200000000001,4410,33210,28520,0.8684531059683313,18662400,1078465600,1059803200
585000.0,4,1.75,3140,12519,1.0,0,0,2,7,2320,820,1951,0.0,98033,47.6941,-122.17299999999999,2240,7308,9379,0.7491812445083473,9859600,156725361,146865761
320000.0,3,2.0,2320,7800,1.0,0,0,3,7,1160,1160,1960,0.0,98168,47.5141,-122.316,1380,7800,5480,0.7025641025641025,5382400,60840000,55457600
305495.0,3,1.75,2110,10200,2.0,0,0,3,7,2110,0,1966,0.0,98059,47.4744,-122.154,1800,10200,8090,0.7931372549019607,4452100,104040000,99587900
240000.0,4,2.0,1790,14690,1.0,0,1,3,7,1670,120,1960,0.0,98198,47.3965,-122.321,2440,10664,12900,0.8781484002722941,3204100,215796100,212592000
199950.0,5,2.5,1740,8750,1.0,0,0,3,7,1740,0,1959,0.0,98198,47.3904,-122.29899999999999,1740,8750,7010,0.8011428571428572,3027600,76562500,73534900
1620000.0,4,3.25,3820,8114,2.0,0,0,2,10,3820,0,2005,0.0,98004,47.5837,-122.194,2440,9195,4294,0.5292087749568647,14592400,65836996,51244596
770000.0,3,3.5,2050,21744,2.0,1,4,3,9,1750,300,1930,0.0,98166,47.4536,-122.376,2300,12200,19694,0.9057211184694628,4202500,472801536,468599036
255000.0,4,2.25,1680,3179,2.0,0,0,2,8,1680,0,2002,0.0,98092,47.3258,-122.186,1678,3590,1499,0.4715319282793331,2822400,10106041,7283641
289000.0,4,2.25,1930,8925,1.0,0,0,3,8,1930,0,1974,0.0,98058,47.4501,-122.12799999999999,1930,8400,6995,0.7837535014005602,3724900,79655625,75930725
494500.0,4,3.0,3760,8804,2.0,0,0,2,8,2470,1290,2002,0.0,98056,47.5161,-122.191,1960,7225,5044,0.5729213993639255,14137600,77510416,63372816
746000.0,3,2.25,2370,9619,1.0,0,0,3,8,1650,720,1973,0.0,98052,47.6366,-122.09899999999999,1960,9712,7249,0.7536126416467408,5616900,92525161,86908261
385000.0,4,3.0,2120,13000,2.0,0,0,3,8,2120,0,1978,0.0,98059,47.4745,-122.141,2180,11440,10880,0.8369230769230769,4494400,169000000,164505600
688100.0,4,2.5,2370,10513,2.0,0,0,3,8,2370,0,1987,0.0,98052,47.6915,-122.09899999999999,2110,9540,8143,0.7745648245029962,5616900,110523169,104906269
870300.0,4,2.5,2350,3150,1.5,0,0,3,8,1690,660,1910,0.0,98103,47.6605,-122.335,1750,3150,800,0.25396825396825395,5522500,9922500,4400000
310000.0,3,1.0,1180,8474,1.5,0,0,2,7,1180,0,1956,0.0,98155,47.7416,-122.32700000000001,1180,7200,7294,0.8607505310361104,1392400,71808676,70416276
500000.0,3,2.5,2270,5654,2.0,0,0,2,8,2270,0,1999,0.0,98133,47.7733,-122.351,1770,7840,3384,0.5985143261407853,5152900,31967716,26814816
255000.0,3,2.25,1830,7770,1.0,0,0,3,7,1400,430,1977,0.0,98042,47.3925,-122.161,1960,7272,5940,0.7644787644787645,3348900,60372900,57024000
1480000.0,3,2.75,3910,7080,1.0,0,0,4,9,1970,1940,1949,0.0,98112,47.6324,-122.289,3480,7370,3170,0.4477401129943503,15288100,50126400,34838300
154500.0,3,1.0,890,9465,1.0,0,0,2,6,890,0,1957,0.0,98148,47.4388,-122.32799999999999,1590,9147,8575,0.9059693608029583,792100,89586225,88794125
425000.0,3,2.25,1820,8058,1.0,0,0,2,7,1260,560,1974,0.0,98034,47.7241,-122.16799999999999,1850,7384,6238,0.7741375031025068,3312400,64931364,61618964
700000.0,4,2.5,2440,7491,2.0,0,0,3,10,2440,0,1988,0.0,98029,47.56100000000001,-122.01899999999999,2490,8580,5051,0.6742757976238153,5953600,56115081,50161481
410500.0,2,1.0,1110,3943,1.0,0,0,4,6,740,370,1916,0.0,98109,47.6436,-122.352,1590,4311,2833,0.7184884605630231,1232100,15547249,14315149
432000.0,3,2.0,1870,7080,1.0,0,0,3,7,1210,660,1969,0.0,98034,47.7244,-122.179,1620,8000,5210,0.7358757062146892,3496900,50126400,46629500
530000.0,3,1.5,1240,4080,1.5,0,0,2,8,1240,0,1914,0.0,98144,47.5745,-122.291,1420,4080,2840,0.696078431372549,1537600,16646400,15108800
465000.0,3,2.0,1560,8640,1.0,0,0,4,7,1560,0,1967,0.0,98034,47.7294,-122.186,1970,8625,7080,0.8194444444444444,2433600,74649600,72216000
498688.0,3,2.5,1910,5600,2.0,0,0,2,8,1910,0,1989,0.0,98029,47.5752,-122.009,1800,4928,3690,0.6589285714285714,3648100,31360000,27711900
573500.0,3,1.0,2200,21450,1.0,0,0,3,9,1600,600,1952,0.0,98166,47.4527,-122.37200000000001,1880,11250,19250,0.8974358974358975,4840000,460102500,455262500
349900.0,4,2.75,2530,13474,2.0,0,0,3,8,2530,0,1994,0.0,98023,47.288999999999994,-122.344,2490,13140,10944,0.8122309633367968,6400900,181548676,175147776
220000.0,3,1.0,1130,12519,1.0,0,0,2,7,1130,0,1958,0.0,98056,47.4965,-122.176,1460,12507,11389,0.9097371994568256,1276900,156725361,155448461
260000.0,2,1.0,820,6771,1.0,0,0,3,6,820,0,1918,0.0,98106,47.52,-122.354,1000,4440,5951,0.8788952887313543,672400,45846441,45174041
290000.0,2,1.0,960,4000,1.0,0,0,2,6,960,0,1918,0.0,98118,47.5554,-122.26700000000001,1210,4000,3040,0.76,921600,16000000,15078400
615000.0,4,1.5,1980,3240,1.5,0,0,3,8,1780,200,1930,0.0,98144,47.583999999999996,-122.294,2250,4000,1260,0.3888888888888889,3920400,10497600,6577200
730000.0,4,3.5,3370,5638,2.0,0,0,2,10,2250,1120,2001,0.0,98034,47.7196,-122.223,3080,7200,2268,0.40227030862007807,11356900,31787044,20430144
1950000.0,4,3.25,7420,167869,2.0,0,3,2,12,7420,0,2002,0.0,98045,47.4548,-121.764,5610,169549,160449,0.9557988669736521,55056400,28180001161,28124944761
332500.0,3,2.25,1800,10500,2.0,0,0,2,7,1800,0,1995,0.0,98038,47.3879,-122.03200000000001,1870,8555,8700,0.8285714285714286,3240000,110250000,107010000
650000.0,5,3.5,3990,10120,2.0,0,0,2,9,2820,1170,1990,0.0,98011,47.74100000000001,-122.208,2750,9622,6130,0.6057312252964426,15920100,102414400,86494300
1400000.0,4,2.5,4070,7800,3.0,0,0,3,8,3390,680,2002,0.0,98115,47.6838,-122.32700000000001,2020,6760,3730,0.4782051282051282,16564900,60840000,44275100
465000.0,4,1.75,1640,7194,1.5,0,0,3,7,1480,160,1915,0.0,98011,47.7649,-122.205,1440,9405,5554,0.7720322490964693,2689600,51753636,49064036
690000.0,4,3.25,3730,11820,2.0,0,0,2,10,2460,1270,1990,0.0,98029,47.5775,-122.01899999999999,3680,10667,8090,0.6844331641285956,13912900,139712400,125799500
289900.0,3,1.75,1220,7004,1.0,0,0,4,7,1220,0,1966,0.0,98058,47.4492,-122.15700000000001,1640,7210,5784,0.8258138206739006,1488400,49056016,47567616
1620000.0,3,3.5,3490,4000,2.0,0,0,2,9,2570,920,2009,0.0,98112,47.6385,-122.281,1880,4000,510,0.1275,12180100,16000000,3819900
339950.0,3,2.5,1730,4286,2.0,0,0,2,7,1730,0,1999,0.0,98148,47.431999999999995,-122.329,1780,4343,2556,0.5963602426504899,2992900,18369796,15376896
367999.0,4,2.75,3430,8000,1.5,0,0,3,8,3430,0,1972,0.0,98023,47.3183,-122.382,2090,8000,4570,0.57125,11764900,64000000,52235100
380000.0,4,2.5,2320,10079,2.0,0,0,2,7,2320,0,1994,0.0,98038,47.3828,-122.02600000000001,2010,7438,7759,0.769818434368489,5382400,101586241,96203841
440000.0,3,1.75,2030,17100,1.0,0,0,3,7,2030,0,1953,0.0,98166,47.451,-122.365,1950,14400,15070,0.8812865497076023,4120900,292410000,288289100
975000.0,5,4.0,4850,36450,2.0,0,0,2,10,4850,0,1977,0.0,98005,47.6426,-122.15799999999999,3850,35325,31600,0.8669410150891632,23522500,1328602500,1305080000
309500.0,3,1.5,1340,13560,1.0,0,0,2,7,1340,0,1968,0.0,98028,47.74100000000001,-122.234,1540,15000,12220,0.9011799410029498,1795600,183873600,182078000
350000.0,3,1.0,1130,8201,1.0,0,0,4,6,1130,0,1948,0.0,98155,47.7359,-122.306,1180,8203,7071,0.8622119253749543,1276900,67256401,65979501
215000.0,2,2.0,1180,2521,2.0,0,0,2,6,1180,0,2005,0.0,98038,47.3487,-122.021,1310,3003,1341,0.5319317731059103,1392400,6355441,4963041
254000.0,2,1.0,910,6000,1.0,0,0,2,6,910,0,1943,0.0,98118,47.5253,-122.266,1460,5800,5090,0.8483333333333334,828100,36000000,35171900
567000.0,3,1.75,1630,4275,1.5,0,3,2,7,1630,0,1908,0.0,98115,47.6851,-122.322,1800,4275,2645,0.6187134502923977,2656900,18275625,15618725
402000.0,2,1.0,710,1173,2.0,0,0,3,7,710,0,1943,0.0,98102,47.6412,-122.329,1370,1173,463,0.39471440750213127,504100,1375929,871829
365000.0,4,1.0,1520,80150,1.0,0,0,1,5,1520,0,1948,0.0,98045,47.4742,-121.76899999999999,1740,84506,78630,0.9810355583281347,2310400,6424022500,6421712100
625000.0,4,2.5,2820,8408,2.0,0,0,2,9,2820,0,2014,0.0,98155,47.7538,-122.325,1300,8408,5588,0.6646051379638439,7952400,70694464,62742064
432000.0,4,1.75,1970,5160,1.5,0,0,2,7,1970,0,1942,0.0,98126,47.534,-122.37299999999999,1230,4920,3190,0.6182170542635659,3880900,26625600,22744700
335500.0,5,3.0,2240,19090,1.0,0,0,3,8,1700,540,1968,0.0,98058,47.4416,-122.149,2280,20000,16850,0.8826610790990047,5017600,364428100,359410500
672500.0,2,1.75,1860,5940,1.0,0,2,4,8,1020,840,1956,0.0,98116,47.5751,-122.40700000000001,2130,5940,4080,0.6868686868686869,3459600,35283600,31824000
336000.0,4,1.0,1780,4310,1.5,0,0,4,6,1780,0,1919,0.0,98118,47.5486,-122.27799999999999,1460,4310,2530,0.5870069605568445,3168400,18576100,15407700
294400.0,4,2.5,1788,10183,2.0,0,0,3,7,1788,0,1990,0.0,98002,47.2883,-122.21799999999999,1700,6600,8395,0.8244132377491898,3196944,103693489,100496545
541900.0,3,2.5,1880,3054,2.0,0,0,2,8,1880,0,1988,0.0,98007,47.6091,-122.147,1840,3815,1174,0.3844138834315652,3534400,9326916,5792516
505000.0,3,1.75,2300,11400,1.0,0,0,3,8,1520,780,1977,0.0,98052,47.6884,-122.12799999999999,2300,10140,9100,0.7982456140350878,5290000,129960000,124670000
255000.0,3,2.5,1610,6176,2.0,0,0,2,7,1610,0,1994,0.0,98030,47.3657,-122.17299999999999,1680,7414,4566,0.7393134715025906,2592100,38142976,35550876
435000.0,6,2.5,2270,11970,1.0,0,0,2,7,1470,800,1964,0.0,98011,47.7722,-122.204,2270,10640,9700,0.810359231411863,5152900,143280900,138128000
636000.0,2,1.75,1230,3600,1.5,0,0,4,7,1230,0,1925,0.0,98119,47.6423,-122.361,1210,4500,2370,0.6583333333333333,1512900,12960000,11447100
655000.0,4,3.5,3420,33106,2.0,0,0,2,9,3420,0,2004,0.0,98010,47.3554,-121.986,3420,36590,29686,0.8966954630580559,11696400,1096007236,1084310836
280500.0,3,1.5,1670,6988,1.0,0,0,2,7,1370,300,1953,0.0,98148,47.4283,-122.323,1090,7753,5318,0.7610188895248998,2788900,48832144,46043244
520000.0,2,1.0,1120,6141,1.0,0,0,2,7,900,220,1946,0.0,98117,47.6924,-122.37200000000001,1500,7529,5021,0.8176192802475167,1254400,37711881,36457481
354000.0,4,2.5,2580,5476,2.0,0,0,2,8,2580,0,2005,0.0,98031,47.4042,-122.205,2900,5476,2896,0.5288531775018261,6656400,29986576,23330176
810000.0,5,2.75,3847,17654,1.0,0,2,4,9,2299,1548,1975,0.0,98003,47.3379,-122.322,2690,15344,13807,0.7820890449756429,14799409,311663716,296864307
400000.0,4,2.5,3630,42884,1.5,0,0,2,9,2300,1330,1979,0.0,98092,47.2617,-122.19,2830,80148,39254,0.9153530454248671,13176900,1839037456,1825860556
879900.0,4,2.75,3580,12000,1.0,0,0,2,10,1840,1740,1979,0.0,98074,47.6319,-122.05,2910,12428,8420,0.7016666666666667,12816400,144000000,131183600
1290000.0,5,4.0,4050,11358,2.0,0,0,3,10,2780,1270,1980,0.0,98040,47.56,-122.225,3120,13555,7308,0.6434231378763867,16402500,129004164,112601664
902500.0,3,3.5,3240,23522,2.0,0,0,2,10,2130,1110,1992,0.0,98010,47.3388,-122.03299999999999,3180,23273,20282,0.8622566108324122,10497600,553284484,542786884
900000.0,3,1.75,1540,8400,1.5,0,0,2,7,1540,0,1902,0.0,98122,47.6187,-122.295,1330,4800,6860,0.8166666666666667,2371600,70560000,68188400
419500.0,4,2.5,2550,7200,2.0,0,2,2,7,2550,0,2003,0.0,98056,47.4793,-122.18,2560,5715,4650,0.6458333333333334,6502500,51840000,45337500
685000.0,4,2.0,2340,6000,1.0,0,0,4,8,1270,1070,1953,0.0,98199,47.6495,-122.40100000000001,1600,6000,3660,0.61,5475600,36000000,30524400
429950.0,4,2.5,2320,4524,2.0,0,0,2,8,2320,0,2004,0.0,98059,47.4798,-122.13600000000001,2330,4524,2204,0.48717948717948717,5382400,20466576,15084176
464950.0,4,2.5,1640,6000,2.0,0,0,2,7,1640,0,2011,0.0,98106,47.559,-122.365,1640,4800,4360,0.7266666666666667,2689600,36000000,33310400
239900.0,2,1.0,910,9000,1.0,0,0,3,6,910,0,1983,0.0,98045,47.4463,-121.771,1410,9440,8090,0.8988888888888888,828100,81000000,80171900
406250.0,4,3.25,2550,11524,2.0,0,0,2,8,2550,0,1990,0.0,98019,47.7324,-121.963,2370,14001,8974,0.7787226657410621,6502500,132802576,126300076
447000.0,4,2.5,2660,8027,2.0,0,0,2,8,2660,0,1997,0.0,98045,47.4831,-121.781,2480,8095,5367,0.668618412856609,7075600,64432729,57357129
466800.0,3,2.5,1480,14250,2.0,0,0,2,7,1480,0,1996,0.0,98033,47.6595,-122.186,1660,14250,12770,0.896140350877193,2190400,203062500,200872100
674000.0,4,2.5,2810,11560,1.0,0,0,4,7,1740,1070,1962,0.0,98008,47.5846,-122.12,1970,11560,8750,0.7569204152249135,7896100,133633600,125737500
525000.0,1,1.0,830,3200,1.0,0,0,2,7,830,0,1924,0.0,98103,47.6557,-122.348,1350,2512,2370,0.740625,688900,10240000,9551100
674950.0,3,2.75,3510,92347,2.0,0,0,2,10,3510,0,1990,0.0,98038,47.3735,-122.01799999999999,2970,37070,88837,0.9619911854202086,12320100,8527968409,8515648309
374900.0,3,2.5,2480,4950,2.0,0,0,2,7,2480,0,2004,0.0,98058,47.4389,-122.116,2230,5298,2470,0.498989898989899,6150400,24502500,18352100
1440000.0,4,3.0,3720,5000,2.5,0,0,4,9,2720,1000,1905,0.0,98102,47.6282,-122.322,2610,5000,1280,0.256,13838400,25000000,11161600
559500.0,3,2.25,2150,9250,2.0,0,0,2,8,2150,0,1984,0.0,98052,47.7179,-122.113,2240,9266,7100,0.7675675675675676,4622500,85562500,80940000
522500.0,3,2.5,2370,7875,2.0,0,0,2,9,2370,0,2003,0.0,98065,47.5427,-121.863,2660,7752,5505,0.699047619047619,5616900,62015625,56398725
1130000.0,5,2.5,4310,28008,2.0,0,0,2,10,4310,0,1988,0.0,98053,47.6662,-122.056,3170,28559,23698,0.8461153956012568,18576100,784448064,765871964
498500.0,5,2.75,2990,7420,2.0,0,0,2,8,2990,0,1996,0.0,98059,47.4944,-122.162,2290,7678,4430,0.5970350404312669,8940100,55056400,46116300
571000.0,4,1.0,1350,4000,1.5,0,0,2,8,1350,0,1930,0.0,98117,47.6885,-122.38600000000001,1520,4000,2650,0.6625,1822500,16000000,14177500
543000.0,2,2.0,2370,217800,1.5,0,0,2,7,1600,770,1992,0.0,98027,47.5007,-122.088,2370,157687,215430,0.9891184573002755,5616900,47436840000,47431223100
271920.0,3,2.0,1410,10248,1.0,0,0,2,7,1410,0,1985,0.0,98001,47.3315,-122.265,2090,9414,8838,0.8624121779859485,1988100,105021504,103033404
104950.0,2,1.0,1170,8254,1.0,0,0,1,6,1170,0,1949,0.0,98146,47.497,-122.346,1820,8922,7084,0.8582505451902108,1368900,68128516,66759616
485500.0,4,2.5,1800,4500,2.0,0,0,2,8,1800,0,1999,0.0,98075,47.5998,-122.014,1800,4500,2700,0.6,3240000,20250000,17010000
1210000.0,4,2.75,3650,6982,2.0,0,2,3,9,2530,1120,1951,2003.0,98115,47.6756,-122.275,3140,7894,3332,0.4772271555428244,13322500,48748324,35425824
260250.0,3,1.75,1490,8357,1.0,0,0,3,7,1490,0,1993,0.0,98038,47.3473,-122.037,1490,7376,6867,0.8217063539547684,2220100,69839449,67619349
875909.0,4,2.5,3610,13292,2.0,0,0,2,10,3610,0,1996,0.0,98075,47.5868,-121.97399999999999,3000,10776,9682,0.7284080650015047,13032100,176677264,163645164
455000.0,4,1.75,2050,94525,1.0,0,0,3,7,1250,800,1959,0.0,98058,47.4492,-122.084,2270,47480,92475,0.9783126157101296,4202500,8934975625,8930773125
309000.0,3,1.0,1092,7500,1.5,0,0,2,6,1092,0,1918,0.0,98106,47.5321,-122.354,930,4000,6408,0.8544,1192464,56250000,55057536
229000.0,4,2.25,2010,7688,1.0,0,0,2,8,1170,840,1979,0.0,98023,47.3086,-122.396,1990,7688,5678,0.7385535900104059,4040100,59105344,55065244
250000.0,3,2.0,1680,7900,2.0,0,0,3,7,1680,0,1953,0.0,98003,47.3255,-122.305,1250,15600,6220,0.7873417721518987,2822400,62410000,59587600
600000.0,4,2.0,2510,38141,1.0,0,0,2,9,2510,0,1960,0.0,98034,47.7219,-122.258,3180,11760,35631,0.9341915523976823,6300100,1454735881,1448435781
535000.0,4,2.5,2280,65836,2.0,0,0,2,8,2280,0,2004,0.0,98077,47.7237,-122.07600000000001,2300,97574,63556,0.9653684914028798,5198400,4334378896,4329180496
571000.0,3,2.5,2510,5186,2.0,0,0,2,7,2510,0,2001,0.0,98053,47.6895,-122.041,2530,5186,2676,0.5160046278441959,6300100,26894596,20594496
1030000.0,5,2.75,3190,16920,1.0,0,3,2,9,1690,1500,1976,0.0,98006,47.5641,-122.16,3100,13100,13730,0.8114657210401891,10176100,286286400,276110300
600000.0,4,3.25,4690,14930,2.0,0,2,2,10,3680,1010,1995,0.0,98155,47.7718,-122.28299999999999,2910,13320,10240,0.6858673811118553,21996100,222904900,200908800
469500.0,3,2.25,1850,12000,1.0,0,0,3,7,1300,550,1977,0.0,98072,47.7408,-122.101,1580,12616,10150,0.8458333333333333,3422500,144000000,140577500
1150000.0,4,3.0,4160,13170,2.0,0,0,2,11,3040,1120,2001,0.0,98059,47.5182,-122.149,3780,13148,9010,0.6841305998481397,17305600,173448900,156143300
785000.0,4,1.5,2220,4000,1.5,0,0,2,8,1970,250,1925,0.0,98105,47.6564,-122.325,1984,4000,1780,0.445,4928400,16000000,11071600
872750.0,3,2.5,2870,13695,2.0,0,0,2,10,2870,0,1991,0.0,98052,47.6944,-122.102,2840,8472,10825,0.7904344651332603,8236900,187553025,179316125
900000.0,4,2.75,3950,10214,1.0,0,3,2,10,2050,1900,1955,0.0,98117,47.6969,-122.384,3130,8608,6264,0.613275895829254,15602500,104325796,88723296
350000.0,2,1.75,1740,6620,1.5,0,0,2,8,1740,0,2002,0.0,98065,47.526,-121.82799999999999,1560,5400,4880,0.7371601208459214,3027600,43824400,40796800
2580000.0,5,3.0,4780,20440,1.0,0,0,3,10,3660,1120,1975,0.0,98039,47.6242,-122.23899999999999,4660,20440,15660,0.7661448140900196,22848400,417793600,394945200
940000.0,4,2.5,3160,39960,1.0,0,0,2,10,3160,0,1980,0.0,98005,47.6418,-122.15700000000001,3900,36444,36800,0.9209209209209209,9985600,1596801600,1586816000
185000.0,5,1.75,1990,27810,1.0,0,0,2,7,1990,0,1955,0.0,98023,47.3325,-122.35,2240,20000,25820,0.928443006112909,3960100,773396100,769436000
850000.0,4,3.5,3920,37122,2.0,0,0,2,10,3920,0,1996,0.0,98053,47.6316,-121.988,2550,32647,33202,0.8944022412585528,15366400,1378042884,1362676484
201000.0,3,1.0,960,15273,1.0,0,0,3,7,960,0,1963,0.0,98022,47.238,-122.039,1930,51400,14313,0.9371439795717934,921600,233264529,232342929
499000.0,2,1.5,1540,6549,2.0,0,0,2,7,1540,0,1980,0.0,98133,47.7189,-122.353,1470,6552,5009,0.76484959535807,2371600,42889401,40517801
315000.0,4,2.5,1970,5190,2.0,0,0,2,7,1970,0,2002,0.0,98059,47.515,-122.164,1840,5564,3220,0.6204238921001927,3880900,26936100,23055200
509950.0,3,2.5,1880,4668,2.0,0,0,2,8,1880,0,1993,0.0,98029,47.5666,-121.999,2060,4668,2788,0.5972579263067695,3534400,21790224,18255824
286300.0,3,2.75,2000,6405,1.0,0,0,2,8,1260,740,1964,0.0,98178,47.5066,-122.259,2130,6510,4405,0.687743950039032,4000000,41024025,37024025
590000.0,3,2.5,1990,8325,2.0,0,0,3,8,1310,680,1997,0.0,98034,47.705,-122.20100000000001,2450,10606,6335,0.760960960960961,3960100,69305625,65345525
325000.0,4,1.0,1400,9384,1.5,0,0,3,6,1400,0,1948,0.0,98106,47.5166,-122.361,1600,8432,7984,0.8508098891730606,1960000,88059456,86099456
625000.0,4,2.5,3190,27806,2.0,0,0,2,9,3190,0,1997,0.0,98010,47.3425,-122.03,2810,28619,24616,0.8852765590160397,10176100,773173636,762997536
378000.0,3,1.5,1000,6914,1.0,0,0,2,7,1000,0,1947,0.0,98125,47.7144,-122.319,1000,6947,5914,0.8553659242117443,1000000,47803396,46803396
239950.0,3,1.75,1670,6900,1.0,0,0,2,7,1170,500,1978,0.0,98023,47.2975,-122.38,1740,7000,5230,0.7579710144927536,2788900,47610000,44821100
550000.0,4,2.0,2100,4500,1.0,0,0,4,7,1060,1040,1924,0.0,98105,47.6699,-122.31700000000001,1920,3900,2400,0.5333333333333333,4410000,20250000,15840000
325000.0,2,1.0,1010,6180,1.0,0,0,2,6,1010,0,1903,0.0,98118,47.5532,-122.28,1560,6180,5170,0.8365695792880259,1020100,38192400,37172300
831000.0,4,2.5,2030,3905,1.5,0,0,3,7,1630,400,1926,0.0,98103,47.6547,-122.34,2000,3905,1875,0.4801536491677337,4120900,15249025,11128125
249000.0,3,1.0,1090,10296,1.0,0,0,3,6,1090,0,1950,0.0,98028,47.7743,-122.26,1910,10296,9206,0.8941336441336442,1188100,106007616,104819516
484000.0,4,1.75,2440,16730,1.0,0,0,2,7,1390,1050,1976,0.0,98072,47.7406,-122.11,1390,11600,14290,0.85415421398685,5953600,279892900,273939300
395000.0,4,3.0,2500,6278,2.0,0,0,2,9,2500,0,2002,0.0,98092,47.3325,-122.16799999999999,2700,7200,3778,0.601784007645747,6250000,39413284,33163284
839900.0,4,2.5,3420,7462,2.0,0,0,2,9,3420,0,2002,0.0,98074,47.6388,-122.064,3080,8031,4042,0.5416778343607612,11696400,55681444,43985044
760000.0,4,2.5,2850,11000,2.0,0,0,2,8,2850,0,1998,0.0,98052,47.6759,-122.161,1720,11000,8150,0.740909090909091,8122500,121000000,112877500
750000.0,4,1.5,2030,3300,1.5,0,0,3,8,1530,500,1927,0.0,98116,47.5855,-122.383,2610,5400,1270,0.38484848484848483,4120900,10890000,6769100
3000000.0,5,3.75,4590,11265,2.0,0,0,3,11,3450,1140,1927,0.0,98112,47.6389,-122.288,3870,8996,6675,0.59254327563249,21068100,126900225,105832125
440000.0,3,2.5,2230,5800,2.0,0,0,2,7,2230,0,2004,0.0,98065,47.5308,-121.84700000000001,2230,6088,3570,0.6155172413793103,4972900,33640000,28667100
501000.0,2,1.75,1810,7523,1.0,0,0,2,8,1170,640,1962,0.0,98027,47.5695,-122.087,2090,7523,5713,0.7594044928884753,3276100,56595529,53319429
739000.0,6,4.5,4000,7500,2.0,0,0,2,7,4000,0,1978,0.0,98122,47.6146,-122.306,1380,6298,3500,0.4666666666666667,16000000,56250000,40250000
685650.0,3,1.75,1490,16200,1.0,0,0,4,8,1490,0,1958,0.0,98005,47.5919,-122.175,2070,16200,14710,0.9080246913580247,2220100,262440000,260219900
1010000.0,4,4.5,4225,284011,2.0,0,0,3,11,4225,0,1985,0.0,98074,47.6118,-122.024,2870,14576,279786,0.9851238156268596,17850625,80662248121,80644397496
980000.0,4,1.75,2120,4000,1.5,0,0,3,8,1920,200,1929,0.0,98105,47.6601,-122.275,2300,4000,1880,0.47,4494400,16000000,11505600
275000.0,3,1.5,1030,7184,1.0,0,0,3,7,1030,0,1968,0.0,98056,47.5069,-122.189,1330,7262,6154,0.8566258351893096,1060900,51609856,50548956
319950.0,4,1.75,2310,8045,1.0,0,0,3,7,1650,660,1976,0.0,98058,47.4569,-122.165,1790,8086,5735,0.7128651336233686,5336100,64722025,59385925
448500.0,3,2.25,1830,7943,2.0,0,0,2,8,1830,0,1985,0.0,98028,47.7466,-122.249,2100,8070,6113,0.7696084602794914,3348900,63091249,59742349
437000.0,5,2.0,2120,137565,1.5,0,0,2,7,2120,0,1913,0.0,98070,47.4558,-122.507,2120,157123,135445,0.9845891033329699,4494400,18924129225,18919634825
330000.0,4,1.5,2500,9448,1.0,0,0,3,7,1250,1250,1966,0.0,98106,47.5212,-122.339,1640,9490,6948,0.7353937341236241,6250000,89264704,83014704
365000.0,3,2.5,2470,7700,2.0,0,0,3,8,2470,0,1990,0.0,98031,47.4096,-122.17,2400,7700,5230,0.6792207792207792,6100900,59290000,53189100
329000.0,2,1.0,940,7700,1.0,0,0,3,6,940,0,1916,0.0,98133,47.7067,-122.354,1290,7375,6760,0.8779220779220779,883600,59290000,58406400
681500.0,5,2.75,3260,11700,1.0,0,0,2,8,1630,1630,1964,0.0,98008,47.6169,-122.104,2860,11700,8440,0.7213675213675214,10627600,136890000,126262400
566000.0,3,2.25,1660,10140,1.0,0,0,3,8,1370,290,1980,0.0,98052,47.6889,-122.12799999999999,2100,10125,8480,0.8362919132149902,2755600,102819600,100064000
897500.0,4,3.0,4370,217882,2.0,0,0,2,10,4370,0,1984,0.0,98053,47.6573,-122.03399999999999,2430,35096,213512,0.979943272046337,19096900,47472565924,47453469024
738000.0,3,2.5,2620,9112,2.0,0,0,2,9,2620,0,1995,0.0,98052,47.6972,-122.116,2620,9067,6492,0.7124670763827919,6864400,83028544,76164144
185000.0,3,1.75,1500,7800,1.0,0,0,2,7,1500,0,1968,0.0,98092,47.3141,-122.19200000000001,1490,7800,6300,0.8076923076923077,2250000,60840000,58590000
445000.0,2,1.0,910,7200,1.0,0,1,3,7,830,80,1936,0.0,98136,47.5145,-122.39,1700,7200,6290,0.8736111111111111,828100,51840000,51011900
175000.0,3,1.75,1430,4920,1.0,0,0,1,6,1430,0,1957,0.0,98118,47.5388,-122.275,1550,5646,3490,0.709349593495935,2044900,24206400,22161500
315000.0,2,1.0,900,8556,1.0,0,0,2,6,760,140,1941,0.0,98136,47.5148,-122.38600000000001,1500,8556,7656,0.8948106591865358,810000,73205136,72395136
445000.0,4,1.75,1250,7400,1.0,0,0,4,6,1250,0,1959,0.0,98008,47.62,-122.12,990,7600,6150,0.831081081081081,1562500,54760000,53197500
1400000.0,5,3.0,3850,14990,1.0,0,0,3,9,2290,1560,1964,0.0,98004,47.6425,-122.21799999999999,3010,15001,11140,0.7431621080720481,14822500,224700100,209877600
832500.0,4,2.5,3450,35100,2.0,0,0,2,10,3450,0,1987,0.0,98052,47.7302,-122.10600000000001,3110,35894,31650,0.9017094017094017,11902500,1232010000,1220107500
771150.0,4,3.5,3950,12320,2.0,0,0,2,10,3950,0,2001,0.0,98065,47.5414,-121.869,3920,11086,8370,0.6793831168831169,15602500,151782400,136179900
225000.0,4,1.5,1950,12559,1.5,0,0,2,6,1950,0,1939,0.0,98188,47.4364,-122.28200000000001,1950,9178,10609,0.8447328608965682,3802500,157728481,153925981
389950.0,3,2.5,1700,6396,2.0,0,0,2,7,1700,0,2003,0.0,98065,47.5333,-121.87,1700,4444,4696,0.734208880550344,2890000,40908816,38018816
435000.0,3,2.5,2370,6082,2.0,0,0,2,7,2370,0,2004,0.0,98065,47.5288,-121.846,2690,6152,3712,0.610325550805656,5616900,36990724,31373824
845000.0,3,1.75,1600,2538,2.0,0,0,2,7,1600,0,1929,0.0,98102,47.6447,-122.32700000000001,1660,1750,938,0.36958234830575254,2560000,6441444,3881444
1300000.0,4,1.75,4060,5500,2.0,0,0,4,9,2660,1400,1924,0.0,98102,47.6437,-122.321,3320,5500,1440,0.26181818181818184,16483600,30250000,13766400
350000.0,3,2.25,1322,1796,2.0,0,0,2,8,1087,235,2005,0.0,98144,47.5976,-122.29799999999999,1690,2025,474,0.2639198218262806,1747684,3225616,1477932
250000.0,3,1.75,1140,10400,1.0,0,0,3,7,1140,0,1983,0.0,98003,47.2598,-122.311,1280,9800,9260,0.8903846153846153,1299600,108160000,106860400
370000.0,2,1.5,1280,2096,2.0,0,0,2,7,1080,200,2007,0.0,98144,47.5872,-122.30799999999999,1340,7452,816,0.3893129770992366,1638400,4393216,2754816
750000.0,4,2.5,3080,4553,2.5,0,0,2,8,3080,0,2008,0.0,98052,47.7066,-122.11200000000001,2750,4929,1473,0.32352295189984626,9486400,20729809,11243409
439950.0,2,1.75,1210,3000,1.0,0,0,4,7,910,300,1906,0.0,98117,47.6789,-122.365,1260,3000,1790,0.5966666666666667,1464100,9000000,7535900
395000.0,4,1.75,1950,10219,1.0,0,0,2,7,1950,0,1962,0.0,98133,47.7492,-122.336,1500,9099,8269,0.8091789803307564,3802500,104427961,100625461
375000.0,4,1.0,1450,6820,1.5,0,0,2,6,1450,0,1947,0.0,98133,47.7061,-122.34700000000001,1450,6820,5370,0.7873900293255132,2102500,46512400,44409900
263000.0,3,2.25,1590,7748,2.0,0,0,3,7,1590,0,1991,0.0,98003,47.2857,-122.3,1590,7606,6158,0.7947857511615901,2528100,60031504,57503404
185000.0,3,1.0,1240,9198,1.5,0,0,3,7,1240,0,1959,0.0,98032,47.37,-122.29700000000001,1170,8970,7958,0.8651880843661666,1537600,84603204,83065604
500000.0,3,1.0,1440,54315,1.0,0,0,2,7,790,650,1974,0.0,98075,47.591,-122.01,2690,40518,52875,0.9734879867439934,2073600,2950119225,2948045625
920000.0,4,2.5,3470,10045,2.0,0,0,2,10,3470,0,1993,0.0,98027,47.553999999999995,-122.095,4370,12359,6575,0.6545545047287208,12040900,100902025,88861125
936000.0,7,3.75,5100,21802,2.0,0,0,2,10,3640,1460,2001,0.0,98075,47.595,-122.04,3350,10005,16702,0.7660765067425007,26010000,475327204,449317204
1500000.0,3,1.75,2430,12757,1.0,0,2,3,8,1340,1090,1952,0.0,98004,47.6201,-122.209,2930,12450,10327,0.8095163439680175,5904900,162741049,156836149
1100000.0,3,2.25,2420,7200,1.0,0,0,2,8,1420,1000,1948,0.0,98115,47.6867,-122.275,2500,7200,4780,0.6638888888888889,5856400,51840000,45983600
247000.0,3,2.5,1510,10875,1.0,0,0,2,7,1150,360,1990,0.0,98003,47.3482,-122.3,1810,9916,9365,0.8611494252873563,2280100,118265625,115985525
289500.0,3,1.0,1200,5525,1.0,0,0,1,7,1200,0,1947,0.0,98115,47.6981,-122.325,1580,7200,4325,0.7828054298642534,1440000,30525625,29085625
432500.0,3,2.5,2240,6396,2.0,0,0,2,7,2240,0,2002,0.0,98065,47.5356,-121.881,2610,5128,4156,0.6497811131957474,5017600,40908816,35891216
680000.0,3,1.75,1870,4320,1.0,0,0,3,7,970,900,1920,0.0,98103,47.6663,-122.35700000000001,1810,3900,2450,0.5671296296296297,3496900,18662400,15165500
589000.0,3,1.0,1110,6000,1.5,0,0,4,7,1110,0,1932,0.0,98199,47.6496,-122.40299999999999,1420,6000,4890,0.815,1232100,36000000,34767900
756450.0,4,2.0,3210,8400,1.5,0,0,4,7,2040,1170,1914,0.0,98136,47.5322,-122.391,2540,6458,5190,0.6178571428571429,10304100,70560000,60255900
536650.0,3,1.75,2090,8910,1.0,0,0,2,8,1230,860,1975,0.0,98034,47.7149,-122.22200000000001,2310,10695,6820,0.7654320987654321,4368100,79388100,75020000
540000.0,3,2.25,1320,1800,2.0,0,0,2,7,1320,0,1994,0.0,98122,47.6081,-122.289,2010,4500,480,0.26666666666666666,1742400,3240000,1497600
385000.0,3,1.75,1340,3850,1.0,0,0,3,7,1340,0,1960,0.0,98125,47.7134,-122.292,1540,7645,2510,0.6519480519480519,1795600,14822500,13026900
485000.0,3,1.0,1020,6120,1.0,0,0,2,7,1020,0,1941,0.0,98115,47.6787,-122.285,2370,6695,5100,0.8333333333333334,1040400,37454400,36414000
240000.0,3,2.0,1220,17652,1.0,0,0,3,7,1220,0,1980,0.0,98059,47.4712,-122.1,1990,17652,16432,0.9308860185814638,1488400,311593104,310104704
415500.0,3,2.0,1220,17652,1.0,0,0,3,7,1220,0,1980,0.0,98059,47.4712,-122.1,1990,17652,16432,0.9308860185814638,1488400,311593104,310104704
550000.0,3,2.0,1390,2688,1.5,0,0,4,7,1390,0,1915,0.0,98117,47.6783,-122.366,1440,2900,1298,0.48288690476190477,1932100,7225344,5293244
1260000.0,4,2.0,2970,5400,2.5,0,0,3,9,2970,0,1900,0.0,98112,47.6235,-122.309,2500,5040,2430,0.45,8820900,29160000,20339100
430000.0,2,2.0,1440,213008,2.0,0,0,3,7,1440,0,1990,0.0,98070,47.3604,-122.45700000000001,1630,161172,211568,0.9932396905280553,2073600,45372408064,45370334464
415000.0,2,1.75,1550,4257,1.0,0,3,2,7,830,720,1953,0.0,98136,47.5274,-122.384,1920,5100,2707,0.6358938219403336,2402500,18122049,15719549
365000.0,4,2.5,1904,8200,2.0,0,0,4,7,1904,0,1999,0.0,98010,47.3107,-122.001,1560,12426,6296,0.7678048780487805,3625216,67240000,63614784
257000.0,4,1.5,1400,8500,2.0,0,0,2,7,1400,0,1975,0.0,98001,47.3314,-122.275,1580,7650,7100,0.8352941176470589,1960000,72250000,70290000
420000.0,3,2.5,2140,3821,2.0,0,0,2,8,2140,0,2005,0.0,98029,47.5541,-121.995,2860,3841,1681,0.4399371892174823,4579600,14600041,10020441
338995.0,3,1.75,1320,9450,1.0,0,0,4,7,1320,0,1943,0.0,98166,47.4557,-122.348,1320,8315,8130,0.8603174603174604,1742400,89302500,87560100
615000.0,3,1.75,2620,8280,1.0,0,0,3,7,1330,1290,1948,0.0,98177,47.7235,-122.359,1530,8160,5660,0.6835748792270532,6864400,68558400,61694000
312500.0,4,0.5,2300,5570,2.0,0,0,2,8,2300,0,1996,0.0,98092,47.3285,-122.16799999999999,1820,6371,3270,0.5870736086175943,5290000,31024900,25734900
513000.0,4,2.5,2000,5684,2.0,0,0,2,8,2000,0,1996,0.0,98028,47.7443,-122.22,2210,7066,3684,0.6481351161154116,4000000,32307856,28307856
857500.0,4,2.75,2960,5040,2.0,0,3,2,9,2210,750,1952,0.0,98116,47.5747,-122.40799999999999,2270,5500,2080,0.4126984126984127,8761600,25401600,16640000
1060000.0,3,2.75,2700,22343,1.5,0,1,3,10,2700,0,1977,0.0,98040,47.5706,-122.209,3390,15682,19643,0.87915678288502,7290000,499209649,491919649
585000.0,3,1.75,1740,9500,1.0,0,3,3,8,1150,590,1958,0.0,98146,47.4919,-122.365,2110,9450,7760,0.8168421052631579,3027600,90250000,87222400
350500.0,2,2.5,1770,4950,1.0,0,0,2,7,1770,0,2003,0.0,98038,47.3497,-122.025,1770,4500,3180,0.6424242424242425,3132900,24502500,21369600
215000.0,3,2.0,1290,9312,1.0,0,0,2,7,1290,0,1947,0.0,98168,47.4811,-122.325,1650,7300,8022,0.8614690721649485,1664100,86713344,85049244
440000.0,4,2.0,1450,8400,1.5,0,0,3,7,1450,0,1962,0.0,98034,47.7285,-122.24,1450,7440,6950,0.8273809523809523,2102500,70560000,68457500
270000.0,3,2.25,1420,7800,1.0,0,0,3,7,1130,290,1985,0.0,98042,47.3598,-122.15700000000001,1460,7800,6380,0.8179487179487179,2016400,60840000,58823600
385000.0,3,0.75,1330,7020,1.0,0,0,4,7,1330,0,1924,0.0,98126,47.5377,-122.376,1410,5802,5690,0.8105413105413105,1768900,49280400,47511500
688500.0,3,1.75,1760,4125,1.5,0,3,3,7,1760,0,1927,0.0,98103,47.6748,-122.352,1760,4000,2365,0.5733333333333334,3097600,17015625,13918025
700000.0,3,1.75,2010,4905,1.0,0,0,4,7,1230,780,1912,0.0,98122,47.6105,-122.309,2210,1834,2895,0.5902140672782875,4040100,24059025,20018925
585000.0,5,2.0,2560,14467,1.0,0,0,2,8,1280,1280,1960,0.0,98006,47.5547,-122.178,2200,10267,11907,0.8230455519458078,6553600,209294089,202740489
401000.0,2,1.5,1260,2625,2.0,0,0,3,7,1260,0,1983,0.0,98052,47.6747,-122.15100000000001,1260,2625,1365,0.52,1587600,6890625,5303025
655000.0,4,2.25,2420,7725,1.0,0,0,3,8,1890,530,1972,0.0,98052,47.6287,-122.09299999999999,1740,7944,5305,0.6867313915857605,5856400,59675625,53819225
317000.0,3,1.0,1010,5400,1.0,0,0,2,6,1010,0,1959,0.0,98144,47.5746,-122.29299999999999,960,5400,4390,0.812962962962963,1020100,29160000,28139900
500000.0,4,2.5,1770,8155,1.5,0,0,3,6,1770,0,1970,0.0,98034,47.718999999999994,-122.17299999999999,1460,7360,6385,0.78295524218271,3132900,66504025,63371125
314963.0,2,1.0,890,6350,1.0,0,0,2,6,890,0,1943,0.0,98103,47.6975,-122.35700000000001,1490,6350,5460,0.8598425196850393,792100,40322500,39530400
715000.0,3,1.5,1670,5060,2.0,0,2,4,7,1670,0,1925,0.0,98126,47.5671,-122.37899999999999,1670,5118,3390,0.6699604743083004,2788900,25603600,22814700
280000.0,3,2.25,1360,9600,2.0,0,0,2,7,1360,0,1992,0.0,98045,47.4687,-121.749,1200,10400,8240,0.8583333333333333,1849600,92160000,90310400
531000.0,3,2.5,2120,9736,2.0,0,0,2,9,2120,0,1988,0.0,98011,47.7374,-122.219,2490,8763,7616,0.7822514379622021,4494400,94789696,90295296
617000.0,3,2.5,1910,4488,2.0,0,0,2,8,1910,0,1998,0.0,98007,47.6176,-122.14,1530,3696,2578,0.5744206773618539,3648100,20142144,16494044
440000.0,4,1.0,1480,7560,1.5,0,0,2,7,1480,0,1940,0.0,98177,47.7079,-122.35799999999999,1480,7560,6080,0.8042328042328042,2190400,57153600,54963200
140000.0,3,1.0,1090,10114,1.0,0,0,3,7,1090,0,1955,0.0,98002,47.2975,-122.223,1380,7800,9024,0.8922285940280799,1188100,102292996,101104896
661000.0,4,1.75,1670,13125,1.0,0,0,4,8,1670,0,1973,0.0,98052,47.6315,-122.101,2360,12500,11455,0.8727619047619047,2788900,172265625,169476725
697000.0,4,1.75,1670,13125,1.0,0,0,4,8,1670,0,1973,0.0,98052,47.6315,-122.101,2360,12500,11455,0.8727619047619047,2788900,172265625,169476725
1200000.0,5,2.75,3650,13297,2.0,0,0,4,9,2750,900,1969,0.0,98040,47.5497,-122.228,2900,11568,9647,0.7255019929307363,13322500,176810209,163487709
535000.0,4,2.0,1970,3515,1.0,0,0,4,8,1030,940,1969,0.0,98115,47.6873,-122.314,1650,4275,1545,0.4395448079658606,3880900,12355225,8474325
404500.0,2,2.0,1320,3060,1.5,0,0,3,6,1320,0,1910,0.0,98118,47.5643,-122.28399999999999,1410,3264,1740,0.5686274509803921,1742400,9363600,7621200
396500.0,3,1.0,1710,5110,1.0,0,0,2,7,1100,610,1954,0.0,98126,47.5256,-122.37899999999999,1310,5110,3400,0.6653620352250489,2924100,26112100,23188000
450000.0,3,2.25,1740,9488,1.0,0,0,3,8,1180,560,1977,0.0,98056,47.5339,-122.17399999999999,1880,8615,7748,0.8166104553119731,3027600,90022144,86994544
605000.0,3,3.25,2200,2400,2.0,0,0,2,8,1740,460,1988,0.0,98119,47.6325,-122.37100000000001,2200,3600,200,0.08333333333333333,4840000,5760000,920000
699000.0,3,2.0,2010,4320,2.0,0,2,2,9,2010,0,1999,0.0,98118,47.5153,-122.256,1640,5225,2310,0.5347222222222222,4040100,18662400,14622300
805000.0,3,3.0,3910,19023,2.0,0,0,2,11,3910,0,1985,0.0,98014,47.6953,-121.914,1860,15001,15113,0.7944593386952636,15288100,361874529,346586429
156000.0,1,0.75,470,15000,1.0,0,0,2,4,470,0,1947,0.0,98014,47.6554,-121.90799999999999,1730,22500,14530,0.9686666666666667,220900,225000000,224779100
595000.0,4,2.5,2330,7064,1.0,0,0,3,8,1780,550,1984,0.0,98052,47.6955,-122.09700000000001,1740,8075,4734,0.670158550396376,5428900,49900096,44471196
285000.0,3,1.75,1930,7200,1.5,0,0,2,6,1930,0,1929,0.0,98065,47.5263,-121.809,1350,9000,5270,0.7319444444444444,3724900,51840000,48115100
725000.0,4,2.5,3270,6055,2.0,0,0,2,9,3270,0,2007,0.0,98056,47.5374,-122.19200000000001,2740,7367,2785,0.4599504541701073,10692900,36663025,25970125
216300.0,3,2.5,1650,5000,2.0,0,0,2,8,1650,0,1985,0.0,98023,47.3206,-122.39399999999999,1720,5000,3350,0.67,2722500,25000000,22277500
410000.0,4,2.75,2220,8450,1.0,0,0,3,7,1260,960,1983,0.0,98059,47.4804,-122.15700000000001,1580,8450,6230,0.7372781065088757,4928400,71402500,66474100
597000.0,2,1.75,2470,4600,1.0,0,3,3,7,1140,1330,1916,0.0,98126,47.5599,-122.37799999999999,1790,5175,2130,0.46304347826086956,6100900,21160000,15059100
325000.0,3,1.0,1300,9300,1.0,0,0,3,7,1300,0,1977,0.0,98077,47.7562,-122.073,1300,10064,8000,0.8602150537634409,1690000,86490000,84800000
355000.0,5,2.75,2530,9375,1.0,0,0,4,7,1530,1000,1966,0.0,98030,47.3738,-122.214,2250,8200,6845,0.7301333333333333,6400900,87890625,81489725
338000.0,3,1.5,2400,8215,1.0,0,0,2,7,1200,1200,1961,0.0,98146,47.5001,-122.338,1460,8217,5815,0.7078514911746805,5760000,67486225,61726225
210000.0,4,2.25,1500,5393,2.0,0,0,2,7,1500,0,1999,0.0,98001,47.3378,-122.26299999999999,1700,5917,3893,0.7218616725384758,2250000,29084449,26834449
423000.0,4,1.75,1700,9000,1.0,0,0,2,7,1700,0,1967,0.0,98034,47.7308,-122.18,1930,7818,7300,0.8111111111111111,2890000,81000000,78110000
249500.0,4,1.5,2120,8554,1.0,0,0,3,7,1170,950,1977,0.0,98002,47.2933,-122.195,1790,8554,6434,0.7521627308861352,4494400,73170916,68676516
325000.0,4,2.5,2240,5105,2.0,0,0,3,8,2240,0,2002,0.0,98042,47.3922,-122.165,1920,5288,2865,0.5612144955925563,5017600,26061025,21043425
257000.0,3,1.75,1540,8223,1.0,0,0,3,7,1070,470,1987,0.0,98042,47.3666,-122.089,1240,8113,6683,0.8127204183388058,2371600,67617729,65246129
550000.0,3,1.75,1890,100623,1.0,0,3,2,8,1890,0,1978,0.0,98053,47.6454,-121.978,2110,50529,98733,0.9812170179779971,3572100,10124988129,10121416029
490000.0,3,1.0,1260,9638,2.0,0,0,3,7,1260,0,1920,0.0,98033,47.6773,-122.178,1760,7822,8378,0.8692674828802656,1587600,92891044,91303444
299000.0,2,1.5,1160,3838,2.0,0,0,2,7,1160,0,1983,0.0,98034,47.7255,-122.164,1410,3780,2678,0.6977592496091715,1345600,14730244,13384644
295000.0,2,1.0,1300,39639,1.0,0,0,3,6,1300,0,1960,0.0,98070,47.466,-122.45200000000001,1880,98881,38339,0.9672040162466258,1690000,1571250321,1569560321
630000.0,4,2.5,3220,14463,2.0,0,0,2,8,3220,0,1978,0.0,98074,47.6261,-122.04700000000001,2550,12109,11243,0.7773629260872571,10368400,209178369,198809969
320000.0,4,1.5,2020,8474,1.0,0,0,4,7,1010,1010,1962,0.0,98058,47.4579,-122.17,1720,8166,6454,0.7616237904177484,4080400,71808676,67728276
1110000.0,4,2.5,2990,8640,1.0,0,0,4,8,2100,890,1959,0.0,98005,47.5932,-122.17200000000001,2270,8800,5650,0.6539351851851852,8940100,74649600,65709500
398000.0,4,1.0,1420,6458,1.0,0,0,3,7,1420,0,1953,0.0,98117,47.6988,-122.35799999999999,1670,6350,5038,0.7801176834933415,2016400,41705764,39689364
218000.0,3,1.0,1020,7874,1.0,0,0,2,7,1020,0,1956,0.0,98106,47.5175,-122.346,1290,7320,6854,0.8704597409194819,1040400,61999876,60959476
590000.0,4,2.75,2400,104108,2.0,0,0,2,8,2400,0,1988,0.0,98027,47.4686,-121.98899999999999,2270,54450,101708,0.9769470165597265,5760000,10838475664,10832715664
1600000.0,5,3.0,3640,8239,2.0,0,3,2,10,2540,1100,1982,0.0,98008,47.5842,-122.111,3330,10643,4599,0.5581988105352591,13249600,67881121,54631521
348500.0,2,2.25,1550,1824,2.0,0,0,2,8,1550,0,2007,0.0,98106,47.5396,-122.368,1460,1826,274,0.15021929824561403,2402500,3326976,924476
592500.0,2,2.0,1870,4751,1.0,0,0,2,8,1870,0,2006,0.0,98053,47.7082,-122.015,2170,5580,2881,0.6063986529151758,3496900,22572001,19075101
505000.0,3,2.5,2340,5957,2.0,0,0,2,8,2340,0,1995,0.0,98028,47.7347,-122.236,2340,6604,3617,0.6071848245761289,5475600,35485849,30010249
1430000.0,5,4.25,3350,3600,2.0,0,0,2,10,2260,1090,2014,0.0,98119,47.6351,-122.36399999999999,1810,3600,250,0.06944444444444445,11222500,12960000,1737500
502000.0,3,1.0,1710,5000,1.0,0,0,4,7,1140,570,1921,0.0,98116,47.5719,-122.385,1670,4000,3290,0.658,2924100,25000000,22075900
257500.0,2,2.0,1180,9265,1.0,0,0,2,7,1180,0,1940,0.0,98125,47.7252,-122.29700000000001,460,18000,8085,0.8726389638424177,1392400,85840225,84447825
405000.0,3,1.5,1600,7500,1.0,0,0,2,7,1600,0,1966,0.0,98034,47.721000000000004,-122.182,1700,7500,5900,0.7866666666666666,2560000,56250000,53690000
427000.0,3,1.75,1300,5111,1.0,0,0,3,7,1300,0,1959,0.0,98115,47.7005,-122.314,1370,5111,3811,0.7456466444922716,1690000,26122321,24432321
290000.0,3,1.5,1040,9997,1.0,0,0,3,7,1040,0,1955,0.0,98155,47.7583,-122.302,1040,8699,8957,0.8959687906371911,1081600,99940009,98858409
222000.0,3,1.0,1220,7695,1.0,0,0,2,7,1220,0,1954,0.0,98106,47.5191,-122.339,1210,7412,6475,0.8414554905782976,1488400,59213025,57724625
315000.0,3,2.5,2240,6097,2.0,0,0,2,8,2240,0,2002,0.0,98038,47.3503,-122.042,2240,5574,3857,0.6326061997703789,5017600,37173409,32155809
371000.0,3,1.5,1420,4500,1.0,0,0,2,7,1420,0,1959,0.0,98103,47.693999999999996,-122.33200000000001,1540,6375,3080,0.6844444444444444,2016400,20250000,18233600
279900.0,3,1.75,1580,6620,1.0,0,0,2,7,1580,0,1988,0.0,98003,47.2798,-122.303,1580,8137,5040,0.7613293051359517,2496400,43824400,41328000
250000.0,3,1.5,2390,23522,1.0,0,0,1,7,1890,500,1938,1968.0,98059,47.4754,-122.09,2430,23958,21132,0.8983929937930448,5712100,553284484,547572384
599000.0,4,2.25,2260,29930,2.0,0,0,3,8,1400,860,1977,0.0,98006,47.5689,-122.126,2770,29930,27670,0.9244904777814902,5107600,895804900,890697300
267300.0,3,1.75,1890,93218,1.0,0,0,3,7,1890,0,1964,0.0,98092,47.2568,-122.07,1690,172062,91328,0.9797249458259134,3572100,8689595524,8686023424
585000.0,2,1.75,1830,7200,1.0,0,2,3,7,1070,760,1949,0.0,98118,47.5592,-122.273,1570,6000,5370,0.7458333333333333,3348900,51840000,48491100
350000.0,3,1.75,1000,8268,1.0,0,0,2,6,1000,0,1969,0.0,98072,47.7417,-122.17200000000001,1220,7800,7268,0.8790517658442186,1000000,68359824,67359824
506000.0,3,1.75,2180,7700,1.0,0,0,2,8,1480,700,1961,0.0,98177,47.7594,-122.361,2180,7604,5520,0.7168831168831169,4752400,59290000,54537600
400000.0,6,2.0,2320,210830,2.0,0,0,3,8,2320,0,1962,0.0,98058,47.398,-122.081,2540,217800,208510,0.9889958734525447,5382400,44449288900,44443906500
151100.0,3,1.0,840,4495,1.0,0,0,2,6,840,0,1921,0.0,98146,47.496,-122.34899999999999,1260,7434,3655,0.8131256952169077,705600,20205025,19499425
251000.0,3,1.0,840,4495,1.0,0,0,2,6,840,0,1921,0.0,98146,47.496,-122.34899999999999,1260,7434,3655,0.8131256952169077,705600,20205025,19499425
555000.0,4,2.25,2350,8140,1.0,0,0,3,8,1430,920,1977,0.0,98006,47.5579,-122.12899999999999,2640,8700,5790,0.7113022113022113,5522500,66259600,60737100
467500.0,3,1.75,2040,273556,1.0,0,0,2,7,2040,0,1997,0.0,98070,47.4361,-122.469,1790,273556,271516,0.9925426603693577,4161600,74832885136,74828723536
479000.0,4,2.5,2370,30378,2.0,0,0,2,8,2370,0,1996,0.0,98042,47.3389,-122.066,2870,34834,28008,0.9219830140233063,5616900,922822884,917205984
247000.0,5,2.0,1590,9350,1.0,0,0,4,7,1060,530,1962,0.0,98001,47.3398,-122.286,1460,8210,7760,0.8299465240641711,2528100,87422500,84894400
299500.0,3,1.0,1380,10875,1.0,0,0,2,7,1380,0,1977,0.0,98045,47.4653,-121.745,1040,10875,9495,0.8731034482758621,1904400,118265625,116361225
306888.0,4,1.5,1940,8970,1.5,0,0,2,7,1270,670,1980,0.0,98125,47.7297,-122.32600000000001,1960,8470,7030,0.7837235228539576,3763600,80460900,76697300
675000.0,4,2.5,3320,244807,2.0,0,0,2,9,3320,0,2001,0.0,98010,47.3637,-121.955,2530,217800,241487,0.9864382962905472,11022400,59930467249,59919444849
577000.0,2,1.0,1090,5265,1.5,0,0,3,7,1090,0,1947,0.0,98105,47.6638,-122.292,2080,4000,4175,0.7929724596391263,1188100,27720225,26532125
219950.0,3,1.5,1650,9936,1.0,0,0,2,7,1090,560,1967,0.0,98003,47.3285,-122.32799999999999,1560,9890,8286,0.8339371980676329,2722500,98724096,96001596
375000.0,3,1.5,1110,5500,1.0,0,0,2,6,1110,0,1940,0.0,98033,47.6717,-122.184,1670,6600,4390,0.7981818181818182,1232100,30250000,29017900
650000.0,4,2.5,2110,6820,1.0,0,0,4,7,1530,580,1942,0.0,98115,47.6882,-122.306,1420,6431,4710,0.6906158357771262,4452100,46512400,42060300
975000.0,3,3.0,1850,5000,1.5,0,0,1,6,1850,0,1900,0.0,98107,47.6711,-122.38600000000001,1360,2500,3150,0.63,3422500,25000000,21577500
229000.0,1,1.0,600,3720,1.0,0,0,2,6,600,0,1920,0.0,98106,47.5558,-122.363,1480,4800,3120,0.8387096774193549,360000,13838400,13478400
575000.0,5,2.5,2760,4000,1.5,0,0,2,8,1730,1030,1926,2014.0,98122,47.6074,-122.29899999999999,1680,4000,1240,0.31,7617600,16000000,8382400
815000.0,4,1.75,2970,14880,1.0,0,4,4,9,1560,1410,1962,0.0,98075,47.5907,-122.086,3310,13388,11910,0.8004032258064516,8820900,221414400,212593500
525000.0,3,1.75,2300,43560,1.0,0,0,3,7,1350,950,1979,0.0,98077,47.7716,-122.101,2320,57000,41260,0.9471992653810836,5290000,1897473600,1892183600
471000.0,3,2.5,2030,2805,2.0,0,0,2,8,1720,310,2001,0.0,98027,47.5305,-122.04700000000001,1670,2898,775,0.27629233511586454,4120900,7868025,3747125
450000.0,4,1.75,2160,4333,1.0,0,0,3,8,1260,900,1942,0.0,98117,47.6893,-122.38799999999999,1670,4426,2173,0.5015001153934918,4665600,18774889,14109289
590000.0,3,2.0,1650,6150,2.0,0,0,3,7,1650,0,1926,1993.0,98116,47.5713,-122.39399999999999,1280,6150,4500,0.7317073170731707,2722500,37822500,35100000
744000.0,4,2.5,3140,7260,2.0,0,0,2,8,2200,940,2004,0.0,98006,47.5664,-122.124,2860,8186,4120,0.5674931129476584,9859600,52707600,42848000
460000.0,4,2.25,2690,36114,2.0,0,0,3,9,2690,0,1986,0.0,98092,47.3106,-122.116,2570,35091,33424,0.925513651215595,7236100,1304220996,1296984896
299000.0,5,2.5,1940,9389,1.0,0,0,3,7,1290,650,1960,0.0,98155,47.7438,-122.32799999999999,1810,9390,7449,0.7933752263286825,3763600,88153321,84389721
231000.0,4,1.0,1220,5120,1.5,0,0,4,6,1220,0,1940,0.0,98022,47.205,-121.99600000000001,1540,7670,3900,0.76171875,1488400,26214400,24726000
195000.0,3,1.0,1300,9600,1.0,0,0,3,6,1300,0,1975,0.0,98092,47.3037,-122.10700000000001,1150,10222,8300,0.8645833333333334,1690000,92160000,90470000
305000.0,3,1.75,1660,11500,1.0,0,0,2,7,1130,530,1979,0.0,98045,47.4473,-121.774,1250,11000,9840,0.8556521739130435,2755600,132250000,129494400
895000.0,4,1.5,3390,6200,2.0,0,0,3,8,2530,860,1916,0.0,98144,47.58,-122.29,3080,6000,2810,0.4532258064516129,11492100,38440000,26947900
1110000.0,4,1.5,2310,13300,1.0,0,0,2,7,1890,420,1950,0.0,98004,47.6232,-122.21,2840,12744,10990,0.8263157894736842,5336100,176890000,171553900
339000.0,2,1.0,950,7954,1.0,0,0,3,7,950,0,1941,0.0,98108,47.556999999999995,-122.306,1180,6828,7004,0.880563238622077,902500,63266116,62363616
885000.0,4,3.75,2400,3520,1.0,0,0,2,7,1370,1030,1924,0.0,98109,47.6295,-122.346,2230,1419,1120,0.3181818181818182,5760000,12390400,6630400
375000.0,3,1.0,1780,5236,1.5,0,0,4,6,1050,730,1944,0.0,98146,47.5119,-122.38600000000001,1260,5320,3456,0.6600458365164248,3168400,27415696,24247296
367400.0,4,1.5,1280,7400,1.0,0,0,2,7,1280,0,1958,0.0,98008,47.6023,-122.12299999999999,1310,7400,6120,0.827027027027027,1638400,54760000,53121600
700000.0,4,2.0,1930,5398,1.0,0,0,2,7,1430,500,1953,0.0,98119,47.646,-122.363,1910,4902,3468,0.6424601704334939,3724900,29138404,25413504
667000.0,5,2.25,2560,10360,1.0,0,0,3,8,1870,690,1966,0.0,98008,47.5819,-122.126,2070,7875,7800,0.752895752895753,6553600,107329600,100776000
200000.0,2,1.0,920,5250,1.0,0,0,3,6,920,0,1906,0.0,98118,47.5177,-122.266,1210,5250,4330,0.8247619047619048,846400,27562500,26716100
552775.0,3,2.5,1900,18414,2.0,0,0,2,8,1900,0,1971,2007.0,98074,47.6326,-122.015,2900,39921,16514,0.8968176387531226,3610000,339075396,335465396
452000.0,3,2.0,2270,148975,1.0,0,0,3,6,1270,1000,1900,1980.0,98056,47.5092,-122.195,2210,17388,146705,0.9847625440510153,5152900,22193550625,22188397725
418000.0,3,2.5,2080,16050,1.0,0,0,4,8,1360,720,1978,0.0,98059,47.4694,-122.069,1790,14550,13970,0.870404984423676,4326400,257602500,253276100
601500.0,3,1.75,1460,10128,1.0,0,0,2,8,1460,0,1968,2000.0,98033,47.6709,-122.167,2240,10154,8668,0.8558451816745656,2131600,102576384,100444784
600000.0,3,1.75,1670,39639,1.0,0,0,3,8,1670,0,1976,1992.0,98075,47.5929,-121.98899999999999,2330,30492,37969,0.9578697747168193,2788900,1571250321,1568461421
340000.0,4,2.5,2810,6481,2.0,0,0,2,9,2810,0,1998,0.0,98092,47.333,-122.17200000000001,2660,6958,3671,0.5664249344237,7896100,42003361,34107261
310000.0,3,2.5,2370,6752,2.0,0,0,2,8,2370,0,1994,0.0,98003,47.2703,-122.31200000000001,1870,7455,4382,0.6489928909952607,5616900,45589504,39972604
290000.0,2,1.75,1700,18000,1.0,0,0,2,8,1700,0,1972,0.0,98056,47.5066,-122.194,1700,8225,16300,0.9055555555555556,2890000,324000000,321110000
438000.0,2,1.0,1630,9255,1.0,0,0,2,7,1630,0,1941,0.0,98133,47.7222,-122.33200000000001,1800,8000,7625,0.823878984332793,2656900,85655025,82998125
718000.0,4,2.75,2930,4408,1.0,0,0,4,8,1660,1270,1939,0.0,98144,47.5841,-122.295,2200,4000,1478,0.3352994555353902,8584900,19430464,10845564
200000.0,2,1.0,860,6600,1.0,0,0,4,6,860,0,1949,0.0,98168,47.4878,-122.324,1030,6732,5740,0.8696969696969697,739600,43560000,42820400
479900.0,3,2.0,1980,12150,1.0,0,0,2,9,1980,0,1994,0.0,98042,47.3657,-122.152,2200,12150,10170,0.837037037037037,3920400,147622500,143702100
400000.0,3,2.5,2080,7877,2.0,0,0,2,9,2080,0,1987,0.0,98058,47.4395,-122.15100000000001,2550,7660,5797,0.7359400787101689,4326400,62047129,57720729
219950.0,3,1.0,1060,10042,1.0,0,0,3,7,1060,0,1957,0.0,98188,47.4434,-122.28299999999999,1130,10925,8982,0.8944433379804819,1123600,100841764,99718164
300000.0,3,2.5,1590,3381,2.0,0,0,2,7,1590,0,2000,0.0,98019,47.7344,-121.986,1820,3383,1791,0.5297249334516415,2528100,11431161,8903061
437000.0,3,2.25,1980,8775,1.0,0,0,2,7,1290,690,1959,0.0,98177,47.7753,-122.359,1550,9240,6795,0.7743589743589744,3920400,77000625,73080225
350000.0,4,2.0,1720,7210,1.0,0,0,2,7,860,0,1971,0.0,98034,47.7307,-122.23899999999999,1250,7210,5490,0.7614424410540915,2958400,51984100,49025700
626000.0,4,1.75,1350,9293,1.0,0,0,3,7,1350,0,1954,0.0,98004,47.6335,-122.196,1890,9293,7943,0.854729366189605,1822500,86359849,84537349
490000.0,3,2.5,2080,12032,2.0,0,0,2,8,2080,0,1978,0.0,98077,47.7455,-122.073,2320,9900,9952,0.8271276595744681,4326400,144769024,140442624
289000.0,3,2.5,2090,4700,2.0,0,0,2,8,2090,0,2002,0.0,98042,47.3724,-122.104,2740,5040,2610,0.5553191489361702,4368100,22090000,17721900
595000.0,3,2.5,2030,5100,2.0,0,0,2,7,2030,0,2008,0.0,98199,47.6594,-122.397,1790,4380,3070,0.6019607843137255,4120900,26010000,21889100
676000.0,3,2.25,2680,41804,1.0,0,0,2,9,2680,0,1989,0.0,98045,47.4828,-121.73,2680,40866,39124,0.9358913022677255,7182400,1747574416,1740392016
389000.0,3,1.75,1820,8028,1.0,0,0,2,7,1220,600,1980,0.0,98133,47.7466,-122.355,1940,11100,6208,0.7732934728450424,3312400,64448784,61136384
240000.0,3,2.0,1300,5000,1.0,0,0,3,7,1300,0,1983,0.0,98198,47.3837,-122.304,1630,7500,3700,0.74,1690000,25000000,23310000
382500.0,4,2.5,2210,7079,2.0,0,0,2,8,2210,0,1993,0.0,98031,47.4206,-122.18299999999999,1970,7000,4869,0.6878090125723972,4884100,50112241,45228141
511555.0,3,2.0,1400,7293,1.0,0,0,3,7,1400,0,1963,0.0,98008,47.58600000000001,-122.12,1600,7960,5893,0.8080351021527492,1960000,53187849,51227849
710500.0,3,1.75,2040,4125,1.5,0,0,3,8,1540,500,1917,0.0,98107,47.6608,-122.359,1620,4400,2085,0.5054545454545455,4161600,17015625,12854025
429000.0,3,2.5,2420,49928,2.0,0,0,2,8,1860,560,1985,0.0,98027,47.463,-122.008,2620,37301,47508,0.95153020349303,5856400,2492805184,2486948784
170000.0,4,1.75,1920,7500,1.0,0,0,3,7,1920,0,1962,0.0,98198,47.4222,-122.318,1490,8000,5580,0.744,3686400,56250000,52563600
2140000.0,4,3.25,3860,17820,1.0,0,4,3,10,2630,1230,1975,0.0,98004,47.6224,-122.215,4590,23760,13960,0.7833894500561167,14899600,317552400,302652800
480000.0,5,2.75,2760,7200,1.0,0,0,2,7,1430,1330,1979,0.0,98072,47.7563,-122.147,2460,8750,4440,0.6166666666666667,7617600,51840000,44222400
1670000.0,4,3.75,3450,8395,2.0,0,4,3,10,2640,810,1993,0.0,98122,47.6134,-122.28200000000001,3180,5183,4945,0.589041095890411,11902500,70476025,58573525
225000.0,3,1.0,1040,6535,1.0,0,0,2,6,1040,0,1947,0.0,98168,47.4906,-122.306,1100,6535,5495,0.8408569242540168,1081600,42706225,41624625
615000.0,3,1.75,2220,7224,1.0,0,2,2,8,2040,180,1975,0.0,98177,47.773999999999994,-122.384,2540,9990,5004,0.6926910299003323,4928400,52186176,47257776
438950.0,4,2.5,2470,385506,2.0,0,3,2,7,2470,0,1991,0.0,98022,47.2396,-121.993,1680,158994,383036,0.9935928364279674,6100900,148614876036,148608775136
242000.0,3,1.75,1300,9856,1.0,0,0,3,7,1300,0,1962,0.0,98003,47.3448,-122.29799999999999,1400,9600,8556,0.8681006493506493,1690000,97140736,95450736
560000.0,3,2.5,1960,9686,1.0,0,0,2,8,1460,500,1989,0.0,98074,47.6339,-122.02600000000001,1960,8254,7726,0.7976460871360727,3841600,93818596,89976996
857500.0,3,1.5,2040,3960,2.0,0,2,4,8,2040,0,1928,0.0,98103,47.6658,-122.355,1540,3400,1920,0.48484848484848486,4161600,15681600,11520000
685000.0,4,2.5,3030,7864,2.0,0,0,2,9,3030,0,1999,0.0,98074,47.6075,-122.01700000000001,2790,7034,4834,0.6146998982706002,9180900,61842496,52661596
486000.0,4,3.0,2260,7336,2.0,0,0,3,7,2260,0,1977,0.0,98034,47.7297,-122.219,2200,7724,5076,0.6919302071973827,5107600,53816896,48709296
749000.0,3,2.5,2670,10338,2.0,0,0,2,9,2670,0,1987,0.0,98007,47.6599,-122.146,2670,8866,7668,0.7417295414973882,7128900,106874244,99745344
260000.0,3,2.5,1520,6298,2.0,0,0,2,7,1520,0,1986,0.0,98030,47.3687,-122.182,1670,7207,4778,0.7586535408066053,2310400,39664804,37354404
1020000.0,3,1.75,3610,8502,1.5,0,2,2,10,2610,1000,1930,0.0,98126,47.583,-122.37899999999999,2900,5016,4892,0.5753940249353093,13032100,72284004,59251904
565000.0,3,1.75,1130,5111,1.0,0,0,3,7,930,200,1942,0.0,98199,47.6379,-122.4,1360,4424,3981,0.7789082371355899,1276900,26122321,24845421
355000.0,3,2.0,1480,2502,2.0,0,0,2,7,1480,0,1991,0.0,98103,47.6969,-122.338,1850,5000,1022,0.4084732214228617,2190400,6260004,4069604
775000.0,5,2.0,3540,9970,2.0,0,3,2,9,3540,0,1970,0.0,98125,47.7108,-122.277,2280,7195,6430,0.6449348044132397,12531600,99400900,86869300
335000.0,4,2.25,2100,7305,1.0,0,0,3,7,1050,1050,1963,0.0,98188,47.4676,-122.296,1760,7308,5205,0.7125256673511293,4410000,53363025,48953025
1300000.0,5,4.0,3366,7800,2.5,0,2,2,8,2966,400,1937,0.0,98199,47.6466,-122.391,2340,6000,4434,0.5684615384615385,11329956,60840000,49510044
545000.0,3,1.75,1810,3000,1.5,0,0,3,7,1810,0,1903,0.0,98107,47.6599,-122.363,1140,3000,1190,0.39666666666666667,3276100,9000000,5723900
540000.0,3,1.75,1680,4240,1.5,0,0,3,7,1680,0,1926,0.0,98144,47.5745,-122.311,1460,4240,2560,0.6037735849056604,2822400,17977600,15155200
687500.0,3,1.75,2450,9377,1.0,0,2,3,8,1540,910,1962,0.0,98125,47.7296,-122.28399999999999,2520,9725,6927,0.7387224058867442,6002500,87928129,81925629
115000.0,1,2.0,1150,9812,1.0,0,0,3,7,1150,0,1962,0.0,98001,47.2951,-122.28399999999999,1200,9812,8662,0.8827965756216878,1322500,96275344,94952844
227000.0,1,2.0,1150,9812,1.0,0,0,3,7,1150,0,1962,0.0,98001,47.2951,-122.28399999999999,1200,9812,8662,0.8827965756216878,1322500,96275344,94952844
870000.0,4,2.5,3240,7621,2.0,0,2,2,9,3240,0,2003,0.0,98075,47.5641,-122.03200000000001,4610,7150,4381,0.574858942396011,10497600,58079641,47582041
1190000.0,4,2.5,3480,12164,1.5,0,0,3,11,3480,0,1984,0.0,98005,47.6404,-122.171,3960,16855,8684,0.7139098980598487,12110400,147962896,135852496
375000.0,4,2.5,2800,5000,2.0,0,0,2,9,2800,0,2006,0.0,98038,47.3596,-122.036,2960,5092,2200,0.44,7840000,25000000,17160000
902000.0,3,2.75,3240,7200,1.0,0,2,2,8,1620,1620,1960,0.0,98118,47.567,-122.273,2700,7200,3960,0.55,10497600,51840000,41342400
269500.0,2,1.5,1480,7276,1.0,0,0,3,6,940,540,1978,0.0,98056,47.4942,-122.166,1090,6710,5796,0.7965915338097856,2190400,52940176,50749776
570000.0,3,1.0,1700,4750,1.5,0,0,3,6,1200,500,1909,0.0,98117,47.6819,-122.389,1550,4750,3050,0.6421052631578947,2890000,22562500,19672500
359950.0,2,1.0,1240,7590,1.0,0,0,3,7,1040,200,1939,0.0,98133,47.7061,-122.34,1190,5692,6350,0.836627140974967,1537600,57608100,56070500
1450000.0,4,3.5,3720,8301,2.0,0,0,2,10,2880,840,2008,0.0,98004,47.5885,-122.199,2080,9676,4581,0.5518612215395735,13838400,68906601,55068201
615000.0,3,2.5,1910,3427,2.0,0,0,2,8,1910,0,2001,0.0,98052,47.6324,-122.11,2240,3720,1517,0.4426612197257076,3648100,11744329,8096229
250000.0,4,2.0,2120,8701,1.5,0,0,3,7,2120,0,1960,0.0,98198,47.3722,-122.30799999999999,1720,8527,6581,0.7563498448454201,4494400,75707401,71213001
530000.0,4,2.5,3020,6788,2.0,0,0,2,7,3020,0,2002,0.0,98065,47.5346,-121.881,2640,5325,3768,0.5550972304065999,9120400,46076944,36956544
474950.0,3,2.0,2250,222156,1.0,0,0,2,7,2250,0,1987,0.0,98065,47.542,-121.792,2110,121968,219906,0.9898719818505914,5062500,49353288336,49348225836
490000.0,4,2.0,1650,6480,2.0,0,0,4,7,1650,0,1947,0.0,98125,47.7117,-122.286,1650,6350,4830,0.7453703703703703,2722500,41990400,39267900
210000.0,2,1.5,880,1157,2.0,0,0,2,7,880,0,2007,0.0,98126,47.5188,-122.376,1070,1203,277,0.2394122731201383,774400,1338649,564249
265500.0,3,1.0,1860,9225,1.0,0,0,2,7,1860,0,1957,0.0,98198,47.3904,-122.3,1740,12204,7365,0.7983739837398374,3459600,85100625,81641025
1460000.0,5,3.25,3840,4800,3.0,0,3,2,10,2750,1090,2008,0.0,98144,47.5929,-122.29,2060,4800,960,0.2,14745600,23040000,8294400
310000.0,4,2.25,2192,12128,2.0,0,0,2,8,2192,0,2006,0.0,98030,47.3644,-122.2,1914,4649,9936,0.8192612137203166,4804864,147088384,142283520
324500.0,3,2.5,1590,4108,2.0,0,0,2,7,1590,0,2003,0.0,98056,47.4832,-122.181,2160,3912,2518,0.612950340798442,2528100,16875664,14347564
599000.0,4,4.75,3700,11000,1.0,0,0,3,7,1840,1860,1962,0.0,98028,47.768,-122.251,1720,11564,7300,0.6636363636363637,13690000,121000000,107310000
525000.0,4,2.5,3670,9958,2.0,0,0,2,10,3670,0,2005,0.0,98058,47.4617,-122.15899999999999,3300,10679,6288,0.6314520988150231,13468900,99161764,85692864
400000.0,3,1.0,1630,10304,1.0,0,0,4,7,1630,0,1953,0.0,98155,47.7548,-122.31700000000001,1480,8515,8674,0.8418090062111802,2656900,106172416,103515516
887500.0,3,3.0,4230,54977,2.0,0,3,2,9,3780,450,1951,2000.0,98166,47.4176,-122.34299999999999,2880,27201,50747,0.9230587336522545,17892900,3022470529,3004577629
344000.0,2,1.0,1060,3325,1.5,0,0,3,6,770,290,1932,0.0,98115,47.6896,-122.307,1820,4275,2265,0.681203007518797,1123600,11055625,9932025
525000.0,3,2.5,2700,7434,2.0,0,0,2,9,2700,0,1991,0.0,98072,47.7434,-122.17399999999999,2660,8405,4734,0.6368038740920097,7290000,55264356,47974356
385000.0,3,2.25,2110,8000,2.0,0,0,2,8,2110,0,1975,0.0,98034,47.7311,-122.204,1740,7270,5890,0.73625,4452100,64000000,59547900
820000.0,4,2.5,3720,8633,2.0,0,0,2,10,3720,0,1999,0.0,98074,47.6085,-122.01299999999999,3515,9660,4913,0.5690953318660952,13838400,74528689,60690289
1310000.0,4,3.5,3440,5000,2.0,0,0,2,11,2560,880,2006,0.0,98199,47.6672,-122.40899999999999,3090,10241,1560,0.312,11833600,25000000,13166400
549000.0,4,2.25,2420,59800,1.0,0,0,3,8,1350,1070,1985,0.0,98074,47.6206,-122.056,2160,17598,57380,0.9595317725752508,5856400,3576040000,3570183600
180000.0,3,1.0,1090,6771,1.5,0,0,2,7,1090,0,1929,0.0,98106,47.5177,-122.353,1230,4662,5681,0.8390193472160685,1188100,45846441,44658341
589000.0,4,2.5,2910,5776,2.0,0,2,2,8,2910,0,1998,0.0,98065,47.5388,-121.87,2550,6750,2866,0.49619113573407203,8468100,33362176,24894076
350000.0,3,1.0,1050,5518,1.0,0,0,2,7,1050,0,1948,0.0,98118,47.5564,-122.27799999999999,1490,4269,4468,0.809713664371149,1102500,30448324,29345824
197400.0,3,2.0,1610,7575,1.0,0,0,3,7,1110,500,1965,0.0,98003,47.333999999999996,-122.3,1920,8400,5965,0.7874587458745874,2592100,57380625,54788525
267000.0,3,2.5,1760,6477,2.0,0,0,3,8,1760,0,1986,0.0,98030,47.3731,-122.17200000000001,1890,6800,4717,0.7282692604600896,3097600,41951529,38853929
480000.0,3,1.5,1540,20281,1.0,0,0,2,7,1540,0,1977,0.0,98075,47.5817,-122.007,1710,21090,18741,0.9240668606084512,2371600,411318961,408947361
650000.0,4,2.5,2580,9450,1.0,0,0,3,8,1660,920,1959,0.0,98125,47.703,-122.28,2060,9450,6870,0.726984126984127,6656400,89302500,82646100
600000.0,2,1.0,1370,5000,1.5,0,0,2,7,1370,0,1905,0.0,98107,47.6744,-122.383,1500,5000,3630,0.726,1876900,25000000,23123100
490000.0,2,1.75,1440,6265,1.0,0,0,2,8,1440,0,2005,0.0,98053,47.7028,-122.01299999999999,1810,5209,4825,0.7701516360734237,2073600,39250225,37176625
225000.0,3,1.0,1410,7700,1.0,0,0,2,7,980,430,1962,0.0,98058,47.4577,-122.171,1510,7700,6290,0.8168831168831169,1988100,59290000,57301900
640000.0,3,2.25,1980,10115,1.0,0,0,2,8,1980,0,1959,0.0,98005,47.6384,-122.17399999999999,2800,10143,8135,0.8042511122095897,3920400,102313225,98392825
710000.0,3,3.5,2440,3427,2.0,0,0,2,7,1990,450,2000,0.0,98005,47.589,-122.165,2440,2601,987,0.2880070032098045,5953600,11744329,5790729
325000.0,3,2.0,1350,11805,1.0,0,0,2,7,1350,0,1986,0.0,98019,47.7313,-121.971,1350,14200,10455,0.8856416772554002,1822500,139358025,137535525
595000.0,3,3.25,3130,28001,1.0,0,0,2,9,2210,920,1985,0.0,98072,47.7741,-122.12200000000001,2710,34999,24871,0.8882182779186457,9796900,784056001,774259101
128750.0,3,1.0,880,7004,1.0,0,0,2,5,880,0,1950,0.0,98002,47.3019,-122.21600000000001,880,7828,6124,0.874357509994289,774400,49056016,48281616
465000.0,3,2.25,1920,7300,1.0,0,0,2,7,1240,680,1961,0.0,98008,47.6078,-122.12799999999999,1920,7700,5380,0.736986301369863,3686400,53290000,49603600
710000.0,4,1.75,2700,7625,1.0,0,0,3,8,1450,1250,1937,0.0,98115,47.6838,-122.323,1760,3300,4925,0.6459016393442623,7290000,58140625,50850625
605000.0,4,2.75,1670,6000,1.0,0,0,4,7,840,830,1917,0.0,98136,47.5496,-122.385,1100,6000,4330,0.7216666666666667,2788900,36000000,33211100
994000.0,4,2.5,3470,20445,2.0,0,0,3,10,3470,0,1963,0.0,98040,47.547,-122.219,3360,21950,16975,0.8302763511861091,12040900,417998025,405957125
489950.0,3,2.25,1820,7326,2.0,0,0,2,8,1820,0,1983,0.0,98034,47.7133,-122.21700000000001,2430,7696,5506,0.7515697515697516,3312400,53670276,50357876
365000.0,3,1.5,1310,8160,1.0,0,0,2,7,1310,0,1950,0.0,98133,47.7291,-122.339,1090,7560,6850,0.8394607843137255,1716100,66585600,64869500
359950.0,3,2.0,1790,7212,1.0,0,0,3,8,1790,0,1998,0.0,98042,47.3898,-122.154,2330,7212,5422,0.7518025513033832,3204100,52012944,48808844
495000.0,4,2.5,2460,4774,2.0,0,0,2,8,2460,0,2006,0.0,98059,47.4912,-122.145,2510,4399,2314,0.48470883954754923,6051600,22791076,16739476
255000.0,3,1.5,1060,9039,1.0,0,0,2,7,1060,0,1973,0.0,98058,47.4293,-122.15100000000001,1410,9515,7979,0.8827303905299259,1123600,81703521,80579921
330000.0,3,1.75,1340,10276,1.0,0,0,3,7,1340,0,1961,0.0,98034,47.7207,-122.22200000000001,2950,7987,8936,0.8695990657843519,1795600,105596176,103800576
450000.0,3,1.75,1480,8394,1.0,0,0,3,8,1480,0,1971,0.0,98052,47.6634,-122.14399999999999,1920,9184,6914,0.8236835835120324,2190400,70459236,68268836
655000.0,4,2.5,3500,11306,2.0,0,2,2,9,3500,0,2005,0.0,98065,47.5428,-121.861,3180,8028,7806,0.690429860251194,12250000,127825636,115575636
485000.0,4,2.75,2910,16362,1.0,0,2,3,9,2120,790,1969,0.0,98003,47.3397,-122.322,2850,14904,13452,0.8221488815548221,8468100,267715044,259246944
375000.0,4,1.75,1940,15909,1.0,0,0,2,8,970,970,1974,0.0,98072,47.7578,-122.094,1940,15120,13969,0.8780564460368345,3763600,253096281,249332681
570000.0,4,2.5,2280,4534,2.0,0,0,2,8,2280,0,2003,0.0,98075,47.5902,-122.01799999999999,2246,4534,2254,0.49713277459197175,5198400,20557156,15358756
350000.0,3,2.25,1190,1022,3.0,0,0,2,8,1190,0,1998,0.0,98103,47.6972,-122.34899999999999,1210,1171,-168,-0.1643835616438356,1416100,1044484,-371616
550000.0,3,1.0,1260,6000,1.0,0,3,2,7,1260,0,1951,0.0,98146,47.5058,-122.384,2020,6600,4740,0.79,1587600,36000000,34412400
513000.0,5,2.0,2270,8652,1.0,0,0,2,7,1150,1120,1965,0.0,98052,47.6692,-122.15100000000001,1950,8050,6382,0.7376329172445677,5152900,74857104,69704204
450000.0,4,2.25,1990,7320,1.0,0,0,3,7,1030,960,1965,0.0,98126,47.5237,-122.376,1320,7320,5330,0.7281420765027322,3960100,53582400,49622300
432500.0,4,1.75,1500,1856,1.0,0,0,4,7,750,750,1901,0.0,98144,47.5917,-122.296,1220,1739,356,0.19181034482758622,2250000,3444736,1194736
432000.0,5,2.75,2060,329903,1.5,0,3,4,7,2060,0,1989,0.0,98022,47.1776,-121.944,2240,220232,327843,0.9937557403236709,4243600,108835989409,108831745809
480000.0,3,2.25,1950,8892,2.0,0,0,2,8,1950,0,1983,0.0,98052,47.7213,-122.11,1900,8750,6942,0.7807017543859649,3802500,79067664,75265164
402200.0,3,1.75,1790,6980,1.0,0,0,2,7,1330,460,1980,0.0,98034,47.7311,-122.226,1770,8081,5190,0.7435530085959885,3204100,48720400,45516300
650000.0,3,1.0,1520,10227,1.0,0,0,3,6,1520,0,1951,0.0,98004,47.5872,-122.196,2710,10912,8707,0.8513738144128288,2310400,104591529,102281129
1200000.0,4,2.5,3240,13044,2.0,0,0,3,9,3240,0,1984,0.0,98040,47.5825,-122.242,2920,13044,9804,0.7516099356025759,10497600,170145936,159648336
312000.0,3,2.0,2440,13250,1.0,0,0,3,8,1440,1000,1977,0.0,98030,47.375,-122.227,2400,10650,10810,0.8158490566037736,5953600,175562500,169608900
610000.0,4,2.0,2220,5821,1.5,0,0,3,7,1380,840,1916,0.0,98116,47.5723,-122.382,1850,5000,3601,0.6186222298574128,4928400,33884041,28955641
823000.0,5,1.75,2640,7722,1.5,0,0,3,7,1650,990,1915,0.0,98117,47.6802,-122.361,1750,4000,5082,0.6581196581196581,6969600,59629284,52659684
471000.0,4,1.75,1450,3750,1.0,0,0,3,7,950,500,1925,0.0,98105,47.6706,-122.3,1850,4000,2300,0.6133333333333333,2102500,14062500,11960000
481015.0,3,2.25,1550,5511,2.0,0,0,2,8,1550,0,1987,0.0,98033,47.6946,-122.185,1620,5511,3961,0.7187443295227727,2402500,30371121,27968621
1960000.0,5,4.5,6200,23373,3.0,0,1,3,11,5050,1150,1988,0.0,98040,47.5632,-122.215,3700,14486,17173,0.7347366619603817,38440000,546297129,507857129
624000.0,4,3.25,2810,11250,1.0,0,0,2,8,1680,1130,1980,0.0,98052,47.692,-122.09899999999999,2110,11250,8440,0.7502222222222222,7896100,126562500,118666400
480000.0,4,2.5,2080,7966,1.0,0,0,2,7,1200,880,1970,0.0,98011,47.7393,-122.181,1920,7500,5886,0.7388902837057494,4326400,63457156,59130756
815000.0,3,1.5,1370,8671,1.0,0,0,2,7,1370,0,1955,0.0,98004,47.6217,-122.198,1580,8671,7301,0.8420020758851343,1876900,75186241,73309341
1650000.0,4,2.25,2920,20400,1.0,0,0,3,11,2920,0,1966,0.0,98004,47.6237,-122.228,3080,20400,17480,0.8568627450980392,8526400,416160000,407633600
180000.0,3,1.0,1000,18513,1.0,0,0,2,6,1000,0,1940,0.0,98146,47.5118,-122.348,1280,8113,17513,0.9459839032031545,1000000,342731169,341731169
156601.0,2,1.75,1210,9750,1.0,0,0,2,7,1210,0,1984,0.0,98038,47.3438,-122.037,1650,9750,8540,0.8758974358974358,1464100,95062500,93598400
374950.0,4,2.5,2790,4650,2.0,0,0,2,8,2790,0,2004,0.0,98038,47.3557,-122.02600000000001,2850,4650,1860,0.4,7784100,21622500,13838400
368000.0,2,1.5,1660,4680,1.0,0,0,4,6,830,830,1908,0.0,98146,47.5134,-122.38799999999999,1930,5400,3020,0.6452991452991453,2755600,21902400,19146800
550000.0,3,2.0,1650,3952,2.0,0,0,2,7,1650,0,1950,0.0,98103,47.6727,-122.33,1210,4560,2302,0.5824898785425101,2722500,15618304,12895804
198000.0,3,1.75,1300,6318,1.0,0,0,2,7,1300,0,1980,0.0,98001,47.2752,-122.251,1150,8002,5018,0.7942386831275721,1690000,39917124,38227124
345000.0,3,1.75,1090,7200,1.0,0,0,2,7,1090,0,1968,0.0,98034,47.7227,-122.179,1240,7200,6110,0.8486111111111111,1188100,51840000,50651900
1710000.0,5,2.5,2660,6572,1.0,0,0,4,9,1960,700,1959,0.0,98039,47.6176,-122.223,3960,14595,3912,0.5952525867315885,7075600,43191184,36115584
185900.0,3,1.0,940,10890,1.0,0,0,3,5,940,0,1909,0.0,98001,47.2763,-122.257,1370,10255,9950,0.9136822773186409,883600,118592100,117708500
950000.0,3,2.75,2750,18029,1.0,0,2,4,9,1810,940,1978,0.0,98006,47.5617,-122.134,2850,10021,15279,0.8474679682733374,7562500,325044841,317482341
995000.0,4,4.5,3850,13551,2.0,0,2,2,10,3000,850,1998,0.0,98006,47.5522,-122.103,3480,10737,9701,0.7158881263375396,14822500,183629601,168807101
345000.0,2,1.0,860,8250,1.0,0,0,2,7,860,0,1940,0.0,98133,47.7132,-122.334,1780,11200,7390,0.8957575757575758,739600,68062500,67322900
741000.0,4,2.75,2070,10125,1.0,0,0,2,7,1390,680,1962,0.0,98040,47.5697,-122.219,1850,10125,8055,0.7955555555555556,4284900,102515625,98230725
737000.0,2,2.25,2290,9772,1.0,0,0,2,8,2290,0,2007,0.0,98053,47.7199,-122.025,1810,6077,7482,0.7656569791240279,5244100,95491984,90247884
668750.0,4,2.5,2340,6420,1.0,0,2,2,8,1590,750,1964,0.0,98177,47.7728,-122.38600000000001,2110,10856,4080,0.6355140186915887,5475600,41216400,35740800
575000.0,3,1.75,2680,8625,1.0,0,0,4,8,1590,1090,1974,0.0,98027,47.5316,-122.056,2620,14275,5945,0.6892753623188406,7182400,74390625,67208225
280000.0,4,2.0,1710,5440,1.0,0,0,4,8,1030,680,1976,0.0,98042,47.36600000000001,-122.09299999999999,1620,6696,3730,0.6856617647058824,2924100,29593600,26669500
583000.0,3,1.5,1800,10050,1.0,0,0,2,7,1800,0,1955,0.0,98008,47.6344,-122.126,1610,10050,8250,0.8208955223880597,3240000,101002500,97762500
196000.0,3,2.25,1510,9600,1.0,0,0,0,7,1090,420,1966,0.0,98028,47.7758,-122.238,1870,10681,8090,0.8427083333333333,2280100,92160000,89879900
349950.0,3,2.5,1700,7496,2.0,0,0,2,8,1700,0,1994,0.0,98055,47.431999999999995,-122.189,2280,7496,5796,0.7732123799359658,2890000,56190016,53300016
429000.0,4,1.0,1350,3333,1.5,0,0,2,7,1350,0,1912,0.0,98107,47.6727,-122.397,1530,5000,1983,0.594959495949595,1822500,11108889,9286389
270000.0,5,2.5,2140,10320,1.0,0,0,3,7,1330,810,1967,0.0,98031,47.3927,-122.194,2050,8964,8180,0.7926356589147286,4579600,106502400,101922800
385000.0,6,4.0,2700,7416,1.0,0,0,2,7,1350,1350,1969,0.0,98108,47.5525,-122.3,2260,5324,4716,0.6359223300970874,7290000,54997056,47707056
535000.0,1,1.0,920,5000,1.0,0,3,3,7,920,0,1906,0.0,98103,47.6748,-122.352,1890,5000,4080,0.816,846400,25000000,24153600
352500.0,3,1.75,1500,10269,1.0,0,0,2,7,1030,470,1958,0.0,98133,47.7672,-122.348,2090,10269,8769,0.8539293017820625,2250000,105452361,103202361
624000.0,3,1.75,1510,5200,1.0,0,0,3,7,860,650,1922,0.0,98117,47.6864,-122.365,1650,4160,3690,0.7096153846153846,2280100,27040000,24759900
215000.0,5,1.5,1980,7958,1.5,0,0,2,7,1980,0,1962,0.0,98058,47.4571,-122.17,1510,8438,5978,0.7511937672782106,3920400,63329764,59409364
870000.0,4,3.0,4500,21780,2.0,0,2,2,9,3040,1460,1980,0.0,98040,47.5581,-122.213,3540,20473,17280,0.7933884297520661,20250000,474368400,454118400
440000.0,4,2.5,3220,8256,2.0,0,0,2,8,2610,610,2006,0.0,98059,47.495,-122.155,2500,9472,5036,0.6099806201550387,10368400,68161536,57793136
518000.0,2,1.5,1140,1149,2.0,0,0,2,7,940,200,2001,0.0,98122,47.6124,-122.314,1460,1149,9,0.007832898172323759,1299600,1320201,20601
259500.0,3,2.25,1490,7589,2.0,0,0,2,7,1490,0,1993,0.0,98038,47.3474,-122.037,1510,6603,6099,0.8036631967321123,2220100,57592921,55372821
795127.0,4,3.25,4360,91158,1.0,0,0,2,10,3360,1000,1993,0.0,98053,47.6398,-121.985,3540,90940,86798,0.9521709559226836,19009600,8309780964,8290771364
290000.0,3,1.0,960,9000,1.0,0,0,3,7,960,0,1955,0.0,98006,47.5765,-122.154,1520,9000,8040,0.8933333333333333,921600,81000000,80078400
385000.0,4,3.0,2253,7700,2.0,0,0,2,7,2253,0,1957,0.0,98198,47.3935,-122.3,1786,9052,5447,0.7074025974025974,5076009,59290000,54213991
259950.0,2,1.0,770,6542,1.0,0,0,2,6,770,0,1948,0.0,98155,47.747,-122.301,1120,8149,5772,0.8822989911342097,592900,42797764,42204864
330000.0,2,2.5,1310,2915,2.0,0,0,2,8,1310,0,1999,0.0,98059,47.4911,-122.154,1310,3425,1605,0.5506003430531733,1716100,8497225,6781125
280000.0,3,1.0,980,7480,1.0,0,0,2,6,830,150,1948,0.0,98106,47.5206,-122.363,1140,7480,6500,0.8689839572192514,960400,55950400,54990000
595000.0,4,2.5,1820,20011,2.0,0,0,2,8,1820,0,1987,0.0,98075,47.5842,-122.045,2710,33915,18191,0.9090500224876318,3312400,400440121,397127721
925900.0,4,3.75,3980,7828,2.0,0,0,2,10,3980,0,2001,0.0,98074,47.6303,-122.065,3980,8910,3848,0.4915687276443536,15840400,61277584,45437184
499000.0,3,2.25,3010,9600,2.0,0,0,2,8,2410,600,1978,0.0,98028,47.7671,-122.26299999999999,2620,9660,6590,0.6864583333333333,9060100,92160000,83099900
325000.0,4,2.5,1830,7762,2.0,0,0,2,8,1830,0,1993,0.0,98003,47.266999999999996,-122.31,2109,8966,5932,0.7642360216439062,3348900,60248644,56899744
895000.0,5,2.5,2550,20875,1.0,0,0,3,9,1610,940,1953,0.0,98004,47.6336,-122.19200000000001,2510,21673,18325,0.8778443113772455,6502500,435765625,429263125
162248.0,2,1.0,800,8960,1.0,0,0,3,6,800,0,1944,0.0,98058,47.4756,-122.17399999999999,850,8082,8160,0.9107142857142857,640000,80281600,79641600
1070000.0,3,2.25,2890,21480,2.0,0,4,2,8,1790,1100,1941,1989.0,98146,47.5027,-122.381,2110,8107,18590,0.8654562383612663,8352100,461390400,453038300
430000.0,3,1.5,1810,5080,1.0,0,0,2,7,1030,780,1958,0.0,98115,47.6819,-122.287,1780,7620,3270,0.6437007874015748,3276100,25806400,22530300
615500.0,3,1.5,1810,5080,1.0,0,0,2,7,1030,780,1958,0.0,98115,47.6819,-122.287,1780,7620,3270,0.6437007874015748,3276100,25806400,22530300
260000.0,3,1.0,940,5650,1.0,0,0,2,6,940,0,1949,0.0,98118,47.5551,-122.292,1180,5276,4710,0.8336283185840708,883600,31922500,31038900
295000.0,4,2.0,1810,42981,1.0,0,0,3,7,1810,0,1973,0.0,98024,47.5597,-121.85,1980,113691,41171,0.9578883692794491,3276100,1847366361,1844090261
1190000.0,3,1.75,2550,6117,2.0,0,0,2,9,1650,900,1951,2004.0,98122,47.6109,-122.285,2100,4967,3567,0.5831289847964689,6502500,37417689,30915189
749950.0,4,2.5,2370,2971,2.0,0,2,2,9,2080,290,2008,0.0,98034,47.7064,-122.22399999999999,2970,7500,601,0.2022887916526422,5616900,8826841,3209941
175000.0,6,1.0,1370,5080,1.5,0,0,2,6,1120,250,1931,0.0,98106,47.5238,-122.35,1020,5080,3710,0.7303149606299213,1876900,25806400,23929500
415000.0,6,1.0,1370,5080,1.5,0,0,2,6,1120,250,1931,0.0,98106,47.5238,-122.35,1020,5080,3710,0.7303149606299213,1876900,25806400,23929500
190000.0,3,1.0,1200,8316,1.0,0,0,3,6,1200,0,1953,0.0,98002,47.3231,-122.215,1250,8316,7116,0.8556998556998557,1440000,69155856,67715856
625000.0,3,1.75,2100,3264,1.5,0,0,4,7,1350,750,1912,0.0,98107,47.6702,-122.36399999999999,1720,3750,1164,0.35661764705882354,4410000,10653696,6243696
420000.0,3,2.25,2020,21010,2.0,0,0,2,7,2020,0,1995,0.0,98014,47.6988,-121.915,1850,18151,18990,0.9038553069966683,4080400,441420100,437339700
339900.0,4,1.5,1570,9210,1.0,0,2,2,7,1400,170,1965,0.0,98030,47.3864,-122.22,2326,9210,7640,0.8295331161780674,2464900,84824100,82359200
160000.0,2,1.0,1140,23030,1.0,0,0,2,8,1140,0,1980,0.0,98028,47.7637,-122.266,1850,14260,21890,0.9504993486756405,1299600,530380900,529081300
353000.0,4,2.5,1830,5331,2.0,0,0,2,7,1830,0,2002,0.0,98038,47.3557,-122.016,1830,5175,3501,0.6567248171074845,3348900,28419561,25070661
390000.0,3,2.0,1010,14183,1.0,0,0,2,8,1010,0,1982,0.0,98074,47.6232,-122.04299999999999,1750,11700,13173,0.9287879856165833,1020100,201157489,200137389
675000.0,4,2.5,1770,9858,1.0,0,2,2,8,1770,0,1971,0.0,98155,47.7382,-122.287,2470,9858,8088,0.8204503956177723,3132900,97180164,94047264
400000.0,3,2.5,2120,3757,2.0,0,0,2,7,2120,0,2006,0.0,98059,47.4787,-122.12799999999999,2230,4103,1637,0.4357199893532073,4494400,14115049,9620649
1340000.0,4,3.5,3190,5040,2.0,0,3,2,10,2160,1030,2003,0.0,98144,47.5928,-122.29,2390,4800,1850,0.36706349206349204,10176100,25401600,15225500
1650000.0,4,2.5,2780,11904,1.0,0,1,4,8,1730,1050,1951,0.0,98004,47.6209,-122.21600000000001,3590,13860,9124,0.7664650537634409,7728400,141705216,133976816
1000000.0,5,3.0,3350,9450,2.0,0,0,4,8,2180,1170,1912,0.0,98103,47.6705,-122.34,2660,4500,6100,0.6455026455026455,11222500,89302500,78080000
850000.0,5,3.5,3450,28324,1.0,0,0,4,8,2350,1100,1972,0.0,98033,47.6991,-122.196,2640,14978,24874,0.8781951701737043,11902500,802248976,790346476
275000.0,3,1.5,1060,6954,1.0,0,0,3,6,1060,0,1983,0.0,98106,47.5498,-122.355,1560,6954,5894,0.8475697440322116,1123600,48358116,47234516
450000.0,3,2.5,1670,2589,2.0,0,0,2,8,1670,0,2000,0.0,98027,47.5314,-122.04700000000001,1670,2897,919,0.35496330629586714,2788900,6702921,3914021
305000.0,4,1.75,2251,12731,1.0,0,1,3,8,1390,861,1957,0.0,98003,47.3369,-122.32,2520,12539,10480,0.8231874950907234,5067001,162078361,157011360
643002.0,3,2.5,1770,3744,1.5,0,0,2,7,1270,500,1929,0.0,98117,47.6807,-122.36399999999999,1400,4680,1974,0.5272435897435898,3132900,14017536,10884636
468000.0,2,1.75,1510,4500,1.0,0,0,2,8,1510,0,1978,0.0,98052,47.6644,-122.13,1740,6000,2990,0.6644444444444444,2280100,20250000,17969900
324950.0,4,2.5,1770,5000,2.0,0,0,2,7,1770,0,2004,0.0,98038,47.3506,-122.006,2080,5100,3230,0.646,3132900,25000000,21867100
290000.0,3,2.0,1260,7346,1.0,0,0,2,7,1260,0,1987,0.0,98031,47.4034,-122.176,1460,7363,6086,0.8284780833106452,1587600,53963716,52376116
488500.0,3,2.0,1710,10959,1.0,0,0,3,7,1030,680,1981,0.0,98033,47.696999999999996,-122.199,1710,10498,9249,0.8439638653161785,2924100,120099681,117175581
367950.0,3,1.75,2290,8234,1.0,0,0,3,7,1250,1040,1950,0.0,98133,47.7611,-122.351,1660,7200,5944,0.721884867622055,5244100,67798756,62554656
285000.0,2,1.0,790,6555,1.0,0,0,1,6,790,0,1956,0.0,98146,47.5015,-122.35,1440,7601,5765,0.8794813119755912,624100,42968025,42343925
417000.0,3,2.75,1820,52889,2.0,0,0,2,8,1820,0,1991,0.0,98070,47.50100000000001,-122.463,1820,45528,51069,0.9655883075875891,3312400,2797246321,2793933921
1120000.0,4,2.5,3180,31931,1.0,0,0,3,10,2390,790,1978,0.0,98007,47.6388,-122.149,3180,35007,28751,0.9004102596223106,10112400,1019588761,1009476361
1550000.0,4,4.0,5280,17677,2.0,0,3,2,11,3220,2060,1978,0.0,98040,47.5323,-122.238,3470,17474,12397,0.70130678282514,27878400,312476329,284597929
604000.0,3,2.5,3240,33151,2.0,0,2,2,10,3240,0,1995,0.0,98023,47.3256,-122.37799999999999,4050,24967,29911,0.9022653916925583,10497600,1098988801,1088491201
380000.0,3,2.5,2390,8102,2.0,0,0,3,8,2390,0,1986,0.0,98058,47.4378,-122.16,2310,8606,5712,0.7050111083683042,5712100,65642404,59930304
336500.0,4,2.5,2500,5264,2.0,0,0,2,7,2500,0,2003,0.0,98038,47.3853,-122.02799999999999,1960,5250,2764,0.5250759878419453,6250000,27709696,21459696
685000.0,4,2.0,2290,6000,1.5,0,3,4,7,2290,0,1900,0.0,98115,47.6807,-122.318,2000,3150,3710,0.6183333333333333,5244100,36000000,30755900
4210000.0,5,6.0,7440,21540,2.0,0,0,2,12,5550,1890,2003,0.0,98006,47.5692,-122.189,4740,19329,14100,0.6545961002785515,55353600,463971600,408618000
670000.0,3,1.0,1600,16868,1.0,0,1,2,7,990,610,1946,0.0,98040,47.5872,-122.241,2600,12735,15268,0.9051458382736542,2560000,284529424,281969424
524000.0,2,1.0,1120,2000,1.5,0,0,2,7,1120,0,1910,0.0,98109,47.6454,-122.354,1500,4000,880,0.44,1254400,4000000,2745600
172000.0,3,1.0,1340,10260,1.0,0,0,2,7,1340,0,1968,0.0,98003,47.3173,-122.31700000000001,1250,8775,8920,0.8693957115009746,1795600,105267600,103472000
680000.0,6,2.0,1670,3000,1.0,0,0,4,7,900,770,1911,0.0,98105,47.6637,-122.316,1330,1099,1330,0.44333333333333336,2788900,9000000,6211100
549900.0,4,3.0,2830,213879,2.0,0,0,3,8,2830,0,1987,0.0,98092,47.2925,-122.10700000000001,2250,213008,211049,0.9867682194137807,8008900,45744226641,45736217741
357000.0,4,2.75,2700,49428,1.0,0,0,3,9,2700,0,1988,0.0,98042,47.3168,-122.079,2728,85905,46728,0.945375091041515,7290000,2443127184,2435837184
107000.0,3,1.5,910,5120,1.0,0,0,2,6,910,0,1973,0.0,98106,47.5238,-122.35600000000001,1410,5132,4210,0.822265625,828100,26214400,25386300
232900.0,3,1.5,910,5120,1.0,0,0,2,6,910,0,1973,0.0,98106,47.5238,-122.35600000000001,1410,5132,4210,0.822265625,828100,26214400,25386300
800000.0,4,3.5,2370,3302,2.0,0,0,2,8,1610,760,1926,2014.0,98103,47.684,-122.34100000000001,2170,3800,932,0.28225317989097515,5616900,10903204,5286304
248500.0,2,1.5,880,1498,2.0,0,0,2,7,880,0,1999,0.0,98133,47.7063,-122.34200000000001,880,5060,618,0.41255006675567424,774400,2244004,1469604
670000.0,3,2.5,2050,6420,1.0,0,3,2,8,1730,320,1956,0.0,98116,47.5708,-122.405,2370,7620,4370,0.6806853582554517,4202500,41216400,37013900
207000.0,3,1.75,1180,21275,1.0,0,0,3,6,1180,0,1958,0.0,98038,47.4018,-122.037,1490,35100,20095,0.9445358401880141,1392400,452625625,451233225
164000.0,3,1.0,1070,8250,1.0,0,0,2,7,1070,0,1961,0.0,98092,47.2899,-122.19200000000001,1190,8250,7180,0.8703030303030304,1144900,68062500,66917600
570500.0,2,1.0,1380,1800,2.0,0,0,2,7,1080,300,1954,0.0,98119,47.6416,-122.361,1600,3600,420,0.23333333333333334,1904400,3240000,1335600
599990.0,3,2.25,2680,9162,1.0,0,0,2,8,1570,1110,1978,0.0,98027,47.5683,-122.09100000000001,2480,8261,6482,0.7074874481554245,7182400,83942244,76759844
395000.0,5,1.75,2100,9599,1.0,0,0,2,7,1060,1040,1961,0.0,98034,47.7097,-122.21600000000001,1680,10712,7499,0.78122721116783,4410000,92140801,87730801
979500.0,4,3.75,4133,361548,2.0,0,0,2,11,4133,0,2000,0.0,98019,47.7479,-121.97200000000001,1970,291416,357415,0.9885685994667375,17081689,130716956304,130699874615
207000.0,3,1.0,920,5546,1.0,0,0,1,6,920,0,1928,0.0,98125,47.7114,-122.28399999999999,1300,5546,4626,0.8341146772448612,846400,30758116,29911716
237000.0,3,1.0,920,5546,1.0,0,0,1,6,920,0,1928,0.0,98125,47.7114,-122.28399999999999,1300,5546,4626,0.8341146772448612,846400,30758116,29911716
650100.0,2,1.0,1750,60872,1.0,0,0,3,7,1180,570,1973,0.0,98075,47.5946,-122.006,2480,5425,59122,0.9712511499540019,3062500,3705400384,3702337884
385000.0,4,2.5,1950,7350,1.0,0,0,2,7,1150,800,1963,0.0,98052,47.65600000000001,-122.134,2050,9068,5400,0.7346938775510204,3802500,54022500,50220000
335000.0,2,1.75,1660,11437,2.0,0,0,2,7,1660,0,1958,1992.0,98146,47.4899,-122.339,1290,7860,9777,0.8548570429308385,2755600,130804969,128049369
347000.0,4,1.5,2670,10026,2.0,0,0,2,8,2670,0,1996,0.0,98092,47.2659,-122.215,2420,11900,7356,0.7336923997606224,7128900,100520676,93391776
204000.0,3,1.0,980,8000,1.0,0,0,3,6,980,0,1954,0.0,98198,47.42,-122.31700000000001,1240,8000,7020,0.8775,960400,64000000,63039600
615000.0,4,2.25,1780,10260,2.0,0,0,2,8,1780,0,1971,0.0,98052,47.6647,-122.14200000000001,2360,10080,8480,0.8265107212475633,3168400,105267600,102099200
943500.0,3,2.25,2370,10890,2.0,0,0,3,7,2370,0,1980,0.0,98004,47.5827,-122.197,2370,9514,8520,0.7823691460055097,5616900,118592100,112975200
560000.0,3,2.0,1640,7333,1.0,0,0,3,7,1020,620,1941,0.0,98108,47.5636,-122.316,2130,4933,5693,0.7763534706123005,2689600,53772889,51083289
547500.0,4,2.5,2610,7254,1.0,0,0,1,8,1610,1000,1975,0.0,98006,47.5618,-122.176,2250,7407,4644,0.6401985111662531,6812100,52620516,45808416
359500.0,4,1.75,2030,7210,1.0,0,0,2,7,1450,580,1968,0.0,98059,47.5067,-122.164,1750,8387,5180,0.7184466019417476,4120900,51984100,47863200
660000.0,3,2.5,2590,35640,1.0,0,0,2,9,2590,0,1987,0.0,98029,47.5516,-122.03,2590,31200,33050,0.9273288439955106,6708100,1270209600,1263501500
258000.0,3,1.75,1620,7540,1.0,0,0,2,7,1310,310,1988,0.0,98038,47.3635,-122.052,1580,7540,5920,0.7851458885941645,2624400,56851600,54227200
355000.0,3,1.75,2040,22693,1.0,0,0,3,8,2040,0,1980,0.0,98042,47.3519,-122.14,1950,6280,20653,0.9101044374917375,4161600,514972249,510810649
253500.0,2,1.0,810,4800,1.0,0,0,2,7,810,0,1948,0.0,98126,47.5232,-122.375,1240,7740,3990,0.83125,656100,23040000,22383900
422500.0,3,1.0,1270,8920,1.0,0,0,4,7,1270,0,1969,0.0,98056,47.534,-122.17200000000001,1590,8589,7650,0.8576233183856502,1612900,79566400,77953500
239000.0,2,2.0,1470,2052,1.5,0,0,2,7,1470,0,1986,0.0,98003,47.3086,-122.32799999999999,1470,2052,582,0.28362573099415206,2160900,4210704,2049804
628000.0,3,2.25,1720,8521,1.0,0,0,3,7,1140,580,1984,0.0,98033,47.6882,-122.184,1530,8692,6801,0.7981457575401948,2958400,72607441,69649041
352000.0,2,2.5,1320,1957,1.0,0,0,2,8,660,660,2004,0.0,98106,47.5364,-122.365,1420,2198,637,0.3254982115482882,1742400,3829849,2087449
311600.0,3,2.25,1358,1196,3.0,0,0,2,7,1358,0,2007,0.0,98133,47.7052,-122.346,1358,1196,-162,-0.1354515050167224,1844164,1430416,-413748
235000.0,4,1.5,2070,7245,1.0,0,0,3,7,1060,1010,1964,0.0,98001,47.3417,-122.281,1450,7350,5175,0.7142857142857143,4284900,52490025,48205125
870000.0,5,2.25,2910,9525,2.0,0,0,3,9,2910,0,1968,0.0,98040,47.5633,-122.21799999999999,2740,9525,6615,0.694488188976378,8468100,90725625,82257525
190848.0,4,1.5,1370,7904,1.0,0,0,2,7,900,470,1970,0.0,98001,47.3344,-122.28,1370,7900,6534,0.8266700404858299,1876900,62473216,60596316
570000.0,4,1.75,2340,5080,1.0,0,0,4,7,1170,1170,1924,0.0,98115,47.6746,-122.32,1270,3270,2740,0.5393700787401575,5475600,25806400,20330800
661254.0,4,4.0,2290,6250,1.5,0,0,4,7,1690,600,1940,0.0,98116,47.5824,-122.384,1920,4335,3960,0.6336,5244100,39062500,33818400
575000.0,4,2.0,1650,5000,1.0,0,0,2,7,1650,0,1955,0.0,98117,47.6781,-122.374,1690,2276,3350,0.67,2722500,25000000,22277500
230000.0,2,0.75,650,5360,1.0,0,0,3,5,650,0,1931,0.0,98133,47.7281,-122.335,1110,6700,4710,0.878731343283582,422500,28729600,28307100
680000.0,3,2.25,2300,9914,2.0,0,0,3,8,2300,0,1980,0.0,98027,47.5677,-122.086,2240,9032,7614,0.7680048416380876,5290000,98287396,92997396
148000.0,1,1.0,620,8261,1.0,0,0,2,5,620,0,1939,0.0,98106,47.5138,-122.36399999999999,1180,8244,7641,0.924948553443893,384400,68244121,67859721
244900.0,1,1.0,620,8261,1.0,0,0,2,5,620,0,1939,0.0,98106,47.5138,-122.36399999999999,1180,8244,7641,0.924948553443893,384400,68244121,67859721
214950.0,3,1.0,1400,6600,1.0,0,0,2,6,1280,120,1954,0.0,98168,47.4845,-122.331,1730,6600,5200,0.7878787878787878,1960000,43560000,41600000
580000.0,3,1.5,1800,6250,1.0,0,0,2,8,1420,380,1947,0.0,98116,47.5778,-122.389,1800,5625,4450,0.712,3240000,39062500,35822500
263000.0,3,1.5,1300,7885,1.0,0,0,2,7,1300,0,1968,0.0,98055,47.4556,-122.209,1840,7600,6585,0.8351299936588459,1690000,62173225,60483225
317000.0,5,2.5,2360,11375,1.0,0,0,3,7,1180,1180,1962,0.0,98178,47.4875,-122.255,1160,7800,9015,0.7925274725274726,5569600,129390625,123821025
302000.0,4,3.0,3320,13500,1.0,0,0,2,7,1750,1570,1963,0.0,98059,47.4596,-122.065,1830,13800,10180,0.7540740740740741,11022400,182250000,171227600
899000.0,3,1.0,1480,6978,2.0,0,0,3,8,1480,0,1949,1985.0,98004,47.6497,-122.21700000000001,2660,13062,5498,0.7879048437947836,2190400,48692484,46502084
1290000.0,3,2.5,2190,11394,1.0,0,0,2,8,1550,640,1956,0.0,98199,47.6685,-122.40899999999999,2190,9540,9204,0.8077935755660874,4796100,129823236,125027136
710000.0,3,3.25,3740,136915,2.5,0,0,2,11,3100,640,1990,0.0,98166,47.4549,-122.363,2400,16104,133175,0.9726837819084834,13987600,18745717225,18731729625
230000.0,3,1.0,1360,9310,1.0,0,0,3,7,1020,340,1980,0.0,98056,47.4901,-122.185,1480,8330,7950,0.8539205155746509,1849600,86676100,84826500
430000.0,3,1.0,1210,5200,1.0,0,0,2,6,1210,0,1941,0.0,98126,47.53100000000001,-122.37299999999999,890,5200,3990,0.7673076923076924,1464100,27040000,25575900
1170000.0,5,4.25,4610,13252,2.0,0,4,2,11,4610,0,2004,0.0,98075,47.5878,-121.969,4400,15154,8642,0.6521279806821612,21252100,175615504,154363404
397000.0,3,1.0,860,6380,1.5,0,0,3,7,860,0,1927,0.0,98115,47.6942,-122.315,1250,6380,5520,0.8652037617554859,739600,40704400,39964800
595000.0,3,2.5,2250,8300,2.0,0,0,2,8,2250,0,2003,0.0,98125,47.7174,-122.30799999999999,1790,7626,6050,0.7289156626506024,5062500,68890000,63827500
485000.0,3,1.75,2030,10089,1.0,0,0,3,8,1330,700,1976,0.0,98027,47.5217,-122.05,2030,9827,8059,0.7987907622162751,4120900,101787921,97667021
755000.0,5,2.5,3260,24300,1.5,0,1,3,8,2310,950,1950,0.0,98155,47.7587,-122.274,2390,32057,21040,0.8658436213991769,10627600,590490000,579862400
185000.0,3,1.0,1840,8100,1.0,0,0,3,7,920,920,1953,0.0,98166,47.455,-122.35,1250,8100,6260,0.7728395061728395,3385600,65610000,62224400
340000.0,3,1.0,1840,8100,1.0,0,0,3,7,920,920,1953,0.0,98166,47.455,-122.35,1250,8100,6260,0.7728395061728395,3385600,65610000,62224400
236000.0,4,2.75,2000,5827,2.0,0,0,2,7,2000,0,1997,0.0,98038,47.3629,-122.02600000000001,1710,6929,3827,0.6567702076540244,4000000,33953929,29953929
550000.0,4,2.5,2810,7549,2.0,0,0,2,9,2810,0,1992,0.0,98072,47.7441,-122.17299999999999,2750,7642,4739,0.6277652669227712,7896100,56987401,49091301
680000.0,3,2.0,1780,5720,1.0,0,0,4,7,980,800,1925,0.0,98103,47.6794,-122.351,1620,5050,3940,0.6888111888111889,3168400,32718400,29550000
630000.0,4,2.5,2540,8706,2.0,0,0,2,9,2540,0,1997,0.0,98075,47.5855,-122.031,2540,6239,6166,0.7082471858488398,6451600,75794436,69342836
560000.0,3,2.0,2340,3477,1.0,0,1,4,7,1170,1170,1971,0.0,98118,47.54,-122.26700000000001,2110,6300,1137,0.3270060396893874,5475600,12089529,6613929
385000.0,3,2.0,1480,6600,1.0,0,2,2,7,740,740,1943,0.0,98146,47.5081,-122.385,1250,7300,5120,0.7757575757575758,2190400,43560000,41369600
280000.0,3,2.25,1358,1141,3.0,0,0,2,7,1358,0,2007,0.0,98133,47.7052,-122.346,1358,1196,-217,-0.1901840490797546,1844164,1301881,-542283
225000.0,3,2.5,1750,7490,1.0,0,0,3,7,1180,570,1979,0.0,98042,47.3746,-122.149,1570,7490,5740,0.7663551401869159,3062500,56100100,53037600
610000.0,4,1.75,1830,29110,2.0,0,0,2,8,1230,600,1990,0.0,98040,47.5449,-122.215,3630,16488,27280,0.9371350051528684,3348900,847392100,844043200
592500.0,3,2.0,1170,6750,1.0,0,0,4,7,800,370,1947,0.0,98115,47.6752,-122.281,1330,6750,5580,0.8266666666666667,1368900,45562500,44193600
750000.0,4,2.75,3170,7634,2.0,0,0,2,10,3170,0,1992,0.0,98075,47.5774,-122.054,2940,7846,4464,0.584752423369138,10048900,58277956,48229056
164000.0,4,1.0,1530,4875,2.0,0,0,2,7,1530,0,1977,0.0,98042,47.3638,-122.09100000000001,1470,4875,3345,0.6861538461538461,2340900,23765625,21424725
320000.0,2,1.0,1100,8281,1.0,0,0,3,7,1100,0,1947,0.0,98155,47.7414,-122.315,1510,8281,7181,0.8671658012317353,1210000,68574961,67364961
544000.0,4,2.5,2030,3974,2.0,0,0,2,8,2030,0,1994,0.0,98029,47.5692,-122.006,1780,3953,1944,0.4891796678409663,4120900,15792676,11671776
344950.0,3,1.75,1870,7500,1.0,0,0,4,8,1320,550,1978,0.0,98058,47.4428,-122.134,1870,7275,5630,0.7506666666666667,3496900,56250000,52753100
539500.0,3,2.5,3080,12476,2.0,0,0,2,10,3080,0,1990,0.0,98038,47.3752,-122.029,3130,13631,9396,0.7531260019236935,9486400,155650576,146164176
420000.0,4,1.75,2480,60548,1.0,0,0,3,7,1600,880,1968,0.0,98027,47.4722,-122.001,2390,90169,58068,0.959040761049085,6150400,3666060304,3659909904
305000.0,2,1.0,910,22725,1.0,0,0,0,6,910,0,1926,0.0,98155,47.7712,-122.29899999999999,2000,14566,21815,0.9599559955995599,828100,516425625,515597525
229000.0,2,1.0,810,5100,1.0,0,0,2,6,810,0,1955,0.0,98133,47.7317,-122.34299999999999,1500,5100,4290,0.8411764705882353,656100,26010000,25353900
1070000.0,5,3.5,3990,9938,2.0,0,0,2,11,3990,0,2001,0.0,98059,47.5198,-122.156,3490,11734,5948,0.598510766753874,15920100,98763844,82843744
397500.0,3,2.25,1430,1383,3.0,0,0,2,8,1430,0,2005,0.0,98103,47.6917,-122.34100000000001,1430,1347,-47,-0.03398409255242227,2044900,1912689,-132211
540000.0,4,2.0,2190,8402,2.0,0,0,3,6,2190,0,1928,0.0,98033,47.6944,-122.175,2210,7802,6212,0.739347774339443,4796100,70593604,65797504
650000.0,4,2.5,2290,10186,2.0,0,0,2,8,2290,0,1985,0.0,98008,47.6353,-122.124,2150,10186,7896,0.7751816218338896,5244100,103754596,98510496
1900000.0,6,4.0,3020,13237,2.0,1,4,2,8,2840,180,1942,1983.0,98144,47.5924,-122.287,3680,12620,10217,0.7718516280123895,9120400,175218169,166097769
649000.0,2,1.75,2260,280962,2.0,0,2,2,9,1890,370,2005,0.0,98014,47.6359,-121.94,2860,219542,278702,0.9919562076010279,5107600,78939645444,78934537844
287500.0,5,2.0,2020,67953,1.5,0,0,3,7,1620,400,1936,0.0,98178,47.4891,-122.26299999999999,1270,13198,65933,0.9702735714390829,4080400,4617610209,4613529809
815000.0,4,2.75,2620,4743,1.0,0,2,3,8,1310,1310,1949,0.0,98117,47.6829,-122.4,1900,4764,2123,0.44760699978916296,6864400,22496049,15631649
795000.0,2,2.5,2830,8630,2.0,0,0,2,10,2830,0,2001,0.0,98074,47.6481,-122.081,3190,7515,5800,0.6720741599073001,8008900,74476900,66468000
502775.0,3,1.75,1700,9840,1.0,0,0,3,8,1200,500,1976,0.0,98027,47.5192,-122.046,2040,14169,8140,0.8272357723577236,2890000,96825600,93935600
222900.0,2,1.0,1110,6411,1.0,0,0,2,6,1110,0,1944,0.0,98178,47.4962,-122.242,1150,6504,5301,0.8268600842302293,1232100,41100921,39868821
399950.0,4,3.0,2150,64694,1.0,0,0,2,8,1450,700,1969,0.0,98023,47.3268,-122.38799999999999,2430,59612,62544,0.9667666244164838,4622500,4185313636,4180691136
728000.0,4,2.5,2650,13684,2.0,0,0,2,9,2650,0,1994,0.0,98052,47.6278,-122.10799999999999,2650,12032,11034,0.8063431745103771,7022500,187251856,180229356
850000.0,5,3.5,3870,65556,2.0,0,0,2,10,3870,0,1994,0.0,98053,47.6403,-121.992,4290,67019,61686,0.9409665019220209,14976900,4297589136,4282612236
525000.0,4,2.75,2530,17856,2.0,0,0,2,8,2530,0,1998,0.0,98019,47.7356,-121.959,2530,14640,15326,0.8583109318996416,6400900,318836736,312435836
257000.0,3,1.0,1450,7850,1.5,0,0,4,7,1450,0,1910,0.0,98055,47.4299,-122.199,1360,10400,6400,0.8152866242038217,2102500,61622500,59520000
433500.0,3,2.5,2200,3360,2.0,0,0,2,8,2200,0,2009,0.0,98118,47.5418,-122.287,2130,3423,1160,0.34523809523809523,4840000,11289600,6449600
314950.0,4,1.75,1890,9623,1.0,0,0,3,7,1290,600,1969,0.0,98001,47.2901,-122.279,1510,9711,7733,0.8035955523225605,3572100,92602129,89030029
500000.0,3,1.75,1530,14633,1.0,0,0,2,7,1100,430,1977,0.0,98052,47.6949,-122.119,1780,8100,13103,0.8954418096084193,2340900,214124689,211783789
300000.0,3,1.5,1590,8911,1.0,0,0,2,7,1590,0,1956,0.0,98028,47.7394,-122.25200000000001,1590,9625,7321,0.821568847491864,2528100,79405921,76877821
645000.0,4,2.5,2690,18653,2.0,0,0,2,8,2690,0,1985,0.0,98074,47.6449,-122.059,2230,9744,15963,0.8557872728247466,7236100,347934409,340698309
222500.0,3,1.0,990,10125,1.0,0,0,2,7,990,0,1972,0.0,98042,47.3422,-122.089,1360,10125,9135,0.9022222222222223,980100,102515625,101535525
275000.0,3,1.75,1300,8099,1.0,0,0,3,7,1080,220,1976,0.0,98056,47.5026,-122.17200000000001,1270,8099,6799,0.8394863563402889,1690000,65593801,63903801
498000.0,3,1.5,1720,6570,1.5,0,0,3,8,1720,0,1909,0.0,98118,47.5284,-122.265,1360,6000,4850,0.7382039573820396,2958400,43164900,40206500
800000.0,3,1.75,2080,75794,1.0,0,0,2,7,2080,0,1958,0.0,98033,47.7018,-122.189,1870,11020,73714,0.972557194500884,4326400,5744730436,5740404036
297000.0,3,2.5,1840,8234,2.0,0,0,2,8,1840,0,1994,0.0,98003,47.266999999999996,-122.31200000000001,1940,7601,6394,0.776536312849162,3385600,67798756,64413156
625000.0,5,3.5,4010,6000,2.0,0,3,2,9,2560,1450,1997,0.0,98178,47.4928,-122.229,2440,6000,1990,0.33166666666666667,16080100,36000000,19919900
770000.0,4,2.5,3560,6187,2.0,0,0,2,9,3560,0,2003,0.0,98029,47.5593,-122.016,3190,6981,2627,0.4245999676741555,12673600,38278969,25605369
517000.0,3,2.25,1640,4635,1.5,0,0,2,8,1540,100,1930,0.0,98115,47.6793,-122.319,1530,4635,2995,0.6461704422869471,2689600,21483225,18793625
238000.0,1,1.0,530,6350,1.0,0,0,4,5,530,0,1941,0.0,98103,47.6946,-122.35700000000001,1200,6350,5820,0.9165354330708662,280900,40322500,40041600
234550.0,3,1.0,1990,15375,1.0,0,0,2,7,1140,850,1946,0.0,98168,47.4778,-122.288,1160,10236,13385,0.8705691056910569,3960100,236390625,232430525
230500.0,3,2.25,1690,7245,1.0,0,1,2,7,1160,530,1973,0.0,98003,47.3505,-122.305,1690,6720,5555,0.766735679779158,2856100,52490025,49633925
585000.0,5,2.5,2670,16777,1.5,0,0,3,7,1620,1050,1920,0.0,98125,47.7015,-122.301,1610,8227,14107,0.8408535495022949,7128900,281467729,274338829
733000.0,4,1.75,1930,3876,1.5,0,0,4,7,1450,480,1924,0.0,98105,47.6604,-122.324,1280,3825,1946,0.5020639834881321,3724900,15023376,11298476
357950.0,2,1.0,810,3880,1.0,0,0,2,7,810,0,1952,0.0,98107,47.6631,-122.365,900,4365,3070,0.7912371134020618,656100,15054400,14398300
530000.0,3,1.75,1550,3680,1.0,0,0,2,7,1050,500,1927,0.0,98117,47.6817,-122.36,1560,4000,2130,0.5788043478260869,2402500,13542400,11139900
377500.0,4,2.5,2640,10720,2.0,0,0,2,8,2640,0,1999,0.0,98188,47.4485,-122.27799999999999,1680,10018,8080,0.753731343283582,6969600,114918400,107948800
475000.0,4,2.5,2320,10046,2.0,0,0,2,7,2320,0,2006,0.0,98065,47.5406,-121.887,2320,5253,7726,0.7690623133585507,5382400,100922116,95539716
399000.0,3,1.75,2170,73616,1.0,0,0,2,7,2170,0,2008,0.0,98092,47.2881,-122.086,1710,297514,71446,0.9705227124538144,4708900,5419315456,5414606556
660000.0,3,2.0,2080,5750,1.0,0,0,4,7,1040,0,1926,0.0,98116,47.5791,-122.39200000000001,1710,4830,3670,0.6382608695652174,4326400,33062500,28736100
400000.0,5,2.25,2070,10488,1.0,0,0,3,7,1080,990,1958,0.0,98008,47.6095,-122.12200000000001,1740,9225,8418,0.8026315789473685,4284900,109998144,105713244
440000.0,2,1.0,800,4850,1.0,0,0,3,7,800,0,1944,0.0,98107,47.6639,-122.36399999999999,1150,4365,4050,0.8350515463917526,640000,23522500,22882500
366400.0,4,2.25,2040,14383,1.0,0,0,3,8,1270,770,1977,0.0,98042,47.3849,-122.163,2030,11500,12343,0.8581658902871445,4161600,206870689,202709089
627250.0,4,2.5,2830,10677,2.0,0,0,2,9,2830,0,1993,0.0,98011,47.742,-122.208,2970,9619,7847,0.7349442727357872,8008900,113998329,105989429
375950.0,3,1.75,1480,7560,1.0,0,0,2,6,1100,380,1920,1985.0,98117,47.6985,-122.36399999999999,1510,7250,6080,0.8042328042328042,2190400,57153600,54963200
162000.0,3,2.25,1810,6750,1.0,0,0,2,7,1280,530,1978,0.0,98023,47.2976,-122.37700000000001,1690,7770,4940,0.7318518518518519,3276100,45562500,42286400
780000.0,3,2.75,1970,2600,2.5,0,0,2,8,1970,0,1924,1994.0,98103,47.663000000000004,-122.335,1680,3120,630,0.2423076923076923,3880900,6760000,2879100
705000.0,4,2.5,2650,4316,1.5,0,0,2,8,1520,1130,1905,2013.0,98116,47.5866,-122.389,1690,5625,1666,0.3860055607043559,7022500,18627856,11605356
450000.0,4,2.5,2820,15233,1.0,0,2,3,9,1820,1000,1972,0.0,98003,47.3426,-122.321,2560,11998,12413,0.8148755990284251,7952400,232044289,224091889
311000.0,3,2.75,1400,7880,1.0,0,0,2,7,1000,400,1981,0.0,98056,47.5095,-122.193,1400,7279,6480,0.8223350253807107,1960000,62094400,60134400
485000.0,3,2.5,1580,6065,2.0,0,0,2,8,1580,0,1985,0.0,98029,47.5692,-122.021,1770,6700,4485,0.7394888705688376,2496400,36784225,34287825
485000.0,3,2.5,1800,11034,2.0,0,0,3,8,1800,0,1987,0.0,98072,47.7558,-122.14200000000001,1940,8900,9234,0.8368678629690048,3240000,121749156,118509156
725000.0,5,3.75,3360,6000,2.0,0,0,2,8,2640,720,1963,1999.0,98118,47.558,-122.277,1930,6000,2640,0.44,11289600,36000000,24710400
185000.0,3,1.0,1510,17040,1.0,0,0,3,6,1510,0,1975,0.0,98001,47.2649,-122.285,1520,14000,15530,0.9113849765258216,2280100,290361600,288081500
1890000.0,4,4.25,4285,9345,2.0,0,0,2,10,4285,0,2013,0.0,98004,47.6332,-122.199,1570,8994,5060,0.541466024612092,18361225,87329025,68967800
260000.0,3,2.25,1610,7423,2.0,0,0,3,7,1610,0,1990,0.0,98042,47.3713,-122.09100000000001,1530,8102,5813,0.783106560689748,2592100,55100929,52508829
356000.0,4,2.5,2470,5074,2.0,0,0,2,8,2470,0,2004,0.0,98038,47.3457,-122.041,2470,5078,2604,0.5132045723295231,6100900,25745476,19644576
225205.0,3,1.0,1200,7220,1.0,0,0,2,6,1200,0,1977,0.0,98030,47.3746,-122.18299999999999,1200,7200,6020,0.8337950138504155,1440000,52128400,50688400
445000.0,3,1.0,1260,8910,1.0,0,0,3,7,1260,0,1949,0.0,98117,47.7,-122.375,1560,8910,7650,0.8585858585858586,1587600,79388100,77800500
356000.0,2,1.0,920,4095,1.0,0,0,3,6,920,0,1914,0.0,98118,47.5484,-122.27799999999999,1460,4945,3175,0.7753357753357754,846400,16769025,15922625
760250.0,5,2.75,2540,8250,1.0,0,0,3,7,1440,1100,1953,0.0,98040,47.5875,-122.24,2540,11000,5710,0.6921212121212121,6451600,68062500,61610900
572000.0,2,2.0,1870,5143,1.0,0,0,2,8,1870,0,2005,0.0,98053,47.7142,-122.03299999999999,1810,5143,3273,0.6363989889169746,3496900,26450449,22953549
970000.0,3,2.25,3060,9950,1.5,0,2,3,9,1810,1250,1930,0.0,98144,47.57899999999999,-122.28399999999999,4950,10655,6890,0.6924623115577889,9363600,99002500,89638900
348450.0,4,2.5,1950,8628,2.0,0,0,2,8,1950,0,1994,0.0,98038,47.3817,-122.035,2210,9019,6678,0.7739916550764951,3802500,74442384,70639884
535500.0,3,1.5,1730,40250,2.0,0,0,3,8,1730,0,1983,0.0,98072,47.7499,-122.111,1730,36250,38520,0.9570186335403726,2992900,1620062500,1617069600
710000.0,5,2.5,2570,9600,1.0,0,2,2,8,1620,950,1956,0.0,98125,47.7216,-122.28200000000001,2680,9900,7030,0.7322916666666667,6604900,92160000,85555100
745000.0,3,1.75,1490,9800,1.0,0,0,3,7,1140,350,1947,0.0,98004,47.583999999999996,-122.198,2310,9800,8310,0.8479591836734693,2220100,96040000,93819900
355000.0,4,2.5,2040,8265,2.0,0,0,2,7,2040,0,1996,0.0,98146,47.4973,-122.34100000000001,2160,8265,6225,0.7531760435571688,4161600,68310225,64148625
333000.0,4,2.5,2690,5505,2.0,0,0,2,8,2690,0,2004,0.0,98042,47.3666,-122.119,2690,5505,2815,0.5113533151680291,7236100,30305025,23068925
282000.0,3,2.5,1610,6000,2.0,0,0,3,7,1610,0,1993,0.0,98038,47.349,-122.036,1570,6000,4390,0.7316666666666667,2592100,36000000,33407900
840500.0,3,2.0,2520,5400,1.5,0,0,3,8,1410,1110,1906,0.0,98119,47.6365,-122.361,1960,5400,2880,0.5333333333333333,6350400,29160000,22809600
432000.0,3,1.75,1550,8134,1.0,0,0,3,7,1550,0,1959,0.0,98008,47.6136,-122.12100000000001,1360,8000,6584,0.8094418490287681,2402500,66161956,63759456
625000.0,3,1.0,1800,4800,1.0,0,2,3,9,900,900,1927,0.0,98126,47.5672,-122.37200000000001,1400,4800,3000,0.625,3240000,23040000,19800000
209977.0,3,1.0,1170,6134,1.0,0,0,3,7,1170,0,1948,0.0,98168,47.4941,-122.31200000000001,1440,9823,4964,0.8092598630583632,1368900,37625956,36257056
174000.0,2,1.0,900,13531,1.0,0,0,2,6,900,0,1979,0.0,98001,47.2616,-122.251,1767,8308,12631,0.9334860690266795,810000,183087961,182277961
740000.0,4,2.0,2800,8540,1.0,0,0,3,8,1730,1070,1977,0.0,98052,47.6869,-122.126,2470,9400,5740,0.6721311475409836,7840000,72931600,65091600
518000.0,3,1.75,1830,4500,1.5,0,0,3,7,1830,0,1909,0.0,98115,47.676,-122.30799999999999,1830,4080,2670,0.5933333333333334,3348900,20250000,16901100
539000.0,3,1.75,1380,3225,1.0,0,0,3,7,940,440,1915,0.0,98103,47.6652,-122.338,1250,3750,1845,0.5720930232558139,1904400,10400625,8496225
575000.0,3,2.75,1990,9600,1.0,0,0,2,8,1530,460,1978,0.0,98027,47.532,-122.05,2170,10400,7610,0.7927083333333333,3960100,92160000,88199900
530000.0,2,1.75,1170,976,2.0,0,0,2,9,780,390,2010,0.0,98102,47.6192,-122.316,1280,1183,-194,-0.1987704918032787,1368900,952576,-416324
242025.0,4,1.75,1400,54014,1.5,0,0,3,7,1400,0,1935,0.0,98031,47.4153,-122.184,1910,8523,52614,0.9740807938682564,1960000,2917512196,2915552196
1030000.0,4,2.5,2620,11200,1.0,0,0,3,8,1770,850,1962,0.0,98004,47.5876,-122.193,2360,11200,8580,0.7660714285714286,6864400,125440000,118575600
230000.0,3,1.0,880,7500,1.0,0,0,2,7,880,0,1978,0.0,98198,47.3837,-122.307,880,7500,6620,0.8826666666666667,774400,56250000,55475600
350000.0,4,2.5,2260,7500,1.0,0,0,2,8,1460,800,1965,0.0,98055,47.4645,-122.196,2260,7500,5240,0.6986666666666667,5107600,56250000,51142400
595000.0,3,1.0,1300,11520,1.0,0,0,2,6,1300,0,1958,0.0,98033,47.6829,-122.195,1440,8064,10220,0.8871527777777778,1690000,132710400,131020400
440000.0,3,1.75,1450,6829,1.0,0,0,2,8,1450,0,1983,0.0,98052,47.7222,-122.10799999999999,1950,7622,5379,0.787670229901889,2102500,46635241,44532741
550000.0,3,1.0,1110,6000,1.0,0,0,2,7,1110,0,1904,0.0,98109,47.6461,-122.35700000000001,1460,6000,4890,0.815,1232100,36000000,34767900
940000.0,4,2.25,1890,5940,1.0,0,1,2,9,1470,420,1963,0.0,98112,47.6316,-122.303,2430,5940,4050,0.6818181818181818,3572100,35283600,31711500
375000.0,3,1.5,1100,1751,2.0,0,0,2,8,940,160,2007,0.0,98144,47.5927,-122.306,1380,1751,651,0.37178754997144486,1210000,3066001,1856001
567500.0,2,1.5,1350,4592,1.0,0,0,2,7,1070,280,1939,0.0,98199,47.6511,-122.405,1610,5102,3242,0.7060104529616724,1822500,21086464,19263964
735000.0,3,2.5,3020,50800,1.0,0,0,4,8,1510,1510,1968,0.0,98029,47.5529,-122.02600000000001,2400,27135,47780,0.9405511811023622,9120400,2580640000,2571519600
114000.0,2,1.0,730,5200,1.0,0,0,2,6,730,0,1928,0.0,98146,47.4943,-122.337,1220,6240,4470,0.8596153846153847,532900,27040000,26507100
608000.0,2,1.0,1390,3600,1.0,0,0,3,7,1010,380,1913,0.0,98119,47.6422,-122.36,1590,3600,2210,0.6138888888888889,1932100,12960000,11027900
442500.0,3,1.5,2710,47419,1.5,0,0,2,7,2170,540,1980,0.0,98053,47.6522,-121.96600000000001,2130,48144,44709,0.9428499124823383,7344100,2248561561,2241217461
381800.0,4,2.0,1530,5250,1.0,0,0,2,7,1110,420,1981,0.0,98133,47.7336,-122.339,1100,5250,3720,0.7085714285714285,2340900,27562500,25221600
330000.0,3,2.0,2170,3978,1.0,0,0,4,7,1340,0,1919,0.0,98116,47.57100000000001,-122.391,1350,4680,1808,0.45449974861739567,4708900,15824484,11115584
90000.0,2,1.0,790,2640,1.0,0,0,2,7,790,0,1973,0.0,98034,47.7351,-122.178,1310,2064,1850,0.7007575757575758,624100,6969600,6345500
312000.0,2,1.75,1160,8625,1.0,0,0,3,6,1160,0,1941,0.0,98106,47.5509,-122.366,960,5750,7465,0.8655072463768116,1345600,74390625,73045025
339000.0,3,1.0,1080,8100,1.0,0,0,3,7,1080,0,1955,0.0,98155,47.777,-122.307,1080,8100,7020,0.8666666666666667,1166400,65610000,64443600
313000.0,3,1.75,2190,8000,1.0,0,0,3,8,2190,0,1967,0.0,98023,47.3098,-122.381,1980,8000,5810,0.72625,4796100,64000000,59203900
618080.0,3,2.5,2030,6500,2.0,0,0,2,8,2030,0,1988,0.0,98027,47.5654,-122.09200000000001,2030,8485,4470,0.6876923076923077,4120900,42250000,38129100
325000.0,3,2.25,2480,8755,2.0,0,0,2,8,2480,0,1979,0.0,98058,47.4543,-122.125,2280,9940,6275,0.7167332952598515,6150400,76650025,70499625
242000.0,4,1.0,2240,7620,1.0,0,0,2,7,1120,1120,1966,0.0,98146,47.5089,-122.346,1080,7620,5380,0.7060367454068242,5017600,58064400,53046800
364000.0,2,1.5,1650,7311,1.0,0,0,2,7,860,790,1978,0.0,98133,47.7772,-122.35700000000001,1660,7255,5661,0.774312679524005,2722500,53450721,50728221
545000.0,3,1.75,1700,5750,1.5,0,2,4,7,1450,250,1925,0.0,98126,47.5643,-122.38,1700,5750,4050,0.7043478260869566,2890000,33062500,30172500
445000.0,3,2.5,2790,16173,2.0,0,0,2,10,2790,0,1988,0.0,98023,47.3043,-122.34299999999999,2890,11632,13383,0.8274902615470228,7784100,261565929,253781829
1090000.0,4,2.75,3010,10830,2.0,0,3,3,9,3010,0,1980,0.0,98034,47.7005,-122.23200000000001,3010,10650,7820,0.7220683287165282,9060100,117288900,108228800
660000.0,4,2.5,2550,10000,1.0,0,0,2,8,1290,1260,1964,0.0,98007,47.6208,-122.141,2270,8640,7450,0.745,6502500,100000000,93497500
845000.0,4,2.5,2880,35610,1.0,0,0,2,10,2880,0,1989,0.0,98052,47.6911,-122.054,3460,35610,32730,0.9191238416175231,8294400,1268072100,1259777700
417000.0,4,2.0,2090,4000,1.0,0,0,2,6,1060,1030,1907,0.0,98144,47.5893,-122.29899999999999,1590,4000,1910,0.4775,4368100,16000000,11631900
213800.0,2,1.0,740,5200,1.0,0,0,3,5,740,0,1952,0.0,98056,47.4934,-122.17299999999999,750,5200,4460,0.8576923076923076,547600,27040000,26492400
400000.0,2,1.75,960,6200,1.0,0,0,3,7,960,0,1946,0.0,98136,47.5551,-122.396,1000,6000,5240,0.8451612903225807,921600,38440000,37518400
759950.0,4,3.5,2100,7560,2.0,0,0,4,8,2100,0,2005,0.0,98133,47.7076,-122.35600000000001,1250,7560,5460,0.7222222222222222,4410000,57153600,52743600
990000.0,4,2.5,2540,5930,2.0,0,0,2,9,2540,0,2003,0.0,98199,47.6451,-122.387,1400,4000,3390,0.5716694772344013,6451600,35164900,28713300
710000.0,3,1.75,1650,10250,1.0,0,0,4,8,1650,0,1963,0.0,98005,47.6118,-122.169,2400,10250,8600,0.8390243902439024,2722500,105062500,102340000
315000.0,1,0.75,770,4600,1.0,0,0,3,6,770,0,1910,0.0,98126,47.5565,-122.37700000000001,1550,4600,3830,0.8326086956521739,592900,21160000,20567100
515000.0,4,2.5,2280,14810,1.0,0,0,4,8,1500,780,1977,0.0,98056,47.5392,-122.186,2690,12196,12530,0.8460499662390277,5198400,219336100,214137700
638000.0,3,2.0,1660,3729,1.0,0,0,4,7,970,690,1922,0.0,98116,47.5741,-122.414,1560,3729,2069,0.554840439796192,2755600,13905441,11149841
370000.0,4,2.0,2020,8100,1.5,0,0,3,7,1160,860,1946,0.0,98125,47.7307,-122.29700000000001,1840,8680,6080,0.7506172839506173,4080400,65610000,61529600
184000.0,3,1.0,970,14850,1.0,0,0,2,7,970,0,1968,0.0,98001,47.3251,-122.26799999999999,1410,14850,13880,0.9346801346801347,940900,220522500,219581600
583800.0,3,2.5,2480,6600,2.0,0,0,2,8,2480,0,2002,0.0,98053,47.6313,-122.008,2310,6656,4120,0.6242424242424243,6150400,43560000,37409600
309500.0,3,1.0,1250,7320,1.0,0,0,2,7,1250,0,1968,0.0,98059,47.5074,-122.163,1770,7320,6070,0.8292349726775956,1562500,53582400,52019900
1960000.0,4,4.0,4430,31353,2.0,0,0,2,12,4430,0,1998,0.0,98005,47.6422,-122.15700000000001,3900,35237,26923,0.858705705993047,19624900,983010609,963385709
299000.0,1,1.0,740,5000,1.0,0,0,2,7,740,0,1923,0.0,98118,47.5519,-122.292,1400,4400,4260,0.852,547600,25000000,24452400
215000.0,2,1.0,710,7200,1.0,0,0,2,6,710,0,1943,0.0,98178,47.4903,-122.245,960,7200,6490,0.9013888888888889,504100,51840000,51335900
410000.0,4,2.0,1970,10500,1.0,0,0,2,8,1820,150,1961,0.0,98166,47.479,-122.35600000000001,2090,12300,8530,0.8123809523809524,3880900,110250000,106369100
478000.0,2,1.0,820,6000,1.0,0,0,2,7,820,0,1939,0.0,98199,47.6494,-122.395,1630,6000,5180,0.8633333333333333,672400,36000000,35327600
431000.0,2,1.0,1000,6500,1.0,0,0,3,7,1000,0,1918,0.0,98136,47.5474,-122.38799999999999,1280,6500,5500,0.8461538461538461,1000000,42250000,41250000
635000.0,4,2.5,3080,35430,2.0,0,0,2,9,3080,0,1997,0.0,98053,47.6325,-121.97,2640,28972,32350,0.913068021450748,9486400,1255284900,1245798500
648000.0,5,2.25,2410,12000,2.0,0,0,3,8,2410,0,1973,0.0,98006,47.5434,-122.175,2080,12000,9590,0.7991666666666667,5808100,144000000,138191900
640000.0,3,2.5,2370,11172,2.0,0,0,2,9,2370,0,1993,0.0,98056,47.5345,-122.179,2550,11558,8802,0.7878625134264232,5616900,124813584,119196684
932808.0,5,4.5,4690,6705,2.0,0,0,2,10,3450,1240,1995,0.0,98006,47.5539,-122.10799999999999,4070,11505,2015,0.3005219985085757,21996100,44957025,22960925
835000.0,2,2.0,2280,6815,1.0,0,0,2,8,2280,0,2002,0.0,98053,47.7103,-122.027,2280,6750,4535,0.6654438738077769,5198400,46444225,41245825
469775.0,2,1.75,1530,7020,1.0,0,0,2,7,1030,500,1942,0.0,98199,47.6465,-122.395,2090,6600,5490,0.782051282051282,2340900,49280400,46939500
587000.0,5,3.5,3610,52595,2.0,0,0,3,7,3610,0,1989,0.0,98014,47.6832,-121.90700000000001,1620,60112,48985,0.9313622967962734,13032100,2766234025,2753201925
677915.0,3,2.0,1740,3600,1.0,0,0,4,7,990,750,1923,0.0,98119,47.6448,-122.35799999999999,1250,3600,1860,0.5166666666666667,3027600,12960000,9932400
1080000.0,4,3.0,3600,9200,1.0,0,4,3,9,2100,1500,1976,0.0,98008,47.5866,-122.116,2700,9775,5600,0.6086956521739131,12960000,84640000,71680000
671000.0,4,3.0,3130,5700,1.5,0,0,2,7,1750,1380,1953,0.0,98115,47.6811,-122.28299999999999,2080,5700,2570,0.45087719298245615,9796900,32490000,22693100
695000.0,5,3.25,3940,9780,2.0,0,0,2,9,3940,0,2007,0.0,98065,47.5435,-121.88799999999999,3550,8468,5840,0.5971370143149284,15523600,95648400,80124800
205000.0,4,2.0,2200,13320,1.0,0,0,2,6,1100,1100,1944,0.0,98168,47.481,-122.292,1330,6099,11120,0.8348348348348348,4840000,177422400,172582400
350000.0,4,1.0,1510,7200,1.5,0,0,3,7,1510,0,1955,0.0,98155,47.761,-122.307,1950,10656,5690,0.7902777777777777,2280100,51840000,49559900
360000.0,3,1.75,1560,7930,2.0,0,0,3,7,1560,0,1980,0.0,98059,47.4779,-122.161,1720,8073,6370,0.8032786885245902,2433600,62884900,60451300
313999.0,4,2.25,1870,4198,2.0,0,0,2,7,1870,0,2008,0.0,98038,47.3657,-122.021,1870,4184,2328,0.5545497856121963,3496900,17623204,14126304
300000.0,3,2.25,2070,7225,1.0,0,0,2,8,1690,380,1979,0.0,98042,47.3551,-122.148,2070,7400,5155,0.7134948096885814,4284900,52200625,47915725
452000.0,2,1.75,1660,11747,1.0,0,0,2,7,830,830,1981,0.0,98155,47.7661,-122.306,1900,19850,10087,0.858687324423257,2755600,137992009,135236409
495500.0,3,2.5,2010,57934,1.0,0,0,2,7,2010,0,1978,0.0,98014,47.6262,-121.96,2040,55527,55924,0.965305347464356,4040100,3356348356,3352308256
288000.0,3,1.0,1410,40500,1.0,0,0,3,7,1410,0,1961,0.0,98092,47.3199,-122.1,1570,40500,39090,0.9651851851851851,1988100,1640250000,1638261900
227490.0,3,1.75,1820,7194,1.0,0,0,3,7,1820,0,1967,0.0,98003,47.3352,-122.307,1420,7560,5374,0.7470113983875452,3312400,51753636,48441236
470950.0,3,2.5,2560,16420,2.0,0,0,3,8,2560,0,1989,0.0,98014,47.6916,-121.916,2120,16298,13860,0.8440925700365408,6553600,269616400,263062800
735000.0,4,2.75,2450,4187,2.0,0,2,2,8,2450,0,2010,0.0,98027,47.5471,-122.016,2320,4187,1737,0.41485550513494146,6002500,17530969,11528469
730000.0,7,2.75,3110,4400,1.5,0,0,4,7,2010,1100,1914,0.0,98105,47.6684,-122.319,1240,4280,1290,0.29318181818181815,9672100,19360000,9687900
412000.0,3,2.5,2210,7000,2.0,0,0,3,8,2210,0,1985,0.0,98058,47.4377,-122.132,2260,7224,4790,0.6842857142857143,4884100,49000000,44115900
589500.0,4,2.5,2630,6326,2.0,0,0,2,9,2630,0,2008,0.0,98065,47.5222,-121.874,3240,6229,3696,0.5842554536832122,6916900,40018276,33101376
291000.0,7,1.0,2350,8636,1.0,0,0,2,7,1550,800,1962,0.0,98118,47.5432,-122.277,1500,7366,6286,0.7278832792959704,5522500,74580496,69057996
1300000.0,5,3.75,4450,7680,2.0,0,0,2,9,3460,990,2010,0.0,98199,47.6418,-122.39200000000001,2550,6400,3230,0.4205729166666667,19802500,58982400,39179900
190000.0,3,1.0,1200,10458,1.0,0,0,3,6,1200,0,1961,0.0,98023,47.3262,-122.34200000000001,1160,9000,9258,0.8852553069420539,1440000,109369764,107929764
456200.0,2,1.75,1210,7733,1.0,0,0,2,6,1210,0,1904,0.0,98125,47.7148,-122.28200000000001,1670,7733,6523,0.8435277382645804,1464100,59799289,58335189
225000.0,3,1.0,1290,8470,1.0,0,0,3,7,970,320,1966,0.0,98023,47.3054,-122.37100000000001,1300,7350,7180,0.8476977567886659,1664100,71740900,70076800
2000000.0,3,2.5,3490,21064,1.0,1,4,2,10,2290,1200,1968,0.0,98074,47.6092,-122.073,1780,15244,17574,0.8343144701860995,12180100,443692096,431511996
740000.0,4,2.5,3360,15091,2.0,0,0,2,9,3360,0,1997,0.0,98052,47.6649,-122.135,1930,9936,11731,0.7773507388509707,11289600,227738281,216448681
467000.0,3,1.75,2660,5511,1.0,0,0,2,8,1330,1330,1948,0.0,98108,47.5575,-122.3,2030,6111,2851,0.5173289784068227,7075600,30371121,23295521
385000.0,2,1.0,770,7554,1.0,0,0,2,6,770,0,1946,0.0,98177,47.7057,-122.36,1390,7500,6784,0.8980672491395287,592900,57062916,56470016
670000.0,3,2.5,1800,4763,2.0,0,0,2,7,1240,560,1985,0.0,98119,47.646,-122.36200000000001,1790,4763,2963,0.622086920008398,3240000,22686169,19446169
500000.0,4,2.5,2900,5760,1.0,0,0,3,8,1660,1240,1959,0.0,98118,47.55,-122.272,2250,6098,2860,0.4965277777777778,8410000,33177600,24767600
352450.0,3,2.0,1430,6000,1.0,0,0,4,7,1430,0,1945,0.0,98155,47.7564,-122.316,1630,6315,4570,0.7616666666666667,2044900,36000000,33955100
669888.0,4,2.75,2550,7591,2.0,0,0,2,9,2550,0,1989,0.0,98059,47.5302,-122.147,2670,7796,5041,0.6640758793307865,6502500,57623281,51120781
405000.0,3,2.75,1310,7300,1.0,0,0,2,7,1310,0,1957,0.0,98008,47.6016,-122.12299999999999,1310,7030,5990,0.8205479452054795,1716100,53290000,51573900
518000.0,3,1.5,1430,8000,1.0,0,0,3,7,1430,0,1956,0.0,98007,47.5874,-122.13600000000001,1450,8000,6570,0.82125,2044900,64000000,61955100
280000.0,4,1.0,1880,6288,1.0,0,0,2,7,1120,760,1974,0.0,98178,47.5101,-122.259,1880,6334,4408,0.7010178117048346,3534400,39538944,36004544
435000.0,3,2.5,1600,2375,2.0,0,0,2,7,1600,0,2005,0.0,98029,47.5531,-121.99600000000001,1830,2375,775,0.3263157894736842,2560000,5640625,3080625
314950.0,3,2.0,1760,9732,1.0,0,0,2,7,1760,0,1996,0.0,98022,47.1923,-122.014,1910,9231,7972,0.8191533086724209,3097600,94711824,91614224
209900.0,2,2.0,1180,3003,2.0,0,0,2,6,1180,0,2005,0.0,98038,47.3491,-122.02,1310,3003,1823,0.607059607059607,1392400,9018009,7625609
630000.0,4,2.5,2330,31705,2.0,0,0,3,8,2330,0,1980,0.0,98052,47.6471,-122.03,2460,36600,29375,0.9265100141933449,5428900,1005207025,999778125
442000.0,4,1.5,1960,12688,1.5,0,0,3,7,1960,0,1962,0.0,98052,47.6304,-122.09700000000001,2050,9375,10728,0.8455233291298865,3841600,160985344,157143744
340000.0,4,1.0,1140,13440,1.0,0,0,1,5,1140,0,1944,0.0,98166,47.4619,-122.344,1450,7560,12300,0.9151785714285714,1299600,180633600,179334000
230000.0,3,1.75,1400,6956,1.0,0,0,3,7,1400,0,1957,0.0,98031,47.4233,-122.198,1400,9375,5556,0.7987349051178838,1960000,48385936,46425936
495200.0,5,2.25,2710,22120,1.0,0,0,2,7,1410,1300,1955,0.0,98011,47.7642,-122.195,2850,12224,19410,0.8774864376130199,7344100,489294400,481950300
900000.0,4,2.5,3510,6745,2.0,0,0,2,10,3510,0,1998,0.0,98075,47.6016,-122.074,3320,8370,3235,0.47961452928094883,12320100,45495025,33174925
265000.0,2,1.0,910,4600,1.0,0,0,2,5,910,0,1917,0.0,98117,47.6916,-122.36200000000001,1020,4600,3690,0.8021739130434783,828100,21160000,20331900
489500.0,3,1.75,2090,65558,1.0,0,0,2,8,1330,760,1977,0.0,98072,47.7621,-122.12700000000001,2450,47178,63468,0.9681198328197932,4368100,4297851364,4293483264
335000.0,3,2.0,1410,44866,1.0,0,0,3,7,1410,0,1985,0.0,98023,47.3273,-122.37,2950,29152,43456,0.9685730842954576,1988100,2012957956,2010969856
585000.0,3,3.25,3050,12700,2.0,0,0,2,8,2240,810,1990,0.0,98011,47.7445,-122.214,3050,12386,9650,0.7598425196850394,9302500,161290000,151987500
800000.0,4,2.25,2010,7200,1.0,0,1,3,8,1010,1000,1950,0.0,98118,47.5591,-122.26700000000001,2010,7200,5190,0.7208333333333333,4040100,51840000,47799900
379500.0,4,2.25,2120,53578,2.0,0,2,3,7,2120,0,1985,0.0,98022,47.2041,-122.021,2120,53578,51458,0.9604315204001642,4494400,2870602084,2866107684
475000.0,3,1.0,1270,8000,1.0,0,0,3,6,1270,0,1959,0.0,98008,47.6175,-122.118,1210,7875,6730,0.84125,1612900,64000000,62387100
520000.0,3,2.0,1670,8800,1.0,0,0,3,7,1150,520,1961,0.0,98008,47.6096,-122.132,2020,8250,7130,0.8102272727272727,2788900,77440000,74651100
515000.0,4,2.5,1800,4338,2.0,0,0,2,8,1800,0,2001,0.0,98075,47.5962,-122.015,1800,4507,2538,0.5850622406639004,3240000,18818244,15578244
577500.0,2,1.0,1640,5515,1.0,0,0,3,7,940,700,1926,0.0,98103,47.6912,-122.334,2054,5515,3875,0.7026291931097008,2689600,30415225,27725625
269900.0,3,2.25,1740,9672,1.0,0,0,3,7,1110,630,1963,0.0,98031,47.4149,-122.181,1640,9600,7932,0.8200992555831266,3027600,93547584,90519984
329000.0,3,1.0,1600,5952,1.0,0,0,3,7,1150,450,1964,0.0,98106,47.5292,-122.36200000000001,1460,6200,4352,0.7311827956989247,2560000,35426304,32866304
458500.0,3,1.5,1280,1920,1.5,0,0,2,7,1280,0,1905,1990.0,98122,47.6117,-122.301,1280,3150,640,0.3333333333333333,1638400,3686400,2048000
890000.0,4,2.0,1480,11171,1.5,0,0,3,6,1480,0,1947,0.0,98075,47.5849,-122.051,2790,20680,9691,0.8675140990063558,2190400,124791241,122600841
361500.0,4,2.5,1980,7334,2.0,0,0,2,7,1980,0,2003,0.0,98038,47.3528,-122.041,1850,7134,5354,0.7300245432233433,3920400,53787556,49867156
2540000.0,5,3.25,3730,10626,1.0,0,4,3,10,3730,0,1963,0.0,98004,47.623999999999995,-122.221,4180,19110,6896,0.6489742141916055,13912900,112911876,98998976
325000.0,2,1.0,900,8374,1.0,0,0,2,7,900,0,1984,0.0,98034,47.7282,-122.225,1580,8965,7474,0.8925244805349892,810000,70123876,69313876
1850000.0,4,3.25,3480,6000,3.0,0,0,2,8,3480,0,2014,0.0,98109,47.6353,-122.353,2200,4080,2520,0.42,12110400,36000000,23889600
945000.0,4,2.0,2840,13367,1.0,0,0,2,7,1420,1420,1952,0.0,98004,47.6237,-122.21,2840,12744,10527,0.7875364704122092,8065600,178676689,170611089
370000.0,3,2.5,2490,4244,2.0,0,0,2,9,2490,0,2005,0.0,98042,47.3705,-122.131,2490,4748,1754,0.41328934967012254,6200100,18011536,11811436
450000.0,2,2.0,1510,4908,1.0,0,0,2,8,1510,0,2006,0.0,98053,47.7196,-122.024,1440,3921,3398,0.6923390383048085,2280100,24088464,21808364
800000.0,4,2.5,2900,18303,2.0,0,0,3,10,2900,0,1994,0.0,98075,47.5981,-122.03,2900,18303,15403,0.8415560290662732,8410000,334999809,326589809
676000.0,3,2.5,2240,3825,2.0,0,0,2,7,2240,0,1995,0.0,98117,47.6786,-122.389,1460,5100,1585,0.4143790849673203,5017600,14630625,9613025
1270000.0,4,1.75,2040,5000,2.0,0,0,3,9,2040,0,1921,0.0,98102,47.6279,-122.315,3220,5600,2960,0.592,4161600,25000000,20838400
290000.0,3,1.75,1460,7980,1.0,0,0,2,7,1460,0,1972,0.0,98028,47.7713,-122.265,1920,7980,6520,0.8170426065162907,2131600,63680400,61548800
158000.0,3,1.5,990,8925,1.0,0,0,3,7,990,0,1962,0.0,98003,47.3294,-122.331,1360,8625,7935,0.8890756302521008,980100,79655625,78675525
379950.0,4,1.75,1970,9389,1.0,0,0,4,7,1140,830,1960,0.0,98133,47.7771,-122.339,1820,8135,7419,0.7901799978698477,3880900,88153321,84272421
583000.0,4,2.5,2660,4000,2.0,0,0,2,8,2660,0,2001,0.0,98053,47.6876,-122.038,2330,4517,1340,0.335,7075600,16000000,8924400
150000.0,2,1.0,870,5700,1.0,0,0,3,6,870,0,1957,0.0,98056,47.49800000000001,-122.17,1020,5700,4830,0.8473684210526315,756900,32490000,31733100
261500.0,3,2.5,1740,6992,2.0,0,0,2,7,1740,0,1990,0.0,98042,47.3574,-122.15799999999999,1260,6825,5252,0.7511441647597255,3027600,48888064,45860464
278000.0,4,2.5,2290,3777,2.0,0,0,2,7,2290,0,2004,0.0,98198,47.3617,-122.30799999999999,1480,3608,1487,0.39369870267407997,5244100,14265729,9021629
555000.0,4,2.75,2170,7140,1.0,0,0,2,8,1290,880,1977,0.0,98052,47.691,-122.113,2120,7820,4970,0.696078431372549,4708900,50979600,46270700
355000.0,3,1.75,2040,8173,1.0,0,0,2,7,1470,570,1958,0.0,98133,47.7439,-122.333,1900,8172,6133,0.7503976508014193,4161600,66797929,62636329
375000.0,4,1.5,1770,6650,1.0,0,0,2,7,1770,0,1958,0.0,98008,47.6011,-122.124,1600,7000,4880,0.7338345864661654,3132900,44222500,41089600
227000.0,3,1.75,2380,12681,1.0,0,0,0,6,1380,1000,1918,0.0,98118,47.5294,-122.279,1720,6377,10301,0.8123176405646242,5664400,160807761,155143361
335000.0,4,2.0,2030,103672,1.0,0,0,3,7,2030,0,1969,0.0,98022,47.1647,-121.973,1560,325393,101642,0.9804190138127942,4120900,10747883584,10743762684
680000.0,3,2.25,2270,23900,1.0,0,0,2,9,1820,450,1975,0.0,98177,47.7506,-122.37200000000001,2520,28300,21630,0.905020920502092,5152900,571210000,566057100
686500.0,2,1.75,1390,5025,1.5,0,0,3,8,1390,0,1928,0.0,98105,47.6701,-122.288,2160,5000,3635,0.7233830845771144,1932100,25250625,23318525
410000.0,3,1.75,1530,26642,1.0,0,0,2,7,1180,350,1988,0.0,98072,47.7422,-122.09700000000001,1550,13566,25112,0.9425718789880639,2340900,709796164,707455264
425000.0,2,1.0,1430,13300,1.5,0,0,2,6,1230,200,1921,0.0,98033,47.6996,-122.20299999999999,1950,11421,11870,0.8924812030075188,2044900,176890000,174845100
562500.0,3,2.5,2030,7549,1.0,0,0,2,8,2030,0,1988,0.0,98074,47.6187,-122.044,2040,7130,5519,0.7310902106239237,4120900,56987401,52866501
345000.0,4,2.5,2390,6976,2.0,0,0,2,7,2390,0,2003,0.0,98056,47.4807,-122.182,2390,6346,4586,0.6573967889908257,5712100,48664576,42952476
627500.0,4,2.5,2540,11500,1.0,0,0,3,8,1640,900,1979,0.0,98006,47.5609,-122.15,2820,9800,8960,0.7791304347826087,6451600,132250000,125798400
355000.0,3,1.0,1890,36300,1.0,0,0,2,7,1890,0,1962,0.0,98024,47.5719,-121.914,1746,54014,34410,0.9479338842975207,3572100,1317690000,1314117900
335000.0,3,2.25,1870,5876,2.0,0,0,2,7,1870,0,1986,0.0,98038,47.3779,-122.045,1670,6203,4006,0.6817562968005446,3496900,34527376,31030476
350000.0,4,3.0,1780,4228,1.0,0,0,2,7,1780,0,1953,0.0,98118,47.5488,-122.287,1730,5304,2448,0.5789971617786187,3168400,17875984,14707584
590000.0,3,1.0,1610,58370,1.0,0,0,2,7,1610,0,1978,0.0,98053,47.6718,-122.044,2510,58127,56760,0.9724173376734624,2592100,3407056900,3404464800
252000.0,3,2.0,1420,6788,2.0,0,0,2,7,1420,0,1990,0.0,98023,47.2887,-122.351,1790,6607,5368,0.7908073070123748,2016400,46076944,44060544
1300000.0,5,4.0,4440,9270,1.0,0,0,4,10,2220,2220,1968,0.0,98040,47.5708,-122.212,2720,9614,4830,0.5210355987055016,19713600,85932900,66219300
705000.0,4,2.0,1820,5001,2.0,0,0,2,7,1820,0,1947,0.0,98119,47.6438,-122.37299999999999,1440,5408,3181,0.6360727854429115,3312400,25010001,21697601
498000.0,3,2.0,1620,8400,1.0,0,0,2,7,1180,440,1968,0.0,98052,47.6574,-122.12799999999999,2120,8424,6780,0.8071428571428572,2624400,70560000,67935600
312500.0,2,1.0,870,7227,1.0,0,0,2,7,870,0,1948,0.0,98133,47.7288,-122.331,1250,7252,6357,0.879618098796181,756900,52229529,51472629
260000.0,4,1.75,1830,5375,1.0,0,0,1,7,1060,770,1962,0.0,98198,47.4169,-122.316,1040,7500,3545,0.6595348837209303,3348900,28890625,25541725
209950.0,3,1.5,2290,9600,1.0,0,0,3,7,2290,0,1967,0.0,98042,47.3643,-122.111,1310,9600,7310,0.7614583333333333,5244100,92160000,86915900
610000.0,3,1.75,1110,10402,1.0,0,0,3,7,1110,0,1967,0.0,98006,47.5676,-122.177,2050,9660,9292,0.8932897519707749,1232100,108201604,106969504
500000.0,4,1.0,1440,7100,1.5,0,0,2,7,1440,0,1906,0.0,98107,47.6725,-122.396,1490,5000,5660,0.7971830985915493,2073600,50410000,48336400
850000.0,3,3.5,3070,7050,1.0,0,3,2,8,1570,1500,1928,1996.0,98125,47.7076,-122.27600000000001,2350,5881,3980,0.5645390070921986,9424900,49702500,40277600
689000.0,4,2.5,2440,11700,1.0,0,0,4,8,1480,960,1961,0.0,98006,47.5606,-122.184,2140,10807,9260,0.7914529914529914,5953600,136890000,130936400
470000.0,4,2.0,2410,4680,2.0,0,0,2,9,2410,0,1974,0.0,98008,47.6234,-122.113,1910,4611,2270,0.48504273504273504,5808100,21902400,16094300
640000.0,3,3.0,2270,5175,2.0,0,0,2,9,2130,140,2002,0.0,98056,47.51600000000001,-122.20299999999999,2850,5661,2905,0.561352657004831,5152900,26780625,21627725
290000.0,4,1.75,2340,7200,1.0,0,0,2,8,1590,750,1960,0.0,98146,47.497,-122.369,1970,7800,4860,0.675,5475600,51840000,46364400
258500.0,3,2.5,1800,9000,2.0,0,0,2,7,1800,0,1983,0.0,98003,47.3186,-122.331,1670,8486,7200,0.8,3240000,81000000,77760000
1100000.0,4,3.5,2210,7597,1.0,0,0,3,9,1550,660,1977,2006.0,98004,47.5816,-122.197,2370,8811,5387,0.7090956956693432,4884100,57714409,52830309
420000.0,3,1.75,1820,22320,1.0,0,0,2,7,1250,570,1977,0.0,98053,47.6441,-121.96,2030,22320,20500,0.9184587813620072,3312400,498182400,494870000
230000.0,3,1.0,1190,9083,1.0,0,0,2,7,1190,0,1955,0.0,98198,47.4116,-122.29299999999999,1190,9450,7893,0.8689860178355169,1416100,82500889,81084789
252000.0,3,1.5,1400,6865,1.0,0,0,3,7,1400,0,1986,0.0,98038,47.3639,-122.04799999999999,1480,8125,5465,0.7960670065549891,1960000,47128225,45168225
515000.0,3,2.5,2600,4506,2.0,0,0,2,8,2600,0,2003,0.0,98028,47.7353,-122.22200000000001,2600,4658,1906,0.42299156679982247,6760000,20304036,13544036
425000.0,2,1.0,910,4635,1.0,0,0,3,6,910,0,1905,0.0,98107,47.675,-122.39299999999999,1740,5000,3725,0.8036677454153183,828100,21483225,20655125
575000.0,3,2.5,1760,2320,2.0,0,2,2,8,1760,0,1994,0.0,98126,47.5723,-122.376,1760,4698,560,0.2413793103448276,3097600,5382400,2284800
390000.0,2,1.0,860,5160,1.0,0,0,3,7,860,0,1909,0.0,98117,47.6823,-122.38799999999999,1090,5356,4300,0.8333333333333334,739600,26625600,25886000
561500.0,4,2.25,2310,9800,1.0,0,0,2,8,1780,530,1968,0.0,98033,47.6657,-122.178,2310,9800,7490,0.7642857142857142,5336100,96040000,90703900
1350000.0,4,1.75,2000,3728,1.5,0,0,3,9,1820,180,1926,0.0,98112,47.643,-122.29899999999999,1950,3728,1728,0.463519313304721,4000000,13897984,9897984
835000.0,5,2.75,2460,7830,1.0,0,0,4,9,1490,970,1955,0.0,98115,47.6938,-122.31,2050,7830,5370,0.685823754789272,6051600,61308900,55257300
245000.0,2,1.0,1020,15000,1.5,0,0,2,6,1020,0,1933,0.0,98168,47.4956,-122.321,1480,14519,13980,0.932,1040400,225000000,223959600
475200.0,3,2.5,1670,3980,2.0,0,0,2,8,1670,0,2000,0.0,98027,47.5317,-122.04700000000001,1670,2897,2310,0.5804020100502513,2788900,15840400,13051500
425000.0,2,1.0,790,5024,1.0,0,0,3,7,790,0,1941,0.0,98117,47.6833,-122.395,1330,5024,4234,0.8427547770700637,624100,25240576,24616476
218000.0,2,1.5,2010,7755,2.0,0,0,2,7,2010,0,1952,0.0,98178,47.4947,-122.23299999999999,1360,8037,5745,0.7408123791102514,4040100,60140025,56099925
600000.0,4,2.5,2600,6536,2.0,0,0,2,9,2600,0,1999,0.0,98056,47.5232,-122.191,2640,6185,3936,0.602203182374541,6760000,42719296,35959296
545000.0,4,2.25,1890,7210,1.0,0,0,2,8,1890,0,1967,0.0,98008,47.6342,-122.117,1920,7210,5320,0.7378640776699029,3572100,51984100,48412000
2410000.0,5,2.5,4600,23250,1.5,0,2,2,9,3600,1000,1918,2003.0,98004,47.62300000000001,-122.21799999999999,5500,20066,18650,0.8021505376344086,21160000,540562500,519402500
460000.0,5,3.0,2008,5050,1.0,0,0,2,7,1216,792,1992,0.0,98118,47.5376,-122.292,2040,5297,3042,0.6023762376237624,4032064,25502500,21470436
425000.0,2,1.0,880,6413,1.0,0,0,2,7,880,0,1950,0.0,98116,47.573,-122.395,1360,6413,5533,0.8627787307032591,774400,41126569,40352169
455000.0,3,1.75,1700,8360,1.0,0,0,3,7,850,850,1955,0.0,98006,47.5766,-122.147,1520,8360,6660,0.7966507177033493,2890000,69889600,66999600
313100.0,3,2.0,1730,12821,1.0,0,0,2,8,1730,0,1994,0.0,98001,47.353,-122.272,1980,11336,11091,0.8650651275251541,2992900,164378041,161385141
780000.0,4,3.5,3910,59863,2.0,0,0,3,10,2490,1420,1987,0.0,98027,47.4846,-122.06700000000001,2830,37674,55953,0.9346841955799075,15288100,3583578769,3568290669
345500.0,4,2.5,2160,9682,2.0,0,0,2,8,2160,0,1999,0.0,98031,47.4106,-122.204,1770,9600,7522,0.7769055980169387,4665600,93741124,89075524
243000.0,3,1.75,1200,8034,1.0,0,0,4,7,1200,0,1975,0.0,98031,47.4135,-122.18,1270,7600,6834,0.8506348020911128,1440000,64545156,63105156
670000.0,5,3.5,3860,9600,1.0,0,3,3,8,2660,1200,1973,0.0,98034,47.7139,-122.223,2440,9600,5740,0.5979166666666667,14899600,92160000,77260400
325000.0,3,1.5,1320,7560,1.0,0,0,2,6,840,480,1983,0.0,98019,47.7451,-121.98,1210,7560,6240,0.8253968253968254,1742400,57153600,55411200
281000.0,2,1.0,1280,12500,1.0,0,0,2,7,1060,220,1951,0.0,98178,47.4833,-122.23700000000001,1460,17771,11220,0.8976,1638400,156250000,154611600
130000.0,3,1.0,1100,5100,1.0,0,0,3,7,1100,0,1913,0.0,98108,47.5231,-122.33200000000001,1450,5100,4000,0.7843137254901961,1210000,26010000,24800000
340000.0,3,2.5,2170,9798,2.0,0,0,2,7,2170,0,1995,0.0,98038,47.3817,-122.023,2020,8121,7628,0.778526229842825,4708900,96000804,91291904
485000.0,4,2.75,2720,51396,2.0,0,0,3,8,2720,0,1977,0.0,98059,47.4777,-122.1,1960,51366,48676,0.9470775935870496,7398400,2641548816,2634150416
642860.0,4,2.75,2520,6398,2.0,0,0,2,8,2520,0,2014,0.0,98072,47.7685,-122.15899999999999,2520,6398,3878,0.6061269146608315,6350400,40934404,34584004
747000.0,3,1.75,2560,4800,1.0,0,0,2,7,1280,1280,1911,0.0,98112,47.6207,-122.295,1620,4800,2240,0.4666666666666667,6553600,23040000,16486400
559950.0,4,2.5,2650,7200,2.0,0,0,2,8,2250,400,1979,0.0,98133,47.7317,-122.354,2110,7269,4550,0.6319444444444444,7022500,51840000,44817500
577288.0,4,2.75,2870,7200,2.0,0,0,2,9,2870,0,2008,0.0,98108,47.5688,-122.31700000000001,2030,5400,4330,0.6013888888888889,8236900,51840000,43603100
575000.0,2,1.0,1230,2726,1.5,0,0,2,7,880,350,1920,0.0,98117,47.6815,-122.359,1710,3750,1496,0.5487894350696992,1512900,7431076,5918176
287000.0,3,1.0,1450,6000,1.0,0,0,3,7,1450,0,1953,0.0,98118,47.5238,-122.287,1170,6464,4550,0.7583333333333333,2102500,36000000,33897500
1150000.0,4,3.75,3180,9889,2.0,0,0,2,9,2500,680,2012,0.0,98033,47.6853,-122.204,2910,8558,6709,0.6784305794316918,10112400,97792321,87679921
335000.0,2,1.0,1800,8900,1.0,0,0,2,6,900,900,1945,0.0,98168,47.51,-122.323,2040,10450,7100,0.797752808988764,3240000,79210000,75970000
375000.0,4,2.25,2020,12500,2.0,0,0,1,8,2020,0,1966,0.0,98056,47.5403,-122.175,1800,13175,10480,0.8384,4080400,156250000,152169600
325000.0,2,1.0,620,14823,1.0,0,0,2,6,620,0,1926,0.0,98125,47.7322,-122.3,1400,7930,14203,0.9581731093570802,384400,219721329,219336929
530000.0,3,2.25,2190,220414,1.0,0,0,3,7,1330,860,1976,0.0,98059,47.5041,-122.102,2550,175982,218224,0.9900641520048635,4796100,48582331396,48577535296
287000.0,4,2.25,1980,7081,1.0,0,0,2,7,1470,510,1977,0.0,98032,47.3669,-122.288,1980,7081,5101,0.7203784776161559,3920400,50140561,46220161
320000.0,5,3.0,2970,7000,1.0,0,0,2,8,1810,1160,1979,0.0,98023,47.3079,-122.34100000000001,2630,8062,4030,0.5757142857142857,8820900,49000000,40179100
425000.0,4,2.5,2270,4400,2.0,0,0,2,7,2270,0,2006,0.0,98065,47.5381,-121.88799999999999,2090,4400,2130,0.48409090909090907,5152900,19360000,14207100
550000.0,3,1.0,1630,6009,1.0,0,3,3,8,1630,0,1954,0.0,98117,47.69300000000001,-122.383,2120,6009,4379,0.7287402229988351,2656900,36108081,33451181
135000.0,3,1.0,1520,8450,1.0,0,0,1,6,1120,400,1961,0.0,98023,47.328,-122.337,1320,8450,6930,0.8201183431952662,2310400,71402500,69092100
695000.0,3,1.75,2080,5687,1.5,0,0,3,8,2080,0,1924,0.0,98144,47.5776,-122.289,2300,5995,3607,0.6342535607525936,4326400,32341969,28015569
975000.0,5,2.5,3020,9648,1.0,0,2,3,9,1980,1040,1977,0.0,98006,47.5586,-122.134,2890,12598,6628,0.6869817578772802,9120400,93083904,83963504
210000.0,4,1.75,2180,28710,1.0,0,0,2,8,1180,1000,1950,0.0,98198,47.405,-122.288,2180,28710,26530,0.9240682688958551,4752400,824264100,819511700
518000.0,4,1.75,1780,8768,1.0,0,0,3,7,1050,730,1951,0.0,98125,47.7085,-122.28299999999999,1590,8100,6988,0.7969890510948905,3168400,76877824,73709424
335500.0,3,1.0,1370,6780,2.0,0,0,2,6,1370,0,1930,0.0,98125,47.7156,-122.291,1450,7214,5410,0.7979351032448377,1876900,45968400,44091500
750000.0,4,3.5,3050,7020,2.0,0,3,2,9,2050,1000,1984,0.0,98126,47.57100000000001,-122.374,2170,5900,3970,0.5655270655270656,9302500,49280400,39977900
515000.0,3,1.75,1490,12000,1.0,0,0,3,7,1490,0,1956,0.0,98006,47.568999999999996,-122.175,1630,12000,10510,0.8758333333333334,2220100,144000000,141779900
344500.0,4,2.75,1800,5453,1.0,0,0,2,7,1050,750,2002,0.0,98055,47.4632,-122.209,1820,6900,3653,0.6699064735008252,3240000,29735209,26495209
470000.0,3,1.5,1760,6723,1.0,0,0,2,7,1160,600,1958,0.0,98118,47.5514,-122.266,2080,8965,4963,0.7382121076900193,3097600,45198729,42101129
606150.0,4,1.75,1770,9848,1.0,0,0,2,8,1370,400,1967,0.0,98008,47.6208,-122.09899999999999,2040,9587,8078,0.820268074735987,3132900,96983104,93850204
292000.0,4,2.75,2910,7712,1.0,0,0,2,7,1600,1310,1998,0.0,98002,47.2842,-122.198,2220,6649,4802,0.6226659751037344,8468100,59474944,51006844
450000.0,3,2.5,2880,426452,2.0,0,3,2,7,2880,0,1979,0.0,98092,47.2485,-122.101,1460,320890,423572,0.9932466021967302,8294400,181861308304,181853013904
429000.0,3,1.75,2520,5043,1.0,0,0,2,8,1260,1260,1957,0.0,98126,47.5339,-122.37200000000001,1360,4920,2523,0.5002974419988102,6350400,25431849,19081449
765000.0,4,2.5,3190,38119,2.0,0,0,2,9,3190,0,1988,0.0,98053,47.6698,-122.044,2560,36280,34929,0.9163146987066817,10176100,1453058161,1442882061
425000.0,2,1.0,540,2500,1.0,0,0,2,5,540,0,1905,0.0,98107,47.6729,-122.383,1290,5000,1960,0.784,291600,6250000,5958400
505000.0,4,2.5,3170,5340,2.0,0,0,2,7,3170,0,2000,0.0,98059,47.4911,-122.13799999999999,3010,5340,2170,0.40636704119850187,10048900,28515600,18466700
544950.0,3,1.75,1830,7371,1.0,0,0,2,7,1830,0,1957,0.0,98008,47.6059,-122.12100000000001,1600,7700,5541,0.7517297517297518,3348900,54331641,50982741
382000.0,3,2.0,1360,4840,1.5,0,0,2,8,1360,0,1936,0.0,98126,47.5487,-122.376,1450,4840,3480,0.71900826446281,1849600,23425600,21576000
475000.0,3,1.75,1870,25157,2.0,0,0,2,7,1870,0,1978,0.0,98014,47.695,-121.915,1870,15391,23287,0.9256668124180149,3496900,632874649,629377749
355000.0,3,1.5,1370,4790,2.0,0,0,3,7,1370,0,1982,0.0,98034,47.7253,-122.164,1370,3799,3420,0.7139874739039666,1876900,22944100,21067200
410000.0,4,2.5,1700,9000,1.0,0,0,4,7,1700,0,1972,0.0,98034,47.7306,-122.23299999999999,1370,7592,7300,0.8111111111111111,2890000,81000000,78110000
450000.0,4,2.0,1960,5008,1.0,0,0,2,6,980,980,1900,0.0,98144,47.5958,-122.29899999999999,1175,2315,3048,0.6086261980830671,3841600,25080064,21238464
565000.0,7,4.5,4140,9066,1.0,0,0,2,7,2070,2070,1978,0.0,98125,47.7302,-122.291,1440,1865,4926,0.5433487756452681,17139600,82192356,65052756
529100.0,2,1.0,1290,6528,1.5,0,0,3,7,1290,0,1941,0.0,98115,47.693999999999996,-122.29,1670,5712,5238,0.8023897058823529,1664100,42614784,40950684
452500.0,4,2.5,2460,6454,2.0,0,0,2,7,2460,0,2006,0.0,98065,47.5381,-121.89,2320,4578,3994,0.6188410288193369,6051600,41654116,35602516
245000.0,4,2.0,1580,8000,1.0,0,0,2,7,1040,540,1967,0.0,98003,47.3467,-122.304,1550,8000,6420,0.8025,2496400,64000000,61503600
415000.0,1,1.0,700,2550,1.0,0,0,2,6,700,0,1954,0.0,98117,47.6783,-122.383,1330,4110,1850,0.7254901960784313,490000,6502500,6012500
610000.0,4,2.5,2410,15899,2.0,0,3,2,9,2410,0,1990,0.0,98074,47.6242,-122.04,2360,11412,13489,0.8484181395056293,5808100,252778201,246970101
363500.0,4,1.75,2180,9702,1.0,0,0,4,7,1090,1090,1962,0.0,98178,47.4973,-122.26799999999999,2020,9792,7522,0.7753040610183467,4752400,94128804,89376404
510000.0,3,2.75,1950,12630,1.0,0,0,3,8,1230,0,1969,0.0,98052,47.6301,-122.10700000000001,1990,12196,10680,0.8456057007125891,3802500,159516900,155714400
650000.0,4,2.5,2630,28298,2.0,0,0,2,8,2630,0,1996,0.0,98053,47.6314,-121.96799999999999,2840,26071,25668,0.9070605696515655,6916900,800776804,793859904
290000.0,4,2.5,2050,9015,2.0,0,0,3,7,2050,0,1973,0.0,98058,47.4357,-122.16799999999999,1780,8820,6965,0.7726012201885746,4202500,81270225,77067725
170000.0,3,1.0,790,6750,1.0,0,0,1,6,790,0,1944,0.0,98178,47.4984,-122.24,960,6298,5960,0.882962962962963,624100,45562500,44938400
510000.0,2,1.0,1070,5280,1.0,0,0,2,6,1070,0,1900,0.0,98122,47.6168,-122.303,1380,2370,4210,0.7973484848484849,1144900,27878400,26733500
2280000.0,7,8.0,13540,307752,3.0,0,4,2,12,9410,4130,1999,0.0,98053,47.6675,-121.986,4850,217800,294212,0.956003535314149,183331600,94711293504,94527961904
316000.0,4,2.5,2320,7379,2.0,0,0,2,8,2320,0,1987,0.0,98003,47.3432,-122.316,2230,7614,5059,0.6855942539639518,5382400,54449641,49067241
690000.0,4,2.5,2670,13463,2.0,0,0,3,9,2670,0,1989,0.0,98029,47.5627,-122.01799999999999,2560,10982,10793,0.8016786748867266,7128900,181252369,174123469
199950.0,2,1.0,700,5200,1.0,0,0,4,5,700,0,1952,0.0,98056,47.4924,-122.17399999999999,970,5200,4500,0.8653846153846154,490000,27040000,26550000
207000.0,3,1.0,860,7740,1.0,0,0,2,6,860,0,1960,0.0,98178,47.4906,-122.244,980,7200,6880,0.8888888888888888,739600,59907600,59168000
449950.0,4,2.25,3490,8400,1.5,0,0,3,8,3490,0,1976,0.0,98058,47.4513,-122.12799999999999,2320,8723,4910,0.5845238095238096,12180100,70560000,58379900
361550.0,3,1.75,1160,257875,1.0,0,0,1,7,1160,0,1980,0.0,98059,47.4655,-122.072,1420,15450,256715,0.99550169655841,1345600,66499515625,66498170025
824000.0,4,3.5,3650,57538,2.0,0,0,2,10,3650,0,1996,0.0,98077,47.7711,-122.041,3730,56257,53888,0.9365636622753658,13322500,3310621444,3297298944
537000.0,3,1.75,1550,10050,1.0,0,0,4,7,1550,0,1957,0.0,98008,47.6345,-122.12299999999999,1720,10050,8500,0.845771144278607,2402500,101002500,98600000
838400.0,4,2.5,2620,9525,2.5,0,0,3,9,2620,0,1974,0.0,98040,47.5631,-122.219,2580,9525,6905,0.7249343832020997,6864400,90725625,83861225
225000.0,2,1.0,720,4758,1.0,0,0,2,6,720,0,1947,0.0,98126,47.5176,-122.376,990,4920,4038,0.8486759142496847,518400,22638564,22120164
329900.0,3,2.0,1380,5198,1.0,0,0,3,7,1380,0,1982,0.0,98106,47.5514,-122.35700000000001,1320,6827,3818,0.7345132743362832,1904400,27019204,25114804
282500.0,4,1.0,1170,34925,1.0,0,0,3,6,1170,0,1942,0.0,98065,47.5305,-121.84100000000001,1610,28108,33755,0.9664996420901932,1368900,1219755625,1218386725
229950.0,3,1.75,1170,11960,1.0,0,0,3,7,1170,0,1969,0.0,98042,47.3279,-122.13600000000001,1230,9800,10790,0.9021739130434783,1368900,143041600,141672700
500000.0,2,1.0,1630,12059,1.0,0,0,2,7,1270,360,1947,0.0,98125,47.7228,-122.314,1660,8800,10429,0.8648312463720043,2656900,145419481,142762581
495000.0,3,1.75,1890,6557,1.0,0,0,2,8,1890,0,1967,0.0,98125,47.7032,-122.286,1920,6793,4667,0.7117584261095012,3572100,42994249,39422149
149500.0,3,1.0,1010,9450,1.0,0,0,3,7,1010,0,1959,0.0,98198,47.3592,-122.315,1240,9450,8440,0.8931216931216931,1020100,89302500,88282400
726000.0,3,2.5,2040,10033,1.0,0,0,3,8,1420,620,1974,0.0,98005,47.6375,-122.17299999999999,2260,10115,7993,0.7966709857470348,4161600,100661089,96499489
899000.0,4,2.5,4080,10295,2.0,0,0,2,10,4080,0,1998,0.0,98075,47.5933,-121.98200000000001,3470,10295,6215,0.6036911121903836,16646400,105987025,89340625
317000.0,3,1.0,1270,8925,1.0,0,0,4,7,1270,0,1955,0.0,98056,47.5124,-122.165,1270,8996,7655,0.857703081232493,1612900,79655625,78042725
395000.0,1,1.0,790,3000,1.0,0,0,2,6,790,0,1953,0.0,98199,47.6544,-122.38600000000001,1110,4100,2210,0.7366666666666667,624100,9000000,8375900
360000.0,4,3.0,2580,6740,2.0,0,0,2,8,2580,0,1999,0.0,98058,47.4296,-122.185,2010,6740,4160,0.6172106824925816,6656400,45427600,38771200
570000.0,4,2.5,2290,6738,2.0,0,0,2,8,2290,0,1996,0.0,98029,47.5714,-122.005,2100,6261,4448,0.6601365390323538,5244100,45400644,40156544
320000.0,4,2.5,3490,5000,2.0,0,0,2,8,3490,0,2003,0.0,98042,47.3772,-122.12700000000001,2910,5025,1510,0.302,12180100,25000000,12819900
320000.0,3,1.75,1510,30185,1.5,0,0,2,7,1510,0,1976,0.0,98058,47.4118,-122.089,1470,12465,28675,0.9499751532217989,2280100,911134225,908854125
268000.0,5,2.5,2400,4564,2.0,0,0,2,7,2400,0,2004,0.0,98042,47.369,-122.126,1880,4109,2164,0.4741454864154251,5760000,20830096,15070096
191000.0,2,1.0,900,3400,1.0,0,0,4,6,900,0,1905,0.0,98108,47.5269,-122.314,940,6000,2500,0.7352941176470589,810000,11560000,10750000
400000.0,2,1.0,1270,7440,1.0,0,0,3,7,910,360,1949,0.0,98126,47.5285,-122.37200000000001,1040,7500,6170,0.8293010752688172,1612900,55353600,53740700
515000.0,2,1.0,1050,5000,1.0,0,0,4,7,1050,0,1907,0.0,98107,47.6699,-122.369,1340,5000,3950,0.79,1102500,25000000,23897500
610000.0,4,2.5,2950,9010,2.0,0,0,2,9,2950,0,2004,0.0,98065,47.53100000000001,-121.86,3160,8813,6060,0.6725860155382908,8702500,81180100,72477600
538000.0,2,1.75,1850,3060,1.0,0,0,2,7,1060,790,1929,1992.0,98115,47.6821,-122.30799999999999,1850,4080,1210,0.3954248366013072,3422500,9363600,5941100
432000.0,3,2.5,1970,4036,2.0,0,0,3,7,1970,0,2003,0.0,98065,47.5335,-121.869,1960,5020,2066,0.5118929633300298,3880900,16289296,12408396
335000.0,4,2.25,2400,8592,2.0,0,0,2,8,2400,0,1978,0.0,98055,47.4383,-122.193,2180,8100,6192,0.7206703910614525,5760000,73822464,68062464
302000.0,5,1.75,2360,8642,1.5,0,0,4,7,2060,300,1926,0.0,98133,47.7617,-122.335,1950,8491,6282,0.7269150659569544,5569600,74684164,69114564
787500.0,4,1.75,1580,9382,1.0,0,0,2,7,1080,500,1963,0.0,98039,47.6353,-122.23200000000001,2010,9382,7802,0.8315924109997869,2496400,88021924,85525524
420000.0,3,1.0,1790,7055,1.0,0,0,4,8,1520,270,1937,0.0,98133,47.718,-122.355,1710,7055,5265,0.7462792345854005,3204100,49773025,46568925
560000.0,3,2.5,2840,216493,2.0,0,0,2,9,2840,0,1991,0.0,98014,47.702,-121.89200000000001,2820,175111,213653,0.9868817929448065,8065600,46869219049,46861153449
535000.0,3,2.5,1970,6634,2.0,0,0,2,8,1970,0,1989,0.0,98029,47.5759,-122.012,2090,6176,4664,0.7030449201085318,3880900,44009956,40129056
310000.0,3,2.5,1780,6771,1.0,0,0,2,7,1230,550,1990,0.0,98106,47.5237,-122.353,1780,6771,4991,0.7371141633436715,3168400,45846441,42678041
760000.0,5,2.0,3920,5250,1.5,0,0,4,7,2560,1360,1910,0.0,98144,47.5798,-122.294,1830,4240,1330,0.25333333333333335,15366400,27562500,12196100
242500.0,3,1.75,1550,1905,2.0,0,0,2,7,1550,0,2005,0.0,98055,47.4331,-122.195,1550,1866,355,0.18635170603674542,2402500,3629025,1226525
1310000.0,6,3.0,2980,7200,1.5,0,2,2,8,2980,0,1911,0.0,98119,47.6366,-122.36200000000001,1720,3600,4220,0.5861111111111111,8880400,51840000,42959600
235000.0,3,1.0,1270,7153,1.0,0,0,4,6,1270,0,1949,0.0,98055,47.4815,-122.226,1650,7153,5883,0.8224521179924508,1612900,51165409,49552509
598780.0,4,2.25,3040,12160,1.0,0,0,3,7,1520,1520,1963,0.0,98007,47.5911,-122.133,2560,12090,9120,0.75,9241600,147865600,138624000
433200.0,3,2.5,2075,16200,2.0,0,0,2,8,2075,0,2002,0.0,98045,47.4848,-121.698,2300,32379,14125,0.8719135802469136,4305625,262440000,258134375
343000.0,2,1.0,1110,9920,1.0,0,0,4,6,700,410,1942,0.0,98056,47.5454,-122.19200000000001,2830,10091,8810,0.8881048387096774,1232100,98406400,97174300
145000.0,2,1.0,800,8125,1.0,0,0,2,6,800,0,1964,0.0,98033,47.6836,-122.17399999999999,2390,8125,7325,0.9015384615384615,640000,66015625,65375625
291970.0,1,1.0,680,21727,1.0,0,0,2,5,680,0,1952,1995.0,98058,47.44600000000001,-122.175,1470,19406,21047,0.9687025360150964,462400,472062529,471600129
599950.0,3,1.0,1680,7910,1.0,0,0,2,7,1680,0,1949,0.0,98146,47.5085,-122.385,1330,7910,6230,0.7876106194690266,2822400,62568100,59745700
1750000.0,4,2.5,3910,22710,1.5,0,0,2,8,3910,0,1908,2003.0,98004,47.6295,-122.21700000000001,2920,16544,18800,0.8278291501541172,15288100,515744100,500456000
870000.0,4,1.75,2780,11000,1.0,0,0,2,9,1560,1220,1964,0.0,98004,47.595,-122.20299999999999,2350,11700,8220,0.7472727272727273,7728400,121000000,113271600
323000.0,4,2.75,2000,9083,2.0,0,0,3,7,2000,0,1992,0.0,98038,47.3511,-122.05799999999999,1690,7735,7083,0.7798084333370032,4000000,82500889,78500889
727000.0,4,3.0,3150,9703,2.0,0,0,2,9,3150,0,2001,0.0,98075,47.5962,-122.01799999999999,3150,8819,6553,0.6753581366587653,9922500,94148209,84225709
166000.0,1,1.0,1120,17332,1.0,0,0,2,7,1120,0,1988,0.0,98001,47.2972,-122.26700000000001,1280,17334,16212,0.9353796445880452,1254400,300398224,299143824
450000.0,4,1.75,1740,12204,1.0,0,0,2,7,1270,470,1961,0.0,98155,47.7675,-122.277,2190,12204,10464,0.8574237954768928,3027600,148937616,145910016
400000.0,3,2.5,2970,23100,1.0,0,0,2,7,1510,1460,1967,0.0,98072,47.7735,-122.133,2390,20300,20130,0.8714285714285714,8820900,533610000,524789100
599000.0,3,2.5,2970,23100,1.0,0,0,2,7,1510,1460,1967,0.0,98072,47.7735,-122.133,2390,20300,20130,0.8714285714285714,8820900,533610000,524789100
165000.0,3,1.0,1150,19200,1.0,0,0,3,5,1150,0,1908,0.0,98001,47.2756,-122.27,1290,19200,18050,0.9401041666666666,1322500,368640000,367317500
229000.0,2,1.0,1190,7408,1.0,0,0,2,6,830,360,1941,0.0,98168,47.5094,-122.31,1140,7408,6218,0.8393628509719222,1416100,54878464,53462364
305000.0,1,1.0,900,7500,1.0,0,0,2,5,900,0,1946,0.0,98155,47.7553,-122.28299999999999,1470,7500,6600,0.88,810000,56250000,55440000
930000.0,3,3.25,2950,4446,2.0,0,0,2,9,2450,500,2001,0.0,98116,47.5852,-122.391,1930,4255,1496,0.33648223121907334,8702500,19766916,11064416
542000.0,3,2.5,1990,15985,1.0,0,0,2,8,1540,450,1964,0.0,98007,47.6205,-122.141,2470,10125,13995,0.8755082890209571,3960100,255520225,251560125
214000.0,3,1.0,1020,9147,1.0,0,0,3,6,1020,0,1900,1965.0,98010,47.3127,-122.00200000000001,1600,9700,8127,0.8884880288619219,1040400,83667609,82627209
718000.0,3,2.5,2070,7200,2.0,0,0,2,8,2070,0,2001,0.0,98033,47.6946,-122.211,1650,8877,5130,0.7125,4284900,51840000,47555100
349000.0,3,2.5,1430,1002,3.0,0,0,2,8,1430,0,2002,0.0,98103,47.698,-122.34899999999999,1430,1530,-428,-0.42714570858283435,2044900,1004004,-1040896
305000.0,3,2.5,2030,8000,2.0,0,0,2,7,2030,0,1997,0.0,98031,47.4024,-122.21600000000001,2290,7945,5970,0.74625,4120900,64000000,59879100
498000.0,3,2.5,1620,2640,2.0,0,0,3,7,1620,0,1900,1993.0,98122,47.6036,-122.305,1370,3840,1020,0.38636363636363635,2624400,6969600,4345200
799950.0,4,3.5,4220,196817,2.0,0,0,2,10,4220,0,1993,0.0,98092,47.2642,-122.18700000000001,2500,195395,192597,0.9785587627085058,17808400,38736931489,38719123089
737000.0,3,2.5,2300,7800,2.0,0,2,2,9,2300,0,1997,0.0,98052,47.6842,-122.155,2300,8187,5500,0.7051282051282052,5290000,60840000,55550000
860000.0,4,3.25,3830,10005,2.0,0,0,2,10,3830,0,2001,0.0,98075,47.5953,-122.039,2555,5204,6175,0.617191404297851,14668900,100100025,85431125
339950.0,3,2.5,2390,34041,1.0,0,0,2,8,1840,550,1984,0.0,98042,47.3546,-122.081,2460,35686,31651,0.9297905466936929,5712100,1158789681,1153077581
249000.0,3,2.25,1440,7673,1.0,0,0,2,7,940,500,1982,0.0,98031,47.4034,-122.178,1440,8418,6233,0.8123289456535905,2073600,58874929,56801329
370000.0,2,1.0,910,5525,1.0,0,0,1,6,910,0,1910,0.0,98126,47.5322,-122.37899999999999,1620,5525,4615,0.8352941176470589,828100,30525625,29697525
725000.0,3,2.0,1550,12262,1.0,0,0,3,7,1550,0,1964,0.0,98040,47.5755,-122.21600000000001,2900,12372,10712,0.8735932148099821,2402500,150356644,147954144
529000.0,5,2.5,2380,91476,1.0,0,0,3,8,1580,800,1976,0.0,98059,47.479,-122.15299999999999,1880,12870,89096,0.9739822467095194,5664400,8367858576,8362194176
310000.0,4,2.75,2060,8100,1.0,0,0,3,7,1310,750,1988,0.0,98198,47.3581,-122.31700000000001,1540,8100,6040,0.745679012345679,4243600,65610000,61366400
315000.0,4,2.25,1880,9163,2.0,0,0,2,8,1880,0,1981,0.0,98058,47.4362,-122.165,1900,7980,7283,0.794827021717778,3534400,83960569,80426169
1300000.0,4,2.5,3470,4160,2.0,0,0,2,9,2480,990,1927,0.0,98119,47.63,-122.363,2280,5440,690,0.1658653846153846,12040900,17305600,5264700
435000.0,3,2.0,2360,12744,2.0,0,0,4,7,2360,0,1964,0.0,98059,47.483000000000004,-122.164,1650,8625,10384,0.8148148148148148,5569600,162409536,156839936
350000.0,3,1.75,1970,10800,1.0,0,0,3,7,1300,670,1979,0.0,98056,47.5107,-122.17200000000001,1970,8768,8830,0.8175925925925925,3880900,116640000,112759100
240000.0,3,1.0,1040,7800,1.0,0,0,2,7,1040,0,1948,0.0,98055,47.4804,-122.229,1780,8400,6760,0.8666666666666667,1081600,60840000,59758400
410000.0,3,2.25,1420,3750,2.0,0,0,2,7,1420,0,1987,0.0,98116,47.5725,-122.383,1430,4664,2330,0.6213333333333333,2016400,14062500,12046100
430000.0,4,2.75,2290,5249,2.0,0,0,2,7,2290,0,2003,0.0,98059,47.4916,-122.162,2270,4348,2959,0.5637264240807773,5244100,27552001,22307901
446000.0,4,2.5,1530,8375,1.0,0,0,2,7,1020,510,1974,0.0,98034,47.7174,-122.236,1650,9794,6845,0.8173134328358209,2340900,70140625,67799725
240000.0,3,1.5,1360,9760,1.5,0,0,4,7,1360,0,1984,0.0,98045,47.4648,-121.757,1310,11456,8400,0.860655737704918,1849600,95257600,93408000
595000.0,4,3.0,3680,35736,1.5,0,0,3,8,2320,1360,1970,0.0,98027,47.4703,-122.015,3210,39512,32056,0.8970226102529661,13542400,1277061696,1263519296
215150.0,3,1.0,920,4770,1.0,0,0,3,6,920,0,1969,0.0,98042,47.3654,-122.08200000000001,920,4770,3850,0.8071278825995807,846400,22752900,21906500
319950.0,2,1.0,1070,5824,1.0,0,2,4,7,1070,0,1949,0.0,98178,47.507,-122.242,2090,7980,4754,0.8162774725274725,1144900,33918976,32774076
385000.0,3,2.0,1590,9912,2.0,0,0,2,8,1590,0,2000,0.0,98070,47.3731,-122.43,1670,9912,8322,0.839588377723971,2528100,98247744,95719644
280000.0,3,2.5,1600,6700,2.0,0,0,2,8,1600,0,1991,0.0,98042,47.3618,-122.074,1790,7577,5100,0.7611940298507462,2560000,44890000,42330000
399950.0,3,2.5,1510,7300,1.0,0,0,2,7,1040,470,1974,0.0,98034,47.7153,-122.211,1360,7300,5790,0.7931506849315069,2280100,53290000,51009900
132500.0,3,1.0,1080,10500,1.0,0,0,2,7,1080,0,1967,0.0,98001,47.32,-122.27799999999999,1200,9607,9420,0.8971428571428571,1166400,110250000,109083600
399950.0,2,0.75,1330,2856,1.0,0,0,3,7,930,400,1916,0.0,98126,47.5671,-122.37,1330,2856,1526,0.5343137254901961,1768900,8156736,6387836
290000.0,2,1.0,850,6800,1.0,0,0,2,7,850,0,1948,0.0,98133,47.7282,-122.337,870,6800,5950,0.875,722500,46240000,45517500
860000.0,5,2.25,1960,8592,1.0,0,0,3,8,1290,670,1958,0.0,98004,47.6066,-122.19200000000001,1720,8592,6632,0.7718808193668529,3841600,73822464,69980864
3100000.0,6,4.25,6980,15682,3.0,0,4,3,12,5330,1650,1999,0.0,98040,47.5552,-122.23100000000001,3930,18367,8702,0.5549037112613187,48720400,245925124,197204724
245000.0,4,1.0,1530,7200,1.5,0,0,2,7,1400,130,1948,0.0,98178,47.5015,-122.262,1530,7200,5670,0.7875,2340900,51840000,49499100
255000.0,3,1.5,1320,7980,1.0,0,0,2,7,1320,0,1956,0.0,98178,47.5068,-122.259,2000,7700,6660,0.8345864661654135,1742400,63680400,61938000
310000.0,4,3.0,2320,7200,2.0,0,0,2,7,2320,0,1976,0.0,98155,47.7703,-122.31200000000001,2050,10000,4880,0.6777777777777778,5382400,51840000,46457600
299000.0,3,1.0,960,8100,1.0,0,0,2,7,960,0,1955,0.0,98155,47.7763,-122.305,1080,8100,7140,0.8814814814814815,921600,65610000,64688400
575000.0,4,2.5,2040,5508,2.0,0,0,3,8,2040,0,1996,0.0,98029,47.5719,-122.007,2130,5496,3468,0.6296296296296297,4161600,30338064,26176464
284000.0,3,1.0,1080,8214,1.0,0,0,2,7,1080,0,1944,0.0,98133,47.7401,-122.348,1850,13560,7134,0.8685171658144631,1166400,67469796,66303396
840000.0,3,1.75,2020,4800,1.0,0,0,3,8,1090,930,1926,0.0,98115,47.6726,-122.294,1680,4800,2780,0.5791666666666667,4080400,23040000,18959600
442573.0,3,1.75,1780,7567,1.0,0,0,2,7,1290,490,1980,0.0,98034,47.7314,-122.225,1910,8645,5787,0.7647680718911061,3168400,57259489,54091089
560000.0,3,1.0,1140,7028,1.0,0,0,2,8,1140,0,1931,0.0,98115,47.6948,-122.322,1350,6923,5888,0.8377916903813318,1299600,49392784,48093184
485000.0,3,2.0,1610,4160,1.0,0,0,3,7,1010,600,1917,0.0,98136,47.5421,-122.38799999999999,1040,4400,2550,0.6129807692307693,2592100,17305600,14713500
472500.0,4,1.75,1440,8536,1.0,0,0,3,7,1440,0,1961,0.0,98033,47.6775,-122.18,1720,9748,7096,0.831302717900656,2073600,72863296,70789696
1610000.0,4,2.75,4270,25807,2.0,0,0,2,11,4270,0,1996,0.0,98004,47.5951,-122.206,3860,20723,21537,0.8345410160034099,18232900,666001249,647768349
808000.0,8,3.75,3460,4600,2.0,0,0,2,7,2860,600,1987,0.0,98105,47.6617,-122.289,2170,3750,1140,0.24782608695652175,11971600,21160000,9188400
398000.0,3,1.75,1890,16001,1.5,0,0,3,7,1890,0,1950,0.0,98011,47.7663,-122.20100000000001,1820,11450,14111,0.8818823823511031,3572100,256032001,252459901
340000.0,3,2.5,2240,6000,2.0,0,0,2,8,2240,0,2003,0.0,98059,47.4837,-122.13799999999999,2400,6000,3760,0.6266666666666667,5017600,36000000,30982400
380000.0,2,1.0,760,4000,1.5,0,0,2,6,760,0,1910,0.0,98108,47.5462,-122.32,1130,4000,3240,0.81,577600,16000000,15422400
235000.0,3,1.0,1020,6173,1.0,0,0,2,6,780,240,1948,0.0,98168,47.5042,-122.329,1330,5909,5153,0.8347642961283006,1040400,38105929,37065529
400000.0,3,1.5,1330,9900,1.0,0,0,2,7,1330,0,1956,0.0,98034,47.7167,-122.23299999999999,1940,9900,8570,0.8656565656565657,1768900,98010000,96241100
582000.0,5,2.5,2780,12335,1.0,0,0,3,8,1590,1190,1968,0.0,98006,47.5681,-122.12799999999999,2750,9930,9555,0.7746250506688286,7728400,152152225,144423825
209000.0,2,1.0,1070,6120,1.0,0,0,2,6,1070,0,1962,0.0,98168,47.4989,-122.31700000000001,1130,6120,5050,0.8251633986928104,1144900,37454400,36309500
335000.0,5,3.0,2660,7700,1.5,0,0,3,7,1670,990,1962,0.0,98058,47.46,-122.17399999999999,1610,7700,5040,0.6545454545454545,7075600,59290000,52214400
285950.0,2,1.0,710,7120,1.0,0,0,4,6,710,0,1942,0.0,98146,47.5122,-122.374,1100,7020,6410,0.9002808988764045,504100,50694400,50190300
645000.0,5,2.25,3340,52476,2.0,0,0,3,8,3340,0,1975,0.0,98027,47.4553,-121.98700000000001,2460,48351,49136,0.936351856086592,11155600,2753730576,2742574976
312000.0,2,1.0,1160,7500,1.5,0,0,3,7,1160,0,1916,0.0,98014,47.6499,-121.916,1110,7500,6340,0.8453333333333334,1345600,56250000,54904400
663000.0,3,2.25,2840,59677,1.0,0,0,2,7,1580,1260,1967,0.0,98075,47.5828,-122.044,2220,31688,56837,0.9524104763979423,8065600,3561344329,3553278729
443950.0,3,1.75,2000,36000,1.0,0,0,2,6,2000,0,1946,0.0,98056,47.5217,-122.182,2100,9681,34000,0.9444444444444444,4000000,1296000000,1292000000
315000.0,3,2.0,1060,5750,1.0,0,0,2,7,1060,0,1981,0.0,98126,47.5523,-122.37200000000001,1080,5750,4690,0.8156521739130435,1123600,33062500,31938900
302200.0,4,1.5,1730,10396,1.0,0,0,2,7,1730,0,1964,0.0,98058,47.4497,-122.16799999999999,1510,10396,8666,0.833589842247018,2992900,108076816,105083916
770000.0,3,2.5,2190,2658,2.0,0,3,3,9,2190,0,1979,0.0,98033,47.6528,-122.20299999999999,2315,2538,468,0.17607223476297967,4796100,7064964,2268864
374950.0,4,1.75,1660,8160,1.0,0,0,2,8,1660,0,1974,0.0,98058,47.4483,-122.12899999999999,1800,7684,6500,0.7965686274509803,2755600,66585600,63830000
330000.0,3,2.5,2210,7557,2.0,0,0,2,9,2210,0,1989,0.0,98023,47.3079,-122.39299999999999,2440,8641,5347,0.7075559084292709,4884100,57108249,52224149
230000.0,2,1.0,870,7020,1.0,0,0,3,6,570,300,1942,0.0,98106,47.5404,-122.352,1730,7020,6150,0.8760683760683761,756900,49280400,48523500
967000.0,4,2.5,3100,7250,2.0,0,0,2,9,3100,0,2010,0.0,98115,47.6961,-122.316,1240,6670,4150,0.5724137931034483,9610000,52562500,42952500
536500.0,4,2.5,1720,3515,2.0,0,2,2,8,1470,0,2000,0.0,98144,47.591,-122.29299999999999,1140,2208,1795,0.5106685633001422,2958400,12355225,9396825
315000.0,6,4.0,3120,4240,2.0,0,2,3,7,2090,1030,1993,0.0,98106,47.5305,-122.353,1460,4240,1120,0.2641509433962264,9734400,17977600,8243200
626000.0,3,1.0,1040,4240,1.0,0,0,3,7,860,180,1924,0.0,98117,47.6768,-122.367,1170,4240,3200,0.7547169811320755,1081600,17977600,16896000
334009.0,4,2.0,1650,9305,1.0,0,0,3,6,1650,0,1960,0.0,98034,47.7183,-122.213,1860,7486,7655,0.8226759806555616,2722500,86583025,83860525
429000.0,2,1.0,1010,5000,1.0,0,0,1,7,1010,0,1924,0.0,98107,47.6715,-122.365,1410,5000,3990,0.798,1020100,25000000,23979900
818000.0,4,2.5,4020,44431,2.0,0,0,2,10,4020,0,1987,0.0,98072,47.7467,-122.132,3440,52900,40411,0.9095226305957552,16160400,1974113761,1957953361
326000.0,5,2.75,2166,6342,2.0,0,0,2,8,2166,0,2013,0.0,98042,47.3461,-122.152,2474,5948,4176,0.6584673604541155,4691556,40220964,35529408
310000.0,5,3.0,1880,5000,1.0,0,0,2,7,1100,780,1997,0.0,98106,47.5453,-122.363,1640,5000,3120,0.624,3534400,25000000,21465600
525000.0,4,2.0,2260,7680,1.0,0,0,3,7,1130,1130,1947,0.0,98177,47.7193,-122.361,1800,7680,5420,0.7057291666666666,5107600,58982400,53874800
350000.0,3,2.25,2010,4400,1.5,0,0,2,7,2010,0,1986,0.0,98055,47.4735,-122.189,1720,4187,2390,0.5431818181818182,4040100,19360000,15319900
936000.0,4,2.5,3330,8897,2.0,0,0,2,10,3330,0,2001,0.0,98074,47.6484,-122.08,3150,7515,5567,0.6257165336630325,11088900,79156609,68067709
226000.0,3,1.0,1520,7200,1.0,0,0,2,7,1030,490,1954,0.0,98166,47.4527,-122.352,1530,7201,5680,0.7888888888888889,2310400,51840000,49529600
1250000.0,5,3.5,3510,4798,2.0,0,0,2,10,2700,810,2008,0.0,98105,47.669,-122.28200000000001,1460,1684,1288,0.2684451854939558,12320100,23020804,10700704
428000.0,3,1.75,1580,507038,1.0,0,2,3,7,1580,0,1985,0.0,98022,47.2303,-121.936,2040,210394,505458,0.9968838627479597,2496400,257087533444,257085037044
329932.0,3,1.5,1460,5040,1.0,0,0,2,7,1100,360,1971,0.0,98133,47.7112,-122.35700000000001,2330,7560,3580,0.7103174603174603,2131600,25401600,23270000
539000.0,3,1.5,1460,5040,1.0,0,0,2,7,1100,360,1971,0.0,98133,47.7112,-122.35700000000001,2330,7560,3580,0.7103174603174603,2131600,25401600,23270000
275000.0,3,1.75,1650,7700,1.0,0,0,3,8,1650,0,1977,0.0,98023,47.3155,-122.365,2020,7700,6050,0.7857142857142857,2722500,59290000,56567500
590000.0,4,2.5,2660,35010,2.0,0,2,2,9,2660,0,1993,0.0,98045,47.4816,-121.714,2330,35448,32350,0.9240217080834048,7075600,1225700100,1218624500
782000.0,4,2.5,3510,24604,2.0,0,0,2,10,3510,0,1997,0.0,98053,47.6772,-122.056,3530,26673,21094,0.8573402698748172,12320100,605356816,593036716
575000.0,4,2.5,2120,9603,2.0,0,0,2,8,2120,0,1985,0.0,98027,47.5348,-122.053,1990,9611,7483,0.7792356555243153,4494400,92217609,87723209
509000.0,3,2.25,1780,9315,2.0,0,0,2,7,1780,0,1996,0.0,98133,47.7484,-122.353,1780,8545,7535,0.8089103596349974,3168400,86769225,83600825
290000.0,4,2.5,2000,13300,1.0,0,0,3,7,1200,800,1968,0.0,98001,47.353,-122.294,1800,9810,11300,0.849624060150376,4000000,176890000,172890000
305240.0,3,1.0,1300,9000,1.0,0,0,2,7,1300,0,1956,0.0,98133,47.7352,-122.337,1500,9600,7700,0.8555555555555555,1690000,81000000,79310000
555000.0,3,2.0,2180,4976,1.5,0,2,3,8,1680,500,1930,0.0,98126,47.573,-122.38,1850,5000,2796,0.5618971061093248,4752400,24760576,20008176
317000.0,3,2.0,1790,8228,1.0,0,0,2,7,1390,400,1980,0.0,98058,47.4658,-122.17200000000001,1880,8228,6438,0.782450170150705,3204100,67699984,64495884
430000.0,3,2.0,1910,5040,1.5,0,0,2,8,1910,0,1971,0.0,98074,47.6312,-122.061,1980,4275,3130,0.621031746031746,3648100,25401600,21753500
850000.0,2,1.5,1800,4144,1.0,0,4,3,7,900,900,1962,0.0,98116,47.5934,-122.39,2090,4173,2344,0.5656370656370656,3240000,17172736,13932736
469000.0,3,2.25,2620,10659,1.0,0,0,2,7,1660,960,1976,0.0,98155,47.7643,-122.273,1820,12071,8039,0.7541983300497233,6864400,113614281,106749881
327200.0,2,2.0,1440,8425,1.0,0,0,3,6,1440,0,1942,1983.0,98168,47.4831,-122.296,1430,12037,6985,0.829080118694362,2073600,70980625,68907025
835000.0,3,3.0,2790,12523,2.0,1,4,3,8,1600,1190,1977,0.0,98198,47.3571,-122.324,2990,11476,9733,0.7772099337219516,7784100,156825529,149041429
360000.0,4,2.5,2340,13445,2.0,0,0,2,8,2340,0,1990,0.0,98042,47.373999999999995,-122.125,2340,11188,11105,0.8259576050576423,5475600,180768025,175292425
372000.0,4,2.5,2070,8658,2.0,0,0,2,8,2070,0,1999,0.0,98178,47.5072,-122.257,2010,7215,6588,0.760914760914761,4284900,74960964,70676064
453000.0,3,1.0,2160,11484,1.5,0,0,3,7,2160,0,1968,0.0,98034,47.7277,-122.185,2270,10080,9324,0.8119122257053292,4665600,131882256,127216656
275000.0,2,1.75,2090,11317,1.0,0,0,4,7,1090,1000,1931,0.0,98188,47.4594,-122.279,1940,11317,9227,0.815322081823805,4368100,128074489,123706389
475000.0,4,2.5,2040,7260,2.0,0,0,3,7,2040,0,1963,0.0,98133,47.7399,-122.33200000000001,2040,7360,5220,0.71900826446281,4161600,52707600,48546000
310000.0,4,2.75,1950,9720,1.0,0,0,2,7,1400,550,1986,0.0,98031,47.3969,-122.205,2300,10530,7770,0.7993827160493827,3802500,94478400,90675900
173000.0,4,2.0,1200,8460,1.0,0,0,4,7,1200,0,1957,0.0,98188,47.4413,-122.277,1350,8623,7260,0.8581560283687943,1440000,71571600,70131600
313500.0,5,3.0,2240,94960,1.0,0,0,2,6,2240,0,1985,0.0,98045,47.481,-121.788,1780,43400,92720,0.9764111204717776,5017600,9017401600,9012384000
345000.0,3,2.5,1360,1489,2.0,0,0,2,8,1360,0,2007,0.0,98126,47.549,-122.37200000000001,1360,1688,129,0.08663532572196105,1849600,2217121,367521
436000.0,3,1.5,1500,10200,1.0,0,0,2,8,1300,200,1955,0.0,98177,47.7598,-122.359,1950,9500,8700,0.8529411764705882,2250000,104040000,101790000
244500.0,2,1.75,1300,14500,1.0,0,0,2,6,650,0,1939,0.0,98168,47.4989,-122.329,1370,12986,13200,0.9103448275862069,1690000,210250000,208560000
206000.0,3,1.75,1140,9800,1.0,0,0,3,7,1140,0,1968,0.0,98001,47.3063,-122.27,1370,9800,8660,0.8836734693877552,1299600,96040000,94740400
890000.0,4,2.5,2930,9158,2.0,0,0,2,9,2930,0,2005,0.0,98052,47.7065,-122.13,3590,8065,6228,0.6800611487224285,8584900,83868964,75284064
329950.0,4,2.25,2140,8874,2.0,0,0,2,8,2140,0,1986,0.0,98092,47.2654,-122.21700000000001,2140,8789,6734,0.7588460671624971,4579600,78747876,74168276
250000.0,3,1.75,1628,286355,1.0,0,0,2,7,1628,0,1996,0.0,98092,47.2558,-122.12200000000001,1490,216344,284727,0.9943147491749751,2650384,81999186025,81996535641
246000.0,3,2.0,1990,203861,1.0,0,0,2,7,1990,0,1949,0.0,98022,47.2507,-122.039,2760,217800,201871,0.9902384467848191,3960100,41559307321,41555347221
440000.0,3,1.75,1950,19747,1.0,0,0,2,7,1150,800,1979,0.0,98072,47.7685,-122.162,2560,9674,17797,0.9012508229098091,3802500,389944009,386141509
395000.0,4,1.75,1910,8117,1.0,0,0,2,7,1460,450,1975,0.0,98072,47.7344,-122.17299999999999,1810,8100,6207,0.7646913884440064,3648100,65885689,62237589
305000.0,3,1.0,820,5150,1.0,0,0,4,6,820,0,1918,0.0,98118,47.5514,-122.28399999999999,1100,5150,4330,0.8407766990291262,672400,26522500,25850100
160000.0,3,2.25,1470,8682,1.0,0,0,2,7,1160,310,1985,0.0,98003,47.2729,-122.29899999999999,1670,8359,7212,0.8306841741534209,2160900,75377124,73216224
269000.0,3,2.25,1470,8682,1.0,0,0,2,7,1160,310,1985,0.0,98003,47.2729,-122.29899999999999,1670,8359,7212,0.8306841741534209,2160900,75377124,73216224
169500.0,3,1.0,1060,10023,1.0,0,0,2,6,1060,0,1962,0.0,98023,47.2869,-122.36,1060,10023,8963,0.8942432405467425,1123600,100460529,99336929
690500.0,4,2.75,3130,8920,2.0,0,0,2,8,3130,0,2014,0.0,98155,47.7397,-122.316,1450,9183,5790,0.649103139013453,9796900,79566400,69769500
245560.0,2,1.5,1260,9693,1.0,0,0,2,7,1260,0,1957,0.0,98177,47.7775,-122.365,1800,9693,8433,0.8700092850510678,1587600,93954249,92366649
345000.0,4,2.75,2200,13498,2.0,0,0,2,8,2200,0,1987,0.0,98023,47.3148,-122.35,2190,11850,11298,0.8370128907986368,4840000,182196004,177356004
383000.0,4,1.75,2580,19607,1.0,0,2,3,8,1290,1290,1958,0.0,98056,47.5067,-122.197,1970,9569,17027,0.8684143418166981,6656400,384434449,377778049
388500.0,3,2.25,1350,944,2.0,0,0,2,8,1050,300,2007,0.0,98144,47.5997,-122.31200000000001,1350,1245,-406,-0.4300847457627119,1822500,891136,-931364
250000.0,3,1.75,1350,8548,1.0,0,0,2,7,1350,0,1985,0.0,98003,47.3179,-122.33,1660,8538,7198,0.8420683200748713,1822500,73068304,71245804
455500.0,3,1.75,2290,19000,1.0,0,0,3,9,1650,640,1973,0.0,98042,47.3837,-122.15799999999999,2900,13034,16710,0.8794736842105263,5244100,361000000,355755900
672000.0,3,1.0,1220,8573,1.0,0,0,3,7,1220,0,1954,0.0,98004,47.6088,-122.193,1390,8573,7353,0.8576927563280066,1488400,73496329,72007929
550000.0,4,1.5,2750,128502,1.0,0,0,1,7,1500,1250,1958,0.0,98055,47.4345,-122.198,1470,11514,125752,0.9785995548707414,7562500,16512764004,16505201504
487000.0,3,1.75,1430,12632,1.0,0,0,2,7,1430,0,1959,0.0,98008,47.6371,-122.12299999999999,1750,10350,11202,0.886795440151995,2044900,159567424,157522524
291375.0,4,2.5,2220,6233,2.0,0,0,2,7,2220,0,2001,0.0,98059,47.4887,-122.15,2220,5352,4013,0.6438312209209048,4928400,38850289,33921889
225000.0,3,1.0,1490,15850,1.0,0,0,2,7,1490,0,1946,0.0,98133,47.7411,-122.34700000000001,1950,13228,14360,0.905993690851735,2220100,251222500,249002400
519950.0,5,3.5,2440,10200,2.0,0,0,3,7,2440,0,1974,0.0,98075,47.5814,-122.00299999999999,2000,10568,7760,0.7607843137254902,5953600,104040000,98086400
250000.0,3,2.5,2070,8400,2.0,0,0,3,8,2070,0,1990,0.0,98002,47.3099,-122.206,2070,9239,6330,0.7535714285714286,4284900,70560000,66275100
614950.0,3,1.0,1500,2400,1.5,0,0,4,7,1500,0,1900,0.0,98119,47.6333,-122.36200000000001,1780,3600,900,0.375,2250000,5760000,3510000
599500.0,4,2.25,2020,10260,2.0,0,0,3,7,2020,0,1984,0.0,98052,47.6801,-122.11399999999999,2020,10311,8240,0.8031189083820662,4080400,105267600,101187200
625000.0,4,1.5,2190,13660,1.0,0,3,2,8,2190,0,1952,0.0,98177,47.7658,-122.37,2520,20500,11470,0.8396778916544656,4796100,186595600,181799500
248500.0,2,1.0,780,10064,1.0,0,0,3,7,780,0,1958,0.0,98168,47.4913,-122.318,1090,14750,9284,0.9224960254372019,608400,101284096,100675696
469950.0,5,2.0,1220,4200,1.0,0,0,3,6,1090,130,1921,0.0,98105,47.6677,-122.321,1790,4200,2980,0.7095238095238096,1488400,17640000,16151600
525000.0,3,1.5,1840,10956,1.0,0,0,3,8,1840,0,1970,0.0,98033,47.6746,-122.164,1680,10950,9116,0.8320554947060971,3385600,120033936,116648336
787500.0,2,2.5,2390,6928,2.0,0,3,3,8,1810,580,1949,1982.0,98146,47.5101,-122.391,2390,12852,4538,0.6550230946882217,5712100,47997184,42285084
485000.0,4,2.5,3710,15935,1.0,0,0,2,10,2130,1580,2005,0.0,98001,47.3528,-122.26700000000001,3674,17913,12225,0.767179165359272,13764100,253924225,240160125
310000.0,2,1.0,750,5379,1.0,0,0,2,6,750,0,1919,0.0,98118,47.5324,-122.272,1030,5511,4629,0.860568878973787,562500,28933641,28371141
280000.0,5,2.0,2110,7919,1.0,0,0,2,7,1110,1000,1966,0.0,98118,47.5164,-122.26700000000001,1590,5250,5809,0.7335522161889128,4452100,62710561,58258461
200000.0,4,1.0,1020,42966,1.5,0,0,3,6,1020,0,1922,0.0,98072,47.7617,-122.11,2250,37680,41946,0.976260298840944,1040400,1846077156,1845036756
490000.0,3,2.5,3080,7363,2.0,0,0,2,9,3080,0,2006,0.0,98055,47.4473,-122.205,2860,5273,4283,0.5816922450088279,9486400,54213769,44727369
146000.0,3,1.0,900,4770,1.0,0,0,2,6,900,0,1969,2009.0,98023,47.3038,-122.36200000000001,900,3480,3870,0.8113207547169812,810000,22752900,21942900
500000.0,5,3.0,3720,25474,2.0,0,4,2,9,2090,1630,1986,0.0,98001,47.3296,-122.256,1870,14547,21754,0.853968752453482,13838400,648924676,635086276
242500.0,3,1.0,940,7380,1.0,0,0,2,6,940,0,1959,0.0,98058,47.4516,-122.175,1210,8095,6440,0.8726287262872628,883600,54464400,53580800
324950.0,3,1.0,1040,7288,1.0,0,0,2,7,1040,0,1959,0.0,98125,47.7287,-122.311,1160,7287,6248,0.8572996706915478,1081600,53114944,52033344
231500.0,2,1.0,1000,7615,1.0,0,0,3,6,1000,0,1943,0.0,98056,47.49,-122.191,1060,8000,6615,0.8686802363755746,1000000,57988225,56988225
300000.0,3,2.5,2080,9827,2.0,0,0,2,8,2080,0,1989,0.0,98023,47.3058,-122.39399999999999,2660,9861,7747,0.7883382517553679,4326400,96569929,92243529
545000.0,4,2.5,2500,50595,2.0,0,0,2,9,2500,0,1997,0.0,98045,47.4736,-121.73100000000001,2765,33720,48095,0.9505880027670719,6250000,2559854025,2553604025
350000.0,3,1.0,1050,8583,1.0,0,0,4,6,1050,0,1955,0.0,98133,47.7451,-122.339,1460,7351,7533,0.8776651520447396,1102500,73667889,72565389
467100.0,3,1.75,1620,8645,1.0,0,0,2,7,1190,430,1973,0.0,98052,47.6651,-122.15100000000001,2010,8645,7025,0.8126084441873915,2624400,74736025,72111625
180000.0,3,1.0,1610,8500,1.5,0,0,2,7,1610,0,1959,0.0,98032,47.3717,-122.29700000000001,1070,8750,6890,0.8105882352941176,2592100,72250000,69657900
749000.0,4,1.5,2130,5000,2.0,0,0,3,8,2130,0,1920,0.0,98144,47.5828,-122.291,2560,5000,2870,0.574,4536900,25000000,20463100
245000.0,3,2.5,1460,11593,2.0,0,0,2,7,1460,0,1989,0.0,98023,47.2984,-122.385,1640,9703,10133,0.8740619339256448,2131600,134397649,132266049
260000.0,5,1.0,1600,7350,1.0,0,0,4,7,1600,0,1962,0.0,98031,47.3943,-122.196,1600,7725,5750,0.782312925170068,2560000,54022500,51462500
490000.0,3,3.0,1730,2940,3.0,0,0,2,7,1730,0,1985,0.0,98117,47.6911,-122.39200000000001,1690,4410,1210,0.41156462585034015,2992900,8643600,5650700
565000.0,4,2.5,2280,4602,2.0,0,0,2,8,2280,0,2003,0.0,98075,47.5895,-122.01899999999999,2280,4193,2322,0.5045632333767927,5198400,21178404,15980004
330000.0,4,2.25,2430,7490,2.0,0,0,2,8,2430,0,1983,0.0,98058,47.4406,-122.139,2070,7469,5060,0.6755674232309746,5904900,56100100,50195200
295000.0,3,1.0,1380,7575,1.0,0,0,3,7,1380,0,1963,0.0,98056,47.5139,-122.18700000000001,1320,7600,6195,0.8178217821782178,1904400,57380625,55476225
725000.0,3,1.5,1790,6000,1.5,0,0,3,7,1790,0,1903,0.0,98115,47.6754,-122.325,1290,3500,4210,0.7016666666666667,3204100,36000000,32795900
1140000.0,4,2.5,3370,10602,2.0,0,0,2,10,3370,0,1999,0.0,98007,47.6591,-122.147,2950,9949,7232,0.6821354461422373,11356900,112402404,101045504
680000.0,3,2.25,2920,6300,1.0,0,0,2,8,1710,1210,1956,0.0,98177,47.7065,-122.37,1940,6300,3380,0.5365079365079365,8526400,39690000,31163600
490000.0,2,1.0,2180,9300,1.0,0,0,3,7,1090,1090,1947,0.0,98177,47.7032,-122.37100000000001,1830,7378,7120,0.7655913978494624,4752400,86490000,81737600
635000.0,3,1.75,1480,6985,1.5,0,0,3,7,1200,280,1926,0.0,98117,47.68600000000001,-122.374,1480,5588,5505,0.788117394416607,2190400,48790225,46599825
750000.0,3,2.5,2350,715690,1.5,0,0,3,9,2350,0,1979,0.0,98022,47.1622,-121.971,1280,325393,713340,0.9967164554485881,5522500,512212176100,512206653600
330000.0,4,2.25,2440,8098,2.0,0,0,2,8,2440,0,1983,0.0,98023,47.3126,-122.346,2110,7911,5658,0.6986910348234132,5953600,65577604,59624004
270000.0,3,2.5,1350,1189,2.0,0,0,2,7,1080,270,2007,0.0,98106,47.5218,-122.35799999999999,1300,1182,-161,-0.13540790580319595,1822500,1413721,-408779
340000.0,3,2.25,1970,3716,2.0,0,0,2,7,1970,0,1997,0.0,98056,47.4907,-122.167,1780,3716,1746,0.4698600645855759,3880900,13808656,9927756
413252.0,3,0.75,1110,3960,1.0,0,0,2,7,1110,0,1951,0.0,98117,47.6834,-122.366,1610,5530,2850,0.7196969696969697,1232100,15681600,14449500
600000.0,4,2.75,2950,5803,2.0,0,0,2,9,2950,0,2007,0.0,98028,47.7368,-122.23100000000001,2940,5803,2853,0.4916422540065483,8702500,33674809,24972309
726888.0,5,3.0,2970,7261,2.0,0,0,2,9,2970,0,1999,0.0,98075,47.5994,-122.01899999999999,2970,8437,4291,0.590965431758711,8820900,52722121,43901221
285000.0,2,1.0,720,6400,1.0,0,0,3,6,720,0,1943,0.0,98126,47.5286,-122.368,1030,6400,5680,0.8875,518400,40960000,40441600
365000.0,2,1.0,770,5680,1.0,0,0,3,6,770,0,1929,0.0,98117,47.6951,-122.366,1170,5514,4910,0.8644366197183099,592900,32262400,31669500
295000.0,4,2.0,1650,7200,1.0,0,0,2,7,1650,0,1964,0.0,98133,47.7543,-122.344,1410,7200,5550,0.7708333333333334,2722500,51840000,49117500
460000.0,3,2.25,1620,7350,1.0,0,0,2,7,1170,450,1969,0.0,98034,47.7248,-122.179,1800,7350,5730,0.7795918367346939,2624400,54022500,51398100
230000.0,3,1.5,1510,10588,1.5,0,0,2,7,1510,0,1947,0.0,98198,47.3775,-122.319,1360,2873,9078,0.8573857196826596,2280100,112105744,109825644
337000.0,3,1.0,1070,6109,1.0,0,0,4,7,1070,0,1951,0.0,98125,47.7207,-122.32,1170,7200,5039,0.8248485840563103,1144900,37319881,36174981
300000.0,3,1.0,1010,6300,1.0,0,0,2,7,1010,0,1957,0.0,98133,47.7304,-122.352,1480,7480,5290,0.8396825396825397,1020100,39690000,38669900
2300000.0,4,2.5,3370,8402,1.0,0,0,4,10,2240,1130,1962,0.0,98112,47.6349,-122.29,3190,8700,5032,0.5989050226136634,11356900,70593604,59236704
360000.0,4,2.5,2000,5500,2.0,0,0,2,8,2000,0,2003,0.0,98038,47.3552,-122.014,2000,5512,3500,0.6363636363636364,4000000,30250000,26250000
585000.0,3,2.5,2060,10839,2.0,0,0,2,8,2060,0,1987,0.0,98029,47.5675,-122.016,2180,8126,8779,0.809945566934219,4243600,117483921,113240321
182700.0,3,2.25,1740,6650,1.0,0,0,2,7,1240,500,1978,0.0,98023,47.2979,-122.37899999999999,1740,7000,4910,0.7383458646616541,3027600,44222500,41194900
305000.0,3,2.25,1740,6650,1.0,0,0,2,7,1240,500,1978,0.0,98023,47.2979,-122.37899999999999,1740,7000,4910,0.7383458646616541,3027600,44222500,41194900
309950.0,3,2.5,1880,7838,2.0,0,0,2,7,1880,0,1994,0.0,98055,47.4439,-122.19,1810,7915,5958,0.760142893595305,3534400,61434244,57899844
550000.0,3,1.0,960,12527,1.0,0,0,2,7,960,0,1972,0.0,98033,47.6891,-122.20299999999999,1220,7579,11567,0.9233655304542189,921600,156925729,156004129
825000.0,3,2.5,3280,26413,1.0,0,3,2,11,2670,610,1985,0.0,98074,47.6395,-122.05,3280,25211,23133,0.8758187256275319,10758400,697646569,686888169
998500.0,2,1.0,1570,4400,1.5,0,0,3,8,1570,0,1914,0.0,98122,47.6112,-122.29299999999999,1850,4400,2830,0.6431818181818182,2464900,19360000,16895100
644500.0,4,2.5,2990,5342,2.0,0,0,2,8,2990,0,2004,0.0,98074,47.6124,-122.009,2990,5936,2352,0.44028453762635716,8940100,28536964,19596864
320000.0,3,2.0,1250,8636,1.0,0,0,4,7,1250,0,1968,0.0,98059,47.5066,-122.15899999999999,1620,7653,7386,0.8552570634553034,1562500,74580496,73017996
266950.0,3,2.5,1920,4803,2.0,0,0,2,7,1920,0,2005,0.0,98042,47.3745,-122.12700000000001,2240,5231,2883,0.6002498438475953,3686400,23068809,19382409
633100.0,4,2.5,2470,33305,2.0,0,0,2,9,2470,0,1993,0.0,98053,47.6303,-121.99,2440,33305,30835,0.9258369614172046,6100900,1109223025,1103122125
395000.0,2,1.0,960,6700,1.0,0,0,2,7,960,0,1951,0.0,98103,47.6955,-122.35700000000001,1350,6700,5740,0.8567164179104477,921600,44890000,43968400
259250.0,3,1.0,940,5904,1.0,0,0,2,6,940,0,1947,0.0,98103,47.699,-122.35,870,5728,4964,0.8407859078590786,883600,34857216,33973616
300000.0,3,1.0,1260,5000,1.0,0,0,3,6,1260,0,1968,0.0,98014,47.6492,-121.915,1180,7500,3740,0.748,1587600,25000000,23412400
413000.0,3,1.75,2280,139392,1.0,0,0,2,8,2280,0,1977,0.0,98092,47.291000000000004,-122.118,2280,117176,137112,0.9836432506887053,5198400,19430129664,19424931264
435000.0,3,2.25,1740,8491,1.0,0,0,2,8,1240,500,1958,0.0,98177,47.7758,-122.37899999999999,2080,8494,6751,0.7950771405017076,3027600,72097081,69069481
500000.0,4,2.75,2630,15000,1.0,0,0,3,7,1690,940,1976,0.0,98072,47.7425,-122.089,1800,16500,12370,0.8246666666666667,6916900,225000000,218083100
402000.0,4,1.75,2430,5481,1.0,0,0,2,8,1430,1000,1953,0.0,98108,47.5569,-122.29799999999999,2050,5508,3051,0.5566502463054187,5904900,30041361,24136461
777700.0,3,2.5,2260,251460,1.5,0,0,2,10,2260,0,1995,0.0,98070,47.4096,-122.449,1610,244372,249200,0.9910124870754792,5107600,63232131600,63227024000
580000.0,2,1.5,1220,5000,1.0,0,2,3,7,1220,0,1938,0.0,98103,47.6624,-122.348,2090,3850,3780,0.756,1488400,25000000,23511600
570000.0,3,1.75,2580,40392,1.0,0,0,2,9,1390,1190,1986,0.0,98072,47.7637,-122.134,2460,46173,37812,0.9361259655377302,6656400,1631513664,1624857264
174950.0,2,1.0,730,6000,1.0,0,0,2,6,730,0,1950,0.0,98198,47.3832,-122.3,1750,7200,5270,0.8783333333333333,532900,36000000,35467100
300000.0,2,1.0,760,3001,1.0,0,0,2,6,760,0,1913,0.0,98144,47.5874,-122.311,1750,5000,2241,0.7467510829723426,577600,9006001,8428401
435000.0,3,1.5,1740,6988,1.0,0,0,2,7,1600,140,1950,0.0,98133,47.7211,-122.33,1650,7500,5248,0.7510017172295363,3027600,48832144,45804544
840000.0,4,2.5,3420,8405,2.0,0,0,2,10,3420,0,2000,0.0,98074,47.6328,-122.064,3230,8460,4985,0.5930993456276026,11696400,70644025,58947625
469000.0,5,2.5,2240,7543,1.0,0,0,2,7,1140,1100,1966,0.0,98177,47.7756,-122.37200000000001,2110,7408,5303,0.7030359273498608,5017600,56896849,51879249
870000.0,4,1.75,1920,3600,2.0,0,0,3,8,1920,0,1907,0.0,98119,47.6382,-122.368,1920,3600,1680,0.4666666666666667,3686400,12960000,9273600
532000.0,4,1.75,2020,7029,1.0,0,0,3,7,1430,590,1979,0.0,98052,47.6983,-122.12700000000001,1780,7200,5009,0.7126191492388676,4080400,49406841,45326441
455000.0,4,1.5,1880,11400,1.0,0,0,2,7,1280,600,1955,0.0,98177,47.7718,-122.381,1880,11400,9520,0.8350877192982457,3534400,129960000,126425600
201000.0,3,1.0,1010,25277,1.0,0,0,4,5,1010,0,1961,0.0,98019,47.7242,-121.95100000000001,1570,213879,24267,0.9600427265893896,1020100,638926729,637906629
649000.0,5,3.25,3990,13087,2.0,0,0,2,9,2400,1590,1991,0.0,98042,47.3632,-122.061,2580,13633,9097,0.6951172919691296,15920100,171269569,155349469
445500.0,2,1.75,1390,6670,1.0,0,0,2,6,720,670,1941,0.0,98115,47.6914,-122.30799999999999,920,6380,5280,0.7916041979010495,1932100,44488900,42556800
475000.0,3,2.0,1230,11502,1.0,0,0,3,7,1230,0,1984,0.0,98052,47.7017,-122.12700000000001,1660,11727,10272,0.8930620761606677,1512900,132296004,130783104
590000.0,4,2.5,2940,29013,2.0,0,0,2,10,2940,0,1992,0.0,98077,47.7635,-122.044,3010,34071,26073,0.8986661151897425,8643600,841754169,833110569
565000.0,4,1.5,2190,8296,2.0,0,0,2,7,2190,0,1935,1963.0,98136,47.5158,-122.385,1160,8160,6106,0.7360173577627772,4796100,68823616,64027516
110000.0,1,1.0,640,10280,1.0,0,0,1,5,640,0,1920,0.0,98126,47.5144,-122.368,1090,9000,9640,0.9377431906614786,409600,105678400,105268800
375000.0,3,2.5,1670,7740,1.0,0,0,2,7,1130,540,1974,0.0,98126,47.5222,-122.37,1220,7740,6070,0.7842377260981912,2788900,59907600,57118700
255000.0,3,1.5,1240,8528,1.0,0,0,3,7,1240,0,1967,0.0,98058,47.4478,-122.15700000000001,1570,8064,7288,0.8545966228893058,1537600,72726784,71189184
315000.0,5,1.75,1850,14800,1.5,0,0,2,6,1760,90,1937,0.0,98168,47.4935,-122.321,1250,14800,12950,0.875,3422500,219040000,215617500
496600.0,4,2.25,2020,8400,1.0,0,0,3,8,1350,670,1961,0.0,98006,47.5488,-122.171,2060,8400,6380,0.7595238095238095,4080400,70560000,66479600
380000.0,3,1.0,1020,4800,1.0,0,0,2,7,1020,0,1944,0.0,98118,47.5615,-122.272,1400,5465,3780,0.7875,1040400,23040000,21999600
338950.0,3,1.75,1610,22496,1.0,0,0,3,7,1610,0,1974,0.0,98042,47.3443,-122.073,2050,35772,20886,0.928431721194879,2592100,506070016,503477916
542500.0,5,3.5,2730,42500,1.0,0,0,2,8,1530,1200,1989,0.0,98027,47.4587,-121.99600000000001,3180,37970,39770,0.9357647058823529,7452900,1806250000,1798797100
739000.0,5,2.5,2840,5000,1.0,0,0,3,7,1620,1220,1913,0.0,98144,47.5817,-122.291,2200,5000,2160,0.432,8065600,25000000,16934400
549000.0,4,1.75,1290,3060,2.0,0,0,3,7,1290,0,1906,0.0,98103,47.6798,-122.348,1510,4080,1770,0.5784313725490197,1664100,9363600,7699500
252000.0,3,2.25,1670,7881,1.0,0,0,3,7,1190,480,1977,0.0,98031,47.4105,-122.18,1870,7820,6211,0.7880979571120417,2788900,62110161,59321261
1700000.0,4,4.5,3860,15246,2.0,0,4,2,11,2940,920,2004,0.0,98006,47.56,-122.161,3750,14790,11386,0.7468188377279287,14899600,232440516,217540916
735000.0,4,1.75,2460,5100,1.5,0,0,4,7,1450,1010,1909,0.0,98115,47.6782,-122.3,1560,5100,2640,0.5176470588235295,6051600,26010000,19958400
270000.0,4,2.5,1660,8063,1.0,0,0,3,7,1660,0,1978,0.0,98198,47.3761,-122.32,1060,8437,6403,0.7941212948034231,2755600,65011969,62256369
2250000.0,3,2.5,3420,8700,1.0,0,0,2,9,2890,530,1951,0.0,98112,47.6352,-122.29,3370,8700,5280,0.6068965517241379,11696400,75690000,63993600
155000.0,2,1.0,1010,43056,1.5,0,0,2,5,1010,0,1990,0.0,98014,47.7105,-121.316,830,18297,42046,0.9765421776291342,1020100,1853819136,1852799036
469000.0,4,2.5,2240,5624,1.0,0,0,2,7,1520,720,1961,0.0,98108,47.5574,-122.30799999999999,2240,7495,3384,0.6017069701280228,5017600,31629376,26611776
305000.0,4,2.25,2340,5250,2.0,0,0,4,7,2340,0,1965,0.0,98118,47.5183,-122.266,1540,5250,2910,0.5542857142857143,5475600,27562500,22086900
675000.0,3,1.75,1920,4500,1.0,0,0,4,7,960,960,1924,0.0,98107,47.6645,-122.35700000000001,1190,4000,2580,0.5733333333333334,3686400,20250000,16563600
931000.0,3,2.5,2460,6600,1.5,0,0,3,8,1560,900,1929,0.0,98109,47.6364,-122.351,2090,3400,4140,0.6272727272727273,6051600,43560000,37508400
385000.0,3,1.0,1470,11398,1.0,0,0,2,8,1470,0,1950,0.0,98155,47.746,-122.296,1710,11407,9928,0.8710300052640814,2160900,129914404,127753504
815000.0,3,2.5,3400,12442,2.0,0,0,2,9,3400,0,2001,0.0,98075,47.5611,-122.03200000000001,3250,8635,9042,0.7267320366500563,11560000,154803364,143243364
531000.0,3,2.25,1910,8390,1.0,0,0,2,7,1910,0,1979,0.0,98034,47.73,-122.21600000000001,2410,8390,6480,0.7723480333730631,3648100,70392100,66744000
386500.0,4,1.0,1400,3600,1.0,0,0,3,6,700,700,1901,0.0,98144,47.5972,-122.295,1690,3600,2200,0.6111111111111112,1960000,12960000,11000000
475580.0,3,1.75,1520,11085,1.0,0,0,2,8,1520,0,1983,0.0,98074,47.646,-122.068,2310,9647,9565,0.8628777627424448,2310400,122877225,120566825
358000.0,2,1.0,930,5077,1.0,0,0,2,6,930,0,1939,0.0,98133,47.7095,-122.35,1080,5803,4147,0.8168209572582233,864900,25775929,24911029
677500.0,5,1.0,2340,4730,2.0,0,0,2,8,1810,530,1918,0.0,98116,47.5895,-122.385,2100,4970,2390,0.5052854122621564,5475600,22372900,16897300
868500.0,3,2.5,2920,3942,3.0,0,0,2,10,2920,0,2008,0.0,98056,47.53100000000001,-122.204,2920,3942,1022,0.25925925925925924,8526400,15539364,7012964
599380.0,3,1.75,1270,7350,1.0,0,0,3,7,1270,0,1967,0.0,98005,47.6046,-122.16799999999999,1880,7350,6080,0.8272108843537415,1612900,54022500,52409600
712000.0,4,2.25,2450,11960,1.0,0,0,2,10,2450,0,1979,0.0,98074,47.6351,-122.06,2600,11960,9510,0.7951505016722408,6002500,143041600,137039100
350000.0,5,1.75,1380,7620,1.0,0,0,2,7,1180,200,1955,0.0,98106,47.5279,-122.345,1990,7620,6240,0.8188976377952756,1904400,58064400,56160000
875000.0,4,2.0,2520,6000,1.0,0,0,2,8,1400,1120,1921,2007.0,98103,47.6767,-122.35,1580,3720,3480,0.58,6350400,36000000,29649600
365000.0,3,2.25,2290,7350,2.0,0,0,2,8,2290,0,1988,0.0,98058,47.428999999999995,-122.162,2170,7529,5060,0.6884353741496598,5244100,54022500,48778400
452000.0,4,2.0,1660,6150,1.0,0,0,2,6,850,810,1945,0.0,98126,47.5371,-122.368,1110,6250,4490,0.7300813008130081,2755600,37822500,35066900
915000.0,3,2.75,2800,9750,1.0,0,0,4,7,1400,1400,1957,0.0,98004,47.5862,-122.20200000000001,2800,9530,6950,0.7128205128205128,7840000,95062500,87222500
482500.0,3,2.5,1690,3068,2.0,0,0,2,7,1690,0,2005,0.0,98053,47.6763,-122.02799999999999,1690,3260,1378,0.4491525423728814,2856100,9412624,6556524
425000.0,3,1.0,1180,7200,1.5,0,0,3,7,1180,0,1949,0.0,98133,47.7121,-122.333,2240,7875,6020,0.8361111111111111,1392400,51840000,50447600
460000.0,2,1.75,1390,4160,1.0,0,0,4,6,790,600,1916,0.0,98105,47.6681,-122.324,1090,4160,2770,0.6658653846153846,1932100,17305600,15373500
666570.0,4,2.0,2320,7400,1.5,0,0,4,7,1620,700,1913,0.0,98118,47.5558,-122.26899999999999,1740,4000,5080,0.6864864864864865,5382400,54760000,49377600
390000.0,3,2.25,2270,32112,1.0,0,0,3,8,1740,530,1980,0.0,98042,47.3451,-122.094,2310,41606,29842,0.9293099152964623,5152900,1031180544,1026027644
650000.0,4,1.75,2640,8215,1.0,0,0,3,7,1500,1140,1966,0.0,98008,47.5819,-122.125,2070,7875,5575,0.6786366402921485,6969600,67486225,60516625
305000.0,3,2.0,1680,8487,1.0,0,0,2,7,1680,0,1993,0.0,98022,47.1959,-122.01,2080,8560,6807,0.8020501944149876,2822400,72029169,69206769
250000.0,3,1.0,990,8100,1.0,0,0,2,6,990,0,1949,0.0,98146,47.4839,-122.34100000000001,1210,8100,7110,0.8777777777777778,980100,65610000,64629900
438800.0,4,2.5,2770,4432,2.0,0,0,2,9,2770,0,2004,0.0,98058,47.4541,-122.117,2770,5423,1662,0.375,7672900,19642624,11969724
290000.0,2,1.0,950,5650,1.0,0,0,4,6,950,0,1943,0.0,98118,47.5149,-122.257,1250,5650,4700,0.831858407079646,902500,31922500,31020000
324950.0,4,2.0,2160,4800,2.0,0,0,3,7,1290,870,1929,0.0,98055,47.4777,-122.212,1570,4800,2640,0.55,4665600,23040000,18374400
453000.0,3,2.5,1650,1838,2.0,0,0,3,7,1270,380,1991,0.0,98107,47.6666,-122.367,1550,1558,188,0.10228509249183895,2722500,3378244,655744
556000.0,3,1.0,1800,4005,1.5,0,0,3,7,1160,640,1929,0.0,98117,47.6876,-122.38,1240,4005,2205,0.550561797752809,3240000,16040025,12800025
315000.0,3,2.0,1660,11135,1.0,0,0,2,8,1660,0,1971,0.0,98045,47.4897,-121.787,1660,11560,9475,0.8509205208801077,2755600,123988225,121232625
445830.0,3,2.5,1870,5449,2.0,0,0,2,8,1870,0,2003,0.0,98011,47.7557,-122.22,2000,7687,3579,0.6568177647274729,3496900,29691601,26194701
1260000.0,3,3.5,3220,3960,2.0,0,4,2,10,2760,460,1991,0.0,98116,47.5909,-122.384,3080,4444,740,0.18686868686868688,10368400,15681600,5313200
287200.0,3,3.0,1850,19966,1.0,0,0,3,7,1090,760,1992,0.0,98038,47.3493,-122.03399999999999,1410,6715,18116,0.9073424822197736,3422500,398641156,395218656
525000.0,4,1.5,1580,6360,1.5,0,0,2,7,1290,290,1945,0.0,98115,47.6873,-122.286,1690,6360,4780,0.7515723270440252,2496400,40449600,37953200
1140000.0,4,4.25,4590,17621,2.0,0,0,2,10,3160,1430,2003,0.0,98033,47.6973,-122.205,3800,12268,13031,0.7395153510016458,21068100,310499641,289431541
381000.0,3,1.75,2700,18246,1.0,0,0,3,7,1510,1190,1967,0.0,98059,47.4817,-122.09700000000001,1620,16986,15546,0.852022361065439,7290000,332916516,325626516
360000.0,3,1.75,1020,7020,1.5,0,0,3,7,1020,0,1953,0.0,98155,47.7362,-122.314,1020,5871,6000,0.8547008547008547,1040400,49280400,48240000
619000.0,5,3.5,2950,2932,3.0,0,0,2,8,2950,0,2004,0.0,98144,47.5923,-122.29799999999999,1580,2047,-18,-0.006139154160982265,8702500,8596624,-105876
535000.0,2,1.75,1780,224769,1.0,0,0,3,8,1780,0,1976,0.0,98038,47.4158,-122.00200000000001,2060,71560,222989,0.9920807584675823,3168400,50521103361,50517934961
402000.0,2,1.0,710,5100,1.0,0,0,4,7,710,0,1905,0.0,98117,47.6765,-122.381,1530,5100,4390,0.8607843137254902,504100,26010000,25505900
600000.0,4,3.5,4300,70407,2.0,0,0,2,10,2710,1590,1992,0.0,98058,47.4472,-122.09200000000001,3520,26727,66107,0.9389265271918985,18490000,4957145649,4938655649
549950.0,3,2.5,2080,8690,1.0,0,0,2,8,1430,650,1974,0.0,98166,47.4424,-122.344,2400,9625,6610,0.760644418872267,4326400,75516100,71189700
300000.0,4,2.0,2360,7440,1.0,0,0,2,7,1180,1180,1955,0.0,98178,47.5044,-122.245,1680,7800,5080,0.6827956989247311,5569600,55353600,49784000
360000.0,6,2.0,2210,9870,2.0,0,0,3,7,2210,0,1969,1995.0,98059,47.4751,-122.145,1390,9912,7660,0.7760891590678825,4884100,97416900,92532800
419000.0,7,3.25,4340,8521,2.0,0,0,2,7,2550,1790,1986,0.0,98106,47.52,-122.338,1890,8951,4181,0.49067010914211945,18835600,72607441,53771841
510000.0,3,3.0,1320,1012,3.0,0,0,2,8,1320,0,2009,0.0,98117,47.6904,-122.395,1320,1536,-308,-0.30434782608695654,1742400,1024144,-718256
319950.0,3,2.5,1980,9907,2.0,0,0,2,8,1980,0,1991,0.0,98022,47.1903,-122.01299999999999,2050,9907,7927,0.8001413142222671,3920400,98148649,94228249
1180000.0,5,5.0,3960,94089,2.0,0,0,2,10,3960,0,1998,0.0,98038,47.38,-122.01100000000001,2240,64468,90129,0.957912189522686,15681600,8852739921,8837058321
381000.0,4,2.5,2130,6003,2.0,0,0,2,8,2130,0,2003,0.0,98058,47.4518,-122.12,1940,4529,3873,0.6451774112943528,4536900,36036009,31499109
256900.0,3,2.5,1720,3951,2.0,0,0,2,7,1720,0,1992,0.0,98031,47.4033,-122.18700000000001,1720,3605,2231,0.5646671728676285,2958400,15610401,12652001
346000.0,5,1.0,1790,30456,1.0,0,0,3,7,1350,440,1964,0.0,98030,47.3469,-122.195,2420,35647,28666,0.9412266876805884,3204100,927567936,924363836
465000.0,2,2.25,1390,1222,3.0,0,0,2,7,1340,50,2009,0.0,98052,47.6754,-122.12100000000001,1480,1369,-168,-0.13747954173486088,1932100,1493284,-438816
545000.0,3,2.0,1900,9975,1.0,0,0,2,8,1500,400,1973,0.0,98027,47.5307,-122.054,2140,9825,8075,0.8095238095238095,3610000,99500625,95890625
516000.0,2,1.75,1640,3090,1.0,0,0,3,7,910,730,1925,0.0,98115,47.678999999999995,-122.319,1510,4120,1450,0.4692556634304207,2689600,9548100,6858500
550000.0,4,2.5,2700,5100,1.0,0,0,3,8,1440,1260,1968,0.0,98136,47.5331,-122.384,1880,5100,2400,0.47058823529411764,7290000,26010000,18720000
339950.0,4,2.25,2200,7150,2.0,0,0,3,7,2200,0,1990,0.0,98042,47.3595,-122.089,1740,7150,4950,0.6923076923076923,4840000,51122500,46282500
417000.0,3,1.0,1310,8514,1.0,0,0,3,7,1310,0,1953,0.0,98133,47.7502,-122.353,1310,8514,7204,0.8461357763683345,1716100,72488196,70772096
906000.0,4,2.5,2480,5000,1.0,0,3,2,8,1480,1000,1951,0.0,98105,47.6653,-122.272,2240,6071,2520,0.504,6150400,25000000,18849600
980000.0,4,2.25,3010,9800,2.0,0,0,3,9,3010,0,1973,0.0,98040,47.5336,-122.223,2510,9800,6790,0.6928571428571428,9060100,96040000,86979900
555000.0,4,2.5,2450,5079,2.0,0,0,2,9,2450,0,2001,0.0,98056,47.5214,-122.191,2690,6675,2629,0.5176215790509943,6002500,25796241,19793741
468000.0,2,1.75,1250,7029,1.0,0,0,3,7,1250,0,1986,0.0,98033,47.6936,-122.186,1680,8470,5779,0.8221653151230616,1562500,49406841,47844341
378000.0,3,1.75,2610,117176,1.0,0,0,2,7,1390,1220,1981,0.0,98022,47.2585,-121.925,2140,142005,114566,0.9777258141598962,6812100,13730214976,13723402876
430000.0,4,2.5,2010,16020,1.5,0,0,4,8,2010,0,1962,0.0,98059,47.4821,-122.10799999999999,1420,16020,14010,0.8745318352059925,4040100,256640400,252600300
730100.0,4,2.5,3120,14300,2.0,0,0,2,9,3120,0,2003,0.0,98027,47.5318,-122.055,2580,10005,11180,0.7818181818181819,9734400,204490000,194755600
219000.0,4,1.5,1370,7944,1.5,0,0,2,7,1370,0,1961,0.0,98198,47.4224,-122.289,1370,9181,6574,0.8275427995971802,1876900,63107136,61230236
570000.0,3,2.5,2420,11953,1.0,0,0,2,9,2420,0,1990,0.0,98074,47.6285,-122.054,2420,12215,9533,0.7975403664352045,5856400,142874209,137017809
262500.0,4,2.75,1500,7036,1.0,0,0,2,7,1060,440,1979,0.0,98032,47.3665,-122.27600000000001,1620,7200,5536,0.7868106878908471,2250000,49505296,47255296
525000.0,5,2.5,2630,9216,2.0,0,0,2,8,2630,0,2003,0.0,98019,47.7379,-121.96600000000001,2020,4980,6586,0.7146267361111112,6916900,84934656,78017756
520000.0,2,1.0,950,3880,1.0,0,0,3,6,950,0,1919,0.0,98117,47.687,-122.389,1660,3880,2930,0.7551546391752577,902500,15054400,14151900
417400.0,3,3.0,2680,12285,1.0,0,0,3,8,2680,0,1970,0.0,98055,47.4633,-122.196,2610,9558,9605,0.7818477818477818,7182400,150921225,143738825
788000.0,4,3.25,3680,5759,2.0,0,0,2,9,2840,840,2003,0.0,98027,47.5367,-122.06700000000001,3620,6006,2079,0.36100017364125714,13542400,33166081,19623681
320000.0,3,1.0,1270,7400,1.0,0,2,3,7,1270,0,1956,0.0,98056,47.4831,-122.191,1800,7400,6130,0.8283783783783784,1612900,54760000,53147100
950000.0,6,1.0,2330,5000,1.5,0,0,3,7,2330,0,1920,0.0,98117,47.6789,-122.397,1570,5000,2670,0.534,5428900,25000000,19571100
255000.0,3,1.0,960,8100,1.0,0,0,2,7,960,0,1955,0.0,98155,47.7766,-122.307,1120,8100,7140,0.8814814814814815,921600,65610000,64688400
260000.0,4,2.5,1990,6671,2.0,0,0,2,7,1990,0,1989,0.0,98023,47.3078,-122.35799999999999,1862,6566,4681,0.7016938989656724,3960100,44502241,40542141
394000.0,3,1.0,1450,7930,1.0,0,0,3,6,1150,300,1923,0.0,98126,47.5212,-122.37100000000001,1040,7740,6480,0.8171500630517023,2102500,62884900,60782400
575000.0,4,2.5,2280,27441,2.0,0,0,2,8,2280,0,1996,0.0,98072,47.7628,-122.12299999999999,2350,35020,25161,0.9169126489559418,5198400,753008481,747810081
1250000.0,4,2.25,1830,7200,2.0,0,2,2,8,1750,80,1923,0.0,98112,47.6315,-122.28200000000001,3100,7200,5370,0.7458333333333333,3348900,51840000,48491100
385000.0,3,2.25,1650,7800,1.0,0,0,2,7,1260,390,1969,0.0,98011,47.7377,-122.197,1760,8268,6150,0.7884615384615384,2722500,60840000,58117500
456000.0,5,2.75,2720,193406,1.0,0,4,3,7,1700,1020,1968,0.0,98092,47.2838,-122.12100000000001,2820,248292,190686,0.9859363204864379,7398400,37405880836,37398482436
637000.0,4,2.5,1710,5000,1.0,0,0,2,8,1110,600,1979,0.0,98115,47.6772,-122.285,1750,5304,3290,0.658,2924100,25000000,22075900
485000.0,5,1.5,1420,9900,1.0,0,0,2,7,1050,370,1964,0.0,98008,47.6348,-122.118,1580,8075,8480,0.8565656565656565,2016400,98010000,95993600
315275.0,3,1.75,1440,8040,1.0,0,0,2,7,960,480,1951,0.0,98125,47.7128,-122.306,1500,8040,6600,0.8208955223880597,2073600,64641600,62568000
252500.0,2,1.5,1280,8710,1.0,0,0,2,7,1280,0,1967,0.0,98058,47.4472,-122.16,1520,9375,7430,0.8530424799081515,1638400,75864100,74225700
240000.0,2,1.0,1320,24319,1.0,0,0,2,7,1320,0,1966,0.0,98027,47.4741,-122.015,1430,98445,22999,0.9457214523623504,1742400,591413761,589671361
790000.0,4,2.5,2560,12760,1.0,0,0,3,7,1760,800,1949,0.0,98115,47.6947,-122.303,1760,6384,10200,0.799373040752351,6553600,162817600,156264000
310000.0,3,1.0,1480,7830,1.0,0,0,2,7,1480,0,1952,0.0,98133,47.7703,-122.336,1450,7830,6350,0.8109833971902938,2190400,61308900,59118500
1250000.0,4,2.5,2960,20240,2.0,0,4,3,10,2960,0,1985,0.0,98146,47.5075,-122.389,2500,14960,17280,0.8537549407114624,8761600,409657600,400896000
425000.0,2,1.0,1160,5038,1.0,0,0,4,7,740,420,1942,0.0,98126,47.5304,-122.38,1160,5076,3878,0.7697499007542675,1345600,25381444,24035844
548000.0,3,2.5,2110,4099,2.0,0,0,2,8,2110,0,2001,0.0,98072,47.7508,-122.17,2110,4871,1989,0.485240302512808,4452100,16801801,12349701
379880.0,3,2.5,1650,14054,1.0,0,0,3,7,1130,520,1986,0.0,98027,47.4821,-122.01700000000001,1940,87555,12404,0.8825957022911627,2722500,197514916,194792416
530000.0,3,2.5,1950,9906,2.0,0,0,2,8,1950,0,1988,0.0,98074,47.6363,-122.025,1860,7689,7956,0.8031496062992126,3802500,98128836,94326336
695000.0,3,2.25,2600,220300,1.5,0,0,4,8,2120,480,1977,0.0,98027,47.4562,-122.016,2760,215600,217700,0.988197911938266,6760000,48532090000,48525330000
435000.0,3,1.0,1270,4000,1.5,0,2,2,7,1270,0,1928,0.0,98126,47.5695,-122.376,1560,4000,2730,0.6825,1612900,16000000,14387100
540000.0,3,1.75,1300,62290,1.0,0,0,2,7,1300,0,1983,0.0,98053,47.6529,-121.979,1850,52272,60990,0.9791298763846524,1690000,3880044100,3878354100
425000.0,3,2.25,1790,10209,1.0,0,0,2,7,1290,500,1967,0.0,98072,47.7492,-122.086,1840,9900,8419,0.824664511705358,3204100,104223681,101019581
490000.0,3,2.5,1930,7266,2.0,0,0,2,8,1930,0,2005,0.0,98125,47.7191,-122.309,1930,7266,5336,0.7343793008532893,3724900,52794756,49069856
220000.0,4,1.0,1200,6000,1.5,0,0,2,6,1200,0,1923,0.0,98106,47.5307,-122.352,950,4000,4800,0.8,1440000,36000000,34560000
540000.0,4,2.5,2050,3784,2.0,0,0,2,8,2050,0,2001,0.0,98034,47.7189,-122.181,2050,3366,1734,0.4582452431289641,4202500,14318656,10116156
670000.0,3,1.0,1710,6195,1.0,0,0,2,7,1410,300,1946,0.0,98105,47.6706,-122.265,1610,6195,4485,0.7239709443099274,2924100,38378025,35453925
667500.0,3,1.75,2130,20423,1.0,0,0,2,9,2130,0,1953,0.0,98004,47.6339,-122.19200000000001,2370,20875,18293,0.8957058218675024,4536900,417098929,412562029
585000.0,3,3.5,1700,2197,2.0,0,0,2,8,1260,440,2010,0.0,98116,47.5767,-122.41,1360,1418,497,0.2262175694128357,2890000,4826809,1936809
225000.0,3,1.5,1390,12500,1.0,0,0,3,6,1390,0,1976,0.0,98014,47.6496,-121.90799999999999,1390,9000,11110,0.8888,1932100,156250000,154317900
375000.0,3,1.0,1230,9877,1.0,0,0,2,7,1230,0,1954,0.0,98006,47.5745,-122.13600000000001,1240,9965,8647,0.8754682595929938,1512900,97555129,96042229
335000.0,3,2.0,1490,8847,1.0,0,0,3,7,1490,0,1967,0.0,98177,47.7639,-122.363,1640,7572,7357,0.8315813270035041,2220100,78269409,76049309
680000.0,5,3.25,2440,15815,2.0,0,0,2,8,1990,450,2014,0.0,98155,47.773999999999994,-122.28,2500,14201,13375,0.8457160923174202,5953600,250114225,244160625
600000.0,3,1.0,970,4800,1.0,0,0,2,6,970,0,1950,0.0,98112,47.6212,-122.29799999999999,1500,2042,3830,0.7979166666666667,940900,23040000,22099100
161000.0,4,2.0,1700,8043,1.0,0,0,2,7,850,850,1954,0.0,98168,47.4758,-122.288,1540,13260,6343,0.7886360810642795,2890000,64689849,61799849
220000.0,4,2.0,1700,8043,1.0,0,0,2,7,850,850,1954,0.0,98168,47.4758,-122.288,1540,13260,6343,0.7886360810642795,2890000,64689849,61799849
420000.0,3,1.75,1720,5000,1.5,0,0,2,8,1720,0,1932,2009.0,98019,47.738,-121.98299999999999,1410,8300,3280,0.656,2958400,25000000,22041600
710000.0,3,1.0,1400,2250,1.5,0,0,2,7,1400,0,1909,0.0,98119,47.6373,-122.35799999999999,1630,3600,850,0.37777777777777777,1960000,5062500,3102500
626000.0,4,2.5,2570,7221,1.0,0,0,3,8,1570,1000,1958,0.0,98117,47.6921,-122.387,2440,7274,4651,0.6440936158426811,6604900,52142841,45537941
279500.0,3,1.5,1200,8040,1.0,0,0,3,7,1200,0,1959,0.0,98146,47.4901,-122.34100000000001,1450,9315,6840,0.8507462686567164,1440000,64641600,63201600
1610000.0,4,3.5,4390,11600,2.0,0,3,2,11,3060,1330,1990,0.0,98040,47.5862,-122.24600000000001,3240,12000,7210,0.621551724137931,19272100,134560000,115287900
325000.0,2,1.0,1080,5000,1.0,0,0,2,7,1080,0,1954,0.0,98106,47.5682,-122.359,1010,5000,3920,0.784,1166400,25000000,23833600
380000.0,4,2.25,1860,7980,1.0,0,0,3,8,1860,0,1966,0.0,98058,47.4524,-122.15,1860,8814,6120,0.7669172932330827,3459600,63680400,60220800
470000.0,4,2.75,2150,9820,1.0,0,0,3,8,1220,930,1979,0.0,98011,47.7758,-122.2,2060,9830,7670,0.7810590631364562,4622500,96432400,91809900
363000.0,4,3.0,2250,12142,2.0,0,0,2,8,2250,0,1986,0.0,98058,47.4338,-122.16,2300,9003,9892,0.8146928018448361,5062500,147428164,142365664
245000.0,4,2.25,2050,7700,2.0,0,0,2,7,2050,0,1977,0.0,98023,47.3009,-122.375,1780,7700,5650,0.7337662337662337,4202500,59290000,55087500
525000.0,3,1.0,1010,3520,1.0,0,0,2,7,1010,0,1902,0.0,98102,47.6208,-122.319,1300,1233,2510,0.7130681818181818,1020100,12390400,11370300
1700000.0,5,3.5,5850,22885,2.0,0,2,3,11,4670,1180,1978,0.0,98004,47.606,-122.211,3240,19020,17035,0.744374044133712,34222500,523723225,489500725
658500.0,4,2.25,1900,5000,1.0,0,0,2,7,1400,500,1963,0.0,98199,47.6456,-122.387,1710,4994,3100,0.62,3610000,25000000,21390000
680000.0,2,1.0,1020,8442,1.0,0,4,3,7,920,100,1941,0.0,98136,47.5145,-122.391,2550,10323,7422,0.8791755508173419,1040400,71267364,70226964
835000.0,4,2.0,3390,16025,2.0,0,0,3,10,3390,0,1987,0.0,98077,47.7222,-122.056,3950,15277,12635,0.7884555382215288,11492100,256800625,245308525
595000.0,4,2.5,1990,2175,2.0,0,0,2,8,1680,310,2005,0.0,98107,47.6696,-122.37100000000001,1560,2087,185,0.08505747126436781,3960100,4730625,770525
419000.0,4,2.5,3190,4980,2.0,0,0,2,9,3190,0,2005,0.0,98038,47.3657,-122.03399999999999,2830,6720,1790,0.35943775100401604,10176100,24800400,14624300
198900.0,2,1.0,1210,18700,1.0,0,0,3,7,1210,0,1940,0.0,98042,47.3752,-122.166,2250,10048,17490,0.9352941176470588,1464100,349690000,348225900
1090000.0,4,3.25,3740,12080,1.0,0,0,2,10,2000,1740,1988,0.0,98077,47.7214,-122.056,4210,15277,8340,0.6903973509933775,13987600,145926400,131938800
500000.0,3,3.5,2150,4368,2.0,0,0,2,8,1610,540,1998,0.0,98074,47.6213,-122.065,2390,16630,2218,0.5077838827838828,4622500,19079424,14456924
575000.0,4,1.75,2440,8100,1.0,0,0,3,9,1620,820,1960,0.0,98177,47.7201,-122.361,2030,8100,5660,0.6987654320987654,5953600,65610000,59656400
324950.0,2,1.5,1230,1516,3.0,0,0,2,8,1230,0,2000,0.0,98125,47.7265,-122.314,1352,1411,286,0.18865435356200527,1512900,2298256,785356
259000.0,3,2.5,2740,7980,2.0,0,0,3,7,2740,0,1964,0.0,98168,47.473,-122.3,1470,8611,5240,0.656641604010025,7507600,63680400,56172800
551000.0,2,2.0,2260,9604,1.0,0,0,2,9,2260,0,1990,0.0,98011,47.7718,-122.208,2260,10747,7344,0.7646813827571846,5107600,92236816,87129216
488000.0,2,1.5,1000,5125,1.0,0,0,2,7,1000,0,1942,1968.0,98103,47.6926,-122.34700000000001,1090,5100,4125,0.8048780487804879,1000000,26265625,25265625
635000.0,4,2.25,2350,46173,2.0,0,0,3,8,2350,0,1980,0.0,98053,47.6657,-122.06700000000001,2390,36567,43823,0.9491044549845148,5522500,2131945929,2126423429
395000.0,3,2.5,2300,8938,2.0,0,0,2,9,2300,0,1989,0.0,98031,47.4181,-122.211,2570,9694,6638,0.7426717386439919,5290000,79887844,74597844
370000.0,3,1.0,1440,8287,1.5,0,0,3,7,1440,0,1928,0.0,98155,47.7438,-122.315,1330,8285,6847,0.8262338602630627,2073600,68674369,66600769
675000.0,4,3.0,2780,5000,1.5,0,0,4,7,1710,1070,1919,0.0,98116,47.5721,-122.381,1150,5000,2220,0.444,7728400,25000000,17271600
402000.0,3,1.0,1200,6825,1.0,0,0,2,7,1200,0,1954,2013.0,98133,47.7491,-122.353,1470,8100,5625,0.8241758241758241,1440000,46580625,45140625
825000.0,3,2.75,3040,24192,2.0,0,0,3,10,3040,0,1987,0.0,98034,47.7108,-122.225,2770,5728,21152,0.8743386243386243,9241600,585252864,576011264
579000.0,3,2.75,2660,223027,1.0,0,0,2,8,1330,1330,1962,0.0,98038,47.4127,-122.071,1560,222591,220367,0.9880731929317975,7075600,49741042729,49733967129
455000.0,5,2.0,1510,3000,2.0,0,0,2,6,1510,0,1983,0.0,98122,47.6029,-122.304,1610,3600,1490,0.49666666666666665,2280100,9000000,6719900
265000.0,3,2.5,1780,6527,2.0,0,0,2,8,1780,0,1989,0.0,98092,47.2578,-122.21700000000001,2040,8840,4747,0.7272866554312855,3168400,42601729,39433329
713500.0,5,2.75,2920,9163,1.0,0,0,3,8,1520,1400,1976,0.0,98006,47.5668,-122.169,2250,9163,6243,0.6813270762850595,8526400,83960569,75434169
240000.0,3,1.0,1550,12670,1.0,0,0,3,7,1550,0,1962,0.0,98056,47.5024,-122.169,1550,8880,11120,0.877663772691397,2402500,160528900,158126400
570000.0,4,3.0,2710,217800,2.5,0,0,2,9,2710,0,2006,0.0,98022,47.2411,-121.932,2710,217800,215090,0.9875573921028467,7344100,47436840000,47429495900
243800.0,3,1.0,1140,27760,1.0,0,0,3,6,1140,0,1981,0.0,98027,47.5372,-121.97200000000001,1690,87300,26620,0.9589337175792507,1299600,770617600,769318000
543000.0,2,1.0,940,3864,1.0,0,0,3,8,940,0,1918,0.0,98103,47.6631,-122.345,1440,3956,2924,0.7567287784679089,883600,14930496,14046896
1010000.0,3,2.25,2160,7500,2.0,0,0,2,10,2160,0,1982,0.0,98112,47.6232,-122.29899999999999,1550,3839,5340,0.712,4665600,56250000,51584400
625000.0,4,2.25,2470,17008,2.0,0,0,3,8,2470,0,1979,0.0,98075,47.5924,-122.04799999999999,2470,31798,14538,0.8547742238946379,6100900,289272064,283171164
459950.0,4,2.5,2800,6567,2.0,0,0,2,9,2800,0,2006,0.0,98038,47.3555,-122.00200000000001,3400,5900,3767,0.5736257042789706,7840000,43125489,35285489
370000.0,4,2.75,2420,39704,1.0,0,0,2,9,2420,0,1985,0.0,98038,47.4053,-122.03,2760,36303,37284,0.9390489623211767,5856400,1576407616,1570551216
150000.0,4,2.0,1460,7254,1.0,0,0,2,6,1460,0,1959,0.0,98178,47.5056,-122.25399999999999,1460,7236,5794,0.7987317342156052,2131600,52620516,50488916
683500.0,3,1.5,1820,5756,1.5,0,0,2,7,1640,180,1946,0.0,98119,47.6479,-122.367,1760,6169,3936,0.6838082001389854,3312400,33131536,29819136
499950.0,3,2.5,1520,2208,2.0,0,0,2,8,1040,480,2007,0.0,98119,47.6419,-122.374,1610,1618,688,0.3115942028985507,2310400,4875264,2564864
255000.0,2,1.0,1320,9967,1.0,0,0,2,6,940,380,1919,0.0,98108,47.5693,-122.296,1970,7587,8647,0.86756295776061,1742400,99341089,97598689
279000.0,3,2.5,1920,7779,2.0,0,0,2,7,1920,0,1989,0.0,98031,47.4024,-122.171,1960,7536,5859,0.7531816428846896,3686400,60512841,56826441
910000.0,5,3.0,2640,5096,2.0,0,0,2,10,2640,0,2009,0.0,98115,47.6809,-122.288,1610,5217,2456,0.48194662480376765,6969600,25969216,18999616
699000.0,4,2.5,2650,7945,2.0,0,0,2,9,2650,0,2006,0.0,98125,47.7113,-122.296,1200,7920,5295,0.6664568911264946,7022500,63123025,56100525
1650000.0,4,3.25,3640,13530,1.0,0,0,2,9,2570,1070,1924,2000.0,98039,47.6293,-122.238,2760,15000,9890,0.7309682187730968,13249600,183060900,169811300
248000.0,3,1.0,1420,8800,1.0,0,0,3,6,1090,330,1981,0.0,98030,47.3746,-122.181,1480,8000,7380,0.8386363636363636,2016400,77440000,75423600
429000.0,3,1.0,1540,37950,1.0,0,0,3,7,1090,450,1959,0.0,98001,47.3259,-122.289,1820,24375,36410,0.9594202898550724,2371600,1440202500,1437830900
685000.0,4,1.0,1550,15239,1.5,1,4,2,6,1370,180,1930,0.0,98166,47.4502,-122.37799999999999,1790,22047,13689,0.8982872891922042,2402500,232227121,229824621
316000.0,2,1.0,730,5040,1.0,0,0,2,6,730,0,1927,0.0,98126,47.5387,-122.374,790,5040,4310,0.8551587301587301,532900,25401600,24868700
410000.0,2,1.0,2020,7540,1.0,0,0,2,7,1010,1010,1921,0.0,98118,47.5359,-122.28,1270,4652,5520,0.7320954907161804,4080400,56851600,52771200
299000.0,3,1.0,1200,15843,1.0,0,2,2,7,1200,0,1955,0.0,98045,47.4991,-121.779,1410,15843,14643,0.9242567695512214,1440000,251000649,249560649
559000.0,2,1.0,1240,6400,1.0,0,1,3,7,1060,180,1938,0.0,98126,47.5493,-122.37700000000001,1240,6400,5160,0.80625,1537600,40960000,39422400
575000.0,3,2.25,2680,100188,2.0,0,0,3,8,1580,1100,1978,0.0,98027,47.4776,-122.02,2540,60548,97508,0.973250289455823,7182400,10037635344,10030452944
602000.0,3,2.5,1640,3804,2.0,0,0,2,8,1640,0,1998,0.0,98122,47.6103,-122.3,1440,3230,2164,0.5688748685594112,2689600,14470416,11780816
492000.0,4,2.0,1640,5000,2.0,0,0,2,7,1640,0,1907,1983.0,98107,47.6662,-122.365,1240,5000,3360,0.672,2689600,25000000,22310400
293500.0,3,2.5,1610,5024,2.0,0,0,2,7,1610,0,2004,0.0,98038,47.3833,-122.04299999999999,1790,3717,3414,0.6795382165605095,2592100,25240576,22648476
481000.0,3,2.75,2290,14810,1.0,0,0,4,7,1400,890,1967,0.0,98056,47.5343,-122.185,2540,8640,12520,0.8453747467927076,5244100,219336100,214092000
311100.0,4,2.25,2130,8078,1.0,0,0,3,7,1380,750,1977,0.0,98055,47.4482,-122.209,2300,8112,5948,0.7363208715028472,4536900,65254084,60717184
375000.0,3,1.75,2140,13598,1.5,0,0,3,7,1620,520,1970,0.0,98014,47.7139,-121.321,930,10150,11458,0.842623915281659,4579600,184905604,180326004
1080000.0,3,3.0,4020,435600,1.5,0,2,2,10,4020,0,1999,0.0,98045,47.4418,-121.73100000000001,2590,283140,431580,0.9907713498622589,16160400,189747360000,189731199600
500000.0,5,2.5,2030,8400,1.0,0,0,2,7,1330,700,1968,0.0,98052,47.6713,-122.152,1920,8400,6370,0.7583333333333333,4120900,70560000,66439100
553000.0,3,1.0,1380,6250,1.0,0,0,3,7,1380,0,1918,0.0,98136,47.5514,-122.385,2270,6250,4870,0.7792,1904400,39062500,37158100
760000.0,3,2.0,1780,1750,1.0,0,2,2,8,1400,380,1927,2014.0,98103,47.6797,-122.35700000000001,1780,3750,-30,-0.017142857142857144,3168400,3062500,-105900
589500.0,4,1.5,1440,3200,1.0,0,1,3,7,960,480,1960,0.0,98136,47.5269,-122.383,1650,6400,1760,0.55,2073600,10240000,8166400
840000.0,5,2.75,2790,20824,1.0,0,0,2,9,1680,1110,1959,0.0,98115,47.6948,-122.28200000000001,2380,10465,18034,0.8660199769496735,7784100,433638976,425854876
2550000.0,4,3.0,4190,8805,2.5,0,2,4,9,3490,700,1928,0.0,98112,47.6181,-122.28399999999999,3780,8558,4615,0.5241340147643384,17556100,77528025,59971925
1280000.0,3,2.5,3870,46609,2.0,0,3,2,9,3870,0,1997,0.0,98008,47.5966,-122.11200000000001,4030,17880,42739,0.9169688257632646,14976900,2172398881,2157421981
260000.0,3,2.5,1850,7875,1.0,0,0,2,7,1250,600,1968,0.0,98058,47.434,-122.171,1930,8062,6025,0.765079365079365,3422500,62015625,58593125
430000.0,3,2.25,1550,1469,3.0,0,0,2,8,1550,0,2004,0.0,98103,47.6911,-122.34100000000001,1520,1465,-81,-0.05513955071477195,2402500,2157961,-244539
781000.0,3,2.5,1920,1896,3.0,0,3,2,8,1920,0,2000,0.0,98103,47.6616,-122.35600000000001,1670,2994,-24,-0.012658227848101266,3686400,3594816,-91584
280000.0,2,1.0,790,13170,1.0,0,0,2,6,790,0,1947,0.0,98106,47.5487,-122.35700000000001,970,12700,12380,0.9400151860288535,624100,173448900,172824800
392000.0,5,2.25,3740,32481,1.5,0,0,2,8,2240,1500,1958,0.0,98198,47.3965,-122.314,2040,11398,28741,0.8848557618299929,13987600,1055015361,1041027761
466200.0,3,1.5,1340,8856,1.0,0,0,3,7,1340,0,1959,0.0,98008,47.6094,-122.126,1850,8740,7516,0.8486901535682023,1795600,78428736,76633136
641000.0,3,1.75,1620,3975,1.0,0,0,4,7,940,680,1926,0.0,98117,47.6786,-122.368,1320,3922,2355,0.5924528301886792,2624400,15800625,13176225
350000.0,3,1.0,1680,8010,1.0,0,0,2,7,840,840,1951,0.0,98117,47.6993,-122.376,1890,8778,6330,0.7902621722846442,2822400,64160100,61337700
450000.0,3,2.0,1610,4364,2.0,0,0,2,8,1610,0,1996,0.0,98029,47.5672,-122.00399999999999,2010,4364,2754,0.6310724106324473,2592100,19044496,16452396
1800000.0,4,3.5,4460,16953,1.0,0,0,2,9,2550,1910,1962,0.0,98039,47.6338,-122.23200000000001,1980,13370,12493,0.7369197192237362,19891600,287404209,267512609
185000.0,3,1.5,1200,1848,2.0,0,0,2,8,1200,0,1966,0.0,98055,47.4658,-122.191,1270,1848,648,0.35064935064935066,1440000,3415104,1975104
290000.0,2,1.0,1250,12507,1.0,0,0,4,7,1250,0,1958,0.0,98056,47.4972,-122.176,1250,12498,11257,0.9000559686575518,1562500,156425049,154862549
964000.0,3,2.5,3630,9475,2.0,0,0,2,11,3630,0,1999,0.0,98074,47.6544,-122.085,3250,11605,5845,0.61688654353562,13176900,89775625,76598725
2000000.0,4,3.0,4260,18000,2.0,0,2,2,11,4260,0,2000,0.0,98040,47.5355,-122.24,3540,17015,13740,0.7633333333333333,18147600,324000000,305852400
545000.0,3,2.5,2180,15693,1.0,0,0,3,8,1850,330,1979,0.0,98075,47.592,-122.08200000000001,2270,24000,13513,0.8610845599949022,4752400,246270249,241517849
609950.0,3,2.25,1760,10350,1.0,0,0,3,7,1330,430,1979,0.0,98033,47.6605,-122.18799999999999,2210,11337,8590,0.8299516908212561,3097600,107122500,104024900
605000.0,4,2.0,1820,7626,1.0,0,0,4,7,990,830,1941,0.0,98103,47.6878,-122.34200000000001,1390,5904,5806,0.7613427747180698,3312400,58155876,54843476
550000.0,4,2.5,2120,9163,1.0,0,0,3,8,1450,670,1961,0.0,98006,47.5551,-122.17200000000001,2120,9166,7043,0.7686347266179199,4494400,83960569,79466169
905000.0,4,2.75,2730,4268,2.0,0,1,2,9,2730,0,2009,0.0,98199,47.6397,-122.395,2340,5000,1538,0.36035613870665417,7452900,18215824,10762924
384200.0,3,2.5,2430,7613,2.0,0,0,3,8,2430,0,1986,0.0,98058,47.4383,-122.135,2440,8342,5183,0.6808091422566662,5904900,57957769,52052869
370000.0,3,1.0,1170,1105,1.0,0,0,2,7,1170,0,1965,0.0,98126,47.5448,-122.375,1380,1399,-65,-0.058823529411764705,1368900,1221025,-147875
717500.0,3,1.0,2090,4000,1.5,0,2,2,8,1890,200,1931,0.0,98199,47.6393,-122.39200000000001,2090,4000,1910,0.4775,4368100,16000000,11631900
2000000.0,4,3.25,3910,7500,2.0,0,2,3,11,2550,1360,1933,0.0,98199,47.6448,-122.40899999999999,3070,7500,3590,0.4786666666666667,15288100,56250000,40961900
365500.0,2,1.0,1140,15624,1.0,0,0,3,6,1140,0,1909,0.0,98177,47.7673,-122.367,2110,15493,14484,0.9270353302611367,1299600,244109376,242809776
580000.0,2,1.5,1460,5700,1.5,0,0,2,7,1460,0,1912,0.0,98115,47.6838,-122.31200000000001,1780,3800,4240,0.743859649122807,2131600,32490000,30358400
415000.0,4,1.5,2700,14760,1.5,0,0,4,9,2700,0,1940,0.0,98022,47.1996,-122.00299999999999,1670,7200,12060,0.8170731707317073,7290000,217857600,210567600
272000.0,2,1.0,670,6300,1.0,0,0,3,6,670,0,1942,0.0,98126,47.5145,-122.374,740,6300,5630,0.8936507936507937,448900,39690000,39241100
600000.0,3,1.75,1880,6360,1.0,0,0,3,7,1040,840,1945,0.0,98115,47.6878,-122.286,1770,6175,4480,0.7044025157232704,3534400,40449600,36915200
744000.0,4,3.0,1980,5352,2.5,0,0,2,8,1980,0,1941,2005.0,98136,47.532,-122.385,1680,5352,3372,0.6300448430493274,3920400,28643904,24723504
830000.0,3,3.0,2080,10521,1.5,0,0,2,9,2080,0,2004,0.0,98034,47.6987,-122.228,3730,11840,8441,0.8023001615815987,4326400,110691441,106365041
322000.0,3,3.25,1380,1225,3.0,0,0,2,7,1380,0,2000,0.0,98133,47.7035,-122.351,1380,1704,-155,-0.12653061224489795,1904400,1500625,-403775
270000.0,3,2.5,1808,19200,1.0,0,0,2,8,1808,0,2005,0.0,98001,47.2598,-122.281,1450,14400,17392,0.9058333333333334,3268864,368640000,365371136
272450.0,3,1.0,1350,7973,1.5,0,0,2,7,1350,0,1954,0.0,98188,47.4323,-122.292,1310,7491,6623,0.8306785400727456,1822500,63568729,61746229
605000.0,3,3.0,1760,2114,2.0,0,0,2,7,1400,0,2008,0.0,98107,47.6666,-122.37,1300,1500,354,0.16745506149479658,3097600,4468996,1371396
510000.0,3,1.75,1950,8325,1.0,0,0,3,7,1950,0,1962,0.0,98011,47.7685,-122.2,1950,8325,6375,0.7657657657657657,3802500,69305625,65503125
1130000.0,4,3.5,3170,4000,2.0,0,0,2,10,2340,830,1999,0.0,98112,47.6265,-122.29799999999999,1770,4000,830,0.2075,10048900,16000000,5951100
1690000.0,4,2.5,3000,7500,2.0,0,0,2,9,3000,0,1937,1994.0,98105,47.6571,-122.277,2580,5000,4500,0.6,9000000,56250000,47250000
162000.0,4,1.0,1460,16638,1.0,0,0,3,6,1460,0,1975,0.0,98010,47.3431,-122.04799999999999,1460,16638,15178,0.912249068397644,2131600,276823044,274691444
337500.0,3,1.75,1350,5850,1.0,0,0,3,7,1050,300,1973,0.0,98198,47.4225,-122.32799999999999,1710,7757,4500,0.7692307692307693,1822500,34222500,32400000
312000.0,3,2.25,1470,7857,1.0,0,0,3,7,1180,290,1973,0.0,98055,47.4547,-122.209,1900,7600,6387,0.812905689194349,2160900,61732449,59571549
740000.0,4,3.0,3350,199253,2.0,0,0,2,10,3350,0,2004,0.0,98010,47.3602,-121.988,3350,183897,195903,0.9831872042077158,11222500,39701758009,39690535509
700000.0,4,3.0,3350,199253,2.0,0,0,2,10,3350,0,2004,0.0,98010,47.3602,-121.988,3350,183897,195903,0.9831872042077158,11222500,39701758009,39690535509
328000.0,4,1.0,1360,8136,1.0,0,0,2,7,1360,0,1948,0.0,98133,47.7366,-122.333,1570,8132,6776,0.8328416912487709,1849600,66194496,64344896
241000.0,3,1.0,1020,7538,1.0,0,0,2,7,1020,0,1981,0.0,98032,47.3587,-122.288,1650,7201,6518,0.8646855929954895,1040400,56821444,55781044
265000.0,3,2.25,1840,6750,1.0,0,0,3,7,1270,570,1980,0.0,98031,47.4075,-122.17200000000001,1750,7004,4910,0.7274074074074074,3385600,45562500,42176900
246000.0,5,1.75,2030,10200,1.0,0,0,3,7,2030,0,1958,0.0,98002,47.2867,-122.209,1760,11550,8170,0.8009803921568628,4120900,104040000,99919100
271000.0,4,1.75,1490,9112,1.0,0,0,2,6,970,520,1940,0.0,98146,47.4991,-122.345,1650,8411,7622,0.8364793678665496,2220100,83028544,80808444
270000.0,2,1.0,2060,8398,1.0,0,0,2,7,1260,800,1962,0.0,98168,47.50899999999999,-122.324,1690,13495,6338,0.7547035008335318,4243600,70526404,66282804
395000.0,4,2.0,2240,7085,1.5,0,0,2,7,2240,0,1944,1992.0,98125,47.7309,-122.305,1440,7085,4845,0.6838390966831334,5017600,50197225,45179625
340000.0,3,2.0,1460,5715,1.0,0,0,2,7,1460,0,1957,0.0,98118,47.54,-122.27600000000001,1400,5715,4255,0.7445319335083115,2131600,32661225,30529625
340000.0,3,1.75,2140,13260,1.0,0,0,2,7,1240,900,1948,0.0,98146,47.5074,-122.353,1640,13260,11120,0.8386123680241327,4579600,175827600,171248000
335000.0,2,2.25,1420,1246,2.0,0,0,2,8,1420,0,2007,0.0,98106,47.5394,-122.368,1420,1826,-174,-0.13964686998394862,2016400,1552516,-463884
435000.0,2,1.0,1060,3036,1.5,0,0,3,6,1060,0,1943,0.0,98105,47.6578,-122.324,1730,5535,1976,0.6508563899868248,1123600,9217296,8093696
527950.0,4,1.75,1760,3600,1.0,0,0,4,7,880,880,1926,0.0,98103,47.6889,-122.33,1500,5580,1840,0.5111111111111111,3097600,12960000,9862400
600000.0,2,2.25,2320,18919,2.0,0,4,3,8,2320,0,1976,0.0,98070,47.3905,-122.462,1610,18919,16599,0.8773719541201966,5382400,357928561,352546161
667000.0,3,1.75,1770,3880,1.0,0,0,2,8,1300,0,1963,0.0,98117,47.6846,-122.39200000000001,1430,3880,2110,0.5438144329896907,3132900,15054400,11921500
1150000.0,10,5.25,4590,10920,1.0,0,2,2,9,2500,2090,2008,0.0,98004,47.5861,-122.113,2730,10400,6330,0.5796703296703297,21068100,119246400,98178300
417000.0,3,2.5,2040,11211,2.0,0,0,2,8,2040,0,2000,0.0,98055,47.4867,-122.223,1830,11964,9171,0.818035857639818,4161600,125686521,121524921
451000.0,4,1.75,1260,7250,1.0,0,0,2,6,1260,0,1943,0.0,98027,47.5267,-122.03200000000001,1880,7250,5990,0.8262068965517242,1587600,52562500,50974900
580000.0,2,1.0,1650,9780,1.0,0,0,2,7,950,700,1943,0.0,98199,47.6549,-122.39399999999999,1650,5458,8130,0.8312883435582822,2722500,95648400,92925900
570000.0,4,2.25,2380,36446,2.0,0,0,3,8,2380,0,1977,0.0,98077,47.7644,-122.072,2790,40005,34066,0.9346979092355814,5664400,1328310916,1322646516
750000.0,5,3.25,2750,7500,2.0,0,1,2,7,2150,600,1937,0.0,98033,47.6636,-122.20299999999999,2750,7500,4750,0.6333333333333333,7562500,56250000,48687500
685000.0,3,2.5,2810,7700,2.0,0,0,2,9,2810,0,2001,0.0,98006,47.5464,-122.191,2910,8250,4890,0.6350649350649351,7896100,59290000,51393900
275000.0,3,2.0,1340,9764,1.0,0,0,2,7,1340,0,1944,0.0,98052,47.6786,-122.161,1310,9764,8424,0.8627611634575993,1795600,95335696,93540096
739888.0,3,2.5,2420,43177,2.0,0,4,3,8,1690,730,1989,0.0,98075,47.568999999999996,-122.05799999999999,3740,8717,40757,0.9439516409199342,5856400,1864253329,1858396929
715000.0,2,2.5,2160,5581,1.0,0,0,2,8,2160,0,2002,0.0,98053,47.7017,-122.023,2315,5652,3421,0.6129725855581437,4665600,31147561,26481961
800000.0,4,2.0,2450,4400,1.0,0,0,2,7,1450,1000,1913,1980.0,98102,47.6414,-122.32700000000001,1890,1386,1950,0.4431818181818182,6002500,19360000,13357500
350000.0,3,1.5,1870,9000,1.0,0,0,2,7,1120,750,1923,0.0,98108,47.5224,-122.318,1850,6000,7130,0.7922222222222223,3496900,81000000,77503100
220000.0,3,1.0,1000,223462,1.0,0,2,3,6,1000,0,1933,0.0,98022,47.2099,-122.04299999999999,1710,105850,222462,0.995524966213495,1000000,49935265444,49934265444
452500.0,3,2.5,2240,7791,2.0,0,0,2,7,2240,0,2002,0.0,98065,47.5361,-121.88,2480,5018,5551,0.7124887690925427,5017600,60699681,55682081
280000.0,4,2.5,2200,5893,2.0,0,0,2,7,2200,0,2008,0.0,98042,47.3333,-122.055,2200,5757,3693,0.6266757169523163,4840000,34727449,29887449
248000.0,1,1.0,790,12000,1.0,0,0,2,6,790,0,1918,0.0,98118,47.5146,-122.265,1900,6000,11210,0.9341666666666667,624100,144000000,143375900
305000.0,2,1.0,890,7200,1.0,0,0,2,7,740,150,1949,0.0,98115,47.6998,-122.27799999999999,1290,7200,6310,0.8763888888888889,792100,51840000,51047900
435010.0,3,1.0,1270,4000,1.0,0,0,2,7,1120,150,1954,0.0,98106,47.5293,-122.354,1220,4600,2730,0.6825,1612900,16000000,14387100
678100.0,3,1.75,1850,2860,1.5,0,0,4,8,1210,640,1931,0.0,98116,47.5853,-122.39,1660,3120,1010,0.3531468531468531,3422500,8179600,4757100
325000.0,3,2.25,1352,1694,3.0,0,0,2,8,1352,0,2007,0.0,98125,47.7265,-122.315,1439,1387,342,0.20188902007083825,1827904,2869636,1041732
529950.0,3,2.0,1540,8400,1.0,0,0,2,7,1180,360,1968,0.0,98052,47.6554,-122.12899999999999,1550,8760,6860,0.8166666666666667,2371600,70560000,68188400
440000.0,3,1.75,1640,8529,1.0,0,0,4,7,1640,0,1951,0.0,98155,47.7751,-122.32,1730,7769,6889,0.8077148551999062,2689600,72743841,70054241
585000.0,3,1.0,1350,4800,1.5,0,0,2,7,1350,0,1928,0.0,98116,47.5749,-122.412,1360,4800,3450,0.71875,1822500,23040000,21217500
462608.0,3,2.5,2010,2778,2.0,0,0,2,8,1390,620,2014,0.0,98029,47.5528,-121.999,1540,1689,768,0.27645788336933047,4040100,7717284,3677184
350500.0,3,1.75,2080,5200,1.0,0,0,2,7,1040,1040,1974,0.0,98166,47.4738,-122.35,1410,6550,3120,0.6,4326400,27040000,22713600
210000.0,3,1.0,1040,8125,1.0,0,0,2,7,1040,0,1956,0.0,98003,47.3171,-122.316,1200,9375,7085,0.872,1081600,66015625,64934025
510000.0,3,2.5,1890,5929,2.0,0,0,2,8,1890,0,1993,0.0,98029,47.5697,-121.994,2060,5775,4039,0.6812278630460449,3572100,35153041,31580941
280000.0,3,2.25,1810,7630,1.0,0,0,3,7,1810,0,1959,0.0,98056,47.497,-122.18,1830,7594,5820,0.762778505897772,3276100,58216900,54940800
385000.0,3,1.75,1930,14389,1.0,0,0,2,7,1130,800,1963,1998.0,98155,47.7733,-122.31700000000001,1730,14378,12459,0.8658697616234624,3724900,207043321,203318421
349000.0,3,1.0,1010,8184,1.0,0,0,3,6,1010,0,1947,0.0,98155,47.7416,-122.319,1010,8184,7174,0.8765884652981427,1020100,66977856,65957756
252000.0,3,2.25,1740,10836,1.0,0,0,2,7,910,830,1981,0.0,98031,47.3976,-122.166,2090,7500,9096,0.8394241417497231,3027600,117418896,114391296
1100000.0,4,2.5,2910,8881,2.0,0,1,2,10,1940,970,1932,0.0,98199,47.6424,-122.411,2540,5250,5971,0.672334196599482,8468100,78872161,70404061
375000.0,3,2.25,1330,8004,2.0,0,0,2,7,1330,0,1985,0.0,98034,47.7098,-122.21700000000001,1300,7971,6674,0.8338330834582709,1768900,64064016,62295116
336000.0,4,2.25,2210,11700,2.0,0,0,3,8,2210,0,1967,0.0,98032,47.3648,-122.28399999999999,2040,9000,9490,0.8111111111111111,4884100,136890000,132005900
732000.0,3,3.75,2670,6517,2.5,0,4,3,8,2020,650,1977,0.0,98126,47.5702,-122.38,2010,6073,3847,0.590302286328065,7128900,42471289,35342389
200000.0,2,1.0,1000,6227,1.0,0,0,2,6,1000,0,1949,0.0,98168,47.51300000000001,-122.333,1240,6250,5227,0.839409025212783,1000000,38775529,37775529
681716.0,4,2.5,3150,7277,2.0,0,0,2,9,3150,0,2006,0.0,98056,47.5159,-122.20200000000001,3030,8643,4127,0.5671293115294764,9922500,52954729,43032229
235000.0,3,1.75,1520,12246,1.0,0,0,3,6,1520,0,1971,0.0,98010,47.3434,-122.04899999999999,1460,12246,10726,0.8758778376612771,2310400,149964516,147654116
257500.0,3,1.0,1690,13825,1.0,0,0,2,7,1210,480,1955,0.0,98148,47.4256,-122.322,1190,9450,12135,0.8777576853526221,2856100,191130625,188274525
315000.0,3,1.0,1070,9497,1.0,0,0,2,7,1070,0,1955,0.0,98028,47.7425,-122.23,1710,9561,8427,0.8873328419500895,1144900,90193009,89048109
299950.0,3,1.0,910,8000,1.0,0,0,3,6,740,170,1950,0.0,98177,47.7746,-122.37799999999999,2090,9007,7090,0.88625,828100,64000000,63171900
530000.0,4,2.25,2130,8640,1.0,0,0,2,7,1430,700,1969,0.0,98034,47.7087,-122.198,2120,8826,6510,0.7534722222222222,4536900,74649600,70112700
766500.0,2,1.75,2230,6930,1.0,0,0,3,8,1530,700,1947,0.0,98105,47.6705,-122.277,1970,6930,4700,0.6782106782106783,4972900,48024900,43052000
860000.0,4,2.5,3560,11119,1.0,0,2,2,10,2290,1270,1986,0.0,98004,47.6456,-122.19,3290,11385,7559,0.6798273226009534,12673600,123632161,110958561
690000.0,3,2.5,2590,4961,2.0,0,0,2,9,2590,0,1944,2007.0,98126,47.5271,-122.381,1230,4961,2371,0.47792783712961096,6708100,24611521,17903421
551000.0,4,1.75,2040,6348,1.0,0,0,2,7,1020,1020,1962,0.0,98103,47.6964,-122.336,1770,5047,4308,0.6786389413988658,4161600,40297104,36135504
530000.0,3,2.75,2100,20150,1.0,0,0,3,7,2100,0,1955,0.0,98034,47.7206,-122.24799999999999,2100,15500,18050,0.8957816377171216,4410000,406022500,401612500
568000.0,3,1.0,1340,7260,1.5,0,0,2,7,1340,0,1953,0.0,98125,47.7016,-122.295,1830,6822,5920,0.8154269972451791,1795600,52707600,50912000
749950.0,3,2.5,2770,10773,2.0,0,2,2,9,2770,0,1992,0.0,98008,47.5754,-122.12,2530,10423,8003,0.7428757077879885,7672900,116057529,108384629
535000.0,3,2.5,2400,12546,1.0,0,0,2,9,2400,0,1983,0.0,98074,47.6317,-122.041,2940,12150,10146,0.8087039693926351,5760000,157402116,151642116
234300.0,3,1.0,1140,9779,1.0,0,0,2,7,1140,0,1963,0.0,98055,47.424,-122.20100000000001,1520,9814,8639,0.883423662951222,1299600,95628841,94329241
190000.0,2,1.0,930,11450,1.0,0,0,2,6,930,0,1946,0.0,98178,47.4862,-122.264,1150,11450,10520,0.9187772925764193,864900,131102500,130237600
525000.0,4,1.75,1820,6600,1.0,0,0,4,7,1820,0,1960,0.0,98007,47.606,-122.135,1430,8800,4780,0.7242424242424242,3312400,43560000,40247600
610000.0,4,1.0,1390,3708,1.5,0,0,3,7,1390,0,1926,0.0,98117,47.685,-122.363,1430,3708,2318,0.6251348435814456,1932100,13749264,11817164
520000.0,3,2.5,1480,1165,3.0,0,0,2,8,1480,0,2006,0.0,98144,47.6199,-122.3,1480,1231,-315,-0.2703862660944206,2190400,1357225,-833175
375000.0,2,1.0,760,6000,1.0,0,0,2,6,760,0,1942,0.0,98199,47.646,-122.384,1360,6000,5240,0.8733333333333333,577600,36000000,35422400
600000.0,3,1.75,1580,7416,1.0,0,0,2,7,1150,430,1967,0.0,98005,47.6056,-122.17299999999999,1730,7416,5836,0.7869471413160734,2496400,54997056,52500656
664000.0,4,2.5,1870,16200,1.0,0,0,4,8,1250,620,1974,0.0,98033,47.6651,-122.17399999999999,2000,11250,14330,0.8845679012345679,3496900,262440000,258943100
698000.0,2,1.0,1510,4080,1.0,0,0,2,7,1010,500,1923,0.0,98103,47.6742,-122.329,1660,4080,2570,0.6299019607843137,2280100,16646400,14366300
418000.0,3,2.0,1250,1306,3.0,0,0,2,7,1250,0,2001,0.0,98107,47.6705,-122.39,1320,1250,56,0.042879019908116385,1562500,1705636,143136
271675.0,3,1.75,2140,13068,1.0,0,0,3,7,1460,680,1974,0.0,98092,47.3099,-122.197,2090,17424,10928,0.8362411998775635,4579600,170772624,166193024
450000.0,3,1.0,1540,9028,1.0,0,0,3,6,1540,0,1968,0.0,98033,47.6698,-122.177,1450,9028,7488,0.8294195835179442,2371600,81504784,79133184
759000.0,3,2.25,2950,78843,1.5,0,0,2,9,2950,0,2006,0.0,98075,47.5917,-122.068,3880,78843,75893,0.9625838692084269,8702500,6216218649,6207516149
599950.0,6,3.0,2020,4129,1.0,0,0,2,7,1230,790,1994,0.0,98105,47.6648,-122.324,2080,4080,2109,0.5107774279486559,4080400,17048641,12968241
810000.0,4,2.75,2820,5000,1.5,0,0,2,8,2170,650,1927,0.0,98199,47.6376,-122.39399999999999,1740,5000,2180,0.436,7952400,25000000,17047600
331292.0,3,1.75,1660,10000,1.0,0,0,2,7,1660,0,1972,0.0,98019,47.74100000000001,-121.978,1770,10000,8340,0.834,2755600,100000000,97244400
348000.0,3,1.75,1830,2417,1.0,0,0,2,7,930,900,1919,0.0,98144,47.5723,-122.309,1320,3200,587,0.2428630533719487,3348900,5841889,2492989
435000.0,2,1.0,720,5600,1.0,0,0,3,7,720,0,1920,0.0,98116,47.5641,-122.391,1330,5600,4880,0.8714285714285714,518400,31360000,30841600
530000.0,3,2.5,2160,9063,2.0,0,0,2,8,2160,0,1992,0.0,98133,47.7296,-122.333,2160,9063,6903,0.7616683217477657,4665600,82137969,77472369
227000.0,3,1.75,1510,9837,2.0,0,0,2,7,1510,0,1989,0.0,98001,47.2576,-122.255,1470,8054,8327,0.8464979160313103,2280100,96766569,94486469
285000.0,3,1.5,1870,42070,1.0,0,0,2,7,1870,0,1953,0.0,98168,47.50899999999999,-122.31299999999999,1870,19965,40200,0.9555502733539339,3496900,1769884900,1766388000
740000.0,4,2.25,2860,26136,1.0,0,0,2,8,1640,1220,1977,0.0,98005,47.6033,-122.15799999999999,2670,25040,23276,0.8905723905723906,8179600,683090496,674910896
246000.0,3,1.0,990,9145,1.5,0,0,3,6,990,0,1939,0.0,98146,47.5022,-122.36,1640,8320,8155,0.8917441224712958,980100,83631025,82650925
260000.0,3,1.0,1910,8710,1.0,0,0,2,7,1080,830,1954,0.0,98168,47.5038,-122.3,1460,8944,6800,0.7807118254879449,3648100,75864100,72216000
366000.0,3,2.0,1350,10200,1.0,0,0,2,7,1350,0,1977,0.0,98074,47.6159,-122.05,1820,9600,8850,0.8676470588235294,1822500,104040000,102217500
594950.0,4,3.25,2557,9480,2.0,0,2,2,7,2557,0,1948,1993.0,98118,47.5449,-122.262,2220,8340,6923,0.7302742616033755,6538249,89870400,83332151
608000.0,3,2.75,2610,5000,2.0,0,0,3,7,1710,900,1946,0.0,98107,47.6729,-122.37299999999999,1500,5000,2390,0.478,6812100,25000000,18187900
313100.0,3,2.0,1720,11875,1.0,0,0,4,6,1720,0,1905,0.0,98056,47.5068,-122.191,1860,7500,10155,0.8551578947368421,2958400,141015625,138057225
185000.0,3,1.75,1170,9085,1.0,0,0,2,7,1170,0,1967,0.0,98023,47.2808,-122.354,1230,9085,7915,0.8712162905888827,1368900,82537225,81168325
455000.0,2,1.0,1140,11480,1.0,0,0,2,6,1140,0,1907,0.0,98118,47.5328,-122.274,1550,8150,10340,0.9006968641114983,1299600,131790400,130490800
235000.0,3,2.5,2350,9051,1.0,0,0,3,8,1570,780,1966,0.0,98023,47.3126,-122.36399999999999,2270,8748,6701,0.740360181195448,5522500,81920601,76398101
230000.0,3,1.0,1020,12289,1.0,0,0,3,7,1020,0,1967,0.0,98058,47.4235,-122.155,1300,9894,11269,0.9169989421433803,1040400,151019521,149979121
770000.0,4,2.25,2730,5000,1.0,0,0,4,7,1460,1270,1955,0.0,98116,47.5843,-122.39299999999999,2010,5000,2270,0.454,7452900,25000000,17547100
240000.0,4,2.25,1830,7614,2.0,0,0,2,7,1830,0,1991,0.0,98030,47.3682,-122.179,1860,6930,5784,0.7596532702915682,3348900,57972996,54624096
461000.0,3,2.5,1690,3026,2.0,0,0,2,7,1690,0,2002,0.0,98053,47.6885,-122.04299999999999,1650,3161,1336,0.44150693985459355,2856100,9156676,6300576
1580000.0,4,2.5,2900,10500,1.0,0,3,4,8,1450,1450,1963,0.0,98040,47.5838,-122.24600000000001,2900,9201,7600,0.7238095238095238,8410000,110250000,101840000
1820000.0,4,4.5,6380,88714,2.0,0,0,2,12,6380,0,2006,0.0,98029,47.5592,-122.015,3040,7113,82334,0.9280835042946998,40704400,7870173796,7829469396
452000.0,3,2.5,1690,4000,2.0,0,0,2,7,1690,0,2004,0.0,98053,47.6788,-122.03399999999999,1690,4000,2310,0.5775,2856100,16000000,13143900
765000.0,4,2.5,2660,5043,2.0,0,2,2,9,2660,0,2003,0.0,98029,47.5445,-121.99600000000001,3010,5500,2383,0.4725361887765219,7075600,25431849,18356249
1050000.0,4,4.0,4550,54013,1.0,0,1,3,9,2300,2250,1989,0.0,98075,47.5964,-122.07700000000001,3540,39634,49463,0.915761020495066,20702500,2917404169,2896701669
546000.0,3,3.0,1530,9999,1.0,0,0,3,7,1150,380,1983,0.0,98033,47.6869,-122.186,1530,8556,8469,0.846984698469847,2340900,99980001,97639101
781000.0,3,2.5,2070,4463,1.5,0,0,4,8,1780,290,1931,0.0,98115,47.6853,-122.305,2070,5000,2393,0.5361864216894465,4284900,19918369,15633469
538000.0,4,1.75,1880,7953,1.0,0,0,3,7,1880,0,1965,0.0,98008,47.5838,-122.12299999999999,1750,8591,6073,0.7636112158933736,3534400,63250209,59715809
790000.0,4,2.5,2240,8664,1.0,0,0,4,8,1470,770,1975,0.0,98033,47.6621,-122.189,2210,8860,6424,0.7414589104339797,5017600,75064896,70047296
696500.0,4,2.75,2540,4400,1.5,0,0,4,7,1630,910,1925,0.0,98103,47.6832,-122.34299999999999,1560,3920,1860,0.42272727272727273,6451600,19360000,12908400
276000.0,3,2.0,1370,8137,1.0,0,0,3,7,1370,0,1988,0.0,98003,47.2802,-122.303,1660,8840,6767,0.8316332800786531,1876900,66210769,64333869
269000.0,2,1.0,770,8612,1.0,0,0,2,6,770,0,1953,0.0,98155,47.7547,-122.323,1290,8407,7842,0.9105898745935903,592900,74166544,73573644
2420000.0,5,4.75,7880,24250,2.0,0,2,2,13,7880,0,1996,0.0,98177,47.7334,-122.36200000000001,2740,10761,16370,0.6750515463917526,62094400,588062500,525968100
829000.0,4,2.75,2970,59677,1.0,0,2,3,8,1610,1360,1973,0.0,98075,47.5953,-122.08,2930,42489,56707,0.9502320827119326,8820900,3561344329,3552523429
122000.0,2,1.0,740,6840,1.0,0,0,2,6,740,0,1942,0.0,98126,47.5168,-122.37299999999999,740,6840,6100,0.8918128654970761,547600,46785600,46238000
352500.0,3,1.5,1360,7680,1.0,0,0,2,7,1360,0,1955,0.0,98133,47.7441,-122.337,1630,7679,6320,0.8229166666666666,1849600,58982400,57132800
249000.0,4,2.0,1280,7560,1.0,0,0,4,6,1280,0,1959,0.0,98058,47.45,-122.175,1250,7690,6280,0.8306878306878307,1638400,57153600,55515200
360000.0,4,2.0,1920,7803,1.0,0,0,2,7,1080,840,1962,0.0,98155,47.758,-122.325,1940,8147,5883,0.7539407920030757,3686400,60886809,57200409
629500.0,3,2.0,2020,10584,1.0,0,0,2,10,2020,0,1994,0.0,98075,47.5851,-122.02799999999999,3030,9870,8564,0.809145880574452,4080400,112021056,107940656
1140000.0,4,2.25,3310,127631,2.0,0,0,4,9,3310,0,1924,1956.0,98072,47.732,-122.134,3830,43959,124321,0.9740658617420532,10956100,16289672161,16278716061
1550000.0,2,2.25,2950,15593,1.0,0,0,3,8,1560,1390,1942,1986.0,98039,47.6209,-122.236,2060,19855,12643,0.8108125440902969,8702500,243141649,234439149
275000.0,3,1.5,1320,7695,1.0,0,0,3,7,1320,0,1959,0.0,98056,47.4908,-122.181,1370,8295,6375,0.8284600389863548,1742400,59213025,57470625
697000.0,4,2.5,3160,6961,2.0,0,0,2,8,3160,0,2005,0.0,98074,47.6125,-122.01,3110,5058,3801,0.5460422353110186,9985600,48455521,38469921
379500.0,2,1.0,1640,17335,1.0,0,0,2,7,840,800,1978,0.0,98053,47.6397,-121.95299999999999,2440,17850,15695,0.9053937121430632,2689600,300502225,297812625
720000.0,3,2.75,2440,76531,1.0,0,0,2,10,1640,800,1980,0.0,98072,47.7672,-122.161,1890,10042,74091,0.9681174948713593,5953600,5856993961,5851040361
675000.0,4,2.5,3000,5548,2.0,0,0,2,9,3000,0,2006,0.0,98059,47.5399,-122.18799999999999,2870,5000,2548,0.45926459985580387,9000000,30780304,21780304
1170000.0,5,2.5,2810,6000,2.5,0,0,2,9,2810,0,1907,0.0,98109,47.6367,-122.35,2240,4800,3190,0.5316666666666666,7896100,36000000,28103900
1100000.0,3,2.0,2390,6888,2.0,0,1,4,8,2390,0,1939,0.0,98115,47.6839,-122.274,2390,7920,4498,0.6530197444831591,5712100,47444544,41732444
520000.0,4,1.0,2080,3500,1.5,0,0,4,7,1260,820,1926,0.0,98136,47.5445,-122.383,1380,5900,1420,0.4057142857142857,4326400,12250000,7923600
415000.0,3,1.75,2650,7500,1.5,0,0,3,7,1590,1060,1962,0.0,98155,47.7716,-122.31700000000001,1340,7500,4850,0.6466666666666666,7022500,56250000,49227500
415000.0,3,2.5,1060,1536,2.0,0,0,2,8,1060,0,2000,0.0,98117,47.6907,-122.395,1220,1316,476,0.3098958333333333,1123600,2359296,1235696
450000.0,3,2.25,1940,8312,1.0,0,1,3,7,1220,720,1963,0.0,98166,47.4556,-122.346,2060,9503,6372,0.7666025024061598,3763600,69089344,65325744
485000.0,2,1.0,1080,4080,1.0,0,0,2,8,1080,0,1948,0.0,98115,47.6899,-122.32,1890,4080,3000,0.7352941176470589,1166400,16646400,15480000
294000.0,3,2.25,1700,9600,2.0,0,0,2,7,1700,0,1984,0.0,98042,47.39,-122.15799999999999,1930,9600,7900,0.8229166666666666,2890000,92160000,89270000
1040000.0,4,3.5,4440,10660,2.0,0,0,2,11,4440,0,2003,0.0,98059,47.5294,-122.137,4390,9976,6220,0.5834896810506567,19713600,113635600,93922000
690000.0,3,1.0,1580,4000,2.0,0,0,2,8,1580,0,1905,0.0,98102,47.6363,-122.32,2190,4000,2420,0.605,2496400,16000000,13503600
716500.0,5,2.75,3630,38461,2.0,0,0,2,11,3630,0,2000,0.0,98058,47.4289,-122.094,4440,50378,34831,0.9056186786615013,13176900,1479248521,1466071621
481000.0,2,2.25,1290,1137,3.0,0,0,2,8,1290,0,2007,0.0,98107,47.6718,-122.382,1290,1332,-153,-0.1345646437994723,1664100,1292769,-371331
575000.0,4,2.75,1960,4635,1.0,0,0,3,7,1000,960,1968,0.0,98118,47.5693,-122.285,1830,6180,2675,0.5771305285868392,3841600,21483225,17641625
785000.0,3,2.0,2090,5015,1.5,0,0,4,7,2090,0,1920,0.0,98112,47.6378,-122.301,1930,4250,2925,0.5832502492522432,4368100,25150225,20782125
480000.0,3,1.75,1960,43995,1.0,0,0,2,7,1960,0,1970,0.0,98059,47.4915,-122.10600000000001,1960,42253,42035,0.9554494828957836,3841600,1935560025,1931718425
720000.0,3,2.25,2120,9297,2.0,0,0,3,8,2120,0,1981,0.0,98006,47.5561,-122.154,2620,10352,7177,0.7719694525115629,4494400,86434209,81939809
536000.0,3,2.75,2290,34548,2.0,0,3,3,7,2290,0,1984,0.0,98042,47.3691,-122.163,399,275299,32258,0.933715410443441,5244100,1193564304,1188320204
324900.0,4,2.5,1880,7965,2.0,0,0,2,7,1880,0,2000,0.0,98038,47.3642,-122.052,1570,7584,6085,0.7639673571876961,3534400,63441225,59906825
265000.0,2,1.0,770,5160,1.0,0,0,2,6,770,0,1943,0.0,98106,47.5304,-122.35600000000001,920,5160,4390,0.8507751937984496,592900,26625600,26032700
545000.0,3,2.5,1530,3210,1.5,0,0,4,7,1010,520,1928,0.0,98117,47.6913,-122.39299999999999,1330,4410,1680,0.5233644859813084,2340900,10304100,7963200
465000.0,2,1.5,1450,27075,1.0,0,0,2,7,1450,0,1940,0.0,98133,47.7281,-122.353,1890,10599,25625,0.9464450600184672,2102500,733055625,730953125
292500.0,3,2.25,1690,7320,2.0,0,0,2,7,1690,0,1987,0.0,98198,47.3889,-122.316,1520,7450,5630,0.7691256830601093,2856100,53582400,50726300
860000.0,4,1.75,1880,3720,1.5,0,0,3,7,1880,0,1924,0.0,98109,47.6431,-122.35600000000001,2090,4095,1840,0.4946236559139785,3534400,13838400,10304000
1050000.0,4,3.25,4160,47480,2.0,0,0,2,10,4160,0,1995,0.0,98072,47.7266,-122.115,3400,40428,43320,0.9123841617523167,17305600,2254350400,2237044800
495000.0,4,2.5,2140,7245,2.0,0,0,2,7,2140,0,2003,0.0,98133,47.729,-122.35,2080,7875,5105,0.704623878536922,4579600,52490025,47910425
342000.0,2,2.0,1320,1462,3.0,0,0,2,7,1320,0,1997,0.0,98125,47.7223,-122.29,1430,1650,142,0.09712722298221614,1742400,2137444,395044
320000.0,4,2.5,2000,10051,2.0,0,0,2,7,2000,0,1997,0.0,98038,47.3625,-122.025,2000,6686,8051,0.8010148243955826,4000000,101022601,97022601
444000.0,3,2.0,1460,2610,2.0,0,0,2,8,1460,0,1987,0.0,98103,47.6864,-122.345,1320,3000,1150,0.44061302681992337,2131600,6812100,4680500
804100.0,4,2.5,3070,8086,2.0,0,0,2,10,3070,0,2005,0.0,98059,47.5399,-122.16,3320,10738,5016,0.6203314370516942,9424900,65383396,55958496
432000.0,3,2.5,1660,15000,1.0,0,0,3,7,1660,0,1970,0.0,98075,47.5803,-122.05,2060,15015,13340,0.8893333333333333,2755600,225000000,222244400
230000.0,6,1.5,1810,4838,1.5,0,0,3,5,1050,760,1905,0.0,98055,47.4874,-122.20200000000001,1300,4838,3028,0.6258784621744522,3276100,23406244,20130144
935000.0,4,3.5,3510,11200,2.0,0,0,2,11,3510,0,2001,0.0,98059,47.5193,-122.15,3600,12124,7690,0.6866071428571429,12320100,125440000,113119900
634950.0,3,3.0,2180,2650,1.5,0,0,4,8,1410,770,1930,0.0,98117,47.6891,-122.375,1570,4820,470,0.17735849056603772,4752400,7022500,2270100
780000.0,6,4.0,3300,5720,1.0,0,0,2,8,1960,1340,1963,0.0,98115,47.676,-122.309,2030,4080,2420,0.4230769230769231,10890000,32718400,21828400
611000.0,4,2.5,2460,4200,2.0,0,0,2,8,2460,0,1998,0.0,98074,47.6031,-122.021,2330,4200,1740,0.4142857142857143,6051600,17640000,11588400
475999.0,4,1.75,1880,4175,1.5,0,0,2,7,1090,790,1944,0.0,98107,47.6646,-122.36399999999999,1700,3758,2295,0.5497005988023952,3534400,17430625,13896225
565000.0,3,2.0,2290,9450,1.0,0,0,2,9,1670,620,1979,0.0,98008,47.5692,-122.1,2750,11700,7160,0.7576719576719577,5244100,89302500,84058400
630000.0,4,2.5,2290,26720,2.0,0,0,2,8,2290,0,1977,0.0,98177,47.7502,-122.374,2290,26720,24430,0.9142964071856288,5244100,713958400,708714300
840000.0,4,3.5,3860,18334,2.0,0,0,2,10,3120,740,1996,0.0,98077,47.7095,-122.075,3550,18334,14474,0.7894622013744955,14899600,336135556,321235956
790000.0,3,2.5,2640,432036,1.5,0,3,2,10,2640,0,1996,0.0,98022,47.1795,-122.036,1500,560617,429396,0.9938893981057134,6969600,186655105296,186648135696
450000.0,5,2.5,2850,209523,1.0,0,0,3,7,1930,0,1925,1968.0,98058,47.3939,-122.089,2220,209523,206673,0.9863976747182887,8122500,43899887529,43891765029
1270000.0,4,3.25,3020,4000,1.5,0,0,4,8,1920,1100,1927,0.0,98112,47.6395,-122.279,2400,4000,980,0.245,9120400,16000000,6879600
520000.0,3,2.0,1510,3760,1.0,0,0,4,7,930,580,1925,0.0,98136,47.5425,-122.39,1510,3760,2250,0.598404255319149,2280100,14137600,11857500
446800.0,4,2.0,2410,8712,1.0,0,0,2,7,1260,1150,1958,0.0,98144,47.5729,-122.302,2220,6038,6302,0.7233700642791552,5808100,75898944,70090844
652000.0,3,1.0,1470,6122,1.0,0,0,2,8,1200,270,1948,0.0,98199,47.6517,-122.406,2200,6122,4652,0.7598823913753675,2160900,37478884,35317984
1170000.0,3,2.75,2890,12130,2.0,0,3,3,10,2830,60,1987,0.0,98033,47.6505,-122.20299999999999,2415,11538,9240,0.761747732893652,8352100,147136900,138784800
745000.0,4,3.25,3490,7024,2.0,0,0,2,10,3490,0,2006,0.0,98075,47.5834,-121.97200000000001,3450,6866,3534,0.503132118451025,12180100,49336576,37156476
594000.0,3,2.25,1270,1406,2.0,0,0,2,8,1060,210,2014,0.0,98105,47.6647,-122.28399999999999,1160,1327,136,0.09672830725462304,1612900,1976836,363936
257000.0,2,1.0,1000,3700,1.0,0,0,2,6,800,200,1929,0.0,98118,47.552,-122.29,1270,5000,2700,0.7297297297297297,1000000,13690000,12690000
485000.0,4,1.75,1430,4096,2.0,0,0,2,7,1430,0,1900,0.0,98122,47.604,-122.306,1640,3377,2666,0.65087890625,2044900,16777216,14732316
330000.0,3,1.0,1060,20040,1.0,0,0,2,6,1060,0,1943,0.0,98034,47.7281,-122.235,1768,10800,18980,0.9471057884231537,1123600,401601600,400478000
381000.0,3,2.0,1680,8946,1.0,0,0,2,6,940,740,1996,0.0,98053,47.6379,-121.96600000000001,1550,11625,7266,0.812206572769953,2822400,80030916,77208516
849900.0,2,2.0,2280,641203,2.0,0,0,2,9,2280,0,1990,0.0,98070,47.4125,-122.455,2030,224334,638923,0.9964441838232198,5198400,411141287209,411136088809
793000.0,4,2.5,2450,4080,1.5,0,0,3,8,1490,960,1930,0.0,98115,47.6899,-122.319,2000,4080,1630,0.39950980392156865,6002500,16646400,10643900
920000.0,3,2.25,3650,5353,2.0,0,4,3,7,2200,1450,1947,0.0,98144,47.5949,-122.291,1950,4970,1703,0.3181393611059219,13322500,28654609,15332109
455000.0,2,1.0,830,4000,1.0,0,0,3,6,830,0,1947,0.0,98117,47.6909,-122.381,1420,4000,3170,0.7925,688900,16000000,15311100
975000.0,4,2.5,3490,7494,2.0,0,3,2,11,3490,0,2000,0.0,98006,47.559,-122.12700000000001,3260,8437,4004,0.5342941019482252,12180100,56160036,43979936
375000.0,2,1.5,1050,1046,2.0,0,0,2,8,960,90,2007,0.0,98122,47.6028,-122.309,1470,1768,-4,-0.0038240917782026767,1102500,1094116,-8384
400000.0,2,2.5,1170,1811,2.0,0,0,2,8,1170,0,2001,0.0,98122,47.6132,-122.29700000000001,1250,3146,641,0.35394809497515184,1368900,3279721,1910821
447000.0,3,1.0,1220,7200,1.0,0,0,3,7,1220,0,1965,0.0,98008,47.6218,-122.116,1320,7200,5980,0.8305555555555556,1488400,51840000,50351600
470000.0,3,1.75,1310,8600,1.0,0,0,3,7,1310,0,1987,0.0,98033,47.68600000000001,-122.185,2510,8515,7290,0.8476744186046512,1716100,73960000,72243900
665000.0,4,2.5,3130,7582,2.0,0,0,2,8,3130,0,2004,0.0,98075,47.577,-122.055,2990,6441,4452,0.5871801635452387,9796900,57486724,47689824
295500.0,3,1.75,1590,41550,1.5,0,0,2,6,1290,300,1933,1989.0,98168,47.4817,-122.28,2990,6464,39960,0.9617328519855596,2528100,1726402500,1723874400
200000.0,4,2.5,1720,8638,2.0,0,0,2,8,1720,0,1994,0.0,98003,47.2704,-122.31299999999999,1870,7455,6918,0.8008798332947441,2958400,74615044,71656644
620000.0,3,2.25,2520,212137,2.0,0,0,2,9,1590,930,2005,0.0,98019,47.7384,-121.87799999999999,2000,212137,209617,0.9881208841456228,6350400,45002106769,44995756369
434900.0,3,2.0,1520,11067,1.0,0,0,2,7,1140,380,1983,0.0,98074,47.6326,-122.03299999999999,1280,11371,9547,0.8626547393150809,2310400,122478489,120168089
1330000.0,4,2.25,3260,4640,2.0,0,0,4,9,2360,900,1907,0.0,98112,47.6272,-122.31200000000001,3240,5800,1380,0.2974137931034483,10627600,21529600,10902000
1650000.0,4,3.25,3910,7500,2.0,0,0,2,10,3910,0,2006,0.0,98033,47.6527,-122.198,2600,9235,3590,0.4786666666666667,15288100,56250000,40961900
852500.0,4,2.5,3480,6315,2.0,0,0,2,9,2360,1120,2000,0.0,98052,47.6841,-122.161,3620,5233,2835,0.4489311163895487,12110400,39879225,27768825
790000.0,3,2.5,3040,34670,2.0,0,0,3,10,3040,0,1983,0.0,98072,47.7565,-122.12899999999999,3480,35001,31630,0.9123161234496683,9241600,1202008900,1192767300
565000.0,4,1.75,2030,7350,1.0,0,0,2,8,2030,0,1966,0.0,98008,47.6274,-122.094,2000,7998,5320,0.7238095238095238,4120900,54022500,49901600
1130000.0,6,3.25,3870,24700,2.0,0,0,2,10,2520,1350,1989,0.0,98028,47.7517,-122.23299999999999,2360,30030,20830,0.8433198380566802,14976900,610090000,595113100
289950.0,3,2.5,1870,1436,2.0,0,0,2,7,1870,0,2004,0.0,98059,47.4899,-122.166,1720,1852,-434,-0.3022284122562674,3496900,2062096,-1434804
850000.0,2,2.0,2640,13939,1.0,0,1,4,8,1640,1000,1963,0.0,98006,47.5647,-122.165,2880,14810,11299,0.8106033431379582,6969600,194295721,187326121
505000.0,4,1.75,1940,4800,1.0,0,0,4,7,1030,910,1922,0.0,98122,47.6054,-122.314,1450,4800,2860,0.5958333333333333,3763600,23040000,19276400
372000.0,3,2.5,1710,5633,2.0,0,0,2,7,1710,0,1981,0.0,98034,47.7232,-122.161,1540,5000,3923,0.696431741523167,2924100,31730689,28806589
207000.0,4,2.0,1690,7728,1.5,0,0,3,7,1690,0,1967,0.0,98198,47.3666,-122.318,1480,8009,6038,0.7813146997929606,2856100,59721984,56865884
780000.0,3,1.75,2340,10495,1.0,0,0,3,8,2340,0,1967,0.0,98040,47.5386,-122.226,3120,11068,8155,0.7770366841353026,5475600,110145025,104669425
400000.0,4,1.75,1700,20283,1.5,0,0,2,7,1340,360,1965,0.0,98019,47.7694,-121.90299999999999,1680,21369,18583,0.916185968545087,2890000,411400089,408510089
440250.0,3,1.5,1850,8124,1.0,0,0,3,7,1850,0,1948,0.0,98177,47.7275,-122.359,1530,8123,6274,0.7722796651895618,3422500,65999376,62576876
585000.0,2,2.0,1370,7920,1.0,0,0,2,8,950,420,1949,0.0,98199,47.6589,-122.397,1370,4680,6550,0.827020202020202,1876900,62726400,60849500
850000.0,4,2.5,2900,9972,2.0,0,0,2,9,2900,0,1993,0.0,98006,47.5536,-122.12100000000001,2901,8567,7072,0.709185720016045,8410000,99440784,91030784
570000.0,3,3.0,2400,3192,2.0,0,0,2,7,2400,0,1991,0.0,98103,47.6963,-122.348,1360,3192,792,0.24812030075187969,5760000,10188864,4428864
869000.0,4,3.0,3740,30884,2.0,0,0,2,9,3060,680,1988,0.0,98072,47.7505,-122.117,3240,37031,27144,0.8789016966714156,13987600,953821456,939833856
551000.0,4,2.75,2170,5988,2.0,0,0,2,8,2170,0,2014,0.0,98155,47.7484,-122.31700000000001,1170,8147,3818,0.6376085504342017,4708900,35856144,31147244
172380.0,3,1.0,970,8378,1.0,0,0,3,6,970,0,1962,0.0,98023,47.3078,-122.365,1050,8563,7408,0.8842205777035091,940900,70190884,69249984
355000.0,3,2.5,2620,78843,1.0,0,3,3,7,1310,1310,1964,0.0,98092,47.2584,-122.09299999999999,2330,130244,76223,0.9667694024834164,6864400,6216218649,6209354249
728935.0,4,2.5,2980,10194,2.0,0,0,2,9,2980,0,1993,0.0,98006,47.5515,-122.12,2980,10053,7214,0.7076711791249755,8880400,103917636,95037236
850000.0,3,2.5,2340,1919,2.0,0,2,3,9,2340,0,1981,0.0,98033,47.6512,-122.20299999999999,2415,2166,-421,-0.21938509640437728,5475600,3682561,-1793039
515000.0,5,1.75,1880,48787,2.0,0,0,2,6,1880,0,1922,0.0,98059,47.5094,-122.165,1690,8401,46907,0.9614651444032222,3534400,2380171369,2376636969
215000.0,2,1.0,1480,5325,1.0,0,0,3,7,1120,360,1925,0.0,98022,47.2079,-121.993,1670,5800,3845,0.7220657276995305,2190400,28355625,26165225
220000.0,4,2.5,2240,9826,1.0,0,0,3,7,1370,870,1988,0.0,98023,47.31399999999999,-122.36399999999999,1980,9826,7586,0.772033380826379,5017600,96550276,91532676
845000.0,4,2.5,2940,7675,2.0,0,0,2,9,2940,0,2004,0.0,98052,47.7054,-122.12899999999999,3120,6574,4735,0.6169381107491857,8643600,58905625,50262025
390000.0,1,1.0,710,4000,1.0,0,0,3,6,610,100,1928,0.0,98103,47.6562,-122.354,1440,4500,3290,0.8225,504100,16000000,15495900
135000.0,4,1.0,1460,18599,1.5,0,0,2,5,1460,0,1940,0.0,98146,47.5006,-122.351,1320,8100,17139,0.9215011559761277,2131600,345922801,343791201
439000.0,3,1.0,1530,19007,1.0,0,0,3,8,1290,240,1949,0.0,98166,47.4508,-122.352,2090,20962,17477,0.9195033408744147,2340900,361266049,358925149
585000.0,4,2.5,2630,6185,2.0,0,0,2,9,2630,0,1999,0.0,98056,47.5229,-122.19200000000001,2720,6185,3555,0.5747776879547292,6916900,38254225,31337325
620000.0,5,1.0,2230,16800,1.5,0,3,3,7,1700,530,1923,0.0,98136,47.5161,-122.395,2730,18400,14570,0.8672619047619048,4972900,282240000,277267100
477000.0,3,1.0,960,3600,1.0,0,0,3,7,960,0,1906,0.0,98117,47.6758,-122.369,1580,5000,2640,0.7333333333333333,921600,12960000,12038400
399500.0,2,1.5,1180,1722,2.0,0,0,2,8,1180,0,2006,0.0,98116,47.5626,-122.384,1490,1469,542,0.3147502903600465,1392400,2965284,1572884
500000.0,2,1.0,1760,27332,1.0,1,4,3,7,1300,460,1951,0.0,98198,47.3799,-122.325,2590,16630,25572,0.9356066149568272,3097600,747038224,743940624
432500.0,3,2.5,1340,8867,2.0,0,0,2,8,1340,0,1984,0.0,98125,47.724,-122.32700000000001,1630,7287,7527,0.8488778617345213,1795600,78623689,76828089
940000.0,4,2.25,2800,18673,1.0,0,0,4,9,1650,1150,1965,0.0,98005,47.5893,-122.177,2800,15300,15873,0.85005087559578,7840000,348680929,340840929
3170000.0,5,3.5,4330,11979,1.0,0,4,2,12,2090,2240,2008,0.0,98004,47.6251,-122.21799999999999,4320,12000,7649,0.6385341013440187,18748900,143496441,124747541
1080000.0,3,2.5,3720,11610,2.0,0,0,2,11,3720,0,1982,0.0,98074,47.636,-122.04899999999999,3530,11877,7890,0.6795865633074936,13838400,134792100,120953700
229999.0,4,2.0,1670,5200,1.0,0,0,3,7,1030,640,1977,0.0,98042,47.3652,-122.09,1500,5200,3530,0.6788461538461539,2788900,27040000,24251100
233000.0,3,1.0,1100,7657,1.0,0,0,2,7,1100,0,1955,0.0,98188,47.4374,-122.285,1300,8000,6557,0.8563406033694658,1210000,58629649,57419649
600000.0,3,2.5,3240,8016,2.0,0,0,2,8,2910,330,2004,0.0,98065,47.5382,-121.87700000000001,2990,7561,4776,0.5958083832335329,10497600,64256256,53758656
334000.0,4,1.5,1680,7620,1.0,0,0,3,7,1180,500,1965,0.0,98166,47.4578,-122.351,1460,7620,5940,0.7795275590551181,2822400,58064400,55242000
332500.0,3,1.0,1030,8164,1.0,0,0,3,7,1030,0,1950,0.0,98133,47.7353,-122.334,1340,8164,7134,0.8738363547280745,1060900,66650896,65589996
249900.0,3,2.5,1630,7700,1.0,0,0,2,7,1120,510,1978,0.0,98031,47.3876,-122.211,1640,8160,6070,0.7883116883116883,2656900,59290000,56633100
310000.0,3,2.0,2610,12180,1.0,0,0,2,7,1670,940,1918,0.0,98146,47.5063,-122.346,1520,12180,9570,0.7857142857142857,6812100,148352400,141540300
200000.0,2,1.0,1250,8520,1.0,0,0,2,6,1250,0,1928,0.0,98126,47.5158,-122.37799999999999,1040,8520,7270,0.8532863849765259,1562500,72590400,71027900
310000.0,4,1.75,1480,11200,1.0,0,0,3,7,1480,0,1969,0.0,98059,47.5064,-122.141,1480,20310,9720,0.8678571428571429,2190400,125440000,123249600
230000.0,3,1.0,1390,6000,1.0,0,0,2,5,1390,0,1954,0.0,98056,47.4977,-122.175,1170,6000,4610,0.7683333333333333,1932100,36000000,34067900
420000.0,4,2.5,1940,5414,2.0,0,0,2,8,1940,0,1997,0.0,98108,47.5461,-122.29899999999999,2050,6307,3474,0.6416697451052826,3763600,29311396,25547796
785000.0,4,2.5,2960,4750,2.0,0,0,2,9,2960,0,2005,0.0,98029,47.5544,-121.993,2960,4750,1790,0.37684210526315787,8761600,22562500,13800900
1780000.0,3,2.25,4320,19225,1.0,0,0,3,10,2160,2160,1972,0.0,98004,47.6368,-122.21600000000001,3430,18469,14905,0.7752925877763329,18662400,369600625,350938225
265000.0,5,1.5,1500,7112,1.0,0,0,4,6,760,740,1920,0.0,98166,47.4692,-122.35,1200,7112,5612,0.7890888638920135,2250000,50580544,48330544
295000.0,2,1.0,840,10465,1.0,0,0,2,6,840,0,1951,0.0,98155,47.755,-122.31700000000001,1320,8515,9625,0.919732441471572,705600,109516225,108810625
896000.0,4,2.5,3560,46644,2.0,0,0,2,11,3560,0,1992,0.0,98077,47.7268,-122.05,3520,50261,43084,0.9236772146471143,12673600,2175662736,2162989136
415000.0,4,2.75,2390,9968,1.0,0,0,3,9,1390,1000,1989,0.0,98038,47.3706,-122.056,2560,12385,7578,0.7602327447833066,5712100,99361024,93648924
250000.0,3,1.75,1200,5478,1.0,0,0,4,6,1200,0,1955,0.0,98056,47.4959,-122.17399999999999,1270,6855,4278,0.7809419496166484,1440000,30008484,28568484
1480000.0,3,2.5,2570,5000,2.0,0,0,2,11,2570,0,1984,0.0,98102,47.6295,-122.32,1570,5000,2430,0.486,6604900,25000000,18395100
635000.0,5,2.25,2180,6000,1.0,0,0,3,8,1430,750,1966,0.0,98007,47.6235,-122.14299999999999,2160,8800,3820,0.6366666666666667,4752400,36000000,31247600
905000.0,3,2.5,3450,48787,2.0,0,0,2,10,3450,0,1987,0.0,98072,47.739,-122.12899999999999,2810,41040,45337,0.9292844405271896,11902500,2380171369,2368268869
528000.0,3,2.5,2020,5613,2.0,0,0,2,7,2020,0,2003,0.0,98053,47.6835,-122.035,2020,4609,3593,0.6401211473365401,4080400,31505769,27425369
530000.0,3,2.5,2480,7480,2.0,0,0,2,9,2480,0,1992,0.0,98072,47.771,-122.166,2480,7480,5000,0.6684491978609626,6150400,55950400,49800000
310000.0,3,1.5,1140,3104,2.0,0,0,2,7,1140,0,1988,0.0,98029,47.5707,-122.01799999999999,1150,2981,1964,0.6327319587628866,1299600,9634816,8335216
252000.0,3,1.0,1530,9465,1.0,0,0,3,7,1530,0,1960,0.0,98059,47.4915,-122.15100000000001,1530,9465,7935,0.838351822503962,2340900,89586225,87245325
334500.0,3,2.0,1700,8160,1.0,0,0,2,7,1120,580,1961,0.0,98133,47.74,-122.339,1740,8181,6460,0.7916666666666666,2890000,66585600,63695600
370000.0,3,1.0,2150,8480,1.0,0,0,2,8,1610,540,1951,0.0,98115,47.6996,-122.30799999999999,1620,5203,6330,0.7464622641509434,4622500,71910400,67287900
311000.0,3,2.0,1190,7840,1.5,0,0,3,6,1190,0,1918,0.0,98108,47.5531,-122.31200000000001,1460,3240,6650,0.8482142857142857,1416100,61465600,60049500
260000.0,3,2.75,1730,4131,2.0,0,2,2,7,1480,250,1975,0.0,98106,47.5327,-122.346,1570,4120,2401,0.5812152021302348,2992900,17065161,14072261
217500.0,3,1.75,1400,9546,1.0,0,0,3,7,1400,0,1984,0.0,98003,47.3179,-122.331,1660,8550,8146,0.8533417138068301,1960000,91126116,89166116
290000.0,3,2.5,2200,4240,2.0,0,0,2,7,2200,0,2003,0.0,98042,47.3715,-122.12700000000001,2200,4311,2040,0.4811320754716981,4840000,17977600,13137600
500000.0,3,1.5,960,4600,1.0,0,0,2,6,960,0,1944,0.0,98033,47.6937,-122.213,2230,9350,3640,0.7913043478260869,921600,21160000,20238400
423500.0,3,2.0,1770,6000,1.0,0,3,2,7,1100,670,1984,0.0,98118,47.5644,-122.29,1300,3000,4230,0.705,3132900,36000000,32867100
715000.0,4,2.5,2970,5722,2.0,0,0,2,9,2970,0,2005,0.0,98074,47.6134,-122.042,3940,4848,2752,0.4809507165326809,8820900,32741284,23920384
299000.0,3,2.5,1590,3121,2.0,0,0,2,7,1590,0,1994,0.0,98118,47.5515,-122.28399999999999,1090,4900,1531,0.49054790131368153,2528100,9740641,7212541
635000.0,3,2.5,3350,4007,2.0,0,0,2,8,2550,800,2005,0.0,98034,47.7277,-122.20700000000001,2340,4167,657,0.16396306463688545,11222500,16056049,4833549
806000.0,4,2.5,3370,9629,2.0,0,0,2,10,3370,0,1999,0.0,98075,47.5896,-121.978,3360,10335,6259,0.6500155779416347,11356900,92717641,81360741
289950.0,3,2.5,1960,3480,2.0,0,0,2,7,1960,0,2004,0.0,98056,47.4802,-122.18,2560,3500,1520,0.4367816091954023,3841600,12110400,8268800
280000.0,3,1.75,1360,6603,1.0,0,0,3,7,1360,0,1981,0.0,98058,47.4619,-122.16799999999999,1770,7107,5243,0.7940330152960775,1849600,43599609,41750009
479950.0,3,2.5,2780,6000,2.0,0,0,2,9,2780,0,2004,0.0,98058,47.4569,-122.118,1940,3466,3220,0.5366666666666666,7728400,36000000,28271600
394000.0,4,2.5,3000,9793,2.0,0,0,2,7,3000,0,2002,0.0,98038,47.3655,-122.02799999999999,1890,7557,6793,0.6936587358317166,9000000,95902849,86902849
682000.0,4,2.5,3600,203425,2.0,0,0,2,9,3400,200,1979,0.0,98077,47.7597,-122.01799999999999,3150,202989,199825,0.9823030600958584,12960000,41381730625,41368770625
409950.0,2,1.0,990,3000,1.0,0,0,3,6,990,0,1918,0.0,98103,47.6839,-122.345,1120,3000,2010,0.67,980100,9000000,8019900
1000000.0,4,3.5,2990,4200,2.0,0,4,4,9,2000,990,1925,0.0,98144,47.593,-122.289,2390,4200,1210,0.28809523809523807,8940100,17640000,8699900
436000.0,4,1.0,1200,6600,1.5,0,2,2,7,1200,0,1908,0.0,98136,47.5372,-122.382,1810,6600,5400,0.8181818181818182,1440000,43560000,42120000
279000.0,3,1.0,1530,15975,1.0,0,0,2,7,970,560,1952,0.0,98168,47.4766,-122.32600000000001,1540,15975,14445,0.9042253521126761,2340900,255200625,252859725
390000.0,1,1.75,1440,4920,1.0,0,0,2,7,720,720,1923,0.0,98126,47.534,-122.376,1440,4920,3480,0.7073170731707317,2073600,24206400,22132800
635000.0,3,1.75,1940,167125,1.0,1,1,3,7,1480,460,1955,0.0,98070,47.458999999999996,-122.50399999999999,1910,127195,165185,0.9883919222139117,3763600,27930765625,27927002025
304400.0,4,2.75,2140,8100,2.0,0,0,3,7,2140,0,1990,0.0,98023,47.3075,-122.359,1960,7002,5960,0.7358024691358025,4579600,65610000,61030400
780000.0,5,1.75,2330,3800,1.5,0,0,2,7,1360,970,1927,0.0,98115,47.6835,-122.30799999999999,2100,3800,1470,0.3868421052631579,5428900,14440000,9011100
520000.0,4,3.5,2734,210201,2.0,0,0,4,8,2734,0,1974,0.0,98070,47.3652,-122.50399999999999,2270,187308,207467,0.9869934015537509,7474756,44184460401,44176985645
580000.0,3,1.75,1950,10633,1.0,0,0,2,7,1250,700,1978,0.0,98125,47.7019,-122.31299999999999,1290,6380,8683,0.8166086711182169,3802500,113060689,109258189
274000.0,3,1.75,1440,7198,1.0,0,0,2,7,990,450,1981,0.0,98055,47.4333,-122.194,1550,7156,5758,0.7999444290080578,2073600,51811204,49737604
315000.0,3,2.25,1530,7906,1.0,0,0,2,7,1150,380,1980,0.0,98058,47.4418,-122.13600000000001,1460,7875,6376,0.8064760941057425,2340900,62504836,60163936
390000.0,4,1.75,1910,77574,1.0,0,0,3,8,1910,0,1971,0.0,98042,47.3932,-122.12,2130,37026,75664,0.9753783484157063,3648100,6017725476,6014077376
340000.0,5,2.0,1750,8220,1.0,0,0,2,7,1750,0,1956,0.0,98155,47.7694,-122.321,1210,6760,6470,0.7871046228710462,3062500,67568400,64505900
502000.0,3,2.25,1600,45613,2.0,0,0,3,8,1600,0,1983,0.0,98072,47.7523,-122.117,2320,43005,44013,0.9649222809286826,2560000,2080545769,2077985769
260000.0,3,1.75,1750,11180,1.0,0,0,2,8,1750,0,1968,0.0,98059,47.4713,-122.117,1730,11180,9430,0.8434704830053668,3062500,124992400,121929900
399000.0,2,1.0,940,4800,1.0,0,0,3,6,940,0,1911,1955.0,98116,47.5756,-122.414,980,5900,3860,0.8041666666666667,883600,23040000,22156400
312500.0,2,1.0,880,6345,1.0,0,0,2,7,880,0,1919,0.0,98106,47.5341,-122.35799999999999,1440,6345,5465,0.8613081166272656,774400,40259025,39484625
370000.0,3,1.75,1650,8254,1.0,0,0,4,7,1060,590,1951,0.0,98155,47.7596,-122.304,2280,9450,6604,0.8000969227041435,2722500,68128516,65406016
1240000.0,4,3.5,3820,13224,2.0,0,0,2,10,3280,540,1990,0.0,98004,47.6005,-122.199,3340,9700,9404,0.7111312764670297,14592400,174874176,160281776
230000.0,3,1.5,1900,9630,1.0,0,0,2,8,1900,0,1967,0.0,98023,47.3352,-122.344,2010,9630,7730,0.8026998961578401,3610000,92736900,89126900
1280000.0,4,1.75,3720,8448,1.0,0,3,3,9,1960,1760,1947,0.0,98199,47.6425,-122.406,2540,7064,4728,0.5596590909090909,13838400,71368704,57530304
294350.0,3,1.0,1410,5120,1.5,0,0,2,6,1210,200,1925,0.0,98106,47.5238,-122.355,1330,5120,3710,0.724609375,1988100,26214400,24226300
208950.0,3,1.0,960,5700,1.0,0,0,3,5,960,0,1956,0.0,98056,47.4983,-122.17200000000001,960,5700,4740,0.8315789473684211,921600,32490000,31568400
515000.0,2,1.75,1930,5570,1.0,0,0,2,8,1930,0,2005,0.0,98053,47.7173,-122.03399999999999,1810,5178,3640,0.6535008976660682,3724900,31024900,27300000
965000.0,4,2.5,3420,9575,2.0,0,0,2,11,3420,0,1994,0.0,98027,47.5527,-122.095,3310,8192,6155,0.6428198433420366,11696400,91680625,79984225
925000.0,4,2.75,3010,3400,2.0,0,2,2,9,2240,770,1923,2009.0,98122,47.6142,-122.28399999999999,1940,5080,390,0.11470588235294117,9060100,11560000,2499900
654500.0,4,1.0,1780,5000,1.5,0,0,2,8,1780,0,1947,0.0,98115,47.6761,-122.29700000000001,2030,5000,3220,0.644,3168400,25000000,21831600
364000.0,4,2.5,2080,11050,1.0,0,0,3,8,2080,0,1969,0.0,98059,47.472,-122.119,1850,11050,8970,0.8117647058823529,4326400,122102500,117776100
150000.0,2,1.0,1250,5208,1.0,0,0,2,7,1050,200,1951,0.0,98002,47.3063,-122.219,1030,5354,3958,0.7599846390168971,1562500,27123264,25560764
349950.0,5,3.0,2257,10117,1.0,0,0,2,8,1363,0,2005,0.0,98188,47.4524,-122.28399999999999,1540,10700,7860,0.7769101512306019,5094049,102353689,97259640
585000.0,3,1.5,1670,5000,1.5,0,0,3,7,1670,0,1912,0.0,98117,47.678000000000004,-122.36,1750,5000,3330,0.666,2788900,25000000,22211100
801501.0,4,2.25,2250,13500,2.0,0,0,3,9,2250,0,1980,0.0,98007,47.621,-122.15100000000001,2730,13500,11250,0.8333333333333334,5062500,182250000,177187500
610000.0,3,1.75,1650,221720,1.0,0,0,2,7,1650,0,1992,0.0,98024,47.5297,-121.90100000000001,2520,221284,220070,0.9925581814901678,2722500,49159758400,49157035900
382000.0,5,2.25,2880,11965,2.0,0,0,3,8,2880,0,1990,0.0,98042,47.3734,-122.124,2370,10715,9085,0.759297952361053,8294400,143161225,134866825
495000.0,4,3.0,3620,403693,2.0,0,2,2,9,3620,0,1980,0.0,98022,47.2527,-121.98,2230,148811,400073,0.9910327897684627,13104400,162968038249,162954933849
447500.0,3,1.75,1950,6504,1.0,0,0,2,8,1530,420,1953,0.0,98115,47.6934,-122.32799999999999,1660,6552,4554,0.7001845018450185,3802500,42302016,38499516
575000.0,4,2.5,2280,9491,1.0,0,0,3,7,1290,990,1966,0.0,98008,47.6297,-122.117,1560,8050,7211,0.759772415973027,5198400,90079081,84880681
565000.0,2,1.75,1740,4736,1.5,0,2,3,7,1040,700,1907,0.0,98144,47.5994,-122.287,2020,4215,2996,0.6326013513513513,3027600,22429696,19402096
348580.0,3,1.0,1220,7876,1.0,0,0,2,7,1220,0,1966,0.0,98034,47.7317,-122.20100000000001,1340,7876,6656,0.8450990350431691,1488400,62031376,60542976
459000.0,4,1.75,2260,9703,1.0,0,0,1,8,1660,600,1978,0.0,98052,47.6622,-122.145,2390,8455,7443,0.7670823456662887,5107600,94148209,89040609
375000.0,4,2.0,1790,61419,2.0,0,2,1,7,1790,0,1988,0.0,98019,47.7216,-121.90700000000001,1790,62290,59629,0.9708559240625865,3204100,3772293561,3769089461
310000.0,4,2.5,2440,7093,2.0,0,0,2,7,2440,0,1999,0.0,98030,47.3817,-122.204,1860,6072,4653,0.6559988721274496,5953600,50310649,44357049
210000.0,3,1.5,1400,9600,1.0,0,0,3,7,1400,0,1964,0.0,98003,47.2878,-122.29700000000001,2210,15000,8200,0.8541666666666666,1960000,92160000,90200000
384205.0,3,2.75,1810,3292,2.0,0,0,2,8,1810,0,2014,0.0,98065,47.5164,-121.87700000000001,1810,2769,1482,0.45018226002430134,3276100,10837264,7561164
180000.0,2,1.0,1400,4500,1.0,0,0,2,7,900,500,1922,0.0,98055,47.4866,-122.219,1400,5500,3100,0.6888888888888889,1960000,20250000,18290000
310000.0,2,1.0,1400,4500,1.0,0,0,2,7,900,500,1922,0.0,98055,47.4866,-122.219,1400,5500,3100,0.6888888888888889,1960000,20250000,18290000
427500.0,4,2.5,2010,6294,2.0,0,0,2,7,2010,0,2000,0.0,98028,47.776,-122.24,1870,4394,4284,0.680648236415634,4040100,39614436,35574336
780000.0,3,3.0,2520,2152,1.5,0,0,2,8,1560,960,1925,2006.0,98119,47.6363,-122.37100000000001,1140,2152,-368,-0.17100371747211895,6350400,4631104,-1719296
1760000.0,3,2.25,3060,16000,2.0,0,0,2,10,3060,0,1988,0.0,98039,47.6189,-122.23,3510,13162,12940,0.80875,9363600,256000000,246636400
339950.0,4,2.5,2150,4000,2.0,0,0,2,7,2150,0,2010,0.0,98038,47.3655,-122.01799999999999,1610,4000,1850,0.4625,4622500,16000000,11377500
820000.0,3,2.25,2880,9750,2.0,0,0,2,10,2880,0,1989,0.0,98006,47.5575,-122.119,2920,11090,6870,0.7046153846153846,8294400,95062500,86768100
398000.0,2,2.0,1300,3865,1.0,0,0,2,8,1300,0,2006,0.0,98053,47.7193,-122.024,1350,4199,2565,0.6636481241914618,1690000,14938225,13248225
492000.0,3,1.75,2770,39927,1.0,0,0,3,8,1580,1190,1978,0.0,98027,47.4669,-122.00299999999999,2420,36384,37157,0.9306233876825206,7672900,1594165329,1586492429
240000.0,4,1.5,1780,14810,1.0,0,0,3,8,1180,600,1950,0.0,98032,47.3581,-122.288,1450,6728,13030,0.8798109385550303,3168400,219336100,216167700
599950.0,4,3.5,3730,15029,2.0,0,2,2,10,2440,1290,1991,0.0,98042,47.3804,-122.163,3440,14280,11299,0.7518131612216382,13912900,225870841,211957941
105500.0,2,1.0,930,7740,1.0,0,0,0,5,930,0,1932,0.0,98148,47.4611,-122.324,1620,8584,6810,0.8798449612403101,864900,59907600,59042700
445000.0,2,1.0,930,7740,1.0,0,0,0,5,930,0,1932,0.0,98148,47.4611,-122.324,1620,8584,6810,0.8798449612403101,864900,59907600,59042700
390500.0,2,1.75,1460,426450,1.0,0,0,4,7,960,500,1966,0.0,98022,47.2079,-121.96700000000001,1810,17350,424990,0.9965763864462422,2131600,181859602500,181857470900
255000.0,3,2.0,1310,8454,1.0,0,0,2,7,1310,0,1994,0.0,98042,47.3697,-122.075,1310,8454,7144,0.8450437662644902,1716100,71470116,69754016
675750.0,4,2.5,2770,10274,2.0,0,0,2,9,2770,0,1989,0.0,98029,47.5748,-122.01799999999999,2270,7210,7504,0.7303873856336384,7672900,105555076,97882176
1640000.0,3,3.25,3140,5445,2.0,0,3,3,10,2240,900,1913,0.0,98109,47.6406,-122.34700000000001,2950,5250,2305,0.4233241505968779,9859600,29648025,19788425
353500.0,4,2.5,1770,9239,2.0,0,0,2,7,1770,0,2004,0.0,98038,47.3512,-122.006,2150,5450,7469,0.8084208247645849,3132900,85359121,82226221
765000.0,3,1.0,1220,7585,1.0,0,0,3,7,1220,0,1954,0.0,98004,47.6094,-122.194,1380,8918,6365,0.8391562294001318,1488400,57532225,56043825
563500.0,4,2.5,2190,4944,2.0,0,0,2,8,2190,0,1999,0.0,98065,47.5341,-121.866,2190,5108,2754,0.5570388349514563,4796100,24443136,19647036
439000.0,4,2.0,1800,5465,1.0,0,0,2,7,900,900,1942,0.0,98118,47.56100000000001,-122.272,1400,5400,3665,0.6706312900274474,3240000,29866225,26626225
975000.0,5,2.75,3100,10014,1.0,0,2,3,9,1660,1440,1973,0.0,98040,47.5734,-122.213,3230,10279,6914,0.6904333932494507,9610000,100280196,90670196
469900.0,3,2.5,2270,4399,2.0,0,0,2,7,2270,0,2007,0.0,98065,47.5415,-121.884,2060,4399,2129,0.48397363037053875,5152900,19351201,14198301
252000.0,3,1.0,1300,8184,2.0,0,0,2,6,1300,0,1947,0.0,98155,47.7469,-122.319,1120,8184,6884,0.8411534701857283,1690000,66977856,65287856
495000.0,3,2.0,1769,9300,1.0,0,0,3,7,1769,0,1955,2009.0,98166,47.441,-122.34200000000001,1870,10226,7531,0.8097849462365592,3129361,86490000,83360639
570000.0,6,2.5,3370,15625,1.0,0,0,2,8,1770,1600,1964,0.0,98166,47.4223,-122.34299999999999,2790,15681,12255,0.78432,11356900,244140625,232783725
327000.0,4,2.5,1630,5361,2.0,0,0,2,7,1630,0,1999,0.0,98144,47.5704,-122.294,1920,5046,3731,0.6959522477149785,2656900,28740321,26083421
898000.0,2,2.25,2470,7658,1.0,0,0,3,8,1480,990,1954,0.0,98199,47.653,-122.416,2070,7270,5188,0.6774614781927396,6100900,58644964,52544064
300000.0,4,2.5,2600,8572,2.0,0,0,2,8,2600,0,2003,0.0,98001,47.3155,-122.266,2170,5288,5972,0.6966868875408306,6760000,73479184,66719184
418500.0,3,2.0,1800,12440,1.0,0,0,2,8,1220,580,1978,0.0,98074,47.6254,-122.05,2460,12352,10640,0.8553054662379421,3240000,154753600,151513600
450000.0,4,2.5,2240,4616,2.0,0,0,2,7,1840,400,2001,0.0,98056,47.5118,-122.194,2260,5200,2376,0.5147313691507799,5017600,21307456,16289856
403000.0,3,2.0,1960,13100,1.0,0,2,4,8,1650,310,1957,0.0,98166,47.4419,-122.34,1960,10518,11140,0.850381679389313,3841600,171610000,167768400
440000.0,3,1.0,1710,6556,1.5,0,0,3,7,1200,510,1926,0.0,98133,47.7185,-122.354,1410,6563,4846,0.739170225747407,2924100,42981136,40057036
350000.0,4,1.75,2140,4959,1.0,0,0,2,7,1080,1060,1965,0.0,98118,47.5166,-122.266,1590,5250,2819,0.568461383343416,4579600,24591681,20012081
240000.0,3,2.0,1400,6200,1.0,0,0,2,6,700,700,1948,0.0,98133,47.7634,-122.34,1410,7564,4800,0.7741935483870968,1960000,38440000,36480000
460000.0,2,1.0,890,2100,1.0,0,0,3,6,760,130,1919,0.0,98107,47.65600000000001,-122.359,1600,4250,1210,0.5761904761904761,792100,4410000,3617900
825000.0,4,1.0,1820,4000,2.0,0,0,2,8,1820,0,1923,0.0,98102,47.6259,-122.321,2050,4000,2180,0.545,3312400,16000000,12687600
267500.0,3,2.25,1860,12000,1.0,0,0,3,7,1860,0,1976,0.0,98092,47.2942,-122.19,1815,9604,10140,0.845,3459600,144000000,140540400
201000.0,3,1.0,1220,22443,1.0,0,0,3,7,1220,0,1972,0.0,98001,47.2633,-122.245,1260,19950,21223,0.9456400659448381,1488400,503688249,502199849
479500.0,3,2.75,2300,4637,2.0,0,0,2,8,2300,0,2008,0.0,98065,47.5216,-121.87799999999999,2420,5699,2337,0.5039896484796205,5290000,21501769,16211769
210000.0,2,1.0,1520,4700,2.0,0,0,3,7,1520,0,1978,0.0,98092,47.3187,-122.182,1140,3906,3180,0.676595744680851,2310400,22090000,19779600
445000.0,2,1.0,1440,3225,1.0,0,0,2,7,960,480,1915,0.0,98103,47.6653,-122.338,1160,3630,1785,0.5534883720930233,2073600,10400625,8327025
265000.0,3,1.75,1170,8148,1.0,0,0,2,7,1170,0,1952,0.0,98155,47.7479,-122.318,1200,8147,6978,0.8564064801178203,1368900,66389904,65021004
399000.0,3,1.75,1170,8148,1.0,0,0,2,7,1170,0,1952,0.0,98155,47.7479,-122.318,1200,8147,6978,0.8564064801178203,1368900,66389904,65021004
785000.0,4,2.25,3200,53357,2.0,0,0,3,9,3200,0,1972,0.0,98077,47.755,-122.035,2650,54014,50157,0.9400266131903967,10240000,2846969449,2836729449
831500.0,5,2.5,4470,35124,2.5,0,0,2,11,4470,0,1984,0.0,98072,47.7377,-122.084,4050,34118,30654,0.8727365903655621,19980900,1233695376,1213714476
360000.0,4,2.5,2570,4557,2.0,0,0,2,7,2570,0,2009,0.0,98042,47.367,-122.115,2200,4500,1987,0.43603247750713187,6604900,20766249,14161349
655000.0,3,2.5,2370,7916,2.0,0,0,2,9,2370,0,1990,0.0,98056,47.528,-122.171,2500,8221,5546,0.7006063668519454,5616900,62663056,57046156
449950.0,4,1.5,1800,10150,1.5,0,0,3,7,1800,0,1958,0.0,98034,47.7325,-122.242,1630,10660,8350,0.8226600985221675,3240000,103022500,99782500
612000.0,5,2.5,2300,7000,1.0,0,0,2,8,1290,1010,1975,0.0,98052,47.6875,-122.12200000000001,2080,7280,4700,0.6714285714285714,5290000,49000000,43710000
575000.0,3,2.5,3240,33661,2.0,0,0,2,8,3240,0,2001,0.0,98059,47.4785,-122.095,1870,43560,30421,0.903746175098779,10497600,1133062921,1122565321
557000.0,3,2.5,2280,18241,1.0,0,0,2,9,960,1320,1995,0.0,98011,47.7453,-122.213,3100,12465,15961,0.8750068526944794,5198400,332734081,327535681
375000.0,4,1.75,1870,12500,1.0,0,1,4,6,1030,840,1943,0.0,98056,47.511,-122.197,2060,14141,10630,0.8504,3496900,156250000,152753100
369000.0,3,2.25,1820,99752,1.0,0,0,3,7,1820,0,1969,0.0,98092,47.2838,-122.006,1850,117612,97932,0.9817547517844254,3312400,9950461504,9947149104
330000.0,5,2.75,2390,6282,1.0,0,0,3,7,1290,1100,1966,0.0,98118,47.5149,-122.26299999999999,1690,5202,3892,0.6195479146768545,5712100,39463524,33751424
1030000.0,4,1.75,2110,6708,1.0,0,3,2,8,1410,700,1941,0.0,98105,47.67,-122.274,2140,7006,4598,0.6854502087060227,4452100,44997264,40545164
550000.0,2,1.0,980,4800,1.0,0,0,3,7,980,0,1910,0.0,98103,47.6569,-122.348,1570,2640,3820,0.7958333333333333,960400,23040000,22079600
338000.0,3,1.75,1250,7710,1.0,0,0,3,7,1250,0,1947,0.0,98155,47.7623,-122.31700000000001,1340,7710,6460,0.8378728923476005,1562500,59444100,57881600
1900000.0,4,2.5,3680,13351,2.0,0,2,4,9,3680,0,1946,1982.0,98004,47.6154,-122.214,3410,11700,9671,0.7243652160886825,13542400,178249201,164706801
235000.0,3,1.0,2230,8163,1.0,0,0,2,7,1230,1000,1966,0.0,98118,47.5215,-122.275,2380,6874,5933,0.7268161215239495,4972900,66634569,61661669
349950.0,1,1.0,1230,9300,1.5,0,0,3,6,1230,0,1918,0.0,98133,47.7055,-122.348,1190,6820,8070,0.867741935483871,1512900,86490000,84977100
300000.0,5,2.5,2093,10350,1.5,0,0,4,7,2093,0,1963,0.0,98058,47.4495,-122.17,1520,10350,8257,0.7977777777777778,4380649,107122500,102741851
431000.0,3,1.75,1660,12865,1.0,0,0,4,7,1660,0,1967,0.0,98056,47.5375,-122.175,1610,12400,11205,0.8709677419354839,2755600,165508225,162752625
280000.0,5,2.5,1630,20750,1.0,0,0,3,7,1100,530,1975,0.0,98042,47.3657,-122.113,1630,8640,19120,0.9214457831325301,2656900,430562500,427905600
295000.0,4,2.5,1677,7209,2.0,0,0,2,7,1677,0,2011,0.0,98023,47.2957,-122.35700000000001,2236,7209,5532,0.7673741156887224,2812329,51969681,49157352
445000.0,4,2.5,2990,6383,2.0,0,0,2,7,2990,0,2003,0.0,98038,47.3499,-122.027,2640,6454,3393,0.5315682281059063,8940100,40742689,31802589
550000.0,5,1.0,2150,262231,1.5,0,0,2,7,2150,0,1900,0.0,98065,47.5519,-121.803,1460,46609,260081,0.991801121911597,4622500,68765097361,68760474861
515000.0,4,2.5,2890,15067,2.0,0,0,2,9,2890,0,2003,0.0,98024,47.5666,-121.90700000000001,3090,15398,12177,0.8081900842901706,8352100,227014489,218662389
555000.0,3,2.5,3050,158558,1.0,0,0,3,9,3050,0,1987,0.0,98055,47.4326,-122.208,2960,31050,155508,0.9807641367827545,9302500,25140639364,25131336864
265000.0,3,2.5,1410,2500,2.0,0,0,2,7,1410,0,2006,0.0,98146,47.5132,-122.35799999999999,1290,5190,1090,0.436,1988100,6250000,4261900
597000.0,4,2.5,2280,2432,2.0,0,0,4,8,1520,760,1921,0.0,98103,47.6605,-122.355,1690,2099,152,0.0625,5198400,5914624,716224
661000.0,2,1.0,1260,5800,1.0,0,0,3,7,1260,0,1939,0.0,98199,47.6501,-122.40899999999999,1830,5800,4540,0.7827586206896552,1587600,33640000,32052400
362764.0,3,2.0,1460,4350,2.0,0,0,2,7,1460,0,2008,0.0,98053,47.69600000000001,-122.02600000000001,1740,4622,2890,0.664367816091954,2131600,18922500,16790900
427000.0,4,2.5,1600,14000,1.0,0,0,2,8,1310,290,1950,0.0,98125,47.7258,-122.32600000000001,1600,10200,12400,0.8857142857142857,2560000,196000000,193440000
405000.0,3,1.75,2020,8531,1.0,0,0,2,7,2020,0,1965,0.0,98011,47.7691,-122.199,1950,8449,6511,0.7632165045129528,4080400,72777961,68697561
157000.0,3,1.5,1170,11530,1.0,0,0,2,7,1170,0,1960,0.0,98198,47.4211,-122.29,1550,8605,10360,0.8985255854293148,1368900,132940900,131572000
246500.0,3,1.5,1170,11530,1.0,0,0,2,7,1170,0,1960,0.0,98198,47.4211,-122.29,1550,8605,10360,0.8985255854293148,1368900,132940900,131572000
386500.0,2,1.5,1280,11071,1.0,0,0,2,7,850,430,1984,0.0,98074,47.6351,-122.03299999999999,1280,10879,9791,0.8843826212627586,1638400,122567041,120928641
300000.0,4,2.5,2680,15508,2.0,0,0,2,8,2680,0,1999,0.0,98023,47.3025,-122.39,1960,15586,12828,0.8271859685323704,7182400,240498064,233315664
240000.0,3,1.75,1770,8571,1.0,0,0,2,8,1270,500,1978,0.0,98023,47.3109,-122.339,2120,7711,6801,0.7934896744837242,3132900,73462041,70329141
818500.0,5,3.5,4790,12957,2.0,0,1,2,9,3110,1680,2005,0.0,98006,47.5469,-122.194,2620,13538,8167,0.6303156594890793,22944100,167883849,144939749
249000.0,3,1.75,1300,8500,1.0,0,0,3,7,1300,0,1964,0.0,98022,47.208999999999996,-122.005,1410,7800,7200,0.8470588235294118,1690000,72250000,70560000
580000.0,4,2.25,2610,7700,1.0,0,0,2,8,1700,910,1977,0.0,98027,47.5659,-122.089,2260,8266,5090,0.6610389610389611,6812100,59290000,52477900
2340000.0,4,2.5,4500,35200,1.0,0,0,2,13,4500,0,1988,0.0,98006,47.5477,-122.126,4760,35200,30700,0.8721590909090909,20250000,1239040000,1218790000
333000.0,4,2.5,2100,7366,2.0,0,0,2,8,2100,0,1997,0.0,98042,47.3703,-122.10700000000001,2060,7324,5266,0.7149063263643769,4410000,54257956,49847956
230000.0,2,2.0,1340,7605,1.0,0,0,2,7,1340,0,1992,0.0,98022,47.1936,-121.98100000000001,1670,7136,6265,0.8238001314924391,1795600,57836025,56040425
360500.0,3,1.0,970,6180,1.0,0,3,2,6,970,0,1974,0.0,98118,47.5658,-122.291,1120,4500,5210,0.843042071197411,940900,38192400,37251500
265000.0,3,1.75,2200,7200,1.0,0,0,2,8,1270,930,1962,0.0,98032,47.3745,-122.27600000000001,1800,8000,5000,0.6944444444444444,4840000,51840000,47000000
490000.0,2,1.0,990,5000,1.0,0,0,2,7,990,0,1941,0.0,98116,47.5666,-122.40299999999999,2250,6032,4010,0.802,980100,25000000,24019900
600000.0,2,1.75,1180,5000,1.0,0,0,1,7,880,300,1925,0.0,98107,47.6749,-122.398,1470,5000,3820,0.764,1392400,25000000,23607600
307500.0,3,1.0,980,6530,1.0,0,0,2,7,980,0,1969,0.0,98034,47.7133,-122.213,1220,6723,5550,0.8499234303215927,960400,42640900,41680500
670000.0,4,2.25,2370,9636,1.0,0,0,2,8,1660,710,1976,0.0,98033,47.6497,-122.194,2350,9588,7266,0.7540473225404732,5616900,92852496,87235596
247200.0,3,1.5,1910,10583,1.5,0,0,3,7,1910,0,1922,1967.0,98002,47.2782,-122.212,1770,9068,8673,0.8195218747047152,3648100,111999889,108351789
2600000.0,4,4.5,5270,12195,2.0,1,4,2,11,3400,1870,1979,0.0,98027,47.5696,-122.09,3390,9905,6925,0.5678556785567855,27772900,148718025,120945125
440000.0,3,1.75,1430,8400,1.0,0,0,3,7,1430,0,1961,0.0,98008,47.6073,-122.12700000000001,1570,7800,6970,0.8297619047619048,2044900,70560000,68515100
700000.0,4,2.5,2490,7694,2.0,0,0,2,8,2490,0,1987,0.0,98029,47.567,-122.016,2140,8126,5204,0.676371198336366,6200100,59197636,52997536
756100.0,4,2.0,2000,8317,1.5,0,0,3,8,2000,0,1917,0.0,98126,47.5394,-122.37899999999999,1390,6001,6317,0.7595286762053625,4000000,69172489,65172489
555000.0,4,2.75,2600,19275,1.0,0,0,2,8,1620,980,1978,0.0,98006,47.5523,-122.162,2230,10119,16675,0.8651102464332037,6760000,371525625,364765625
830000.0,5,3.5,2880,3750,2.0,0,2,2,8,2270,610,2001,0.0,98144,47.5905,-122.292,2060,4000,870,0.232,8294400,14062500,5768100
180000.0,3,1.0,1010,8863,1.0,0,0,3,6,1010,0,1990,0.0,98022,47.1955,-121.999,1090,8410,7853,0.8860431005302944,1020100,78552769,77532669
775000.0,5,3.5,3290,5600,2.0,0,0,2,9,2670,620,2004,0.0,98052,47.7056,-122.119,3130,5600,2310,0.4125,10824100,31360000,20535900
220000.0,4,1.75,1530,18400,1.5,0,0,3,6,1530,0,1938,0.0,98002,47.32899999999999,-122.219,1620,13535,16870,0.9168478260869565,2340900,338560000,336219100
650000.0,4,2.75,2020,15810,1.0,0,0,3,9,1620,400,1967,0.0,98005,47.5921,-122.155,2210,10160,13790,0.8722327640733712,4080400,249956100,245875700
410000.0,3,1.75,1340,9975,1.0,0,0,3,7,1340,0,1961,0.0,98033,47.7012,-122.169,1340,10050,8635,0.8656641604010025,1795600,99500625,97705025
339995.0,4,2.5,2180,5367,2.0,0,0,2,7,2180,0,2000,0.0,98038,47.3775,-122.022,2180,5130,3187,0.5938140488168436,4752400,28804689,24052289
1160000.0,5,1.75,2870,9680,1.0,0,4,4,9,1440,1430,1966,0.0,98008,47.6122,-122.111,2940,9729,6810,0.7035123966942148,8236900,93702400,85465500
440000.0,3,2.75,2070,9697,2.0,0,0,3,7,1330,740,1929,0.0,98188,47.4327,-122.28299999999999,2000,14436,7627,0.786531917087759,4284900,94031809,89746909
275000.0,2,1.75,930,7080,1.0,0,0,2,6,930,0,1923,2006.0,98106,47.5224,-122.36,1100,7680,6150,0.8686440677966102,864900,50126400,49261500
766000.0,3,2.5,2270,9822,2.0,0,0,2,9,2270,0,1988,0.0,98052,47.6685,-122.137,2790,8089,7552,0.768886173895337,5152900,96471684,91318784
231500.0,3,2.25,1630,7900,1.0,0,0,3,7,1130,500,1973,0.0,98023,47.3076,-122.37700000000001,1630,8200,6270,0.7936708860759494,2656900,62410000,59753100
472000.0,3,2.0,2770,89298,2.0,0,0,2,9,2770,0,2004,0.0,98045,47.4291,-121.84200000000001,2040,109771,86528,0.9689802683150799,7672900,7974132804,7966459904
1330000.0,4,2.5,4010,37076,2.0,0,0,3,12,4010,0,1990,0.0,98052,47.7139,-122.10600000000001,4280,35326,33066,0.8918437803430791,16080100,1374629776,1358549676
265000.0,4,1.75,1970,8390,1.0,0,0,2,7,1140,830,1955,0.0,98178,47.4861,-122.251,1710,10890,6420,0.7651966626936829,3880900,70392100,66511200
325000.0,2,1.0,790,6000,1.0,0,0,2,7,790,0,1948,0.0,98118,47.5543,-122.273,960,6000,5210,0.8683333333333333,624100,36000000,35375900
364500.0,3,1.75,1740,8424,1.0,0,0,4,7,1040,700,1954,0.0,98133,47.7508,-122.352,1370,8424,6684,0.7934472934472935,3027600,70963776,67936176
322500.0,2,1.0,1130,8184,1.0,0,0,2,6,1130,0,1947,0.0,98155,47.7473,-122.32,1010,8184,7054,0.8619257086999023,1276900,66977856,65700956
338900.0,3,1.75,1180,4000,1.0,0,0,2,7,1040,140,1929,0.0,98118,47.5226,-122.28399999999999,1430,4000,2820,0.705,1392400,16000000,14607600
910000.0,5,2.5,2350,4000,2.0,0,0,2,9,2350,0,1993,0.0,98112,47.6265,-122.296,1840,4000,1650,0.4125,5522500,16000000,10477500
1020000.0,5,2.5,2350,4000,2.0,0,0,2,9,2350,0,1993,0.0,98112,47.6265,-122.296,1840,4000,1650,0.4125,5522500,16000000,10477500
459950.0,3,1.75,1850,6869,1.0,0,2,4,6,1100,750,1919,1934.0,98166,47.4648,-122.363,1850,10096,5019,0.7306740428009899,3422500,47183161,43760661
584950.0,4,3.0,3220,6224,1.5,0,0,2,9,3220,0,2009,0.0,98059,47.4813,-122.12899999999999,2950,6224,3004,0.48264781491002573,10368400,38738176,28369776
252000.0,3,1.75,2050,11313,1.0,0,0,2,7,1520,530,1987,0.0,98023,47.2837,-122.35799999999999,1620,8065,9263,0.8187925395562627,4202500,127983969,123781469
270000.0,3,2.5,1430,8470,1.0,0,0,2,7,1190,240,1992,0.0,98022,47.1943,-121.991,1670,8418,7040,0.8311688311688312,2044900,71740900,69696000
750000.0,4,2.5,3210,8938,2.0,0,0,2,10,3210,0,2005,0.0,98075,47.582,-121.971,3740,8108,5728,0.6408592526292235,10304100,79887844,69583744
775000.0,3,1.75,3520,12350,1.0,0,4,3,8,1530,1990,1960,0.0,98116,47.5837,-122.382,2140,7800,8830,0.7149797570850203,12390400,152522500,140132100
325000.0,3,2.5,2260,8120,2.0,0,0,2,8,2260,0,2004,0.0,98023,47.2924,-122.35700000000001,2250,7784,5860,0.7216748768472906,5107600,65934400,60826800
810000.0,5,3.25,3290,6422,2.0,0,0,2,9,3290,0,2012,0.0,98074,47.5933,-122.061,3210,6891,3132,0.48769853628153226,10824100,41242084,30417984
409000.0,2,2.25,1640,2128,2.0,0,0,3,8,1640,0,1974,0.0,98028,47.753,-122.25200000000001,1640,2128,488,0.22932330827067668,2689600,4528384,1838784
400000.0,4,1.75,1580,5340,1.0,0,0,2,7,1130,450,1947,0.0,98144,47.6003,-122.306,830,980,3760,0.704119850187266,2496400,28515600,26019200
530000.0,4,2.25,1940,8270,2.0,0,0,4,7,1940,0,1962,0.0,98133,47.7567,-122.333,1800,7743,6330,0.7654171704957679,3763600,68392900,64629300
580000.0,3,2.25,1580,8506,2.0,0,0,2,7,1580,0,1987,0.0,98033,47.68600000000001,-122.185,2253,8515,6926,0.8142487655772396,2496400,72352036,69855636
491300.0,3,1.75,1750,11340,1.0,0,1,3,7,1300,450,1987,0.0,98074,47.6099,-122.05799999999999,2310,11340,9590,0.845679012345679,3062500,128595600,125533100
272000.0,4,2.75,1810,7350,1.0,0,0,3,7,1200,610,1980,0.0,98030,47.3703,-122.171,1750,7350,5540,0.7537414965986394,3276100,54022500,50746400
599950.0,3,2.5,1970,106722,1.0,0,4,2,9,1970,0,1985,0.0,98022,47.2498,-122.00299999999999,2910,101494,104752,0.9815408256966699,3880900,11389585284,11385704384
464000.0,3,2.5,1770,5146,2.0,0,0,2,8,1770,0,1992,0.0,98029,47.5704,-121.999,1870,5146,3376,0.6560435289545278,3132900,26481316,23348416
471001.0,3,1.75,1800,6000,1.0,0,0,4,7,900,900,1905,0.0,98103,47.6867,-122.34899999999999,1800,3000,4200,0.7,3240000,36000000,32760000
230000.0,3,1.5,1500,11616,1.0,0,0,2,7,1100,400,1980,0.0,98031,47.4062,-122.17399999999999,1830,8288,10116,0.8708677685950413,2250000,134931456,132681456
358000.0,3,1.0,940,6695,1.0,0,0,3,6,940,0,1959,0.0,98008,47.6195,-122.12,1230,7400,5755,0.859596713965646,883600,44823025,43939425
510000.0,3,2.25,2340,6183,1.0,0,0,2,7,1210,1130,1929,0.0,98115,47.6979,-122.31,1970,6183,3843,0.6215429403202329,5475600,38229489,32753889
86500.0,3,1.0,840,9480,1.0,0,0,2,6,840,0,1960,0.0,98023,47.3277,-122.34100000000001,840,9420,8640,0.9113924050632911,705600,89870400,89164800
199950.0,3,1.0,840,9480,1.0,0,0,2,6,840,0,1960,0.0,98023,47.3277,-122.34100000000001,840,9420,8640,0.9113924050632911,705600,89870400,89164800
1710000.0,3,3.25,2940,5432,3.0,0,3,3,10,2440,500,1978,0.0,98109,47.6299,-122.354,4400,5500,2492,0.4587628865979381,8643600,29506624,20863024
850000.0,3,2.75,3180,3680,2.0,0,0,3,9,2190,990,1918,0.0,98126,47.577,-122.38,2000,3680,500,0.1358695652173913,10112400,13542400,3430000
542000.0,4,2.5,2020,3440,1.5,0,0,3,7,1480,540,1928,0.0,98117,47.6885,-122.376,1520,5080,1420,0.4127906976744186,4080400,11833600,7753200
102500.0,2,1.0,820,4320,1.0,0,0,2,5,820,0,1937,0.0,98106,47.513999999999996,-122.359,780,7424,3500,0.8101851851851852,672400,18662400,17990000
718000.0,3,1.75,4060,136290,1.0,0,0,2,8,2810,1250,1995,0.0,98045,47.4843,-121.719,1300,51836,132230,0.9702105803800719,16483600,18574964100,18558480500
625000.0,4,2.25,2660,22194,1.0,0,0,3,8,2180,480,1977,0.0,98008,47.6142,-122.10700000000001,2660,18135,19534,0.8801477876903667,7075600,492573636,485498036
350000.0,3,1.0,1010,11244,1.0,0,0,3,7,1010,0,1947,0.0,98155,47.7467,-122.321,1220,11242,10234,0.9101743151903238,1020100,126427536,125407436
216000.0,2,1.0,710,5120,1.0,0,0,2,6,710,0,1918,0.0,98106,47.5224,-122.35700000000001,1150,1252,4410,0.861328125,504100,26214400,25710300
340000.0,3,1.0,980,7228,1.5,0,0,2,7,980,0,1946,0.0,98133,47.7294,-122.353,1070,7228,6248,0.8644161593801881,960400,52243984,51283584
505000.0,3,1.0,1100,5400,1.5,0,0,2,7,1100,0,1908,0.0,98199,47.6604,-122.396,1770,4400,4300,0.7962962962962963,1210000,29160000,27950000
372000.0,5,2.5,2840,6010,2.0,0,0,2,8,2840,0,2003,0.0,98001,47.3161,-122.27,2740,5509,3170,0.5274542429284526,8065600,36120100,28054500
263850.0,4,2.25,2300,7524,2.0,0,0,3,8,2300,0,1978,0.0,98023,47.313,-122.38799999999999,2270,8025,5224,0.6943115364167995,5290000,56610576,51320576
1350000.0,4,3.25,5370,20388,2.0,0,4,3,11,5370,0,1990,0.0,98198,47.405,-122.331,2770,22270,15018,0.7366097704532077,28836900,415670544,386833644
325000.0,4,2.5,2280,9899,2.0,0,0,2,8,2280,0,1987,0.0,98058,47.46100000000001,-122.148,1970,9451,7619,0.7696737044145874,5198400,97990201,92791801
289000.0,2,1.0,1010,7740,1.0,0,0,2,6,890,120,1924,0.0,98106,47.5323,-122.355,1030,6000,6730,0.8695090439276486,1020100,59907600,58887500
364000.0,3,2.25,1420,6600,1.0,0,0,2,7,1160,260,1987,0.0,98028,47.77,-122.265,1920,7902,5180,0.7848484848484848,2016400,43560000,41543600
610000.0,4,2.5,2100,8800,1.0,0,0,4,8,1250,850,1980,0.0,98033,47.6909,-122.186,2100,9000,6700,0.7613636363636364,4410000,77440000,73030000
531500.0,4,2.75,3110,49765,1.0,0,0,3,8,3110,0,1958,1972.0,98010,47.3343,-122.044,1880,19709,46655,0.9375062795137145,9672100,2476555225,2466883125
402500.0,3,2.25,2160,9540,2.0,0,0,2,8,2160,0,1979,0.0,98028,47.7668,-122.243,1720,12593,7380,0.7735849056603774,4665600,91011600,86346000
375000.0,2,1.0,820,6250,1.0,0,0,3,5,820,0,1922,0.0,98136,47.5479,-122.384,1300,6250,5430,0.8688,672400,39062500,38390100
537500.0,5,2.5,4340,9108,1.0,0,0,4,8,2170,2170,1979,0.0,98118,47.5384,-122.27600000000001,2030,6812,4768,0.5234958278436539,18835600,82955664,64120064
375000.0,3,1.75,2100,9066,1.0,0,0,2,8,1440,660,1962,0.0,98188,47.4294,-122.292,2000,9132,6966,0.7683653209794837,4410000,82192356,77782356
293550.0,4,1.75,1250,8840,1.0,0,0,3,7,910,340,1979,0.0,98198,47.4138,-122.31700000000001,1410,8378,7590,0.8585972850678733,1562500,78145600,76583100
585000.0,6,3.0,3870,43787,2.0,0,0,2,8,2700,1170,1976,0.0,98077,47.7642,-122.098,2600,35381,39917,0.9116176033982689,14976900,1917301369,1902324469
225000.0,2,2.5,1360,2693,2.0,0,0,2,6,1360,0,2003,0.0,98038,47.3492,-122.025,1360,2693,1333,0.49498700334199774,1849600,7252249,5402649
185000.0,4,1.0,1400,8684,1.5,0,0,2,7,1400,0,1957,0.0,98146,47.4887,-122.344,1520,8712,7284,0.8387839705204975,1960000,75411856,73451856
402000.0,3,1.5,1450,7375,1.0,0,0,2,7,1010,440,1968,0.0,98034,47.7212,-122.179,1350,7440,5925,0.8033898305084746,2102500,54390625,52288125
585000.0,5,1.75,1880,16617,1.0,0,0,2,7,960,920,1963,0.0,98007,47.6003,-122.132,1720,8400,14737,0.8868628512968647,3534400,276124689,272590289
549000.0,2,2.5,1380,953,3.0,0,0,2,9,1380,0,2006,0.0,98103,47.6654,-122.355,1430,3400,-427,-0.44805876180482684,1904400,908209,-996191
1810000.0,3,2.25,2910,15626,1.5,0,0,3,9,2510,400,1923,0.0,98199,47.6534,-122.412,2370,6519,12716,0.8137719185972098,8468100,244171876,235703776
345000.0,3,1.75,1380,10529,1.0,0,0,2,7,1380,0,1967,0.0,98034,47.7119,-122.23299999999999,1670,5694,9149,0.8689334219773958,1904400,110859841,108955441
302500.0,3,2.25,3100,11985,1.0,0,0,3,7,1790,1310,1963,0.0,98198,47.3825,-122.31,1770,7954,8885,0.7413433458489779,9610000,143640225,134030225
218500.0,4,1.75,1400,25500,1.0,0,0,3,7,1400,0,1964,0.0,98042,47.36,-122.164,2170,25500,24100,0.9450980392156862,1960000,650250000,648290000
705000.0,2,2.0,1650,6840,1.5,0,0,4,7,1650,0,1916,0.0,98103,47.6512,-122.338,1700,4560,5190,0.7587719298245614,2722500,46785600,44063100
191000.0,3,1.0,840,5525,1.0,0,0,4,6,840,0,1969,0.0,98042,47.3607,-122.085,920,5330,4685,0.8479638009049774,705600,30525625,29820025
695000.0,3,2.5,2550,45254,2.0,0,0,2,9,2550,0,2001,0.0,98053,47.6498,-121.964,2190,49222,42704,0.9436513899323816,6502500,2047924516,2041422016
350000.0,2,2.75,2820,11770,2.0,0,0,2,7,1630,1190,1947,0.0,98168,47.5102,-122.324,1690,12500,8950,0.7604078164825828,7952400,138532900,130580500
480000.0,3,1.75,1710,4080,1.0,0,0,3,7,1130,580,1979,0.0,98136,47.5563,-122.39200000000001,1200,4080,2370,0.5808823529411765,2924100,16646400,13722300
220000.0,3,1.0,820,5200,1.0,0,0,3,6,820,0,1977,0.0,98042,47.363,-122.094,1120,5200,4380,0.8423076923076923,672400,27040000,26367600
535000.0,4,2.25,2620,33578,2.0,0,0,2,7,2620,0,1977,0.0,98075,47.5921,-122.01299999999999,2520,35160,30958,0.9219727202334862,6864400,1127482084,1120617684
1000000.0,2,1.75,2430,23400,1.0,0,4,2,10,2430,0,1951,0.0,98177,47.7616,-122.37200000000001,3150,23600,20970,0.8961538461538462,5904900,547560000,541655100
592000.0,3,1.75,1560,7424,1.0,0,0,4,8,1560,0,1940,0.0,98117,47.6981,-122.374,1370,7424,5864,0.7898706896551724,2433600,55115776,52682176
775000.0,4,2.5,3060,6826,2.0,0,0,2,9,3060,0,2004,0.0,98052,47.7006,-122.11200000000001,3110,6932,3766,0.5517140345736888,9363600,46594276,37230676
320000.0,3,2.5,1680,4584,2.0,0,0,2,7,1680,0,2003,0.0,98056,47.4794,-122.182,2160,4621,2904,0.6335078534031413,2822400,21013056,18190656
760000.0,3,3.25,3320,15022,2.0,0,0,2,10,3320,0,1989,0.0,98166,47.428999999999995,-122.34100000000001,3430,15018,11702,0.7789908134735721,11022400,225660484,214638084
640000.0,3,2.5,2390,8315,2.0,0,0,3,9,2390,0,1990,0.0,98074,47.6271,-122.02799999999999,2370,7816,5925,0.7125676488274203,5712100,69139225,63427125
253200.0,3,1.0,1360,5840,1.0,0,0,3,5,1360,0,1953,0.0,98056,47.4945,-122.166,1250,6708,4480,0.7671232876712328,1849600,34105600,32256000
228000.0,2,1.0,1800,9236,1.0,0,0,2,7,1800,0,1954,0.0,98030,47.3792,-122.198,1730,5701,7436,0.8051104374187961,3240000,85303696,82063696
325000.0,3,1.0,1160,9525,1.0,0,0,3,7,1160,0,1968,0.0,98077,47.7431,-122.073,1160,10640,8365,0.8782152230971129,1345600,90725625,89380025
530000.0,4,3.25,4160,35654,2.0,0,0,2,8,2760,1400,1973,0.0,98027,47.4683,-122.008,2500,35675,31494,0.8833230493072306,17305600,1271207716,1253902116
300000.0,4,2.25,1660,3200,2.0,0,0,2,7,1660,0,2011,0.0,98038,47.3666,-122.01899999999999,1960,3558,1540,0.48125,2755600,10240000,7484400
418000.0,3,2.0,1410,6030,1.5,0,0,3,7,1410,0,1930,0.0,98103,47.6994,-122.34700000000001,1410,6300,4620,0.7661691542288557,1988100,36360900,34372800
415000.0,4,1.75,2230,9625,1.0,0,4,2,8,1180,1050,1955,0.0,98178,47.508,-122.244,2300,8211,7395,0.7683116883116883,4972900,92640625,87667725
384000.0,3,2.5,1700,4000,2.0,0,0,2,7,1700,0,2003,0.0,98065,47.5327,-121.87100000000001,1700,4417,2300,0.575,2890000,16000000,13110000
325000.0,3,2.5,2070,8337,2.0,0,0,2,8,2070,0,1997,0.0,98030,47.3658,-122.176,2030,7248,6267,0.7517092479309104,4284900,69505569,65220669
600000.0,3,1.75,2300,12682,1.0,0,2,2,8,2300,0,1955,0.0,98028,47.7588,-122.27,2720,14643,10382,0.8186405929664091,5290000,160833124,155543124
760000.0,4,2.25,3040,9690,1.0,0,0,3,9,1940,1100,1978,0.0,98005,47.5923,-122.169,2430,9690,6650,0.6862745098039216,9241600,93896100,84654500
168000.0,2,1.5,1220,3568,1.5,0,0,3,8,1220,0,1976,0.0,98198,47.3804,-122.318,1180,3678,2348,0.6580717488789237,1488400,12730624,11242224
405000.0,3,1.0,960,3960,1.0,0,0,2,7,960,0,1943,0.0,98199,47.6465,-122.404,1550,6050,3000,0.7575757575757576,921600,15681600,14760000
479000.0,3,1.0,1480,10094,1.0,0,0,3,7,1480,0,1956,0.0,98007,47.5942,-122.13600000000001,1430,10083,8614,0.8533782445016842,2190400,101888836,99698436
549000.0,3,2.0,1560,5130,1.0,0,0,4,7,1150,410,1915,0.0,98103,47.6913,-122.333,1560,4500,3570,0.695906432748538,2433600,26316900,23883300
215000.0,3,1.5,1100,33600,1.0,0,0,2,7,1100,0,1967,0.0,98001,47.3185,-122.29,1570,32700,32500,0.9672619047619048,1210000,1128960000,1127750000
550000.0,2,1.5,900,5750,1.0,0,2,2,7,900,0,1940,0.0,98116,47.5623,-122.384,1300,1413,4850,0.8434782608695652,810000,33062500,32252500
389000.0,4,1.75,2400,7700,1.5,0,0,3,7,1500,900,1927,0.0,98133,47.7125,-122.33200000000001,1530,7700,5300,0.6883116883116883,5760000,59290000,53530000
447500.0,3,2.5,2320,15024,2.0,0,0,2,8,2320,0,1990,0.0,98045,47.4829,-121.766,2300,15145,12704,0.845580404685836,5382400,225720576,220338176
540000.0,5,3.0,2570,5590,1.0,0,0,2,8,1580,0,2009,0.0,98034,47.7271,-122.228,2020,10500,3020,0.5402504472271914,6604900,31248100,24643200
273500.0,4,2.75,1300,9638,1.0,0,0,1,7,1300,0,1983,0.0,98042,47.3683,-122.109,1670,9638,8338,0.8651172442415439,1690000,92891044,91201044
257000.0,5,2.75,2930,10148,2.0,0,0,2,9,2930,0,2002,0.0,98059,47.4887,-122.145,2930,8425,7218,0.711273157272369,8584900,102981904,94397004
199000.0,2,1.0,720,7200,1.0,0,0,4,6,720,0,1943,0.0,98058,47.4763,-122.177,970,8027,6480,0.9,518400,51840000,51321600
339100.0,4,2.5,2350,10655,2.0,0,0,2,8,2350,0,1992,0.0,98092,47.3284,-122.171,2210,7028,8305,0.7794462693571094,5522500,113529025,108006525
435000.0,4,2.5,2940,7590,2.0,0,0,2,9,2940,0,1991,0.0,98058,47.4341,-122.16,2550,8360,4650,0.6126482213438735,8643600,57608100,48964500
400000.0,3,2.5,2020,3000,1.0,0,0,3,6,1010,1010,1910,0.0,98118,47.5621,-122.291,1670,3000,980,0.32666666666666666,4080400,9000000,4919600
356000.0,2,1.0,1430,365904,1.0,0,0,2,7,1010,420,1991,0.0,98065,47.51300000000001,-121.85700000000001,2300,253519,364474,0.9960918710918711,2044900,133885737216,133883692316
395000.0,3,1.0,950,6951,1.0,0,0,3,7,950,0,1950,0.0,98125,47.7263,-122.3,1410,7200,6001,0.8633290174075673,902500,48316401,47413901
575000.0,2,1.0,1250,4320,1.0,0,0,3,7,850,400,1911,0.0,98103,47.6549,-122.352,1520,4320,3070,0.7106481481481481,1562500,18662400,17099900
515000.0,3,1.75,1300,5120,1.5,0,0,3,6,1300,0,1925,0.0,98116,47.5589,-122.39399999999999,1090,5124,3820,0.74609375,1690000,26214400,24524400
618250.0,4,3.25,2520,3360,1.5,0,0,3,8,1550,970,1931,0.0,98115,47.6801,-122.315,1730,3360,840,0.25,6350400,11289600,4939200
245000.0,3,1.5,1330,7125,2.0,0,0,2,7,1330,0,1968,0.0,98034,47.7308,-122.194,1570,7350,5795,0.8133333333333334,1768900,50765625,48996725
690000.0,3,2.75,2480,3240,1.5,0,0,2,9,1890,590,1929,0.0,98112,47.6399,-122.311,2160,3240,760,0.2345679012345679,6150400,10497600,4347200
465000.0,5,2.25,3020,10010,1.0,0,0,2,7,1510,1510,1959,0.0,98027,47.5249,-122.044,1760,10878,6990,0.6983016983016983,9120400,100200100,91079700
280000.0,3,1.75,1770,8240,1.0,0,0,3,7,1240,530,1978,0.0,98023,47.3066,-122.37799999999999,2060,8250,6470,0.7851941747572816,3132900,67897600,64764700
285000.0,3,1.75,1930,6533,1.0,0,0,2,7,1230,0,1960,0.0,98055,47.4883,-122.221,2030,5954,4603,0.7045767641206184,3724900,42680089,38955189
320000.0,3,2.25,1650,7047,2.0,0,0,2,7,1650,0,1994,0.0,98038,47.3826,-122.027,2010,7763,5397,0.7658578118348234,2722500,49660209,46937709
355000.0,4,3.0,2580,9601,2.0,0,0,3,7,2130,450,1992,0.0,98070,47.3726,-122.43299999999999,1900,10092,7021,0.7312779918758463,6656400,92179201,85522801
670000.0,3,2.0,2570,10078,1.5,0,0,2,8,2570,0,1965,0.0,98008,47.6275,-122.12,2660,8013,7508,0.7449890851359396,6604900,101566084,94961184
550000.0,1,1.0,2880,7560,1.0,0,0,2,7,1440,1440,1925,2014.0,98126,47.537,-122.375,1400,5040,4680,0.6190476190476191,8294400,57153600,48859200
765000.0,4,2.75,2660,4500,1.5,0,0,4,8,1860,800,1909,0.0,98103,47.6864,-122.34700000000001,1830,4000,1840,0.4088888888888889,7075600,20250000,13174400
430000.0,3,1.0,1560,5225,1.5,0,0,2,7,1260,300,1927,0.0,98118,47.5554,-122.279,1560,5322,3665,0.7014354066985646,2433600,27300625,24867025
950000.0,3,2.5,3080,8448,2.0,0,2,2,9,3080,0,2000,0.0,98199,47.6469,-122.389,2500,6400,5368,0.6354166666666666,9486400,71368704,61882304
525000.0,4,1.75,2540,7200,1.0,0,0,3,7,1270,1270,1947,0.0,98118,47.5579,-122.271,1650,7200,4660,0.6472222222222223,6451600,51840000,45388400
300000.0,6,2.5,3080,8163,1.0,0,0,2,7,1580,1500,1985,0.0,98030,47.3859,-122.221,1850,8658,5083,0.6226877373514639,9486400,66634569,57148169
345000.0,3,2.75,2190,7258,2.0,0,0,2,8,2190,0,2000,0.0,98003,47.3486,-122.301,2190,8645,5068,0.6982639845687517,4796100,52678564,47882464
838000.0,3,3.75,2930,150945,2.0,0,0,2,8,2930,0,1972,2000.0,98058,47.4658,-122.115,2070,43935,148015,0.9805889562423399,8584900,22784393025,22775808125
1800000.0,5,2.75,2880,20274,1.0,0,3,3,9,1660,1220,1959,0.0,98004,47.6267,-122.22200000000001,3750,20220,17394,0.8579461379106245,8294400,411035076,402740676
390000.0,3,1.75,2160,98445,2.0,0,0,2,8,2160,0,1978,0.0,98042,47.35,-122.162,2004,44431,96285,0.9780588145665092,4665600,9691418025,9686752425
1150000.0,3,2.0,2110,18815,2.0,0,0,4,7,2110,0,1979,0.0,98075,47.5836,-122.042,2690,21010,16705,0.887855434493755,4452100,354004225,349552125
295000.0,4,2.25,1830,5720,2.0,0,0,2,7,1830,0,2003,0.0,98030,47.3604,-122.179,1960,5754,3890,0.6800699300699301,3348900,32718400,29369500
775000.0,4,4.0,3180,7650,2.0,0,0,2,8,2530,650,1920,0.0,98115,47.6887,-122.319,2000,4080,4470,0.5843137254901961,10112400,58522500,48410100
380000.0,3,2.5,1880,6047,2.0,0,0,2,8,1880,0,1993,0.0,98038,47.3722,-122.044,2120,7188,4167,0.6891020340664793,3534400,36566209,33031809
550000.0,3,1.0,1140,8180,1.0,0,0,2,7,1140,0,1959,0.0,98005,47.5851,-122.17200000000001,1510,8588,7040,0.8606356968215159,1299600,66912400,65612800
199900.0,5,1.75,1798,11232,1.0,0,0,2,7,1798,0,1967,0.0,98001,47.3266,-122.291,1300,15582,9434,0.8399216524216524,3232804,126157824,122925020
329900.0,3,1.75,1670,5209,1.5,0,0,4,7,1670,0,1908,0.0,98118,47.5362,-122.271,1990,4960,3539,0.6794010366673066,2788900,27133681,24344781
898000.0,3,2.25,2580,11060,1.0,0,0,2,8,2580,0,1964,0.0,98005,47.6113,-122.164,2580,13868,8480,0.7667269439421338,6656400,122323600,115667200
875000.0,4,2.25,3720,12384,1.0,0,2,4,8,1860,1860,1970,0.0,98075,47.5836,-122.074,3180,15541,8664,0.6996124031007752,13838400,153363456,139525056
375000.0,4,2.5,2790,7956,2.0,0,0,2,9,2790,0,2005,0.0,98198,47.3681,-122.31,1660,8192,5166,0.6493212669683258,7784100,63297936,55513836
365000.0,3,2.5,2190,5091,2.0,0,0,2,8,2190,0,2004,0.0,98038,47.3506,-122.039,2200,5948,2901,0.5698291101944608,4796100,25918281,21122181
530000.0,4,2.75,2280,2850,1.5,0,0,3,7,1540,740,1930,0.0,98115,47.6871,-122.307,1680,3800,570,0.2,5198400,8122500,2924100
225500.0,3,1.0,1100,5200,1.0,0,0,3,6,1100,0,1969,0.0,98042,47.3643,-122.081,920,5200,4100,0.7884615384615384,1210000,27040000,25830000
318000.0,4,2.25,2180,7000,1.0,0,0,2,8,1680,500,1969,0.0,98055,47.4651,-122.19200000000001,2000,8000,4820,0.6885714285714286,4752400,49000000,44247600
910000.0,4,2.5,2770,9798,2.0,0,0,3,9,2770,0,1986,0.0,98027,47.562,-122.081,3040,11100,7028,0.7172892427025923,7672900,96000804,88327904
207000.0,3,1.0,1980,18730,1.0,0,0,3,7,1280,700,1943,0.0,98001,47.3221,-122.28200000000001,1356,9450,16750,0.8942872397223706,3920400,350812900,346892500
1890000.0,5,3.5,4180,17935,2.0,0,0,2,11,4180,0,2004,0.0,98004,47.5873,-122.20200000000001,2950,13760,13755,0.7669361583495957,17472400,321664225,304191825
624500.0,6,3.0,3030,31920,1.0,0,0,3,8,1670,1360,1980,0.0,98075,47.575,-122.03299999999999,2890,35100,28890,0.9050751879699248,9180900,1018886400,1009705500
640000.0,3,2.5,1690,1553,2.5,0,0,2,8,1690,0,2007,0.0,98199,47.6443,-122.385,1910,1553,-137,-0.08821635544108178,2856100,2411809,-444291
500000.0,3,2.0,1990,65340,2.0,0,0,2,8,1990,0,1986,0.0,98027,47.4726,-121.99,2120,59241,63350,0.9695439240893786,3960100,4269315600,4265355500
390000.0,5,1.75,2250,8970,1.0,0,0,3,7,1500,750,1966,0.0,98034,47.7217,-122.18799999999999,1940,8710,6720,0.7491638795986622,5062500,80460900,75398400
284000.0,3,2.25,2080,2050,1.5,0,0,2,7,1550,530,2003,0.0,98042,47.4199,-122.15700000000001,2080,2275,-30,-0.014634146341463415,4326400,4202500,-123900
620000.0,3,2.0,2460,41343,1.0,0,0,3,8,2460,0,1988,0.0,98027,47.5142,-122.021,2500,53885,38883,0.940497786807924,6051600,1709243649,1703192049
306000.0,3,2.5,2588,5702,2.0,0,0,2,8,2588,0,2008,0.0,98042,47.3453,-122.15100000000001,2403,5703,3114,0.5461241669589618,6697744,32512804,25815060
495000.0,4,1.75,2570,12039,1.0,0,0,2,8,1910,660,1978,0.0,98074,47.62600000000001,-122.04799999999999,2200,12384,9469,0.786527120192707,6604900,144937521,138332621
499950.0,3,2.5,2370,12753,2.0,0,0,2,7,2370,0,2001,0.0,98019,47.7359,-121.984,2280,16808,10383,0.8141613737944013,5616900,162639009,157022109
330000.0,3,1.0,1070,10563,1.0,0,0,2,7,1070,0,1969,0.0,98072,47.7687,-122.166,1840,9638,9493,0.8987030199753858,1144900,111576969,110432069
665000.0,3,2.0,1940,5820,1.5,0,0,4,7,1150,790,1944,0.0,98107,47.6638,-122.36200000000001,990,3880,3880,0.6666666666666666,3763600,33872400,30108800
850000.0,3,2.5,2650,2387,2.0,0,0,2,8,1830,820,1920,0.0,98119,47.6315,-122.36200000000001,1870,2216,-263,-0.11018014243820695,7022500,5697769,-1324731
599950.0,4,2.5,2290,6318,2.0,0,0,3,8,2290,0,1988,0.0,98029,47.57,-122.02,2150,7350,4028,0.6375435264324153,5244100,39917124,34673024
360000.0,4,2.5,2050,9143,2.0,0,0,2,8,2050,0,1992,0.0,98166,47.4597,-122.355,1510,9484,7093,0.7757847533632287,4202500,83594449,79391949
699000.0,3,2.5,2680,5497,2.0,0,0,2,9,2680,0,2001,0.0,98052,47.7043,-122.12799999999999,2780,5497,2817,0.512461342550482,7182400,30217009,23034609
475000.0,3,1.75,1520,8100,1.0,0,0,4,6,760,760,1945,0.0,98117,47.6966,-122.375,1040,8100,6580,0.8123456790123457,2310400,65610000,63299600
575000.0,3,2.0,2690,435600,2.0,0,0,2,8,2690,0,1992,0.0,98070,47.3477,-122.51899999999999,1700,163350,432910,0.9938246097337007,7236100,189747360000,189740123900
345000.0,2,1.5,1180,844,2.0,0,0,2,7,990,190,2005,0.0,98144,47.5998,-122.3,1170,1400,-336,-0.3981042654028436,1392400,712336,-680064
367950.0,4,2.5,3030,9500,2.0,0,0,2,8,3030,0,1989,0.0,98001,47.3511,-122.287,2650,9500,6470,0.6810526315789474,9180900,90250000,81069100
374500.0,3,2.25,1400,11400,2.0,0,0,2,8,1400,0,1984,0.0,98028,47.7428,-122.23100000000001,2180,9248,10000,0.8771929824561403,1960000,129960000,128000000
607500.0,4,2.5,3000,8100,2.0,0,0,2,8,3000,0,1992,0.0,98125,47.7151,-122.305,1550,8100,5100,0.6296296296296297,9000000,65610000,56610000
374000.0,3,1.0,1200,9800,1.0,0,0,3,7,1200,0,1971,0.0,98072,47.7412,-122.109,1220,10220,8600,0.8775510204081632,1440000,96040000,94600000
390000.0,3,1.0,1000,6947,1.0,0,0,2,7,1000,0,1947,0.0,98125,47.7142,-122.319,1000,6947,5947,0.8560529725061178,1000000,48260809,47260809
705000.0,4,3.25,2740,5339,2.5,0,0,2,9,2740,0,2004,0.0,98103,47.6706,-122.35600000000001,1770,4820,2599,0.48679528001498407,7507600,28504921,20997321
467000.0,3,2.5,1990,4978,2.0,0,0,2,8,1990,0,2004,0.0,98065,47.5323,-121.85600000000001,2650,6816,2988,0.6002410606669345,3960100,24780484,20820384
243500.0,3,3.0,2110,7794,1.0,0,0,2,6,2110,0,1981,0.0,98198,47.4005,-122.29299999999999,1330,10044,5684,0.7292789325121889,4452100,60746436,56294336
593000.0,3,2.75,1830,1850,2.0,0,0,2,10,1690,140,2011,0.0,98027,47.5307,-122.074,2310,2680,20,0.010810810810810811,3348900,3422500,73600
223000.0,3,1.0,940,7980,1.0,0,0,2,6,940,0,1961,0.0,98146,47.5107,-122.345,1050,7980,7040,0.8822055137844611,883600,63680400,62796800
574000.0,4,2.5,2980,10179,2.0,0,2,2,9,2980,0,2003,0.0,98038,47.3895,-122.03299999999999,2980,8828,7199,0.7072403968955693,8880400,103612041,94731641
400000.0,3,2.0,2260,11305,1.0,0,0,2,7,1130,1130,1986,0.0,98055,47.4544,-122.204,2080,10248,9045,0.8000884564352057,5107600,127803025,122695425
772000.0,4,2.75,3470,70131,1.0,0,0,3,8,1750,1720,1962,0.0,98005,47.6339,-122.18,2950,43560,66661,0.9505211675293379,12040900,4918357161,4906316261
593777.0,3,1.75,1510,10450,1.0,0,0,3,7,1510,0,1964,0.0,98052,47.684,-122.113,1310,9450,8940,0.8555023923444977,2280100,109202500,106922400
539500.0,4,3.5,2710,5722,2.0,0,0,3,8,2040,670,1997,0.0,98108,47.5591,-122.302,2500,5722,3012,0.5263893743446347,7344100,32741284,25397184
550000.0,3,2.5,2080,2625,2.0,0,0,2,8,2080,0,2006,0.0,98029,47.5469,-121.99700000000001,1760,2772,545,0.20761904761904762,4326400,6890625,2564225
265000.0,2,2.0,1860,10856,1.0,0,0,2,8,1260,600,1952,0.0,98178,47.4989,-122.265,1250,10008,8996,0.8286661753868828,3459600,117852736,114393136
428000.0,3,1.75,2120,9350,1.0,0,0,2,7,1280,840,1979,0.0,98072,47.7562,-122.145,2200,9000,7230,0.7732620320855615,4494400,87422500,82928100
505000.0,3,2.0,1110,8375,1.0,0,0,4,7,1110,0,1951,0.0,98115,47.6978,-122.29700000000001,1410,7734,7265,0.8674626865671642,1232100,70140625,68908525
925000.0,5,5.5,5190,12637,2.0,0,2,2,11,5190,0,2001,0.0,98065,47.5424,-121.87200000000001,3840,12637,7447,0.5893012582100182,26936100,159693769,132757669
230000.0,3,1.75,1520,15344,1.0,0,0,2,8,1520,0,1968,0.0,98023,47.3308,-122.365,2270,14981,13824,0.9009384775808134,2310400,235438336,233127936
695000.0,4,2.5,2650,9990,2.0,0,0,2,10,2650,0,1990,0.0,98029,47.5605,-122.016,2710,8012,7340,0.7347347347347347,7022500,99800100,92777600
700000.0,4,2.75,3350,7857,2.0,0,2,2,9,3350,0,2004,0.0,98065,47.5398,-121.859,3870,7886,4507,0.5736286114292987,11222500,61732449,50509949
712500.0,3,1.75,1770,2800,1.5,0,0,2,7,1770,0,1914,0.0,98103,47.6631,-122.35700000000001,1630,3254,1030,0.3678571428571429,3132900,7840000,4707100
480000.0,3,2.5,2200,4692,2.0,0,0,2,8,2200,0,2005,0.0,98011,47.7761,-122.169,2440,3833,2492,0.5311167945439045,4840000,22014864,17174864
470000.0,3,2.5,2000,8424,1.0,0,0,3,7,1300,700,1968,0.0,98034,47.7089,-122.20100000000001,2110,8400,6424,0.7625830959164293,4000000,70963776,66963776
335000.0,3,1.75,1730,15003,1.0,0,0,2,7,1150,580,1980,0.0,98014,47.6923,-121.92,1900,15483,13273,0.8846897287209224,2992900,225090009,222097109
270000.0,3,1.5,1300,7907,1.0,0,0,2,7,900,400,1970,0.0,98030,47.3737,-122.22399999999999,1630,7600,6607,0.8355887188567093,1690000,62520649,60830649
810000.0,5,3.25,2950,67475,1.0,0,0,2,8,2530,420,1981,2004.0,98072,47.7233,-122.117,2620,39820,64525,0.9562801037421267,8702500,4552875625,4544173125
589000.0,3,3.0,1720,954,3.0,0,0,2,8,1460,260,2006,0.0,98119,47.648,-122.35799999999999,1720,1294,-766,-0.8029350104821803,2958400,910116,-2048284
415000.0,2,1.0,880,4558,1.0,0,0,2,7,880,0,1951,0.0,98115,47.6803,-122.287,1370,5243,3678,0.8069328652917946,774400,20775364,20000964
197000.0,4,2.25,1790,13200,1.0,0,0,2,7,1220,570,1979,0.0,98058,47.4672,-122.185,1740,8950,11410,0.8643939393939394,3204100,174240000,171035900
235500.0,3,1.5,1380,7600,1.0,0,0,3,7,790,590,1971,0.0,98003,47.3489,-122.306,1570,7904,6220,0.8184210526315789,1904400,57760000,55855600
460000.0,3,2.25,1530,1840,2.0,0,0,2,8,1240,290,2008,0.0,98144,47.586999999999996,-122.301,1800,3431,310,0.16847826086956522,2340900,3385600,1044700
572500.0,5,1.75,2330,4947,1.0,0,0,3,8,1380,950,1955,0.0,98136,47.5352,-122.39200000000001,2120,5605,2617,0.529007479280372,5428900,24472809,19043909
302000.0,5,2.0,1540,9629,1.0,0,0,3,7,1540,0,1960,0.0,98059,47.4915,-122.14299999999999,2260,9600,8089,0.8400664658843078,2371600,92717641,90346041
870000.0,3,2.5,3210,8630,2.0,0,0,3,10,2530,680,1990,0.0,98033,47.6939,-122.189,2630,8630,5420,0.6280417149478563,10304100,74476900,64172800
485000.0,3,1.0,1130,5758,1.0,0,0,2,7,960,0,1939,0.0,98199,47.6413,-122.40100000000001,1510,6000,4628,0.8037513025356027,1276900,33154564,31877664
240000.0,3,2.0,1460,7526,1.0,0,0,2,7,1460,0,1968,0.0,98003,47.3463,-122.304,1580,7526,6066,0.8060058463991496,2131600,56640676,54509076
383000.0,3,1.75,1410,7215,1.0,0,0,2,7,1410,0,1967,0.0,98034,47.7343,-122.193,1550,7600,5805,0.8045738045738046,1988100,52056225,50068125
750000.0,4,2.75,1750,5080,1.5,0,0,2,8,1750,0,1903,0.0,98122,47.6143,-122.305,1700,4572,3330,0.655511811023622,3062500,25806400,22743900
409950.0,2,1.75,1370,5125,1.0,0,0,4,6,1370,0,1944,0.0,98103,47.6926,-122.346,1200,5100,3755,0.7326829268292683,1876900,26265625,24388725
246000.0,3,1.5,1780,23819,1.0,0,0,2,7,1780,0,1953,0.0,98168,47.4912,-122.31200000000001,1130,14450,22039,0.9252697426424283,3168400,567344761,564176361
860000.0,4,1.75,1890,4500,2.0,0,0,4,7,1490,400,1937,0.0,98115,47.6751,-122.289,1890,5000,2610,0.58,3572100,20250000,16677900
339950.0,3,2.25,1630,12295,2.0,0,0,3,7,1630,0,1985,0.0,98058,47.4279,-122.161,1730,9948,10665,0.8674257828385522,2656900,151167025,148510125
315000.0,5,1.75,2320,8100,1.0,0,0,3,7,1160,1160,1956,0.0,98166,47.4631,-122.34100000000001,1410,7271,5780,0.7135802469135802,5382400,65610000,60227600
698000.0,3,2.5,2580,4636,2.0,0,0,2,9,2580,0,2006,0.0,98074,47.6201,-122.025,2480,4500,2056,0.44348576358930114,6656400,21492496,14836096
419000.0,2,2.5,1470,2034,2.0,0,0,3,8,1470,0,1985,0.0,98007,47.6213,-122.15299999999999,1510,2055,564,0.27728613569321536,2160900,4137156,1976256
372000.0,3,1.0,2298,10140,1.0,0,0,2,7,2298,0,1969,0.0,98052,47.6909,-122.083,2580,24724,7842,0.7733727810650888,5280804,102819600,97538796
425000.0,3,2.5,1960,4709,2.0,0,0,2,7,1960,0,2003,0.0,98065,47.5322,-121.87100000000001,1700,4444,2749,0.5837757485665747,3841600,22174681,18333081
386500.0,3,2.25,2950,8036,1.5,0,0,2,8,1950,1000,1963,0.0,98125,47.7239,-122.31299999999999,2060,7200,5086,0.6329019412643107,8702500,64577296,55874796
348000.0,2,1.0,670,7312,1.0,0,0,2,5,670,0,1942,0.0,98125,47.7145,-122.285,860,8242,6642,0.9083698030634574,448900,53465344,53016444
754000.0,5,3.5,3020,15305,2.0,0,0,2,10,2230,790,1978,0.0,98040,47.5627,-122.21600000000001,3680,14486,12285,0.8026788631166285,9120400,234243025,225122625
269950.0,4,3.0,2390,7309,2.0,0,0,3,7,2390,0,1944,1981.0,98002,47.294,-122.21799999999999,930,7308,4919,0.6730058831577507,5712100,53421481,47709381
891500.0,3,2.5,3090,20785,2.0,0,0,3,10,3090,0,1991,0.0,98075,47.5602,-122.03,3400,7566,17695,0.8513350974260284,9548100,432016225,422468125
349950.0,4,1.75,1780,5000,1.0,0,0,4,7,890,890,1903,0.0,98108,47.5329,-122.292,1860,5000,3220,0.644,3168400,25000000,21831600
360000.0,2,1.0,1420,81892,1.0,0,0,2,7,1180,240,1956,0.0,98055,47.4342,-122.195,1490,1863,80472,0.9826600888975724,2016400,6706299664,6704283264
975000.0,4,2.25,2420,15482,2.0,0,0,3,8,2420,0,1925,1997.0,98004,47.5907,-122.196,2870,13905,13062,0.8436894458080352,5856400,239692324,233835924
449250.0,4,2.0,1480,3844,1.5,0,0,4,7,1480,0,1928,0.0,98133,47.7042,-122.352,1480,3844,2364,0.6149843912591051,2190400,14776336,12585936
350000.0,4,2.25,2190,3850,2.0,0,0,2,7,2190,0,2006,0.0,98059,47.4854,-122.16,1900,3850,1660,0.43116883116883115,4796100,14822500,10026400
790000.0,4,1.75,1820,6137,1.5,0,3,3,7,1690,0,1911,0.0,98107,47.6681,-122.36,2130,5100,4317,0.7034381619683885,3312400,37662769,34350369
990000.0,3,1.75,1810,24586,1.0,0,4,3,9,930,880,1983,0.0,98040,47.5314,-122.22200000000001,3540,14200,22776,0.9263808671601724,3276100,604471396,601195296
834000.0,3,2.25,2550,4089,2.0,0,0,2,9,2550,0,1983,0.0,98112,47.6272,-122.29700000000001,1680,4089,1539,0.3763756419662509,6502500,16719921,10217421
466950.0,3,1.0,1360,3880,1.0,0,0,2,7,1060,300,1963,0.0,98117,47.6837,-122.391,1110,3880,2520,0.6494845360824743,1849600,15054400,13204800
262500.0,3,1.75,2259,26831,1.5,0,3,4,7,1491,768,1908,0.0,98001,47.2741,-122.266,1980,15794,24572,0.9158063434087437,5103081,719902561,714799480
762300.0,4,2.5,3880,14550,2.0,0,0,2,10,3880,0,1987,0.0,98074,47.6378,-122.04,3240,14045,10670,0.7333333333333333,15054400,211702500,196648100
733000.0,6,2.75,2730,5000,1.0,0,0,2,8,1780,950,1962,0.0,98107,47.6751,-122.38,2090,5000,2270,0.454,7452900,25000000,17547100
439000.0,4,2.5,2800,17279,1.0,0,2,2,7,1560,1240,1957,0.0,98028,47.7596,-122.26899999999999,3060,13423,14479,0.8379535852769258,7840000,298563841,290723841
1160000.0,5,3.25,4290,7019,2.5,0,0,3,10,3590,700,1927,0.0,98112,47.6439,-122.302,1920,4000,2729,0.38880182362159854,18404100,49266361,30862261
420000.0,3,2.5,1770,3993,2.0,0,0,2,8,1770,0,1999,0.0,98074,47.6027,-122.02,1820,4046,2223,0.5567242674680691,3132900,15944049,12811149
549000.0,3,2.25,1920,10961,2.0,0,0,2,8,1920,0,1981,0.0,98074,47.6432,-122.057,2000,10706,9041,0.8248335005930116,3686400,120143521,116457121
518000.0,4,2.5,2320,4000,1.5,0,0,4,8,1510,810,1905,0.0,98122,47.6048,-122.29799999999999,1490,4500,1680,0.42,5382400,16000000,10617600
695000.0,4,2.5,2961,12146,2.0,0,0,2,9,2961,0,1998,0.0,98075,47.5839,-122.052,2620,17749,9185,0.7562160382018772,8767521,147525316,138757795
485000.0,3,2.5,1680,7385,2.0,0,0,2,8,1680,0,1988,0.0,98074,47.6194,-122.041,1970,7470,5705,0.7725118483412322,2822400,54538225,51715825
280000.0,3,1.75,1590,27200,1.5,0,0,3,6,1590,0,1926,0.0,98038,47.4238,-122.052,1820,74052,25610,0.9415441176470588,2528100,739840000,737311900
306500.0,2,1.0,1420,16400,1.5,0,0,3,6,1420,0,1943,0.0,98023,47.3221,-122.344,1900,16400,14980,0.9134146341463415,2016400,268960000,266943600
720000.0,2,1.0,1370,9460,1.0,0,0,2,6,1370,0,1950,0.0,98004,47.6238,-122.191,1690,9930,8090,0.8551797040169133,1876900,89491600,87614700
277500.0,3,2.5,2620,4558,2.0,0,3,2,7,2620,0,2010,0.0,98022,47.1944,-121.97399999999999,1670,4558,1938,0.4251864853005704,6864400,20775364,13910964
649000.0,3,2.0,1810,17006,2.0,0,4,2,8,1810,0,1913,1987.0,98166,47.4663,-122.369,2180,24911,15196,0.8935669763612842,3276100,289204036,285927936
3400000.0,4,3.5,4730,47870,1.0,1,4,2,10,2940,1790,1954,0.0,98033,47.6967,-122.21600000000001,3250,49346,43140,0.901190724879883,22372900,2291536900,2269164000
267800.0,2,1.0,700,6000,1.0,0,0,3,6,700,0,1949,0.0,98155,47.7515,-122.316,920,6000,5300,0.8833333333333333,490000,36000000,35510000
625000.0,4,2.75,2390,6979,2.0,0,0,2,8,2390,0,1993,0.0,98029,47.5703,-121.99600000000001,2090,6321,4589,0.6575440607536897,5712100,48706441,42994341
600000.0,4,2.5,2070,8127,1.5,0,0,2,9,1590,480,1924,2003.0,98125,47.7316,-122.289,2050,8131,6057,0.7452934662236987,4284900,66048129,61763229
395000.0,4,2.0,1780,8149,1.5,0,0,3,7,1780,0,1948,0.0,98155,47.745,-122.302,1180,8149,6369,0.7815682905878022,3168400,66406201,63237801
212000.0,4,2.5,1900,21780,1.5,0,0,2,7,1900,0,1940,1987.0,98198,47.3776,-122.314,1240,9166,19880,0.9127640036730946,3610000,474368400,470758400
425000.0,2,1.0,1040,4040,1.0,0,0,2,7,940,100,1928,0.0,98117,47.6829,-122.39299999999999,1420,4040,3000,0.7425742574257426,1081600,16321600,15240000
870000.0,4,1.75,2370,5000,1.5,0,2,2,8,1770,600,1919,0.0,98103,47.6779,-122.35700000000001,2100,4550,2630,0.526,5616900,25000000,19383100
420000.0,3,2.5,1970,3667,2.0,0,0,2,7,1970,0,2004,0.0,98065,47.5321,-121.851,1970,3739,1697,0.4627761112626125,3880900,13446889,9565989
800000.0,4,2.25,2120,9921,2.0,0,0,2,8,2120,0,1981,0.0,98027,47.5593,-122.08200000000001,1890,7845,7801,0.786311863723415,4494400,98426241,93931841
575000.0,3,2.5,1960,9535,2.0,0,0,2,8,1960,0,1989,0.0,98011,47.7371,-122.215,2520,9206,7575,0.794441531200839,3841600,90916225,87074625
915000.0,3,3.25,2660,4000,2.0,0,0,2,9,2170,490,2003,0.0,98122,47.6186,-122.288,2660,4000,1340,0.335,7075600,16000000,8924400
400000.0,3,2.25,1180,14258,2.0,0,0,2,7,1180,0,1987,0.0,98034,47.7112,-122.238,1860,10390,13078,0.9172394445223734,1392400,203290564,201898164
750000.0,3,2.5,2390,6550,1.0,0,2,3,8,1440,950,1955,0.0,98116,47.5714,-122.40799999999999,2010,6550,4160,0.6351145038167939,5712100,42902500,37190400
235000.0,3,1.0,1250,7592,1.0,0,0,4,7,1250,0,1961,0.0,98042,47.3604,-122.111,1250,7592,6342,0.8353530031612223,1562500,57638464,56075964
599950.0,5,3.0,2600,13674,1.0,0,0,4,8,1300,1300,1967,0.0,98125,47.7176,-122.302,2150,7800,11074,0.8098581249085857,6760000,186978276,180218276
481203.0,2,1.0,940,3800,1.0,0,0,2,7,940,0,1929,0.0,98115,47.6798,-122.292,1680,3800,2860,0.7526315789473684,883600,14440000,13556400
1820000.0,5,3.0,3880,13000,2.0,0,0,2,10,3880,0,1972,2003.0,98040,47.5467,-122.234,3470,13701,9120,0.7015384615384616,15054400,169000000,153945600
379000.0,3,2.5,1530,2913,2.0,0,0,3,7,1530,0,1986,0.0,98033,47.6939,-122.184,1370,3783,1383,0.4747682801235839,2340900,8485569,6144669
626000.0,3,1.75,2430,5000,2.0,0,0,3,7,1760,670,1945,0.0,98117,47.6785,-122.37200000000001,1320,4062,2570,0.514,5904900,25000000,19095100
535000.0,2,1.0,1030,4841,1.0,0,0,2,7,920,110,1939,0.0,98103,47.68600000000001,-122.34100000000001,1530,4944,3811,0.7872340425531915,1060900,23435281,22374381
1230000.0,4,2.5,2740,16007,2.0,0,0,2,9,2740,0,1984,0.0,98039,47.6353,-122.229,2760,16008,13267,0.8288248891110139,7507600,256224049,248716449
410000.0,2,1.5,1180,1034,2.0,0,0,2,7,1120,60,2001,0.0,98115,47.678000000000004,-122.322,1137,1034,-146,-0.14119922630560927,1392400,1069156,-323244
940000.0,4,2.5,3090,9238,1.0,0,3,3,8,1680,1410,1967,0.0,98006,47.5654,-122.163,2690,8500,6148,0.6655120155877896,9548100,85340644,75792544
326250.0,3,1.0,1060,9663,1.0,0,0,2,7,1060,0,1967,0.0,98034,47.7244,-122.226,1320,10162,8603,0.8903032184621753,1123600,93373569,92249969
200000.0,2,1.0,790,5985,1.0,0,0,2,6,790,0,1944,0.0,98178,47.4941,-122.24,1030,5985,5195,0.8680033416875522,624100,35820225,35196125
880000.0,4,2.5,3070,8250,1.0,0,0,4,8,2100,970,1958,0.0,98005,47.5935,-122.17200000000001,2270,8800,5180,0.6278787878787879,9424900,68062500,58637600
370000.0,2,2.0,2100,58488,2.0,0,0,2,9,2100,0,2005,0.0,98014,47.72,-121.402,1440,59346,56388,0.9640951990151826,4410000,3420846144,3416436144
190000.0,2,2.5,1100,1737,2.0,0,0,2,8,1100,0,2006,0.0,98055,47.4499,-122.189,1610,2563,637,0.3667242371905584,1210000,3017169,1807169
160000.0,2,1.0,1070,4200,1.0,0,0,3,6,1070,0,1983,0.0,98002,47.3336,-122.215,1150,4200,3130,0.7452380952380953,1144900,17640000,16495100
625000.0,4,3.0,2190,12825,1.0,0,0,2,9,1520,670,1989,0.0,98034,47.7107,-122.229,3050,4673,10635,0.8292397660818713,4796100,164480625,159684525
590000.0,4,3.5,3450,6873,2.0,0,0,2,10,2750,700,2004,0.0,98058,47.458999999999996,-122.118,3450,6873,3423,0.49803579223046707,11902500,47238129,35335629
575000.0,3,2.5,2070,3599,2.0,0,0,2,8,2070,0,1999,0.0,98033,47.6679,-122.165,2070,6844,1529,0.4248402333981662,4284900,12952801,8667901
470000.0,2,1.0,1190,5200,1.0,0,0,4,7,1190,0,1912,0.0,98103,47.6939,-122.348,1550,5100,4010,0.7711538461538462,1416100,27040000,25623900
130000.0,2,1.0,600,1500,1.0,0,0,3,4,600,0,1900,0.0,98027,47.5289,-122.03299999999999,1130,6000,900,0.6,360000,2250000,1890000
229000.0,3,1.0,940,8400,1.0,0,0,2,7,940,0,1958,0.0,98056,47.5108,-122.165,1190,8400,7460,0.888095238095238,883600,70560000,69676400
279900.0,3,1.0,1280,12928,1.5,0,0,2,6,1280,0,1942,0.0,98023,47.3215,-122.399,1610,19467,11648,0.900990099009901,1638400,167133184,165494784
307000.0,3,1.0,1370,7500,1.0,0,0,2,7,1370,0,1960,0.0,98014,47.6499,-121.915,1160,7500,6130,0.8173333333333334,1876900,56250000,54373100
399950.0,3,1.75,2450,15001,1.0,0,0,2,7,1980,470,1989,0.0,98014,47.6957,-121.913,1790,15323,12551,0.836677554829678,6002500,225030001,219027501
405000.0,4,2.25,1970,15743,1.0,0,0,2,7,1370,600,1962,0.0,98011,47.7673,-122.20200000000001,2390,11336,13773,0.8748650193736899,3880900,247842049,243961149
539950.0,4,2.75,2910,9000,1.0,0,0,3,8,2130,780,1966,0.0,98006,47.544,-122.176,1970,9000,6090,0.6766666666666666,8468100,81000000,72531900
129000.0,2,1.0,760,5240,1.0,0,0,2,6,760,0,1949,0.0,98032,47.38800000000001,-122.234,980,5080,4480,0.8549618320610687,577600,27457600,26880000
340000.0,3,1.75,1270,8422,1.0,0,0,2,7,1270,0,1967,0.0,98011,47.7601,-122.197,1470,8500,7152,0.849204464497744,1612900,70930084,69317184
214950.0,3,1.75,1570,4875,1.0,0,0,3,7,1310,260,1977,0.0,98042,47.3621,-122.094,1380,5200,3305,0.6779487179487179,2464900,23765625,21300725
450000.0,4,2.75,2310,5650,1.0,0,2,2,8,1330,980,1952,0.0,98118,47.51300000000001,-122.25200000000001,2300,5650,3340,0.5911504424778761,5336100,31922500,26586400
515000.0,3,1.75,1900,5000,1.0,0,0,3,7,950,950,1925,0.0,98106,47.5677,-122.363,1420,5000,3100,0.62,3610000,25000000,21390000
1400000.0,4,2.25,3780,5160,2.0,0,0,3,9,2510,1270,1907,0.0,98112,47.6275,-122.30799999999999,2740,5160,1380,0.26744186046511625,14288400,26625600,12337200
230000.0,3,1.0,1060,9946,1.0,0,0,3,7,1060,0,1956,0.0,98188,47.4432,-122.28200000000001,1310,10619,8886,0.8934244922581942,1123600,98922916,97799316
681000.0,3,1.75,1880,10032,1.0,0,0,3,8,1880,0,1984,0.0,98006,47.5527,-122.16,2430,9732,8152,0.8125996810207337,3534400,100641024,97106624
255000.0,3,1.0,1160,8636,1.0,0,0,2,6,1160,0,1923,0.0,98146,47.5097,-122.35700000000001,1300,8636,7476,0.8656785548865216,1345600,74580496,73234896
580000.0,2,1.0,860,4013,1.0,0,0,2,7,860,0,1925,0.0,98103,47.6652,-122.338,1490,4013,3153,0.7856964864191378,739600,16104169,15364569
295000.0,2,2.0,1590,8000,1.0,0,0,2,7,910,680,1984,0.0,98055,47.458999999999996,-122.205,1590,8364,6410,0.80125,2528100,64000000,61471900
286000.0,2,1.0,1170,6543,1.0,0,0,2,7,1170,0,1913,0.0,98136,47.537,-122.385,1550,7225,5373,0.8211829436038515,1368900,42810849,41441949
425000.0,3,1.5,1190,8100,1.0,0,0,2,7,830,360,1947,0.0,98125,47.7146,-122.311,1256,8100,6910,0.8530864197530864,1416100,65610000,64193900
170000.0,2,1.0,1300,11400,1.0,0,0,2,7,1300,0,1961,0.0,98003,47.3459,-122.29899999999999,1360,9750,10100,0.8859649122807017,1690000,129960000,128270000
380000.0,3,2.0,1660,8281,1.0,0,0,2,7,1660,0,1949,0.0,98136,47.5568,-122.382,1660,7559,6621,0.7995411182224369,2755600,68574961,65819361
506000.0,3,2.0,1160,6120,1.0,0,0,2,7,1160,0,1947,0.0,98115,47.6853,-122.29299999999999,1150,5100,4960,0.8104575163398693,1345600,37454400,36108800
315000.0,3,2.5,1950,9618,2.0,0,0,2,7,1950,0,1992,0.0,98031,47.4068,-122.18,1890,7133,7668,0.7972551466001248,3802500,92505924,88703424
449950.0,4,2.5,2470,3811,2.0,0,0,2,8,2470,0,1999,0.0,98065,47.5362,-121.87700000000001,2400,4266,1341,0.3518761479926528,6100900,14523721,8422821
255000.0,3,1.0,1430,12420,1.0,0,0,2,7,1430,0,1964,0.0,98056,47.5116,-122.191,1900,10350,10990,0.8848631239935588,2044900,154256400,152211500
289000.0,3,2.5,1970,9607,2.0,0,0,2,7,1090,880,1988,0.0,98001,47.3462,-122.286,2020,9608,7637,0.7949411887165608,3880900,92294449,88413549
389000.0,3,1.75,1400,10018,1.0,0,0,3,7,1400,0,1962,0.0,98027,47.5327,-122.03200000000001,1350,9300,8618,0.860251547215013,1960000,100360324,98400324
327000.0,3,1.5,1510,344124,1.0,0,2,3,7,1510,0,1964,0.0,98022,47.2156,-122.029,1750,169884,342614,0.9956120468203322,2280100,118421327376,118419047276
2890000.0,7,3.0,5350,14400,2.5,0,0,3,10,5020,330,1910,0.0,98112,47.6295,-122.285,3050,7469,9050,0.6284722222222222,28622500,207360000,178737500
210000.0,3,1.0,920,6612,1.0,0,0,2,6,920,0,1948,0.0,98118,47.548,-122.28399999999999,1860,8424,5692,0.8608590441621294,846400,43718544,42872144
1680000.0,4,3.75,7620,29536,2.0,0,3,2,11,5980,1640,2005,0.0,98006,47.5571,-122.14,2840,20809,21916,0.7420097508125677,58064400,872375296,814310896
360000.0,4,2.5,2490,4751,2.0,0,0,2,7,2490,0,2001,0.0,98056,47.4813,-122.18799999999999,2510,5233,2261,0.47589981056619657,6200100,22572001,16371901
875000.0,4,2.5,3030,16000,2.0,0,0,2,11,3030,0,1990,0.0,98077,47.7125,-122.081,3670,16641,12970,0.810625,9180900,256000000,246819100
550000.0,4,2.25,1650,7200,1.0,0,0,2,8,1650,0,1967,0.0,98008,47.6384,-122.116,2180,7950,5550,0.7708333333333334,2722500,51840000,49117500
257500.0,3,1.5,1210,12500,1.0,0,0,2,7,1210,0,1962,0.0,98146,47.503,-122.351,1210,12500,11290,0.9032,1464100,156250000,154785900
1080000.0,4,2.75,2990,7389,1.5,0,0,3,8,2090,900,1923,0.0,98144,47.5711,-122.28399999999999,2510,6157,4399,0.5953444309108133,8940100,54597321,45657221
202950.0,2,1.0,1060,5144,1.0,0,0,4,6,1060,0,1969,0.0,98042,47.3613,-122.088,1130,5200,4084,0.7939346811819595,1123600,26460736,25337136
622000.0,4,1.75,2680,6120,1.0,0,0,4,8,1340,1340,1959,0.0,98117,47.6965,-122.39299999999999,2320,6840,3440,0.5620915032679739,7182400,37454400,30272000
455000.0,4,1.75,1790,45738,1.0,0,0,2,8,1410,380,1976,0.0,98072,47.7453,-122.12899999999999,1870,47480,43948,0.9608640517731427,3204100,2091964644,2088760544
805000.0,3,2.5,2690,17461,2.0,0,3,2,10,2690,0,1997,0.0,98074,47.653999999999996,-122.088,3610,16887,14771,0.8459423858885516,7236100,304886521,297650421
257000.0,2,1.0,770,9497,1.0,0,0,2,6,770,0,1950,0.0,98133,47.7407,-122.351,1550,7532,8727,0.9189217647678214,592900,90193009,89600109
744500.0,5,2.5,2700,16570,1.0,0,0,3,8,1750,950,1967,0.0,98005,47.6144,-122.167,2570,11840,13870,0.8370549185274593,7290000,274564900,267274900
885000.0,4,2.5,2620,9157,2.0,0,0,2,8,2620,0,1996,0.0,98033,47.6916,-122.20299999999999,2240,7405,6537,0.7138800917331004,6864400,83850649,76986249
355000.0,2,2.25,930,747,2.0,0,0,2,8,630,300,2007,0.0,98144,47.5844,-122.316,940,6000,-183,-0.24497991967871485,864900,558009,-306891
240000.0,3,1.0,1340,7000,1.0,0,0,3,7,1340,0,1978,0.0,98042,47.3742,-122.149,1850,7904,5660,0.8085714285714286,1795600,49000000,47204400
169000.0,3,1.5,1470,18459,2.0,0,0,3,6,1470,0,1916,0.0,98023,47.3302,-122.36,1750,16074,16989,0.9203640500568828,2160900,340734681,338573781
639900.0,3,2.5,2330,4160,2.0,0,0,3,8,2330,0,1992,0.0,98052,47.6367,-122.109,2940,4500,1830,0.43990384615384615,5428900,17305600,11876700
292000.0,3,1.75,1730,11325,1.0,0,0,4,7,1730,0,1972,0.0,98031,47.3921,-122.182,2030,17859,9595,0.8472406181015453,2992900,128255625,125262725
563500.0,4,2.5,2780,7838,2.0,0,3,2,9,2780,0,2004,0.0,98065,47.5312,-121.861,3160,7848,5058,0.645317683082419,7728400,61434244,53705844
389000.0,2,2.0,1200,7131,1.0,0,0,2,8,1200,0,2006,0.0,98053,47.7199,-122.022,1670,4601,5931,0.8317206562894405,1440000,50851161,49411161
2750000.0,4,3.25,4430,21000,2.0,0,0,2,10,4430,0,1952,2007.0,98039,47.6398,-122.23700000000001,3930,20000,16570,0.789047619047619,19624900,441000000,421375100
661000.0,3,2.0,1820,4418,2.0,0,0,3,8,1820,0,1994,0.0,98033,47.6947,-122.19,1920,13402,2598,0.5880488909008601,3312400,19518724,16206324
344000.0,2,2.0,1300,4659,1.0,0,0,2,8,1300,0,2005,0.0,98053,47.7132,-122.03299999999999,1640,4780,3359,0.7209701652715175,1690000,21706281,20016281
510000.0,1,1.0,680,6600,1.0,0,0,2,5,480,200,1916,0.0,98199,47.6567,-122.39200000000001,1170,5500,5920,0.896969696969697,462400,43560000,43097600
289000.0,2,1.0,780,4132,1.0,0,0,2,7,780,0,1942,0.0,98136,47.5324,-122.387,1100,5100,3352,0.8112294288480155,608400,17073424,16465024
365000.0,3,2.25,2430,7614,1.5,0,0,2,8,1900,530,1979,0.0,98056,47.5065,-122.191,1720,11250,5184,0.6808510638297872,5904900,57972996,52068096
410000.0,3,1.5,1750,32500,1.0,0,0,3,7,1750,0,1966,0.0,98027,47.5316,-121.959,1820,102801,30750,0.9461538461538461,3062500,1056250000,1053187500
535610.0,3,1.0,1610,5100,1.5,0,0,4,7,1010,600,1901,0.0,98117,47.6765,-122.38600000000001,1270,5100,3490,0.6843137254901961,2592100,26010000,23417900
397950.0,4,1.75,2120,7620,2.0,0,0,2,8,2120,0,1971,2002.0,98166,47.457,-122.346,1820,7620,5500,0.7217847769028871,4494400,58064400,53570000
284000.0,3,1.75,1430,4850,1.0,0,0,2,7,930,500,1978,0.0,98108,47.5472,-122.303,1430,4850,3420,0.7051546391752578,2044900,23522500,21477600
201000.0,4,1.5,1360,8100,1.5,0,0,2,7,1360,0,1962,0.0,98168,47.4931,-122.305,1300,8100,6740,0.8320987654320988,1849600,65610000,63760400
734000.0,4,2.25,2530,5000,1.5,0,0,3,7,1690,840,1925,0.0,98117,47.6806,-122.36,1530,5000,2470,0.494,6400900,25000000,18599100
357500.0,5,3.0,3270,9146,2.0,0,0,2,7,3270,0,2002,0.0,98092,47.3342,-122.169,3200,6300,5876,0.6424666520883446,10692900,83649316,72956416
550120.0,5,2.5,2620,8050,1.0,0,0,2,8,1520,1100,1975,0.0,98052,47.6919,-122.115,2030,7676,5430,0.6745341614906832,6864400,64802500,57938100
300000.0,3,1.5,1810,8232,1.0,0,0,2,8,1810,0,1988,0.0,98001,47.3195,-122.273,2260,8491,6422,0.7801263362487852,3276100,67765824,64489724
374950.0,3,2.5,2120,9653,2.0,0,0,2,8,2120,0,1992,0.0,98030,47.3843,-122.213,1780,9801,7533,0.7803791567388376,4494400,93180409,88686009
602500.0,4,1.75,2190,41000,2.0,0,0,2,8,2190,0,1980,0.0,98075,47.5755,-122.03299999999999,2590,35370,38810,0.9465853658536585,4796100,1681000000,1676203900
221000.0,3,1.0,980,7606,1.0,0,0,2,7,980,0,1954,0.0,98188,47.4356,-122.29,980,8125,6626,0.8711543518275046,960400,57851236,56890836
920000.0,5,3.0,2230,4400,2.0,0,0,2,7,1730,500,1913,0.0,98102,47.6404,-122.325,1280,1800,2170,0.49318181818181817,4972900,19360000,14387100
235000.0,4,2.0,1540,9279,1.0,0,0,2,7,1540,0,1955,0.0,98118,47.5163,-122.26799999999999,1540,5110,7739,0.8340338398534325,2371600,86099841,83728241
375000.0,3,1.0,980,7296,1.0,0,0,2,7,980,0,1967,0.0,98034,47.7292,-122.23100000000001,1280,7296,6316,0.8656798245614035,960400,53231616,52271216
599000.0,4,2.5,2120,3640,2.0,0,0,2,8,2120,0,2005,0.0,98029,47.5521,-121.99600000000001,2190,3640,1520,0.4175824175824176,4494400,13249600,8755200
562100.0,3,2.25,2090,12112,2.0,0,0,2,8,2090,0,1983,0.0,98052,47.7015,-122.13,1760,12112,10022,0.827443857331572,4368100,146700544,142332444
640000.0,3,2.5,1620,1377,2.0,0,0,2,8,1100,520,2009,0.0,98112,47.6195,-122.29899999999999,1620,1251,-243,-0.17647058823529413,2624400,1896129,-728271
294000.0,3,2.0,1650,11256,1.0,0,0,3,7,1250,400,1957,0.0,98168,47.4707,-122.26,1860,11256,9606,0.853411513859275,2722500,126697536,123975036
714000.0,4,2.5,3230,7766,2.0,0,0,2,9,3230,0,2005,0.0,98052,47.7069,-122.131,3740,8344,4536,0.5840844707700231,10432900,60310756,49877856
970000.0,4,3.25,2790,5420,1.0,0,3,2,9,1130,1660,1963,2013.0,98177,47.7698,-122.38600000000001,2530,7200,2630,0.48523985239852396,7784100,29376400,21592300
280000.0,4,2.25,1600,7916,2.0,0,0,2,7,1600,0,1991,0.0,98022,47.193999999999996,-121.98100000000001,1540,7242,6316,0.797877716018191,2560000,62663056,60103056
260000.0,4,2.5,1790,4358,2.0,0,0,2,7,1790,0,1993,0.0,98031,47.3994,-122.204,1790,4305,2568,0.5892611289582377,3204100,18992164,15788064
294000.0,3,1.5,2060,15050,1.5,0,0,3,7,2060,0,1938,0.0,98023,47.3321,-122.37299999999999,1900,15674,12990,0.8631229235880399,4243600,226502500,222258900
255500.0,4,1.0,1370,41194,1.5,0,2,4,5,1370,0,1900,0.0,98092,47.2716,-122.14399999999999,1590,84070,39824,0.9667427295237171,1876900,1696945636,1695068736
3300000.0,5,4.75,6200,13873,2.0,1,4,3,11,4440,1760,1989,0.0,98008,47.605,-122.11200000000001,2940,13525,7673,0.5530887335111367,38440000,192460129,154020129
450000.0,3,2.0,1510,43560,1.0,0,0,2,7,1510,0,1954,0.0,98077,47.7218,-122.079,2060,67756,42050,0.9653351698806244,2280100,1897473600,1895193500
368000.0,3,1.0,1280,9898,1.0,0,0,2,7,1280,0,1968,0.0,98072,47.7677,-122.163,1290,9625,8618,0.870680945645585,1638400,97970404,96332004
830000.0,4,2.25,2180,11056,1.0,0,0,2,8,1370,810,1963,0.0,98004,47.6042,-122.193,2090,8747,8876,0.802821997105644,4752400,122235136,117482736
282500.0,2,1.75,1440,11210,1.0,0,0,3,6,1130,310,1935,0.0,98146,47.49800000000001,-122.35,1250,9381,9770,0.8715432649420161,2073600,125664100,123590500
335000.0,3,2.25,1580,16215,1.0,0,0,3,7,1580,0,1978,0.0,98024,47.5643,-121.897,1450,16215,14635,0.9025593586185631,2496400,262926225,260429825
558000.0,2,2.0,1580,5750,1.0,0,0,4,6,790,790,1910,0.0,98116,47.5668,-122.384,1580,5750,4170,0.7252173913043478,2496400,33062500,30566100
270000.0,4,1.5,1730,8505,1.5,0,0,3,7,1730,0,1961,0.0,98146,47.4905,-122.34700000000001,1510,8505,6775,0.7965902410346855,2992900,72335025,69342125
152000.0,2,1.0,700,13500,1.0,0,0,2,4,700,0,1920,0.0,98031,47.3882,-122.208,1600,10124,12800,0.9481481481481482,490000,182250000,181760000
493000.0,4,1.75,2030,18295,1.5,0,0,3,7,2030,0,1975,0.0,98034,47.7326,-122.179,1970,7307,16265,0.8890407215086089,4120900,334707025,330586125
740000.0,4,2.5,2500,10330,2.0,0,0,2,10,2500,0,1992,0.0,98006,47.5595,-122.11399999999999,2710,8375,7830,0.7579864472410455,6250000,106708900,100458900
789800.0,3,2.5,2605,2216,2.0,0,2,2,9,2090,515,1979,0.0,98033,47.6536,-122.20299999999999,2605,2300,-389,-0.17554151624548736,6786025,4910656,-1875369
275000.0,2,1.0,910,4191,1.0,0,0,2,6,910,0,1910,0.0,98117,47.6929,-122.36,1480,6050,3281,0.782868050584586,828100,17564481,16736381
1500000.0,6,2.5,3560,6480,2.5,0,0,3,11,3560,0,1914,0.0,98112,47.626999999999995,-122.304,2780,6480,2920,0.4506172839506173,12673600,41990400,29316800
424000.0,3,1.75,1140,3395,1.0,0,0,4,7,620,520,1925,0.0,98107,47.6712,-122.39299999999999,1480,3500,2255,0.6642120765832106,1299600,11526025,10226425
715000.0,2,1.0,1000,3513,1.0,0,4,3,5,1000,0,1914,0.0,98116,47.5935,-122.39,1930,4920,2513,0.7153430116709365,1000000,12341169,11341169
600000.0,4,2.5,3010,7953,2.0,0,0,2,9,3010,0,2000,0.0,98056,47.522,-122.19,2670,6202,4943,0.6215264679994971,9060100,63250209,54190109
802000.0,2,1.75,2110,8700,1.0,0,4,3,9,1760,350,1960,0.0,98146,47.4912,-122.365,2120,9500,6590,0.7574712643678161,4452100,75690000,71237900
165000.0,3,1.0,910,8700,1.0,0,0,3,6,910,0,1943,0.0,98188,47.449,-122.29,1090,8700,7790,0.8954022988505748,828100,75690000,74861900
750000.0,4,3.25,2050,5000,2.0,0,0,3,8,1370,680,1987,0.0,98112,47.6235,-122.29799999999999,1720,5000,2950,0.59,4202500,25000000,20797500
405000.0,2,1.0,1090,10481,1.0,0,0,1,7,780,310,1981,0.0,98074,47.632,-122.03,1160,10533,9391,0.896002289857838,1188100,109851361,108663261
521900.0,3,2.5,2100,12338,2.0,0,0,2,9,2100,0,1997,0.0,98072,47.7412,-122.16799999999999,2320,6257,10238,0.8297941319500729,4410000,152226244,147816244
275000.0,3,1.0,1000,8018,1.0,0,0,2,7,1000,0,1969,0.0,98034,47.7285,-122.198,1270,8000,7018,0.8752806186081317,1000000,64288324,63288324
600000.0,5,3.25,4410,58157,2.0,0,0,3,9,2330,2080,2001,0.0,98058,47.4395,-122.111,2460,42565,53747,0.924170779097959,19448100,3382236649,3362788549
442500.0,3,1.75,1800,10200,1.0,0,0,2,8,1800,0,1967,0.0,98058,47.4496,-122.146,2140,10128,8400,0.8235294117647058,3240000,104040000,100800000
229950.0,2,1.0,920,7716,1.0,0,0,2,6,920,0,1944,0.0,98178,47.5028,-122.243,1410,7128,6796,0.8807672369103162,846400,59536656,58690256
274950.0,3,2.0,1410,7265,1.0,0,0,3,7,1410,0,1983,0.0,98042,47.3654,-122.07600000000001,1390,8060,5855,0.8059187887130076,1988100,52780225,50792125
407185.0,3,1.75,1860,48076,1.5,0,0,3,8,1860,0,1929,0.0,98070,47.5051,-122.461,1410,23066,46216,0.9613112571761377,3459600,2311301776,2307842176
468000.0,4,2.5,2100,8400,1.0,0,0,3,7,1240,860,1976,0.0,98072,47.735,-122.17,1980,8610,6300,0.75,4410000,70560000,66150000
450000.0,2,1.0,1030,4365,1.0,0,0,2,7,1030,0,1942,0.0,98117,47.6875,-122.387,1420,4268,3335,0.7640320733104238,1060900,19053225,17992325
219950.0,2,1.0,940,8997,1.0,0,0,4,7,940,0,1955,0.0,98022,47.2005,-121.999,1110,9126,8057,0.8955207291319328,883600,80946009,80062409
275000.0,2,2.5,1340,5995,2.0,0,0,2,7,1340,0,1989,0.0,98028,47.7366,-122.23299999999999,1540,6616,4655,0.7764804003336113,1795600,35940025,34144425
229950.0,2,1.0,850,6000,1.0,0,0,2,6,850,0,1924,0.0,98178,47.4972,-122.22399999999999,1100,6000,5150,0.8583333333333333,722500,36000000,35277500
675000.0,3,1.75,2130,4400,1.0,0,0,2,7,1430,700,1922,0.0,98102,47.6417,-122.325,1710,3300,2270,0.5159090909090909,4536900,19360000,14823100
412950.0,4,2.5,2430,6796,2.0,0,0,2,8,2430,0,1993,0.0,98058,47.4499,-122.12700000000001,2450,8400,4366,0.642436727486757,5904900,46185616,40280716
670000.0,5,2.25,2290,39000,2.0,0,0,2,8,2290,0,1979,0.0,98052,47.7012,-122.12,2750,39900,36710,0.9412820512820513,5244100,1521000000,1515755900
420000.0,3,1.75,1230,10005,1.0,0,0,3,7,1230,0,1963,0.0,98008,47.621,-122.11399999999999,1530,8560,8775,0.8770614692653673,1512900,100100025,98587125
358000.0,3,1.5,1150,27319,1.0,0,0,3,6,1150,0,1976,0.0,98070,47.3933,-122.454,1700,30691,26169,0.9579047549324646,1322500,746327761,745005261
680000.0,3,2.5,2120,3600,2.0,0,0,2,9,2120,0,2005,0.0,98052,47.6649,-122.08200000000001,2540,4592,1480,0.4111111111111111,4494400,12960000,8465600
380000.0,2,1.0,980,3400,1.0,0,0,2,7,980,0,1923,0.0,98105,47.6688,-122.323,1200,3420,2420,0.711764705882353,960400,11560000,10599600
515000.0,3,2.5,2130,219978,2.0,0,0,2,8,2130,0,1986,0.0,98077,47.7754,-122.03200000000001,3340,217800,217848,0.9903172135395357,4536900,48390320484,48385783584
325000.0,2,1.0,1050,4800,1.0,0,0,3,7,1050,0,1969,0.0,98146,47.5128,-122.38799999999999,1230,4800,3750,0.78125,1102500,23040000,21937500
875000.0,3,2.5,1820,6848,1.0,0,0,3,7,1820,0,1953,0.0,98004,47.6287,-122.20700000000001,2080,11700,5028,0.7342289719626168,3312400,46895104,43582704
426000.0,3,2.5,2210,5750,2.0,0,0,2,7,1710,500,1914,2000.0,98106,47.5525,-122.366,1350,5750,3540,0.6156521739130435,4884100,33062500,28178400
868500.0,5,2.5,2490,9639,1.0,0,0,3,8,1610,880,1959,0.0,98040,47.551,-122.22,2290,9958,7149,0.7416744475568005,6200100,92910321,86710221
657500.0,4,2.75,4140,24190,2.0,0,0,2,11,4140,0,2002,0.0,98092,47.3062,-122.15,3950,24190,20050,0.8288548987184787,17139600,585156100,568016500
366000.0,2,1.0,1210,3090,1.0,0,0,2,6,860,350,1926,0.0,98118,47.5532,-122.277,1210,3348,1880,0.6084142394822006,1464100,9548100,8084000
385000.0,2,1.0,1010,4000,1.0,0,0,2,6,1010,0,1911,0.0,98118,47.5536,-122.26700000000001,1040,4000,2990,0.7475,1020100,16000000,14979900
300000.0,4,2.0,2050,8750,1.0,0,0,2,7,1300,750,1967,0.0,98058,47.4324,-122.171,2050,8750,6700,0.7657142857142857,4202500,76562500,72360000
810000.0,3,1.75,2060,3300,2.0,0,0,3,9,1500,560,1918,0.0,98102,47.6498,-122.32,1830,3712,1240,0.37575757575757573,4243600,10890000,6646400
460000.0,4,1.75,1560,7200,1.0,0,0,2,6,860,700,1943,0.0,98115,47.7001,-122.279,1420,7200,5640,0.7833333333333333,2433600,51840000,49406400
459000.0,3,2.5,1780,4000,2.0,0,0,3,8,1780,0,1995,0.0,98029,47.5677,-122.00299999999999,1730,4000,2220,0.555,3168400,16000000,12831600
260000.0,3,1.75,1460,10000,1.0,0,0,3,8,1460,0,1967,0.0,98092,47.342,-122.195,1930,14175,8540,0.854,2131600,100000000,97868400
557865.0,4,2.5,3030,6813,2.0,0,0,2,9,3030,0,1987,0.0,98074,47.6296,-122.029,2310,8682,3783,0.5552619991193307,9180900,46416969,37236069
295000.0,4,1.0,980,3000,1.5,0,0,3,7,980,0,1914,0.0,98144,47.5892,-122.31200000000001,1525,3000,2020,0.6733333333333333,960400,9000000,8039600
375000.0,4,2.25,1450,7245,1.0,0,0,4,7,1450,0,1950,1983.0,98133,47.7643,-122.34299999999999,1660,7800,5795,0.7998619737750172,2102500,52490025,50387525
2110000.0,3,2.25,3230,17833,2.0,0,0,3,9,3230,0,1973,0.0,98006,47.5683,-122.18799999999999,3690,17162,14603,0.8188751191611058,10432900,318015889,307582989
307300.0,2,2.0,1520,1020,3.0,0,0,2,7,1520,0,1999,0.0,98133,47.7292,-122.34299999999999,1500,1245,-500,-0.49019607843137253,2310400,1040400,-1270000
225000.0,4,1.0,1410,7000,1.5,0,0,2,7,1410,0,1963,0.0,98032,47.3767,-122.287,1540,7000,5590,0.7985714285714286,1988100,49000000,47011900
290000.0,3,1.75,1390,13200,2.0,0,0,2,7,1390,0,1979,0.0,98045,47.4429,-121.771,1430,10725,11810,0.8946969696969697,1932100,174240000,172307900
690000.0,4,2.0,2230,5000,1.5,0,0,3,7,1510,720,1922,0.0,98144,47.5772,-122.292,2140,5000,2770,0.554,4972900,25000000,20027100
825000.0,4,2.25,2110,12653,2.0,0,0,3,8,2110,0,1972,0.0,98040,47.536,-122.225,2350,10980,10543,0.8332411285861061,4452100,160098409,155646309
645000.0,3,1.75,2270,11472,1.0,0,0,3,7,1370,900,1956,0.0,98177,47.7057,-122.374,2270,8340,9202,0.8021269177126917,5152900,131606784,126453884
590000.0,4,2.25,2530,10611,1.0,0,0,4,8,1320,1210,1977,0.0,98006,47.5698,-122.132,2530,10125,8081,0.7615681839600414,6400900,112593321,106192421
667000.0,5,2.0,1900,5470,1.0,0,0,2,7,1180,720,1930,1965.0,98105,47.6666,-122.303,1300,3250,3570,0.6526508226691042,3610000,29920900,26310900
664000.0,4,2.5,2390,8432,2.0,0,0,2,9,2390,0,1998,0.0,98074,47.6027,-122.024,2710,7417,6042,0.7165559772296015,5712100,71098624,65386524
452100.0,4,2.5,3160,6540,1.0,0,3,2,8,1580,1580,1959,0.0,98178,47.5037,-122.24,1990,7090,3380,0.5168195718654435,9985600,42771600,32786000
290000.0,2,1.0,900,2728,2.0,0,0,2,7,900,0,1998,0.0,98144,47.5877,-122.29799999999999,900,2728,1828,0.6700879765395894,810000,7441984,6631984
950000.0,3,3.0,3610,17483,2.0,0,2,3,8,3610,0,1954,0.0,98146,47.4852,-122.35700000000001,2230,12600,13873,0.793513699021907,13032100,305655289,292623189
662500.0,3,2.0,2070,4200,1.5,0,0,3,7,1670,400,1906,0.0,98103,47.6624,-122.333,1490,4560,2130,0.5071428571428571,4284900,17640000,13355100
475000.0,4,2.5,1850,5444,2.0,0,0,4,7,1850,0,1981,0.0,98034,47.7227,-122.16,1540,5000,3594,0.6601763409257898,3422500,29637136,26214636
450000.0,3,1.5,1440,9711,1.0,0,0,2,7,1140,300,1956,0.0,98028,47.7394,-122.25200000000001,1590,9711,8271,0.8517145505097312,2073600,94303521,92229921
538250.0,3,2.25,2590,15229,2.0,0,3,2,8,2590,0,1984,0.0,98198,47.3948,-122.325,2590,15229,12639,0.8299297393131525,6708100,231922441,225214341
329950.0,2,1.0,1140,5250,1.5,0,0,3,6,1140,0,1949,0.0,98133,47.731,-122.34100000000001,1450,5250,4110,0.7828571428571428,1299600,27562500,26262900
1100000.0,4,3.5,2760,5040,2.0,0,2,2,9,2760,0,1955,2005.0,98117,47.6756,-122.40100000000001,2370,5760,2280,0.4523809523809524,7617600,25401600,17784000
307000.0,5,1.5,1310,4800,1.5,0,0,2,6,1110,200,1929,0.0,98106,47.5545,-122.365,960,4800,3490,0.7270833333333333,1716100,23040000,21323900
433000.0,3,1.75,1870,7189,1.0,0,0,2,7,1270,600,1959,0.0,98118,47.5412,-122.27,1780,6200,5319,0.7398803727917652,3496900,51681721,48184821
212000.0,3,2.25,1900,18000,1.0,0,0,3,7,1280,620,1968,0.0,98023,47.3251,-122.354,1920,15000,16100,0.8944444444444445,3610000,324000000,320390000
750000.0,5,2.75,2860,6000,2.5,0,0,3,8,2380,480,1902,0.0,98144,47.5906,-122.316,2240,6000,3140,0.5233333333333333,8179600,36000000,27820400
279000.0,3,2.0,1640,5650,1.0,0,0,2,7,1640,0,2003,0.0,98042,47.3736,-122.13,2250,5488,4010,0.7097345132743362,2689600,31922500,29232900
476000.0,3,1.0,1140,5500,1.5,0,0,3,6,1140,0,1908,0.0,98199,47.6606,-122.395,1690,4400,4360,0.7927272727272727,1299600,30250000,28950400
368000.0,5,1.75,2590,9394,1.0,0,0,3,7,1390,1200,1963,0.0,98198,47.3941,-122.307,2580,9049,6804,0.7242921013412816,6708100,88247236,81539136
228950.0,4,3.0,2160,5200,1.0,0,0,2,7,1320,840,1978,0.0,98042,47.3627,-122.09100000000001,1460,5144,3040,0.5846153846153846,4665600,27040000,22374400
568450.0,5,3.5,3260,58806,2.0,0,0,3,8,3260,0,1969,0.0,98042,47.3703,-122.15899999999999,1810,17927,55546,0.9445634799170153,10627600,3458145636,3447518036
619000.0,4,1.75,1660,3800,1.5,0,0,2,7,1660,0,1926,0.0,98115,47.6883,-122.314,1660,3767,2140,0.5631578947368421,2755600,14440000,11684400
275000.0,3,2.25,1640,6044,2.0,0,0,2,7,1640,0,1996,0.0,98002,47.2844,-122.205,1600,7418,4404,0.728656518861681,2689600,36529936,33840336
321500.0,4,2.5,2620,5457,2.0,0,0,2,8,2620,0,2003,0.0,98001,47.3148,-122.27,2740,5816,2837,0.5198827194429173,6864400,29778849,22914449
230000.0,3,1.75,950,6000,1.0,0,0,2,6,790,160,1939,0.0,98108,47.5271,-122.316,1360,6000,5050,0.8416666666666667,902500,36000000,35097500
179500.0,3,1.0,900,8100,1.0,0,0,3,6,900,0,1959,0.0,98002,47.2866,-122.221,1000,7830,7200,0.8888888888888888,810000,65610000,64800000
460000.0,3,2.25,1650,7313,1.0,0,0,2,7,1220,430,1975,0.0,98011,47.7375,-122.194,1690,7252,5663,0.7743744017503077,2722500,53479969,50757469
286000.0,3,2.5,1800,3980,2.0,0,0,2,7,1800,0,2006,0.0,98042,47.4006,-122.162,2580,4307,2180,0.5477386934673367,3240000,15840400,12600400
427500.0,3,1.0,1480,4200,1.5,0,0,2,7,1480,0,1925,0.0,98122,47.6147,-122.29799999999999,1460,3600,2720,0.6476190476190476,2190400,17640000,15449600
400000.0,3,1.0,1040,6250,1.0,0,0,2,7,1040,0,1942,0.0,98136,47.5526,-122.385,1770,6250,5210,0.8336,1081600,39062500,37980900
675000.0,3,3.5,2300,5611,1.0,0,0,2,8,2300,0,2004,0.0,98053,47.7122,-122.02600000000001,2170,5926,3311,0.5900908928889681,5290000,31483321,26193321
350000.0,3,1.0,2480,8906,1.0,0,0,2,7,1240,1240,1969,0.0,98118,47.5366,-122.289,1800,8906,6426,0.7215360431169998,6150400,79316836,73166436
385000.0,4,1.75,1970,10358,1.0,0,0,2,8,1540,430,1977,0.0,98028,47.7719,-122.255,1900,10358,8388,0.809808843406063,3880900,107288164,103407264
525000.0,2,1.75,1530,3503,1.0,0,1,3,7,830,0,1916,0.0,98119,47.6368,-122.37100000000001,1280,1531,1973,0.5632315158435627,2340900,12271009,9930109
315000.0,2,1.0,970,18557,1.0,0,0,2,6,970,0,1939,0.0,98146,47.5116,-122.37,1150,7200,17587,0.94772861992779,940900,344362249,343421349
820000.0,4,2.5,2920,252648,2.0,0,0,2,10,2920,0,2002,0.0,98027,47.4784,-122.04799999999999,2180,71874,249728,0.9884424179095026,8526400,63831011904,63822485504
205000.0,3,1.0,970,7700,1.0,0,0,3,7,970,0,1959,0.0,98032,47.3793,-122.304,1160,8250,6730,0.874025974025974,940900,59290000,58349100
500000.0,2,1.0,680,5250,1.0,0,0,3,6,680,0,1922,0.0,98177,47.7013,-122.359,1620,5461,4570,0.8704761904761905,462400,27562500,27100100
599000.0,4,2.5,2640,6738,2.0,0,0,3,8,2640,0,1989,0.0,98029,47.5787,-122.0,2180,5782,4098,0.6081923419412288,6969600,45400644,38431044
2230000.0,3,4.0,4200,30120,2.0,0,2,3,11,3600,600,1933,0.0,98112,47.6379,-122.311,2760,12200,25920,0.8605577689243028,17640000,907214400,889574400
299000.0,1,2.5,1980,7521,1.0,0,0,3,7,1180,800,1979,0.0,98055,47.4343,-122.19200000000001,1980,8000,5541,0.7367371360191464,3920400,56565441,52645041
947500.0,3,2.75,2980,27144,1.5,1,2,4,8,2180,800,1917,0.0,98166,47.4522,-122.37799999999999,1890,12514,24164,0.8902151488358385,8880400,736796736,727916336
385000.0,3,3.25,1630,1677,3.0,0,0,2,8,1630,0,2007,0.0,98133,47.7048,-122.353,1220,1677,47,0.02802623732856291,2656900,2812329,155429
639950.0,2,1.75,1780,4520,1.0,0,0,4,7,890,890,1925,0.0,98116,47.5798,-122.404,1560,4520,2740,0.6061946902654868,3168400,20430400,17262000
824000.0,2,1.0,1210,8400,1.0,0,0,2,8,780,430,2000,0.0,98199,47.6503,-122.39299999999999,1860,6000,7190,0.8559523809523809,1464100,70560000,69095900
199950.0,3,1.0,1010,7245,1.0,0,0,2,7,1010,0,1969,0.0,98003,47.3338,-122.306,1300,8236,6235,0.8605935127674258,1020100,52490025,51469925
1010000.0,3,2.5,2570,5000,1.0,0,0,3,8,1480,1090,1940,0.0,98105,47.6578,-122.285,2420,5484,2430,0.486,6604900,25000000,18395100
950000.0,4,2.25,2770,5320,2.0,0,1,2,9,2440,330,2013,0.0,98136,47.5283,-122.385,2100,6011,2550,0.4793233082706767,7672900,28302400,20629500
822000.0,3,2.5,2290,9158,2.0,0,0,3,8,2290,0,1984,0.0,98006,47.5476,-122.14,2210,9588,6868,0.7499454029264031,5244100,83868964,78624864
473600.0,4,1.5,1780,8400,1.0,0,0,2,7,1080,700,1969,0.0,98136,47.5173,-122.385,1660,8400,6620,0.7880952380952381,3168400,70560000,67391600
490000.0,5,2.0,2150,4500,1.5,0,0,2,8,2150,0,1938,0.0,98116,47.5582,-122.38799999999999,1300,4500,2350,0.5222222222222223,4622500,20250000,15627500
245000.0,3,1.75,1920,9306,1.0,0,0,2,7,1000,920,1984,0.0,98001,47.3319,-122.26700000000001,1860,8458,7386,0.7936814958091554,3686400,86601636,82915236
199000.0,4,1.0,1220,11730,1.0,0,0,3,7,1220,0,1960,0.0,98001,47.3229,-122.28299999999999,1270,9520,10510,0.8959931798806479,1488400,137592900,136104500
1340000.0,3,3.0,2960,5500,2.0,0,2,2,10,2440,520,1937,1990.0,98199,47.6356,-122.402,2960,5876,2540,0.4618181818181818,8761600,30250000,21488400
418000.0,3,1.75,1500,19113,1.0,0,0,2,7,1500,0,1984,0.0,98014,47.6976,-121.916,1820,18151,17613,0.9215193847119761,2250000,365306769,363056769
450000.0,7,3.5,2830,8625,1.0,0,0,3,8,1830,1000,1957,0.0,98133,47.7493,-122.355,1570,8400,5795,0.6718840579710145,8008900,74390625,66381725
280000.0,3,2.5,1580,7000,2.0,0,0,2,8,1580,0,1992,0.0,98030,47.3659,-122.17,2110,7062,5420,0.7742857142857142,2496400,49000000,46503600
273000.0,3,2.25,1230,11601,1.0,0,0,3,7,910,320,1992,0.0,98022,47.1955,-121.991,1820,8465,10371,0.8939746573571243,1512900,134583201,133070301
549000.0,4,2.5,2910,6338,2.0,0,0,2,8,2910,0,2008,0.0,98059,47.4804,-122.126,2500,5877,3428,0.5408646260650047,8468100,40170244,31702144
913888.0,5,2.25,2370,15512,2.0,0,0,3,9,2370,0,1981,0.0,98006,47.5555,-122.15,2380,15100,13142,0.8472150593089222,5616900,240622144,235005244
689888.0,4,2.25,1930,3500,1.5,0,0,4,8,1540,390,1916,0.0,98122,47.6167,-122.29,1800,5000,1570,0.44857142857142857,3724900,12250000,8525100
305000.0,4,2.0,1780,5043,1.0,0,0,2,7,870,910,1993,0.0,98133,47.7045,-122.34200000000001,1350,5044,3263,0.6470354947451914,3168400,25431849,22263449
602500.0,4,2.5,2760,6850,2.0,0,0,2,9,2760,0,1999,0.0,98056,47.5346,-122.185,2640,9803,4090,0.5970802919708029,7617600,46922500,39304900
355000.0,2,1.75,1620,3640,1.0,0,0,2,7,900,720,1929,0.0,98108,47.543,-122.29899999999999,1590,5538,2020,0.554945054945055,2624400,13249600,10625200
756000.0,3,2.5,2160,7525,2.0,0,0,2,9,2160,0,1986,0.0,98052,47.6608,-122.145,2470,7941,5365,0.7129568106312293,4665600,56625625,51960025
289950.0,4,2.25,2190,6906,1.0,0,0,3,7,1040,1150,1977,0.0,98023,47.318999999999996,-122.37299999999999,1250,6440,4716,0.6828844483058211,4796100,47692836,42896736
800000.0,3,2.5,3240,7857,2.0,0,0,2,10,3240,0,1994,0.0,98075,47.5857,-122.038,2970,7857,4617,0.5876288659793815,10497600,61732449,51234849
403000.0,2,1.0,720,3255,1.0,0,0,3,6,720,0,1905,0.0,98103,47.6823,-122.348,1430,3170,2535,0.7788018433179723,518400,10595025,10076625
350000.0,3,2.25,1410,1340,2.0,0,0,2,8,1370,40,1967,0.0,98008,47.6108,-122.113,1730,2748,-70,-0.05223880597014925,1988100,1795600,-192500
1290000.0,5,3.5,2980,5100,2.0,0,0,2,10,2370,610,2015,0.0,98115,47.6782,-122.29899999999999,1780,5100,2120,0.41568627450980394,8880400,26010000,17129600
525126.0,5,2.25,1950,8025,1.0,0,2,2,7,1150,800,1960,0.0,98008,47.6159,-122.11399999999999,1780,8560,6075,0.7570093457943925,3802500,64400625,60598125
241450.0,3,1.0,1100,8138,1.0,0,0,2,7,1100,0,1949,0.0,98155,47.7393,-122.325,1440,8131,7038,0.8648316539690342,1210000,66227044,65017044
320000.0,3,1.5,1400,9087,1.0,0,0,2,7,1400,0,1954,0.0,98133,47.7711,-122.34,1490,8380,7687,0.8459337515131506,1960000,82573569,80613569
234000.0,4,2.0,1710,7455,1.0,0,0,2,7,1030,680,1975,0.0,98031,47.3965,-122.17299999999999,1710,7350,5745,0.7706237424547284,2924100,55577025,52652925
441000.0,5,2.5,2000,3600,1.0,0,0,2,6,1150,850,1987,0.0,98144,47.5971,-122.295,1410,3600,1600,0.4444444444444444,4000000,12960000,8960000
474500.0,5,2.5,2000,3600,1.0,0,0,2,6,1150,850,1987,0.0,98144,47.5971,-122.295,1410,3600,1600,0.4444444444444444,4000000,12960000,8960000
705000.0,3,1.0,1440,2618,1.5,0,0,3,7,1440,0,1906,0.0,98103,47.6582,-122.336,1850,3990,1178,0.4499618029029794,2073600,6853924,4780324
517500.0,4,2.5,1520,3370,2.0,0,0,2,8,1520,0,1994,0.0,98029,47.5696,-122.00399999999999,1860,4486,1850,0.5489614243323442,2310400,11356900,9046500
142500.0,4,0.75,1440,13300,1.0,0,0,2,6,1440,0,1948,0.0,98166,47.4761,-122.337,1460,11100,11860,0.8917293233082707,2073600,176890000,174816400
310000.0,2,1.5,1010,10005,2.0,0,0,2,7,1010,0,1981,0.0,98056,47.5118,-122.189,1210,7794,8995,0.8990504747626187,1020100,100100025,99079925
749500.0,4,2.5,2440,9727,2.0,0,0,2,9,2440,0,1987,0.0,98052,47.6613,-122.132,2370,11503,7287,0.7491518453788424,5953600,94614529,88660929
360000.0,5,3.0,2480,7200,1.0,0,0,2,7,1560,920,1999,0.0,98188,47.4586,-122.28299999999999,1910,9432,4720,0.6555555555555556,6150400,51840000,45689600
267500.0,3,1.0,1090,22080,1.0,0,0,4,7,1090,0,1967,0.0,98038,47.3991,-121.964,1590,19457,20990,0.9506340579710145,1188100,487526400,486338300
290000.0,3,1.0,1480,32700,1.0,0,0,3,6,1380,100,1942,0.0,98168,47.4949,-122.32700000000001,1500,22600,31220,0.9547400611620795,2190400,1069290000,1067099600
850000.0,5,2.5,2800,11325,1.0,0,0,3,8,1400,1400,1970,0.0,98005,47.6166,-122.17200000000001,2510,13700,8525,0.7527593818984547,7840000,128255625,120415625
815000.0,4,1.75,1820,4500,1.5,0,0,2,8,1820,0,1921,0.0,98119,47.6429,-122.36,1870,3600,2680,0.5955555555555555,3312400,20250000,16937600
2200000.0,5,4.0,5840,11652,2.0,0,1,2,11,4410,1430,1988,0.0,98004,47.5835,-122.20200000000001,3120,13639,5812,0.49879848952969447,34105600,135769104,101663504
1630000.0,4,3.25,2980,3600,2.0,0,0,2,9,2150,830,1999,0.0,98112,47.6352,-122.28399999999999,2980,4800,620,0.17222222222222222,8880400,12960000,4079600
175000.0,3,1.5,1220,7300,1.0,0,0,2,7,1220,0,1973,0.0,98001,47.3341,-122.279,1260,7347,6080,0.8328767123287671,1488400,53290000,51801600
429950.0,3,1.75,1830,9758,1.0,0,0,2,8,1300,530,1977,0.0,98034,47.7107,-122.23,1850,8000,7928,0.8124615699938512,3348900,95218564,91869664
675000.0,4,2.5,2900,5505,2.0,0,0,2,8,2900,0,2002,0.0,98074,47.6063,-122.02,2970,5251,2605,0.4732061762034514,8410000,30305025,21895025
580000.0,3,2.25,1940,5980,1.0,0,0,2,7,1520,420,1987,0.0,98027,47.5476,-122.075,1910,6309,4040,0.6755852842809364,3763600,35760400,31996800
240000.0,4,2.0,1750,7800,1.0,0,0,3,6,1750,0,1944,0.0,98166,47.4791,-122.34700000000001,1270,7800,6050,0.7756410256410257,3062500,60840000,57777500
374000.0,3,2.5,1850,17808,1.0,0,0,3,8,1210,640,1982,0.0,98032,47.3631,-122.271,2260,16754,15958,0.8961141060197664,3422500,317124864,313702364
862500.0,4,2.5,3220,4400,2.0,0,2,2,9,2180,1040,1937,0.0,98199,47.6325,-122.39399999999999,3000,5000,1180,0.2681818181818182,10368400,19360000,8991600
140000.0,2,1.0,1080,6052,1.0,0,0,4,6,1080,0,1908,0.0,98030,47.3857,-122.215,1810,7830,4972,0.8215465961665566,1166400,36626704,35460304
740000.0,5,3.75,3990,18897,2.0,0,0,2,8,3090,900,1937,0.0,98125,47.7228,-122.31,2080,9793,14907,0.7888553738688681,15920100,357096609,341176509
589000.0,3,1.75,920,3600,1.0,0,0,3,6,820,100,1904,0.0,98119,47.6386,-122.365,1620,3600,2680,0.7444444444444445,846400,12960000,12113600
275000.0,3,1.75,1290,9760,1.0,0,0,2,7,1290,0,1979,0.0,98058,47.4265,-122.148,1410,8034,8470,0.867827868852459,1664100,95257600,93593500
489900.0,4,2.5,2090,4196,2.0,0,0,2,8,2090,0,2006,0.0,98011,47.7453,-122.19200000000001,2640,4503,2106,0.501906577693041,4368100,17606416,13238316
545000.0,3,2.5,1900,3366,2.0,0,0,2,9,1900,0,1996,0.0,98033,47.6679,-122.184,2500,3954,1466,0.4355317884729649,3610000,11329956,7719956
235000.0,4,1.0,1360,7132,1.5,0,0,2,6,1360,0,1941,0.0,98168,47.5054,-122.301,1280,7175,5772,0.8093101514301738,1849600,50865424,49015824
230000.0,3,1.0,1000,4000,1.5,0,0,3,6,1000,0,1915,0.0,98118,47.5523,-122.286,1040,4240,3000,0.75,1000000,16000000,15000000
655000.0,4,2.25,2170,4080,2.0,0,0,2,7,1920,250,1980,0.0,98122,47.6124,-122.29299999999999,1890,4400,1910,0.4681372549019608,4708900,16646400,11937500
185000.0,2,1.0,820,16030,1.0,0,0,3,5,820,0,1923,0.0,98022,47.2039,-122.00299999999999,1880,14046,15210,0.9488459139114162,672400,256960900,256288500
196000.0,3,1.0,1090,7400,1.0,0,0,3,7,1090,0,1962,0.0,98092,47.2923,-122.19,1140,8165,6310,0.8527027027027027,1188100,54760000,53571900
572000.0,3,2.25,1830,7897,1.0,0,0,3,8,1290,540,1986,0.0,98052,47.6914,-122.103,1990,8306,6067,0.7682664302899835,3348900,62362609,59013709
615000.0,4,2.5,3010,6903,2.0,0,0,2,9,3010,0,2001,0.0,98056,47.5213,-122.193,2860,6435,3893,0.5639576995509199,9060100,47651409,38591309
1950000.0,4,3.75,4150,17424,1.0,0,0,2,9,3130,1020,1963,2000.0,98039,47.638999999999996,-122.236,3930,21420,13274,0.7618227731864096,17222500,303595776,286373276
1230000.0,6,2.25,2930,4320,2.0,0,0,2,9,2130,800,1913,0.0,98112,47.6295,-122.306,2860,4320,1390,0.32175925925925924,8584900,18662400,10077500
375000.0,3,2.5,1520,5649,2.0,0,0,3,7,1520,0,1989,0.0,98034,47.7221,-122.162,1540,5000,4129,0.7309258275801027,2310400,31911201,29600801
295000.0,3,1.75,1250,9486,1.0,0,0,3,6,1250,0,1971,0.0,98070,47.4341,-122.446,1270,9600,8236,0.8682268606367278,1562500,89984196,88421696
760000.0,4,2.5,2760,6000,2.0,0,0,4,7,2230,530,1942,0.0,98115,47.6877,-122.295,1600,6000,3240,0.54,7617600,36000000,28382400
347000.0,3,1.75,1330,7848,1.0,0,0,2,8,1330,0,1978,0.0,98058,47.4463,-122.12700000000001,2110,8497,6518,0.8305300713557594,1768900,61591104,59822204
712000.0,3,2.0,1700,5100,1.5,0,0,3,7,1500,200,1924,0.0,98117,47.678999999999995,-122.39,1700,5100,3400,0.6666666666666666,2890000,26010000,23120000
495000.0,4,2.0,2050,4000,1.5,0,0,4,7,1210,840,1941,0.0,98144,47.5799,-122.306,1310,4000,1950,0.4875,4202500,16000000,11797500
925000.0,4,2.0,3140,10437,1.0,0,0,3,8,2040,1100,1959,0.0,98040,47.5786,-122.229,2010,10437,7297,0.6991472645396186,9859600,108930969,99071369
775000.0,3,1.0,2030,4080,1.5,0,0,3,7,1840,190,1908,0.0,98115,47.6765,-122.30799999999999,2030,4080,2050,0.5024509803921569,4120900,16646400,12525500
429000.0,4,2.5,2100,7920,1.5,0,0,3,6,1400,700,1916,0.0,98126,47.5293,-122.37100000000001,1230,7920,5820,0.7348484848484849,4410000,62726400,58316400
229000.0,3,1.0,1010,12705,1.0,0,0,3,7,1010,0,1959,0.0,98003,47.3348,-122.303,1490,10200,11695,0.9205037386855569,1020100,161417025,160396925
400000.0,4,1.5,1980,113691,1.0,0,0,2,7,1980,0,1962,0.0,98024,47.5606,-121.853,1980,89298,111711,0.9825843734332533,3920400,12925643481,12921723081
625000.0,4,2.25,2100,8290,2.0,0,0,3,8,2100,0,1978,0.0,98006,47.5595,-122.12899999999999,2100,8290,6190,0.7466827503015682,4410000,68724100,64314100
130000.0,2,1.0,840,6654,1.0,0,0,2,7,840,0,1951,0.0,98133,47.7319,-122.335,1350,5831,5814,0.8737601442741209,705600,44275716,43570116
349000.0,3,1.75,1690,5080,1.0,0,0,2,7,1190,500,1976,0.0,98106,47.5312,-122.348,1300,5080,3390,0.6673228346456693,2856100,25806400,22950300
365000.0,3,2.0,2140,26600,1.0,0,0,3,7,2140,0,1983,0.0,98031,47.4066,-122.169,2310,8783,24460,0.9195488721804511,4579600,707560000,702980400
487500.0,3,2.5,1810,1988,2.0,0,0,2,7,1350,460,1997,0.0,98199,47.6513,-122.385,1600,1525,178,0.08953722334004025,3276100,3952144,676044
475000.0,3,2.5,2600,7210,2.0,0,0,2,8,2600,0,1989,0.0,98059,47.5123,-122.15100000000001,2350,7225,4610,0.6393897364771152,6760000,51984100,45224100
685000.0,3,1.75,1650,8400,1.0,0,0,2,8,1470,180,1959,0.0,98040,47.5766,-122.236,2020,7777,6750,0.8035714285714286,2722500,70560000,67837500
960000.0,3,1.75,2460,4800,1.0,0,0,3,7,1230,1230,1938,0.0,98112,47.6343,-122.28200000000001,2860,4800,2340,0.4875,6051600,23040000,16988400
1100000.0,5,2.25,4320,7620,2.0,0,0,2,7,2880,1440,1973,2014.0,98115,47.6824,-122.287,1880,7620,3300,0.4330708661417323,18662400,58064400,39402000
428000.0,3,2.25,2600,15000,2.0,0,0,2,9,2600,0,1978,0.0,98038,47.3719,-122.056,2380,15000,12400,0.8266666666666667,6760000,225000000,218240000
435000.0,3,2.5,1930,5790,2.0,0,0,3,7,1930,0,1988,0.0,98011,47.7733,-122.17,1790,4901,3860,0.6666666666666666,3724900,33524100,29799200
769950.0,3,2.0,2190,5400,1.0,0,2,4,7,1260,930,1952,0.0,98107,47.6737,-122.4,2160,5400,3210,0.5944444444444444,4796100,29160000,24363900
385000.0,3,1.0,1420,10980,1.0,0,0,3,7,1200,220,1954,0.0,98006,47.574,-122.13799999999999,1630,9763,9560,0.8706739526411658,2016400,120560400,118544000
352000.0,3,2.5,2090,3002,2.0,0,0,2,7,1670,420,2005,0.0,98019,47.745,-121.984,2090,3163,912,0.3037974683544304,4368100,9012004,4643904
622500.0,3,2.5,2290,14374,2.0,0,0,2,8,2290,0,1983,2012.0,98075,47.5886,-122.074,2290,33450,12084,0.8406845693613468,5244100,206611876,201367776
660000.0,3,3.0,2470,11900,2.0,0,0,2,9,2290,180,1976,0.0,98074,47.64100000000001,-122.057,2590,11900,9430,0.7924369747899159,6100900,141610000,135509100
105000.0,3,1.0,840,8400,1.0,0,0,2,6,840,0,1959,0.0,98023,47.3277,-122.34299999999999,840,9450,7560,0.9,705600,70560000,69854400
420000.0,2,1.0,2100,4480,1.0,0,0,4,7,1400,700,1908,0.0,98126,47.574,-122.37200000000001,1570,4400,2380,0.53125,4410000,20070400,15660400
499950.0,3,1.5,1360,11250,1.0,0,0,3,7,1360,0,1955,0.0,98006,47.5697,-122.177,1440,11250,9890,0.8791111111111111,1849600,126562500,124712900
975000.0,6,3.0,3420,22421,1.0,0,0,4,9,2270,1150,1948,0.0,98006,47.5508,-122.189,2430,15560,19001,0.8474644306676776,11696400,502701241,491004841
665000.0,3,2.75,1930,2960,1.5,0,0,4,7,1490,440,1929,0.0,98105,47.6659,-122.287,2080,3760,1030,0.34797297297297297,3724900,8761600,5036700
540000.0,4,2.5,2180,10140,1.0,0,0,3,7,1180,1000,1968,0.0,98052,47.6822,-122.111,1840,9375,7960,0.7850098619329389,4752400,102819600,98067200
400000.0,4,2.0,1670,12056,1.0,0,0,2,7,1670,0,1955,0.0,98028,47.7418,-122.244,1860,12056,10386,0.8614797611147976,2788900,145347136,142558236
469950.0,4,2.75,2720,6427,1.0,0,0,2,8,1650,1070,2008,0.0,98146,47.4931,-122.354,2720,8484,3707,0.5767854364400187,7398400,41306329,33907929
777000.0,4,2.5,3170,9900,2.0,0,0,3,8,3170,0,1979,0.0,98007,47.6181,-122.147,2540,12400,6730,0.6797979797979798,10048900,98010000,87961100
346500.0,2,1.75,1610,6300,1.0,0,0,2,7,1010,600,1941,0.0,98108,47.553999999999995,-122.304,1370,5225,4690,0.7444444444444445,2592100,39690000,37097900
685000.0,3,2.5,2370,4950,2.0,0,0,2,8,2370,0,2003,0.0,98029,47.5465,-122.01299999999999,2230,4950,2580,0.5212121212121212,5616900,24502500,18885600
396500.0,3,2.5,2590,18980,1.0,0,0,3,10,2590,0,1976,0.0,98042,47.3839,-122.15299999999999,3110,14652,16390,0.8635405690200211,6708100,360240400,353532300
783500.0,3,2.5,2850,7130,2.0,0,0,2,10,1990,860,1980,0.0,98122,47.603,-122.289,2280,6459,4280,0.6002805049088359,8122500,50836900,42714400
575000.0,4,2.0,1660,4800,1.5,0,0,2,7,1660,0,1922,0.0,98103,47.6556,-122.345,1660,4800,3140,0.6541666666666667,2755600,23040000,20284400
1500000.0,4,4.25,5550,12968,2.0,0,0,2,11,5550,0,2005,0.0,98059,47.5305,-122.135,4750,13001,7418,0.5720234423195558,30802500,168169024,137366524
515000.0,3,1.5,2200,7620,1.0,0,0,3,7,1130,1070,1942,0.0,98177,47.7263,-122.363,2170,7672,5420,0.7112860892388452,4840000,58064400,53224400
300000.0,3,2.5,2020,6628,1.0,0,0,3,7,1250,770,1963,0.0,98168,47.4934,-122.33200000000001,1540,9995,4608,0.6952323476161738,4080400,43930384,39849984
272000.0,3,1.5,1760,9600,1.0,0,0,3,7,1760,0,1966,0.0,98031,47.4085,-122.195,1450,9600,7840,0.8166666666666667,3097600,92160000,89062400
355000.0,4,2.25,1810,4970,2.0,0,0,2,7,1810,0,2003,0.0,98059,47.5003,-122.156,1810,4858,3160,0.635814889336016,3276100,24700900,21424800
223000.0,3,2.0,1310,8440,1.0,0,0,4,6,1310,0,1951,0.0,98178,47.5003,-122.26899999999999,1790,10775,7130,0.8447867298578199,1716100,71233600,69517500
397000.0,4,2.5,3000,8584,2.0,0,0,2,7,3000,0,2003,0.0,98038,47.369,-122.03200000000001,2610,7570,5584,0.6505125815470643,9000000,73685056,64685056
460000.0,2,2.0,1080,5000,1.0,0,0,4,6,1080,0,1923,0.0,98117,47.6826,-122.39399999999999,1530,5000,3920,0.784,1166400,25000000,23833600
848000.0,3,2.75,2170,2738,1.5,0,0,3,9,1550,620,1930,0.0,98109,47.6389,-122.34899999999999,1170,1062,568,0.20745069393718044,4708900,7496644,2787744
392800.0,2,1.0,740,4275,1.0,0,0,4,6,740,0,1924,0.0,98115,47.688,-122.30799999999999,1900,4275,3535,0.8269005847953217,547600,18275625,17728025
1690000.0,3,3.25,5290,224442,2.0,0,0,3,11,4540,750,1988,0.0,98053,47.6671,-122.051,3750,84936,219152,0.9764304363710892,27984100,50374211364,50346227264
1800000.0,3,3.25,5290,224442,2.0,0,0,3,11,4540,750,1988,0.0,98053,47.6671,-122.051,3750,84936,219152,0.9764304363710892,27984100,50374211364,50346227264
577000.0,3,2.25,2370,7878,2.0,0,0,2,8,2370,0,1985,0.0,98034,47.7281,-122.16799999999999,1870,7766,5508,0.6991622239146992,5616900,62062884,56445984
570000.0,3,1.0,1890,3330,1.5,0,0,3,7,1390,500,1901,0.0,98103,47.6597,-122.352,1530,3330,1440,0.43243243243243246,3572100,11088900,7516800
250000.0,3,1.75,1160,6134,1.0,0,0,2,7,1160,0,1998,0.0,98002,47.3414,-122.21799999999999,1330,6301,4974,0.810890120639061,1345600,37625956,36280356
645000.0,4,1.75,1550,7350,1.5,0,0,3,8,1550,0,1958,0.0,98040,47.5795,-122.235,1860,7350,5800,0.7891156462585034,2402500,54022500,51620000
567500.0,3,2.5,3090,67082,2.0,0,0,2,9,3090,0,1990,0.0,98038,47.4032,-122.023,3650,62290,63992,0.9539369726603262,9548100,4499994724,4490446624
337000.0,4,2.5,2610,5240,2.0,0,0,2,8,2610,0,2004,0.0,98038,47.345,-122.042,2480,5240,2630,0.5019083969465649,6812100,27457600,20645500
280000.0,3,1.75,1230,8250,1.0,0,0,2,7,1230,0,1966,0.0,98058,47.4526,-122.176,1250,8250,7020,0.850909090909091,1512900,68062500,66549600
167000.0,3,1.5,1280,5547,2.0,0,0,3,6,1280,0,1985,0.0,98002,47.3344,-122.215,1150,4500,4267,0.7692446367405805,1638400,30769209,29130809
280000.0,2,1.0,1880,7560,1.0,0,0,2,6,940,940,1919,0.0,98126,47.5261,-122.374,1280,7560,5680,0.7513227513227513,3534400,57153600,53619200
317500.0,2,1.5,1220,8409,1.0,0,0,3,6,1220,0,1948,0.0,98155,47.7534,-122.324,1130,8409,7189,0.8549173504578428,1488400,70711281,69222881
405500.0,2,2.75,1350,1252,2.0,0,0,2,8,1120,230,2006,0.0,98136,47.522,-122.39,1410,1265,-98,-0.07827476038338659,1822500,1567504,-254996
495000.0,4,2.5,2370,15336,2.0,0,0,2,8,2370,0,1995,0.0,98024,47.5633,-121.90100000000001,2110,15925,12966,0.8454616588419406,5616900,235192896,229575996
691000.0,4,3.0,3040,11651,2.0,0,0,2,10,3040,0,1987,0.0,98074,47.6348,-122.038,2540,11815,8611,0.7390781907132435,9241600,135745801,126504201
480000.0,5,1.75,2080,217800,1.0,0,0,4,7,2080,0,1963,0.0,98070,47.3884,-122.404,1670,213008,215720,0.9904499540863178,4326400,47436840000,47432513600
549010.0,2,1.75,1560,4141,1.0,0,0,3,7,880,680,1942,0.0,98117,47.6863,-122.382,1210,4141,2581,0.6232794011108428,2433600,17147881,14714281
750000.0,5,3.5,2980,5809,2.0,0,2,2,8,2980,0,2005,0.0,98029,47.5537,-121.99600000000001,2120,3416,2829,0.48700292649337235,8880400,33744481,24864081
365000.0,2,1.0,870,5689,1.0,0,0,3,7,870,0,1948,0.0,98103,47.6988,-122.351,1100,5711,4819,0.847073299349622,756900,32364721,31607821
412500.0,3,1.75,1660,10716,1.0,0,0,2,7,1100,560,1988,0.0,98034,47.7326,-122.234,1630,7626,9056,0.8450914520343412,2755600,114832656,112077056
425000.0,3,2.25,1870,9000,1.0,0,0,2,7,1440,430,1978,0.0,98011,47.7373,-122.198,1870,8640,7130,0.7922222222222223,3496900,81000000,77503100
920000.0,3,1.0,1410,9656,1.0,0,0,2,7,960,450,1953,0.0,98004,47.6354,-122.208,2410,9384,8246,0.853976801988401,1988100,93238336,91250236
340000.0,4,2.25,2180,8000,1.0,0,0,3,9,1630,550,1975,0.0,98023,47.317,-122.37799999999999,2310,8000,5820,0.7275,4752400,64000000,59247600
405000.0,4,2.5,2620,8960,1.0,0,0,4,7,1520,1100,1955,0.0,98133,47.7642,-122.335,1880,8960,6340,0.7075892857142857,6864400,80281600,73417200
537100.0,3,2.5,2450,7051,1.0,0,0,2,8,1870,580,1990,0.0,98056,47.5308,-122.171,2450,8788,4601,0.6525315558076868,6002500,49716601,43714101
353500.0,4,2.5,3250,4650,2.0,0,0,2,8,3250,0,2007,0.0,98031,47.4004,-122.20299999999999,2960,4650,1400,0.3010752688172043,10562500,21622500,11060000
522000.0,3,1.0,1150,7080,1.0,0,0,2,7,1150,0,1952,0.0,98125,47.7106,-122.288,1490,7921,5930,0.8375706214689266,1322500,50126400,48803900
710000.0,4,2.75,2780,6978,2.0,0,0,2,8,2780,0,2001,0.0,98053,47.6881,-122.04,2760,5460,4198,0.6016050444253368,7728400,48692484,40964084
329950.0,3,1.75,1360,13320,1.0,0,0,3,7,1360,0,1985,0.0,98059,47.4625,-122.069,1580,13625,11960,0.8978978978978979,1849600,177422400,175572800
830000.0,5,2.5,2810,14207,1.0,0,3,2,9,1540,1270,1979,0.0,98008,47.5742,-122.11,3190,14000,11397,0.8022101780812275,7896100,201838849,193942749
800500.0,4,2.5,1780,11130,1.0,0,0,4,8,1780,0,1962,0.0,98005,47.5931,-122.178,2610,11130,9350,0.8400718778077269,3168400,123876900,120708500
168500.0,3,1.0,1100,10125,1.0,0,0,2,7,1100,0,1969,0.0,98042,47.367,-122.10700000000001,1570,10650,9025,0.891358024691358,1210000,102515625,101305625
490000.0,3,2.5,2230,5348,2.0,0,0,2,8,2230,0,2000,0.0,98065,47.5347,-121.866,2190,5205,3118,0.5830216903515333,4972900,28601104,23628204
579000.0,3,2.5,1710,1904,2.0,0,0,2,8,1140,570,2003,0.0,98116,47.5827,-122.387,1260,1316,194,0.10189075630252101,2924100,3625216,701116
600000.0,4,2.5,2620,9873,2.0,0,0,2,8,2620,0,1987,0.0,98075,47.5822,-122.051,2520,9935,7253,0.7346297984401904,6864400,97476129,90611729
445000.0,4,1.75,1990,4725,1.5,0,0,3,7,1190,800,1944,0.0,98126,47.5275,-122.38,1240,4961,2735,0.5788359788359788,3960100,22325625,18365525
362500.0,4,1.75,1450,8450,1.0,0,0,2,7,1450,0,1960,0.0,98027,47.5289,-122.02799999999999,1540,8450,7000,0.8284023668639053,2102500,71402500,69300000
234000.0,4,2.0,1630,9010,1.0,0,0,3,7,1050,580,1975,0.0,98092,47.317,-122.196,1670,7820,7380,0.8190899001109878,2656900,81180100,78523200
321500.0,1,1.0,730,1942,1.0,0,0,2,7,730,0,2008,0.0,98144,47.5939,-122.29899999999999,1020,2183,1212,0.6240988671472708,532900,3771364,3238464
660000.0,3,1.75,1980,3300,1.5,0,0,3,7,1140,840,1926,0.0,98115,47.6733,-122.29799999999999,1590,5000,1320,0.4,3920400,10890000,6969600
319000.0,4,1.0,1730,36356,1.5,0,0,3,6,1730,0,1954,0.0,98031,47.4135,-122.199,1380,14060,34626,0.9524150071515018,2992900,1321758736,1318765836
314000.0,3,1.75,1350,217852,1.0,0,0,2,8,1100,250,1953,0.0,98022,47.2628,-122.03,2190,217800,216502,0.9938031324018141,1822500,47459493904,47457671404
517950.0,3,2.0,1410,5000,1.0,0,0,4,7,740,670,1908,0.0,98107,47.6752,-122.361,1830,4000,3590,0.718,1988100,25000000,23011900
525000.0,5,2.5,2360,10081,1.0,0,0,3,7,1180,1180,1961,0.0,98006,47.5552,-122.178,2200,10461,7721,0.7658962404523361,5569600,101626561,96056961
319500.0,3,1.0,1190,8450,1.0,0,0,4,6,1190,0,1961,0.0,98059,47.4807,-122.15700000000001,1660,8450,7260,0.8591715976331361,1416100,71402500,69986400
1580000.0,4,3.25,3760,10920,1.5,0,0,4,9,2400,1360,1950,0.0,98105,47.6687,-122.264,3430,11050,7160,0.6556776556776557,14137600,119246400,105108800
325000.0,1,1.0,1220,12426,1.0,0,4,3,6,1220,0,1946,0.0,98198,47.4047,-122.331,2770,22270,11206,0.9018187671012393,1488400,154405476,152917076
795000.0,4,2.5,2920,32219,2.0,0,0,4,10,2920,0,1995,0.0,98077,47.7439,-122.041,3420,37206,29299,0.9093702473695645,8526400,1038063961,1029537561
850000.0,2,1.75,1590,5136,1.5,0,3,2,9,1320,270,1927,0.0,98199,47.6424,-122.411,2520,5243,3546,0.6904205607476636,2528100,26378496,23850396
1010000.0,5,3.25,3510,10930,2.0,0,0,2,9,3510,0,2013,0.0,98033,47.6914,-122.21,1970,7488,7420,0.6788655077767612,12320100,119464900,107144800
475000.0,3,2.5,1320,1310,3.0,0,0,2,8,1320,0,2006,0.0,98107,47.6719,-122.38,1350,1250,-10,-0.007633587786259542,1742400,1716100,-26300
375000.0,3,1.0,1610,11250,1.0,0,0,2,7,1090,520,1975,0.0,98028,47.7391,-122.256,2040,10692,9640,0.8568888888888889,2592100,126562500,123970400
405000.0,3,1.0,1410,8053,1.0,0,0,3,7,1410,0,1951,0.0,98177,47.70399999999999,-122.367,1170,8042,6643,0.8249099714392152,1988100,64850809,62862709
420000.0,4,2.5,2170,10500,1.0,0,0,2,7,1570,600,1962,0.0,98155,47.7512,-122.295,1850,11127,8330,0.7933333333333333,4708900,110250000,105541100
775000.0,4,1.75,1890,4800,1.5,0,0,2,7,1390,500,1906,0.0,98119,47.6405,-122.367,1890,4800,2910,0.60625,3572100,23040000,19467900
800000.0,4,2.75,3260,5000,2.0,0,0,2,9,3260,0,2007,0.0,98027,47.5395,-121.99700000000001,3450,6218,1740,0.348,10627600,25000000,14372400
436800.0,3,1.75,2080,12714,2.0,0,0,3,8,1540,540,1984,0.0,98052,47.7056,-122.162,2080,12107,10634,0.83640081799591,4326400,161645796,157319396
620000.0,3,1.75,2040,4005,1.5,0,0,3,8,1740,300,1930,0.0,98117,47.6885,-122.38,1380,4005,1965,0.49063670411985016,4161600,16040025,11878425
230000.0,3,1.0,1250,9035,1.0,0,0,3,7,1250,0,1970,0.0,98003,47.275,-122.302,1350,10425,7785,0.8616491422246818,1562500,81631225,80068725
165000.0,1,1.0,850,8050,1.0,0,0,1,6,850,0,1906,0.0,98118,47.5427,-122.288,1590,5180,7200,0.8944099378881988,722500,64802500,64080000
490000.0,1,1.0,850,8050,1.0,0,0,1,6,850,0,1906,0.0,98118,47.5427,-122.288,1590,5180,7200,0.8944099378881988,722500,64802500,64080000
480000.0,3,1.75,1600,8400,1.0,0,0,4,8,1600,0,1963,0.0,98006,47.5479,-122.179,2210,8400,6800,0.8095238095238095,2560000,70560000,68000000
570000.0,3,2.5,2400,6975,2.0,0,0,2,9,2400,0,1993,0.0,98056,47.534,-122.179,2640,11172,4575,0.6559139784946236,5760000,48650625,42890625
615000.0,3,2.25,1870,4894,2.0,0,0,3,8,1750,120,1992,0.0,98033,47.6943,-122.19,1920,5988,3024,0.6178994687372292,3496900,23951236,20454336
280000.0,3,1.0,1720,9605,1.0,0,0,2,7,860,860,1969,0.0,98028,47.7439,-122.242,1720,9998,7885,0.8209266007287871,2958400,92256025,89297625
326000.0,3,1.0,1030,9834,1.0,0,0,2,7,1030,0,1969,0.0,98072,47.7676,-122.164,1210,9875,8804,0.8952613382143584,1060900,96707556,95646656
550700.0,2,2.25,1190,1499,2.0,0,0,2,9,1100,90,2004,0.0,98105,47.6666,-122.285,1430,1332,309,0.20613742494996665,1416100,2247001,830901
600000.0,2,1.0,910,2002,1.5,0,0,2,6,910,0,1900,0.0,98112,47.6188,-122.306,1190,1208,1092,0.5454545454545454,828100,4008004,3179904
450000.0,3,1.0,1290,47044,1.0,0,0,2,7,1150,140,1968,0.0,98029,47.5655,-121.99799999999999,1960,49658,45754,0.9725788623416376,1664100,2213137936,2211473836
546000.0,2,2.25,1530,1324,2.0,0,0,2,8,1280,250,2010,0.0,98122,47.6032,-122.311,1410,1689,-206,-0.1555891238670695,2340900,1752976,-587924
585000.0,3,2.5,2330,33750,2.0,0,0,2,9,2330,0,1983,2001.0,98045,47.4787,-121.723,2270,35000,31420,0.930962962962963,5428900,1139062500,1133633600
489000.0,3,1.75,2090,7667,1.0,0,2,2,7,1200,890,1952,0.0,98115,47.7007,-122.31200000000001,1480,7666,5577,0.727403156384505,4368100,58782889,54414789
765000.0,3,2.0,1570,7000,2.0,0,2,3,8,1050,520,1971,0.0,98122,47.6061,-122.286,1990,6675,5430,0.7757142857142857,2464900,49000000,46535100
519000.0,3,1.75,1560,26099,1.0,0,3,3,8,1560,0,1973,0.0,98070,47.5023,-122.46700000000001,1760,19687,24539,0.9402275949270087,2433600,681157801,678724201
262000.0,2,1.0,1500,4120,1.5,0,0,2,5,880,620,1928,0.0,98055,47.4857,-122.2,1300,4120,2620,0.6359223300970874,2250000,16974400,14724400
550000.0,4,2.75,2160,5005,1.0,0,0,2,7,1430,730,1987,0.0,98115,47.6971,-122.302,1770,5326,2845,0.5684315684315684,4665600,25050025,20384425
285000.0,2,1.0,780,5000,1.0,0,0,3,6,780,0,1943,0.0,98146,47.5112,-122.35700000000001,1030,5000,4220,0.844,608400,25000000,24391600
476000.0,4,1.75,2340,17541,1.0,0,0,3,7,1360,980,1956,0.0,98028,47.745,-122.229,2250,9212,15201,0.8665982555156491,5475600,307686681,302211081
2200000.0,3,2.0,3570,30456,1.0,0,1,2,8,2070,1500,1946,1982.0,98039,47.6413,-122.24,3570,27418,26886,0.8827817178881009,12744900,927567936,914823036
335000.0,1,1.0,720,5100,1.0,0,0,2,6,720,0,1907,0.0,98117,47.6821,-122.38,1320,5100,4380,0.8588235294117647,518400,26010000,25491600
510000.0,4,2.0,2990,102366,1.0,0,0,3,8,2990,0,1974,0.0,98092,47.3068,-122.088,2820,57140,99376,0.9707910829767696,8940100,10478797956,10469857856
291000.0,3,2.25,1860,13939,1.0,0,0,3,7,1860,0,1961,0.0,98030,47.3746,-122.21700000000001,1530,10018,12079,0.8665614463017434,3459600,194295721,190836121
335000.0,4,1.75,1950,13440,1.5,0,0,3,6,1950,0,1931,0.0,98065,47.5232,-121.821,1300,7432,11490,0.8549107142857143,3802500,180633600,176831100
415000.0,3,1.5,1860,9003,1.0,0,0,2,7,1490,370,1955,0.0,98028,47.7624,-122.26,2090,11574,7143,0.793402199266911,3459600,81054009,77594409
430000.0,3,2.0,1550,6039,1.0,0,0,4,7,830,720,1942,0.0,98126,47.5436,-122.37799999999999,1330,6042,4489,0.7433349892366286,2402500,36469521,34067021
270000.0,3,1.75,1610,6205,1.0,0,0,3,7,1210,400,1979,0.0,98023,47.3004,-122.383,1780,8056,4595,0.7405318291700241,2592100,38502025,35909925
760000.0,3,2.0,1810,4500,1.0,0,0,3,7,980,830,1906,0.0,98117,47.681000000000004,-122.359,1800,4500,2690,0.5977777777777777,3276100,20250000,16973900
450000.0,2,2.0,1730,4248,2.0,0,0,2,7,1730,0,1905,0.0,98144,47.5933,-122.30799999999999,1380,4000,2518,0.5927495291902072,2992900,18045504,15052604
425000.0,3,2.5,1230,23522,1.0,0,0,3,7,1230,0,1978,0.0,98059,47.515,-122.162,2340,23522,22292,0.9477085281863787,1512900,553284484,551771584
725000.0,4,2.5,2130,3420,1.5,0,0,3,7,1730,400,1916,0.0,98103,47.648999999999994,-122.336,1520,3420,1290,0.37719298245614036,4536900,11696400,7159500
700000.0,3,2.75,2190,11060,1.0,0,0,3,7,1610,580,1973,0.0,98033,47.6893,-122.208,2020,8588,8870,0.8019891500904159,4796100,122323600,117527500
998000.0,5,4.5,4130,10404,2.0,0,0,2,10,4130,0,2004,0.0,98029,47.5556,-122.03,3890,11531,6274,0.603037293348712,17056900,108243216,91186316
396000.0,3,2.25,1680,9766,2.0,0,0,2,7,1680,0,1989,0.0,98019,47.7341,-121.98100000000001,1590,9757,8086,0.8279746057751383,2822400,95374756,92552356
547000.0,3,2.5,1480,8381,1.0,0,0,3,7,1480,0,1968,0.0,98125,47.7078,-122.288,1710,8050,6901,0.8234100942608281,2190400,70241161,68050761
302000.0,4,1.5,1790,10200,1.0,0,0,3,8,1210,580,1963,0.0,98030,47.3774,-122.225,1540,6600,8410,0.8245098039215686,3204100,104040000,100835900
999000.0,5,3.5,2810,2700,2.0,0,0,4,9,1900,910,1910,0.0,98117,47.6799,-122.363,1510,3800,-110,-0.040740740740740744,7896100,7290000,-606100
633000.0,4,2.5,2360,10000,1.0,0,3,2,8,1980,380,1977,0.0,98126,47.573,-122.374,2480,5000,7640,0.764,5569600,100000000,94430400
265800.0,3,1.75,1460,7361,1.0,0,0,2,6,1460,0,1982,0.0,98019,47.7436,-121.979,1460,7505,5901,0.8016573835076756,2131600,54184321,52052721
530000.0,3,2.25,2160,8114,1.0,0,0,2,8,1460,700,1960,0.0,98133,47.7176,-122.35,2160,8000,5954,0.7337934434311068,4665600,65836996,61171396
605000.0,6,2.0,2610,9132,1.0,0,0,3,8,1320,1290,1965,0.0,98007,47.622,-122.14,2170,8000,6522,0.71419185282523,6812100,83393424,76581324
489000.0,4,2.5,2170,4587,2.0,0,0,2,7,2170,0,2006,0.0,98065,47.5396,-121.889,2170,5211,2417,0.526923915413124,4708900,21040569,16331669
305000.0,2,1.0,2160,12960,1.0,0,0,2,7,1360,800,1968,0.0,98168,47.4702,-122.26100000000001,2070,12960,10800,0.8333333333333334,4665600,167961600,163296000
513000.0,4,2.75,2020,7070,1.0,0,0,4,7,1010,1010,1958,0.0,98126,47.5202,-122.37799999999999,1390,6000,5050,0.7142857142857143,4080400,49984900,45904500
765000.0,4,2.5,2980,5000,2.0,0,0,2,10,2980,0,2006,0.0,98027,47.5431,-121.99700000000001,3140,5500,2020,0.404,8880400,25000000,16119600
550000.0,2,1.5,1300,2970,1.0,0,0,2,7,990,310,1903,0.0,98102,47.6233,-122.319,1700,3000,1670,0.5622895622895623,1690000,8820900,7130900
974350.0,4,2.5,3090,10730,2.0,0,0,4,8,2420,670,1985,0.0,98006,47.5458,-122.141,2220,7875,7640,0.712022367194781,9548100,115132900,105584800
653675.0,4,2.25,2280,7229,2.0,0,0,3,8,2280,0,1984,0.0,98027,47.5609,-122.081,2320,7735,4949,0.6846036796237377,5198400,52258441,47060041
245000.0,3,1.75,1260,8614,1.0,0,0,3,7,1260,0,1985,0.0,98038,47.3586,-122.056,1600,8614,7354,0.853726491757604,1587600,74200996,72613396
700180.0,2,1.75,1530,4387,1.0,0,0,2,8,1020,510,1952,0.0,98115,47.6726,-122.264,1870,5029,2857,0.6512423068155915,2340900,19245769,16904869
510000.0,3,2.5,1830,8133,1.0,0,0,2,8,1390,440,1996,0.0,98028,47.7478,-122.24700000000001,2310,11522,6303,0.7749907783105865,3348900,66145689,62796789
390000.0,3,2.5,1610,10292,1.0,0,0,3,7,1190,420,1969,0.0,98056,47.5349,-122.17399999999999,1940,8700,8682,0.8435678196657598,2592100,105925264,103333164
606500.0,3,2.5,2170,5500,2.0,0,0,2,8,2170,0,2000,0.0,98075,47.5975,-122.01799999999999,2170,5862,3330,0.6054545454545455,4708900,30250000,25541100
1500000.0,4,4.25,5020,26319,2.0,0,0,2,12,5020,0,1998,0.0,98074,47.6008,-122.01,4930,26319,21299,0.8092632698810746,25200400,692689761,667489361
290000.0,3,2.25,1620,7772,2.0,0,0,3,8,1620,0,1988,0.0,98003,47.3521,-122.302,1710,6455,6152,0.7915594441585178,2624400,60403984,57779584
115000.0,3,1.75,1080,7942,1.0,0,0,2,7,1080,0,1981,0.0,98023,47.3141,-122.355,1380,8244,6862,0.8640141022412491,1166400,63075364,61908964
500000.0,3,2.5,1940,37565,1.0,0,0,3,8,1940,0,1987,0.0,98027,47.4801,-122.06299999999999,2560,37565,35625,0.9483561826167975,3763600,1411129225,1407365625
580050.0,3,2.5,2360,4638,2.0,0,3,2,9,2360,0,1996,0.0,98115,47.6837,-122.321,1620,4638,2278,0.49115998275118583,5569600,21511044,15941444
550000.0,3,2.5,2010,2261,2.0,0,0,2,8,1390,620,2014,0.0,98029,47.5514,-121.99799999999999,1690,1899,251,0.11101282618310482,4040100,5112121,1072021
465000.0,3,1.0,800,3060,1.5,0,0,3,6,800,0,1903,0.0,98117,47.6769,-122.389,1180,3060,2260,0.738562091503268,640000,9363600,8723600
354950.0,3,1.0,970,5922,1.5,0,0,2,7,970,0,1949,0.0,98125,47.718999999999994,-122.321,1730,6128,4952,0.8362039851401554,940900,35070084,34129184
980000.0,4,3.25,3720,7150,2.0,0,2,2,11,3720,0,2007,0.0,98027,47.5359,-122.069,4040,7442,3430,0.4797202797202797,13838400,51122500,37284100
500000.0,3,2.25,2010,7447,2.0,0,0,2,8,2010,0,1985,0.0,98028,47.747,-122.24799999999999,2230,7846,5437,0.7300926547603062,4040100,55457809,51417709
667750.0,4,1.0,1430,4080,1.5,0,0,2,7,1430,0,1924,0.0,98105,47.6696,-122.324,1760,4080,2650,0.6495098039215687,2044900,16646400,14601500
735000.0,3,1.75,2250,11520,1.0,0,1,2,8,2250,0,1956,0.0,98028,47.7619,-122.26799999999999,2730,12445,9270,0.8046875,5062500,132710400,127647900
361000.0,3,1.75,2130,8742,1.0,0,3,2,7,1330,800,1955,0.0,98178,47.5057,-122.23100000000001,2380,7448,6612,0.7563486616334935,4536900,76422564,71885664
276750.0,3,2.0,1620,12482,1.0,0,0,3,7,1290,330,1989,0.0,98042,47.3584,-122.086,1560,8499,10862,0.8702131068738984,2624400,155800324,153175924
760000.0,4,3.25,3140,3680,2.0,0,0,2,10,2310,830,2009,0.0,98027,47.5319,-122.07600000000001,2620,2664,540,0.14673913043478262,9859600,13542400,3682800
475000.0,2,1.0,870,7975,1.0,0,2,2,7,870,0,1946,0.0,98107,47.6698,-122.361,1080,5722,7105,0.8909090909090909,756900,63600625,62843725
234000.0,4,2.5,1820,8217,1.0,0,0,2,7,1120,700,1987,0.0,98001,47.26300000000001,-122.242,1310,8217,6397,0.7785079712790556,3312400,67519089,64206689
234950.0,3,2.0,1510,9153,1.0,0,0,3,7,1510,0,1974,0.0,98001,47.3412,-122.273,1780,9286,7643,0.8350267671801596,2280100,83777409,81497309
269950.0,2,1.75,1320,7540,1.0,0,0,2,7,1320,0,1968,0.0,98038,47.3634,-122.052,1570,7540,6220,0.8249336870026526,1742400,56851600,55109200
495000.0,3,2.5,1800,7318,2.0,0,0,2,8,1800,0,1989,0.0,98029,47.5747,-122.008,1800,5414,5518,0.7540311560535665,3240000,53553124,50313124
438000.0,2,1.0,1120,6380,1.0,0,0,2,7,1120,0,1942,1994.0,98115,47.6951,-122.316,1230,6380,5260,0.8244514106583072,1254400,40704400,39450000
260000.0,3,1.75,2160,22702,1.0,0,0,3,7,2160,0,1981,0.0,98019,47.7355,-121.98200000000001,1820,22687,20542,0.9048541978680292,4665600,515380804,510715204
697000.0,4,2.5,3220,6399,2.0,0,0,2,9,3220,0,2004,0.0,98075,47.5883,-121.991,2850,6399,3179,0.4967963744335052,10368400,40947201,30578801
212625.0,2,1.0,960,5000,1.0,0,0,2,6,960,0,1951,0.0,98126,47.5188,-122.37200000000001,930,5000,4040,0.808,921600,25000000,24078400
593000.0,5,2.5,2640,4400,1.5,0,0,4,7,1840,800,1925,0.0,98122,47.605,-122.3,1720,4400,1760,0.4,6969600,19360000,12390400
410000.0,4,3.0,2430,7243,2.0,0,0,2,8,2430,0,2003,0.0,98038,47.3533,-122.016,2430,7084,4813,0.6645036587049565,5904900,52461049,46556149
445434.0,2,1.0,1470,7137,1.0,0,0,2,7,1020,450,1941,0.0,98103,47.7008,-122.352,1470,7067,5667,0.7940311055065153,2160900,50936769,48775869
200126.0,3,2.5,2040,15463,1.0,0,0,2,8,1340,700,1968,0.0,98003,47.3334,-122.322,2370,12672,13423,0.8680721722822221,4161600,239104369,234942769
290700.0,3,2.5,1670,6666,2.0,0,0,3,7,1670,0,1992,0.0,98038,47.3488,-122.03299999999999,1370,6170,4996,0.7494749474947495,2788900,44435556,41646656
248000.0,4,1.0,1010,7515,1.0,0,0,3,6,1010,0,1955,0.0,98198,47.4174,-122.316,1330,7515,6505,0.865602129075183,1020100,56475225,55455125
345000.0,1,1.0,540,10125,1.0,0,0,2,5,540,0,1961,0.0,98177,47.7739,-122.35799999999999,1840,10125,9585,0.9466666666666667,291600,102515625,102224025
525000.0,3,1.0,1240,4800,1.0,0,0,2,7,800,440,1951,0.0,98103,47.6563,-122.353,1440,4800,3560,0.7416666666666667,1537600,23040000,21502400
400000.0,3,1.75,1510,8385,1.0,0,0,2,7,1510,0,1968,0.0,98034,47.7279,-122.195,1570,7480,6875,0.8199165175909362,2280100,70308225,68028125
532000.0,3,1.0,1820,5750,1.0,0,0,2,7,1120,700,1918,0.0,98116,47.5773,-122.383,1500,5750,3930,0.6834782608695652,3312400,33062500,29750100
159995.0,2,1.0,1000,5026,1.0,0,0,4,5,760,240,1915,0.0,98002,47.297,-122.225,990,5026,4026,0.8010346199761241,1000000,25260676,24260676
287000.0,5,1.5,2040,11772,1.0,0,0,3,7,1030,1010,1963,0.0,98056,47.5015,-122.166,1560,9435,9732,0.8267074413863404,4161600,138579984,134418384
1120000.0,4,2.5,3690,11191,1.0,0,3,3,10,2190,1500,1951,0.0,98199,47.6434,-122.412,3460,8160,7501,0.6702707532838889,13616100,125238481,111622381
765000.0,3,2.5,2310,11993,2.0,0,0,2,9,2310,0,1988,0.0,98006,47.5438,-122.139,2830,10031,9683,0.8073876427916284,5336100,143832049,138495949
185000.0,3,1.5,1090,9605,1.0,0,0,3,6,1090,0,1969,0.0,98038,47.3609,-122.02799999999999,1160,10487,8515,0.8865174388339406,1188100,92256025,91067925
430000.0,3,1.0,1150,3000,1.0,0,0,4,6,1150,0,1906,0.0,98103,47.6867,-122.345,1460,3200,1850,0.6166666666666667,1322500,9000000,7677500
346000.0,4,2.5,2100,3916,2.0,0,0,2,8,2100,0,2009,0.0,98058,47.4324,-122.185,2100,3916,1816,0.4637385086823289,4410000,15335056,10925056
607000.0,4,2.75,2150,16728,1.0,0,0,3,8,1240,910,1982,0.0,98033,47.6915,-122.18299999999999,2200,9257,14578,0.8714729794356767,4622500,279825984,275203484
417000.0,3,1.5,2500,6000,1.5,0,0,4,7,1730,770,1941,1984.0,98106,47.5297,-122.354,1340,5000,3500,0.5833333333333334,6250000,36000000,29750000
930000.0,5,2.0,3530,9385,1.5,0,0,2,9,3530,0,1925,0.0,98144,47.5774,-122.285,4100,9203,5855,0.623867874267448,12460900,88078225,75617325
573300.0,2,1.75,1290,6600,1.0,0,2,2,7,870,420,1951,0.0,98136,47.53100000000001,-122.39,2380,7370,5310,0.8045454545454546,1664100,43560000,41895900
260000.0,4,1.75,2010,10816,1.0,0,0,2,7,1410,600,1955,0.0,98178,47.5048,-122.251,1610,9360,8806,0.8141642011834319,4040100,116985856,112945756
280000.0,1,0.75,420,6720,1.0,0,0,2,5,420,0,1922,0.0,98108,47.552,-122.311,1420,6720,6300,0.9375,176400,45158400,44982000
825000.0,4,2.5,2180,4000,2.0,0,0,2,8,2180,0,1920,2005.0,98122,47.6186,-122.288,2660,4000,1820,0.455,4752400,16000000,11247600
307000.0,4,1.0,1150,8184,1.5,0,0,2,6,1150,0,1947,0.0,98155,47.7431,-122.319,990,8184,7034,0.8594819159335289,1322500,66977856,65655356
595000.0,4,1.75,2000,5100,1.0,0,0,3,7,1130,870,1949,0.0,98117,47.6798,-122.391,1540,5100,3100,0.6078431372549019,4000000,26010000,22010000
528000.0,5,1.75,2780,7786,1.0,0,0,2,8,1390,1390,1966,0.0,98052,47.6694,-122.15700000000001,2130,7918,5006,0.6429488826098125,7728400,60621796,52893396
600000.0,2,1.75,1550,7764,1.0,1,4,3,8,1550,0,1965,1986.0,98070,47.358000000000004,-122.446,1690,11620,6214,0.8003606388459557,2402500,60279696,57877196
275000.0,2,1.0,2180,12875,1.0,0,0,2,7,1480,700,1959,0.0,98198,47.3757,-122.303,1800,7447,10695,0.8306796116504854,4752400,165765625,161013225
782000.0,2,1.5,1570,3600,1.5,0,2,3,7,1320,250,1906,0.0,98119,47.6366,-122.363,2140,3600,2030,0.5638888888888889,2464900,12960000,10495100
610000.0,3,2.5,2260,33042,1.0,0,0,2,9,1660,600,1986,0.0,98077,47.7634,-122.086,2600,40115,30782,0.9316022032564615,5107600,1091773764,1086666164
488000.0,3,1.0,1600,3200,1.5,0,0,2,7,1600,0,1909,0.0,98103,47.653,-122.331,1860,3420,1600,0.5,2560000,10240000,7680000
320000.0,3,1.0,1630,5000,1.0,0,0,2,7,930,700,1954,0.0,98108,47.5497,-122.295,1630,5480,3370,0.674,2656900,25000000,22343100
153500.0,3,1.0,890,4810,1.0,0,0,2,6,890,0,1910,0.0,98118,47.5153,-122.266,1230,6057,3920,0.814968814968815,792100,23136100,22344000
414500.0,3,1.0,1350,9450,1.0,0,0,2,7,1350,0,1979,0.0,98034,47.7186,-122.236,1460,9461,8100,0.8571428571428571,1822500,89302500,87480000
750000.0,5,1.75,2850,11860,1.0,0,0,2,9,2850,0,1951,0.0,98155,47.7503,-122.28,2640,11604,9010,0.7596964586846543,8122500,140659600,132537100
349990.0,3,1.0,1350,165092,1.0,0,3,4,6,1350,0,1925,0.0,98022,47.2217,-122.06299999999999,2300,211266,163742,0.9918227412594189,1822500,27255368464,27253545964
645000.0,3,2.25,3280,79279,1.0,0,0,2,10,3280,0,2001,0.0,98003,47.3207,-122.29299999999999,1860,24008,75999,0.9586271269819246,10758400,6285159841,6274401441
425000.0,2,1.0,1090,6000,1.0,0,0,2,7,1090,0,1922,0.0,98144,47.5886,-122.292,1960,5000,4910,0.8183333333333334,1188100,36000000,34811900
785000.0,4,2.5,2990,9374,2.0,0,0,2,9,2990,0,2003,0.0,98074,47.6287,-122.024,2440,8711,6384,0.6810326434819715,8940100,87871876,78931776
290000.0,3,1.75,1340,63597,1.0,0,0,3,7,1340,0,1963,0.0,98038,47.4379,-122.01100000000001,1950,87120,62257,0.9789298237338239,1795600,4044578409,4042782809
415000.0,3,1.75,1340,63597,1.0,0,0,3,7,1340,0,1963,0.0,98038,47.4379,-122.01100000000001,1950,87120,62257,0.9789298237338239,1795600,4044578409,4042782809
248500.0,2,1.0,720,5160,1.0,0,0,2,6,720,0,1949,0.0,98106,47.5274,-122.35700000000001,990,5160,4440,0.8604651162790697,518400,26625600,26107200
325000.0,3,2.5,2330,8627,1.0,0,0,3,7,1480,850,1980,0.0,98055,47.4543,-122.21,1940,9607,6297,0.7299177002434218,5428900,74425129,68996229
272925.0,2,1.0,1280,5728,1.5,0,0,4,6,1280,0,1941,0.0,98028,47.7477,-122.23200000000001,2480,9775,4448,0.776536312849162,1638400,32809984,31171584
500000.0,2,2.25,1570,1269,2.0,0,0,2,9,1280,290,2015,0.0,98199,47.6514,-122.385,1570,6000,-301,-0.2371946414499606,2464900,1610361,-854539
250000.0,4,1.75,1510,5500,1.5,0,0,2,7,1510,0,1920,0.0,98106,47.535,-122.359,1320,6431,3990,0.7254545454545455,2280100,30250000,27969900
470000.0,4,2.5,2470,8536,2.0,0,0,2,8,2470,0,2002,0.0,98155,47.7699,-122.292,1690,8840,6066,0.7106373008434864,6100900,72863296,66762396
440000.0,2,1.0,1190,3400,1.0,0,0,3,7,990,200,1917,0.0,98118,47.5539,-122.26799999999999,1180,4000,2210,0.65,1416100,11560000,10143900
299999.0,4,2.5,1981,4828,2.0,0,0,2,8,1981,0,2013,0.0,98092,47.3252,-122.167,1981,3783,2847,0.5896851698425849,3924361,23309584,19385223
255000.0,3,1.75,1590,7810,1.0,0,0,3,7,1590,0,1959,0.0,98002,47.2932,-122.22,1470,7810,6220,0.7964148527528809,2528100,60996100,58468000
415950.0,3,1.75,1150,7700,1.0,0,0,2,7,1150,0,1957,0.0,98008,47.6048,-122.12100000000001,1650,8000,6550,0.8506493506493507,1322500,59290000,57967500
402000.0,5,2.75,2160,7200,1.5,0,0,2,7,1220,940,1955,0.0,98118,47.5576,-122.273,1900,7200,5040,0.7,4665600,51840000,47174400
729000.0,3,1.5,1770,30689,1.0,0,4,2,9,1770,0,1953,0.0,98177,47.7648,-122.37,2650,30280,28919,0.9423246114242888,3132900,941814721,938681821
635000.0,2,2.5,2470,8840,2.0,0,0,3,8,1780,690,2001,0.0,98108,47.5693,-122.301,1940,8840,6370,0.7205882352941176,6100900,78145600,72044700
479000.0,3,2.5,1710,8998,2.0,0,0,2,8,1710,0,1982,0.0,98052,47.7236,-122.11,1710,9859,7288,0.8099577683929762,2924100,80964004,78039904
462370.0,2,2.25,1860,2670,2.0,0,0,3,8,1860,0,1986,0.0,98006,47.5436,-122.18700000000001,1860,2531,810,0.30337078651685395,3459600,7128900,3669300
171500.0,3,1.0,1150,6480,1.5,0,0,3,5,1150,0,1946,0.0,98001,47.2642,-122.258,1100,7300,5330,0.8225308641975309,1322500,41990400,40667900
925000.0,5,3.0,3850,9457,2.0,0,0,3,9,2910,940,1963,0.0,98177,47.727,-122.36200000000001,2830,9608,5607,0.5928941524796447,14822500,89434849,74612349
675000.0,5,3.0,3410,9600,1.0,0,0,3,8,1870,1540,1968,0.0,98052,47.6358,-122.103,2390,9679,6190,0.6447916666666667,11628100,92160000,80531900
320000.0,4,1.5,1890,43560,1.0,0,0,3,8,1890,0,1974,0.0,98092,47.3267,-122.166,2376,5820,41670,0.9566115702479339,3572100,1897473600,1893901500
499950.0,5,3.5,3200,43560,2.0,0,0,2,7,3200,0,1989,0.0,98059,47.475,-122.09299999999999,2730,43560,40360,0.9265381083562901,10240000,1897473600,1887233600
435000.0,5,1.0,2170,65340,1.5,0,0,3,7,1670,500,1930,0.0,98011,47.7555,-122.204,3170,12884,63170,0.9667891031527395,4708900,4269315600,4264606700
359800.0,4,2.5,2390,6426,2.0,0,0,2,9,2390,0,1999,0.0,98092,47.2586,-122.221,2520,6700,4036,0.6280734516028633,5712100,41293476,35581376
239900.0,3,2.0,1410,7566,1.0,0,0,2,7,1410,0,1985,0.0,98030,47.3674,-122.182,1570,7210,6156,0.8136399682791435,1988100,57244356,55256256
295000.0,2,1.0,740,4459,1.0,0,2,2,5,740,0,1915,0.0,98116,47.5704,-122.40899999999999,1490,4700,3719,0.8340435075128952,547600,19882681,19335081
380000.0,3,2.5,2150,25705,1.5,0,0,2,6,2150,0,1980,2009.0,98058,47.4514,-122.089,1850,20160,23555,0.9163586850807236,4622500,660747025,656124525
435000.0,4,2.5,2180,6500,2.0,0,0,2,7,1410,770,1945,0.0,98126,47.5365,-122.37,920,6500,4320,0.6646153846153846,4752400,42250000,37497600
508000.0,2,1.0,820,5040,1.0,0,0,2,7,820,0,1953,0.0,98199,47.6498,-122.38799999999999,1730,5760,4220,0.8373015873015873,672400,25401600,24729200
2400000.0,6,4.5,5480,10800,2.0,0,3,3,9,4430,1050,1999,0.0,98119,47.6307,-122.367,2970,7200,5320,0.4925925925925926,30030400,116640000,86609600
234500.0,4,2.5,1960,7875,1.0,0,0,2,7,1220,740,1978,0.0,98001,47.3427,-122.274,2030,7650,5915,0.7511111111111111,3841600,62015625,58174025
355000.0,2,1.0,1270,3200,1.0,0,0,3,7,960,310,1920,0.0,98103,47.6565,-122.348,1410,1320,1930,0.603125,1612900,10240000,8627100
230000.0,3,2.0,1710,5200,1.0,0,0,4,7,1030,680,1977,0.0,98042,47.3651,-122.094,1390,5200,3490,0.6711538461538461,2924100,27040000,24115900
345000.0,3,1.75,1930,9000,1.0,0,1,3,7,1150,780,1951,0.0,98166,47.4539,-122.348,1590,9000,7070,0.7855555555555556,3724900,81000000,77275100
430000.0,3,1.75,1200,4500,1.0,0,0,4,7,1200,0,1906,0.0,98108,47.5553,-122.316,1340,4500,3300,0.7333333333333333,1440000,20250000,18810000
500000.0,3,1.5,1680,17409,1.0,0,0,2,7,1680,0,1962,0.0,98033,47.6766,-122.176,1680,9101,15729,0.9034981905910736,2822400,303073281,300250881
378000.0,4,1.0,1300,6075,1.0,0,0,4,7,1300,0,1954,0.0,98133,47.773,-122.34899999999999,1450,7320,4775,0.7860082304526749,1690000,36905625,35215625
345000.0,3,2.5,1540,3237,2.0,0,0,2,7,1540,0,1999,0.0,98065,47.5299,-121.87799999999999,1780,3411,1697,0.5242508495520544,2371600,10478169,8106569
410000.0,2,1.75,870,4000,1.0,0,0,2,6,870,0,1941,0.0,98126,47.5657,-122.376,1420,4000,3130,0.7825,756900,16000000,15243100
750000.0,2,2.25,1890,5400,2.0,0,0,4,8,1610,280,1905,0.0,98105,47.6688,-122.31,2820,4860,3510,0.65,3572100,29160000,25587900
485000.0,4,1.75,2050,8913,1.0,0,0,2,7,1330,720,1968,0.0,98052,47.6735,-122.15100000000001,1290,8550,6863,0.7699988780433076,4202500,79441569,75239069
105000.0,3,1.0,880,18109,1.0,0,0,3,6,880,0,1970,0.0,98042,47.3634,-122.101,940,11193,17229,0.9514053785410569,774400,327935881,327161481
1030000.0,3,2.75,2780,4000,2.0,0,2,4,8,1960,820,1904,0.0,98103,47.6565,-122.355,1490,4800,1220,0.305,7728400,16000000,8271600
360000.0,3,1.0,1160,10988,1.0,0,0,2,7,1160,0,1965,0.0,98033,47.6818,-122.165,1670,51376,9828,0.8944302875864579,1345600,120736144,119390544
294000.0,5,2.75,2300,7600,1.0,0,0,3,7,1400,900,1969,0.0,98023,47.3084,-122.37200000000001,1750,8500,5300,0.6973684210526315,5290000,57760000,52470000
400000.0,4,2.5,3140,12792,2.0,0,0,3,9,3140,0,1977,0.0,98042,47.3863,-122.156,2510,12792,9652,0.7545340838023765,9859600,163635264,153775664
325000.0,3,1.75,2300,6200,1.0,0,0,3,7,1150,1150,1970,0.0,98198,47.4176,-122.323,1740,6600,3900,0.6290322580645161,5290000,38440000,33150000
770000.0,3,2.5,2900,23550,1.0,0,0,2,10,1490,1410,1987,0.0,98006,47.5708,-122.15299999999999,2900,19604,20650,0.8768577494692145,8410000,554602500,546192500
443000.0,3,2.25,1920,8223,2.0,0,0,3,7,1920,0,1989,0.0,98011,47.735,-122.20100000000001,1940,7274,6303,0.7665085735133164,3686400,67617729,63931329
325000.0,3,1.0,1150,7486,1.0,0,0,2,7,1150,0,1970,0.0,98034,47.7261,-122.219,1510,7486,6336,0.8463799091637724,1322500,56040196,54717696
760000.0,4,2.5,3120,8792,2.0,0,0,3,9,3120,0,1992,0.0,98029,47.5699,-121.993,2150,7688,5672,0.6451319381255687,9734400,77299264,67564864
640000.0,4,2.0,2560,7798,1.0,0,0,3,7,1890,670,1947,0.0,98115,47.6914,-122.296,1330,7798,5238,0.6717106950500128,6553600,60808804,54255204
415000.0,3,2.0,1410,4303,1.5,0,0,3,7,1410,0,1900,0.0,98108,47.5541,-122.31700000000001,1660,4326,2893,0.6723216360678597,1988100,18515809,16527709
156000.0,3,1.0,970,8580,1.0,0,0,2,7,970,0,1959,0.0,98003,47.3363,-122.311,1430,11907,7610,0.8869463869463869,940900,73616400,72675500
996000.0,3,3.25,3620,8131,2.0,0,0,3,10,2730,890,1988,0.0,98040,47.5776,-122.214,2040,3776,4511,0.5547903086951175,13104400,66113161,53008761
415000.0,2,1.0,880,5100,1.0,0,0,3,7,880,0,1941,0.0,98103,47.693999999999996,-122.346,980,5100,4220,0.8274509803921568,774400,26010000,25235600
615000.0,3,1.75,1900,3783,1.5,0,0,4,7,1110,790,1927,0.0,98144,47.5742,-122.315,1530,5098,1883,0.4977531060005287,3610000,14311089,10701089
717000.0,4,2.5,2540,4241,2.0,0,0,2,8,2540,0,2009,0.0,98052,47.7073,-122.11200000000001,3010,4929,1701,0.40108464984673425,6451600,17986081,11534481
548000.0,4,1.75,1690,7794,1.0,0,0,2,7,1090,600,1968,0.0,98033,47.6888,-122.20299999999999,1380,7325,6104,0.7831665383628432,2856100,60746436,57890336
425000.0,3,1.5,1120,6653,1.0,0,0,3,7,1120,0,1937,0.0,98133,47.7321,-122.334,1580,7355,5533,0.8316548925296858,1254400,44262409,43008009
325250.0,4,2.75,2130,9339,1.0,0,0,2,7,1330,800,1991,0.0,98198,47.3788,-122.316,2090,7628,7209,0.7719241888853197,4536900,87216921,82680021
1230000.0,3,2.5,3420,79279,2.0,0,0,2,11,3420,0,1990,0.0,98052,47.7225,-122.126,4240,40500,75859,0.9568612116701775,11696400,6285159841,6273463441
557500.0,3,1.75,1900,11165,1.0,0,0,3,7,1900,0,1959,0.0,98008,47.5789,-122.118,2030,11165,9265,0.8298253470667264,3610000,124657225,121047225
1260000.0,4,2.5,3730,16950,2.0,0,0,2,10,3730,0,1990,0.0,98040,47.5678,-122.228,3200,16950,13220,0.7799410029498525,13912900,287302500,273389600
249950.0,3,3.0,1790,2003,2.0,0,0,2,7,1480,310,2006,0.0,98108,47.5421,-122.321,1220,4000,213,0.10634048926610085,3204100,4012009,807909
260000.0,4,2.75,2250,7345,1.0,0,0,3,8,1320,930,1984,0.0,98023,47.2895,-122.37,1800,6950,5095,0.6936691626957113,5062500,53949025,48886525
1990000.0,3,2.5,2880,13500,1.0,0,4,4,8,1520,1360,1950,0.0,98004,47.6281,-122.21600000000001,3710,20486,10620,0.7866666666666666,8294400,182250000,173955600
442900.0,4,1.75,1780,2788,1.0,0,0,3,6,890,890,1943,0.0,98199,47.6511,-122.4,1760,5664,1008,0.3615494978479197,3168400,7772944,4604544
475000.0,3,2.25,1580,12177,1.0,0,0,2,7,1200,380,1981,0.0,98074,47.6254,-122.045,1660,11374,10597,0.8702471873203581,2496400,148279329,145782929
365000.0,5,2.75,3260,9253,2.0,0,0,2,8,3260,0,2004,0.0,98042,47.3674,-122.07,2770,8067,5993,0.6476818329190532,10627600,85618009,74990409
780000.0,4,2.5,3180,9603,2.0,0,2,2,9,3180,0,2002,0.0,98155,47.7717,-122.277,2440,15261,6423,0.668853483286473,10112400,92217609,82105209
930000.0,3,1.75,2460,4240,1.0,0,0,3,7,1230,1230,1925,0.0,98103,47.6593,-122.337,1700,4240,1780,0.419811320754717,6051600,17977600,11926000
2890000.0,5,6.25,8670,64033,2.0,0,4,2,13,6120,2550,1965,0.0,98177,47.7295,-122.37200000000001,4140,81021,55363,0.8646010650758202,75168900,4100225089,4025056189
350000.0,3,1.0,1020,4980,1.0,0,0,3,7,850,170,1941,0.0,98133,47.7039,-122.34,970,4980,3960,0.7951807228915663,1040400,24800400,23760000
357500.0,3,1.75,1630,9403,1.0,0,0,2,7,1630,0,1983,0.0,98155,47.757,-122.316,1430,8461,7773,0.8266510688078272,2656900,88416409,85759509
520000.0,4,2.5,3290,11446,2.0,0,0,2,8,3290,0,1992,0.0,98028,47.7399,-122.234,2050,11933,8156,0.7125633409051197,10824100,131010916,120186816
330000.0,4,2.5,1940,3784,2.0,0,0,2,8,1940,0,2003,0.0,98058,47.4513,-122.119,1940,4499,1844,0.48731501057082455,3763600,14318656,10555056
310000.0,3,2.0,1350,11150,1.0,0,0,2,7,1110,240,1995,0.0,98045,47.44600000000001,-121.77600000000001,1290,10043,9800,0.8789237668161435,1822500,124322500,122500000
279000.0,3,1.0,1110,6060,1.0,0,0,2,6,1110,0,1949,0.0,98166,47.4705,-122.352,1480,8100,4950,0.8168316831683168,1232100,36723600,35491500
540000.0,4,1.5,2993,19400,2.0,0,0,3,7,2233,760,1921,0.0,98166,47.4692,-122.365,2060,15100,16407,0.8457216494845361,8958049,376360000,367401951
322000.0,4,2.5,2280,7200,2.0,0,0,2,8,2280,0,1994,0.0,98030,47.3829,-122.20700000000001,2250,7200,4920,0.6833333333333333,5198400,51840000,46641600
380000.0,5,3.25,3800,15500,1.0,0,0,2,7,2490,1310,1965,0.0,98032,47.3862,-122.28,2000,13980,11700,0.7548387096774194,14440000,240250000,225810000
320000.0,2,1.0,850,8400,1.0,0,0,3,6,850,0,1941,0.0,98166,47.4696,-122.359,1280,8400,7550,0.8988095238095238,722500,70560000,69837500
400000.0,3,1.75,1560,8456,1.0,0,0,4,7,1560,0,1970,0.0,98028,47.7769,-122.25,2230,13109,6896,0.815515610217597,2433600,71503936,69070336
412000.0,3,1.0,1000,3844,1.0,0,0,4,7,900,100,1928,0.0,98133,47.7031,-122.34899999999999,1000,3920,2844,0.7398543184183143,1000000,14776336,13776336
887200.0,3,1.0,1400,5100,1.5,0,0,2,7,1400,0,1900,0.0,98103,47.6677,-122.333,1740,3060,3700,0.7254901960784313,1960000,26010000,24050000
395000.0,4,1.75,1540,5120,1.0,0,0,4,6,770,770,1943,0.0,98126,47.5359,-122.37200000000001,1080,5120,3580,0.69921875,2371600,26214400,23842800
895000.0,4,3.0,3570,10273,1.5,0,3,2,9,2630,940,1935,2007.0,98074,47.6394,-122.07700000000001,3640,15324,6703,0.6524871021123333,12744900,105534529,92789629
195000.0,2,1.0,800,5280,1.0,0,0,4,6,800,0,1918,0.0,98022,47.205,-121.995,1240,7670,4480,0.8484848484848485,640000,27878400,27238400
390000.0,3,1.0,1160,3750,1.5,0,0,2,7,1160,0,1910,0.0,98106,47.5652,-122.359,1530,3750,2590,0.6906666666666667,1345600,14062500,12716900
165000.0,3,1.0,1010,7690,1.0,0,0,3,6,1010,0,1958,0.0,98058,47.4501,-122.176,1010,7619,6680,0.8686605981794538,1020100,59136100,58116000
255000.0,3,1.0,1010,7690,1.0,0,0,3,6,1010,0,1958,0.0,98058,47.4501,-122.176,1010,7619,6680,0.8686605981794538,1020100,59136100,58116000
589000.0,4,2.25,2390,57599,2.0,0,0,2,8,2390,0,1981,0.0,98053,47.6651,-122.06700000000001,2390,38186,55209,0.9585062240663901,5712100,3317644801,3311932701
505000.0,3,2.5,1610,4611,2.0,0,0,2,8,1610,0,1996,0.0,98029,47.5678,-122.00399999999999,1730,4461,3001,0.6508349598785513,2592100,21261321,18669221
335750.0,3,3.0,2400,7260,1.0,0,0,2,7,1440,960,1955,0.0,98178,47.5045,-122.251,1060,7200,4860,0.6694214876033058,5760000,52707600,46947600
719000.0,3,1.75,1800,5816,1.0,0,0,4,7,900,900,1947,0.0,98199,47.6529,-122.40700000000001,1650,5816,4016,0.6905089408528198,3240000,33825856,30585856
796000.0,4,3.25,2110,3000,2.0,0,0,2,8,2110,0,2001,0.0,98115,47.6769,-122.32799999999999,1780,4000,890,0.2966666666666667,4452100,9000000,4547900
95000.0,2,1.0,960,7000,1.0,0,0,2,4,960,0,1918,0.0,98198,47.3864,-122.307,1850,8120,6040,0.8628571428571429,921600,49000000,48078400
525000.0,3,3.0,2600,5238,1.5,0,3,2,9,1890,710,1989,0.0,98198,47.3448,-122.32700000000001,2220,4853,2638,0.5036273386788851,6760000,27436644,20676644
417000.0,3,1.5,1340,10224,1.0,0,0,3,7,1340,0,1956,0.0,98006,47.5752,-122.15700000000001,1340,10440,8884,0.8689358372456965,1795600,104530176,102734576
410000.0,3,1.0,1410,5000,1.0,0,0,2,6,980,430,1925,0.0,98116,47.5769,-122.397,1410,5000,3590,0.718,1988100,25000000,23011900
984000.0,4,2.25,2390,12292,1.0,0,0,4,9,2390,0,1962,0.0,98040,47.5528,-122.221,2870,12337,9902,0.8055645948584446,5712100,151093264,145381164
325000.0,2,1.5,1180,834,3.0,0,0,2,8,1180,0,2009,0.0,98133,47.7074,-122.35600000000001,1180,1207,-346,-0.4148681055155875,1392400,695556,-696844
314950.0,3,1.0,1040,16986,1.0,0,0,3,7,1040,0,1968,0.0,98059,47.4812,-122.09700000000001,1660,16986,15946,0.9387731072648063,1081600,288524196,287442596
350000.0,3,2.25,1840,9929,1.0,0,0,2,7,1200,640,1987,0.0,98028,47.7408,-122.236,1710,9929,8089,0.8146842582334576,3385600,98585041,95199441
1050000.0,4,2.25,2630,4000,2.0,0,0,4,9,1810,820,1909,0.0,98102,47.6393,-122.31700000000001,2370,4700,1370,0.3425,6916900,16000000,9083100
657000.0,4,2.5,2640,25038,2.0,0,0,3,8,2640,0,1995,0.0,98056,47.5277,-122.17399999999999,2630,16668,22398,0.8945602683920441,6969600,626901444,619931844
234950.0,2,2.5,1720,3132,2.0,0,0,2,8,1720,0,1999,0.0,98042,47.3728,-122.15700000000001,1740,4220,1412,0.4508301404853129,2958400,9809424,6851024
410000.0,4,1.75,2320,7500,1.0,0,0,2,7,1220,1100,1955,0.0,98133,47.7574,-122.34299999999999,2230,7500,5180,0.6906666666666667,5382400,56250000,50867600
625000.0,3,1.75,1840,5664,2.0,0,0,2,7,1270,570,1948,0.0,98115,47.6899,-122.28299999999999,1480,5664,3824,0.6751412429378532,3385600,32080896,28695296
706000.0,5,2.5,2890,15891,2.0,0,0,2,9,2890,0,1990,0.0,98059,47.5286,-122.16,2590,10556,13001,0.8181360518532502,8352100,252523881,244171781
485000.0,3,1.75,2200,7706,2.0,0,2,2,7,2200,0,1908,1988.0,98198,47.3878,-122.32600000000001,1170,70973,5506,0.7145081754477031,4840000,59382436,54542436
685000.0,4,2.75,1660,5150,1.5,0,0,4,7,1280,380,1928,0.0,98117,47.6835,-122.36200000000001,1490,4017,3490,0.6776699029126214,2755600,26522500,23766900
242050.0,3,2.5,2170,9900,1.0,0,0,2,7,1690,480,1980,0.0,98038,47.3634,-122.031,1420,10614,7730,0.7808080808080808,4708900,98010000,93301100
770000.0,3,3.25,3310,5000,2.0,0,0,2,9,3310,0,2006,0.0,98029,47.5558,-122.001,2670,4907,1690,0.338,10956100,25000000,14043900
557000.0,2,1.5,1450,3840,1.0,0,0,2,7,950,500,1947,0.0,98117,47.684,-122.381,1450,3840,2390,0.6223958333333334,2102500,14745600,12643100
246000.0,3,1.75,1440,11325,1.0,0,0,3,8,1440,0,1966,0.0,98001,47.3503,-122.279,1440,20000,9885,0.8728476821192053,2073600,128255625,126182025
194000.0,4,2.0,1760,7700,1.0,0,0,3,7,1760,0,1962,0.0,98003,47.3299,-122.318,1870,7316,5940,0.7714285714285715,3097600,59290000,56192400
720000.0,3,2.5,3170,7187,2.0,0,0,2,9,3170,0,2005,0.0,98033,47.6934,-122.166,2790,7336,4017,0.5589258383191874,10048900,51652969,41604069
449000.0,2,1.0,1250,4576,1.0,0,0,2,6,1040,0,1925,0.0,98118,47.5387,-122.266,1550,5000,3326,0.7268356643356644,1562500,20939776,19377276
925000.0,4,2.5,3280,209088,2.0,0,0,2,10,3280,0,1994,0.0,98053,47.6553,-122.023,2460,39498,205808,0.9843128252219161,10758400,43717791744,43707033344
570000.0,4,3.0,2460,10401,1.0,0,0,4,7,1700,760,1947,0.0,98125,47.7106,-122.285,1470,7727,7941,0.7634842803576579,6051600,108180801,102129201
395000.0,3,2.0,1470,10125,1.0,0,0,3,7,1470,0,1962,0.0,98011,47.7751,-122.22200000000001,1440,10125,8655,0.8548148148148148,2160900,102515625,100354725
1000000.0,4,2.0,1780,15648,1.5,0,0,4,8,1780,0,1918,0.0,98004,47.5849,-122.198,2320,14963,13868,0.8862474437627812,3168400,244859904,241691504
406000.0,4,1.0,1580,8475,1.5,0,2,3,7,1580,0,1928,0.0,98178,47.5104,-122.25399999999999,1700,5650,6895,0.8135693215339233,2496400,71825625,69329225
574800.0,3,1.5,1630,2946,1.5,0,0,3,8,1630,0,1932,0.0,98115,47.6865,-122.31,1550,3800,1316,0.4467073998642227,2656900,8678916,6022016
309000.0,4,2.0,2240,9240,1.0,0,0,2,7,1120,1120,1968,0.0,98032,47.3666,-122.288,2040,8250,7000,0.7575757575757576,5017600,85377600,80360000
770000.0,3,2.5,2430,54059,2.0,0,0,2,10,2430,0,1987,0.0,98027,47.4664,-121.992,2910,49658,51629,0.9550491130061599,5904900,2922375481,2916470581
525000.0,3,1.5,1940,5625,1.0,0,0,3,7,1440,500,1941,0.0,98117,47.6818,-122.38799999999999,1460,5500,3685,0.6551111111111111,3763600,31640625,27877025
419000.0,3,2.5,1970,4058,2.0,0,0,2,7,1970,0,2004,0.0,98065,47.5308,-121.853,2340,4067,2088,0.5145391818629866,3880900,16467364,12586464
479000.0,4,2.5,2050,6705,1.0,0,0,3,7,1230,820,1973,0.0,98034,47.7242,-122.21700000000001,1610,7292,4655,0.6942580164056674,4202500,44957025,40754525
160000.0,3,1.0,1340,18552,1.5,0,0,3,5,1340,0,1935,0.0,98014,47.7129,-121.325,960,15141,17212,0.9277705907718844,1795600,344176704,342381104
333000.0,4,1.75,1880,9880,1.0,0,0,3,8,1880,0,1967,0.0,98058,47.4551,-122.15100000000001,1880,9600,8000,0.8097165991902834,3534400,97614400,94080000
310000.0,2,1.0,860,12160,1.0,0,0,3,6,860,0,1921,0.0,98106,47.5267,-122.361,1010,7611,11300,0.9292763157894737,739600,147865600,147126000
666000.0,3,2.5,2140,2868,2.0,0,0,2,8,1770,370,2007,0.0,98052,47.6668,-122.132,2140,2527,728,0.25383542538354253,4579600,8225424,3645824
2230000.0,3,3.0,3620,28064,2.0,1,4,4,10,2370,1250,1977,0.0,98136,47.5516,-122.398,2550,34713,24444,0.8710091220068416,13104400,787588096,774483696
310000.0,4,2.75,2370,7320,2.0,0,0,2,7,2370,0,1989,0.0,98023,47.3071,-122.36,1960,7320,4950,0.6762295081967213,5616900,53582400,47965500
350000.0,3,2.5,1860,21876,2.0,0,0,2,8,1860,0,1992,0.0,98014,47.6455,-121.90100000000001,2450,21876,20016,0.9149753154141524,3459600,478559376,475099776
610000.0,4,3.0,2110,5000,1.5,0,2,3,7,1640,0,1930,0.0,98136,47.5195,-122.391,1380,5000,2890,0.578,4452100,25000000,20547900
564800.0,3,2.25,1990,8501,2.0,0,0,2,8,1990,0,1991,0.0,98029,47.5707,-121.99600000000001,2090,6459,6511,0.7659098929537701,3960100,72267001,68306901
438000.0,3,2.25,1820,9150,1.0,0,0,2,7,1320,500,1961,0.0,98133,47.736999999999995,-122.334,1780,8055,7330,0.8010928961748633,3312400,83722500,80410100
855000.0,3,2.0,3120,9400,1.0,0,0,4,9,1820,1300,1978,0.0,98006,47.5612,-122.15,2770,9500,6280,0.6680851063829787,9734400,88360000,78625600
229000.0,3,2.5,1190,3000,2.0,0,0,2,7,1190,0,2002,0.0,98178,47.4933,-122.275,1190,3000,1810,0.6033333333333334,1416100,9000000,7583900
260000.0,3,2.0,1170,5450,1.0,0,0,4,6,1170,0,1902,0.0,98118,47.5276,-122.273,1340,6384,4280,0.7853211009174312,1368900,29702500,28333600
609000.0,3,2.5,2630,10131,2.0,0,0,2,9,2630,0,1989,0.0,98028,47.7695,-122.259,2800,10123,7501,0.7404007501727371,6916900,102637161,95720261
277000.0,4,1.0,1450,6250,1.0,0,0,2,6,990,460,1964,0.0,98146,47.5131,-122.35700000000001,1440,4000,4800,0.768,2102500,39062500,36960000
283000.0,4,2.0,2100,8160,1.0,0,0,2,7,1200,900,1959,0.0,98106,47.5145,-122.365,1140,8160,6060,0.7426470588235294,4410000,66585600,62175600
334000.0,2,1.75,1680,8367,1.0,0,0,2,6,840,840,1914,0.0,98115,47.6976,-122.288,1830,6720,6687,0.7992111868053066,2822400,70006689,67184289
267000.0,4,1.75,2000,7350,1.0,0,0,2,7,1100,900,1963,0.0,98003,47.3428,-122.303,1720,7350,5350,0.7278911564625851,4000000,54022500,50022500
385000.0,3,1.0,1030,3000,1.0,0,0,2,7,830,200,1924,0.0,98115,47.6813,-122.31700000000001,1830,3000,1970,0.6566666666666666,1060900,9000000,7939100
640000.0,5,1.75,2020,6565,1.0,0,0,2,8,1120,900,1956,0.0,98115,47.6821,-122.28299999999999,2020,6552,4545,0.6923076923076923,4080400,43099225,39018825
532500.0,4,2.0,2220,23750,1.0,0,0,2,7,2220,0,1963,0.0,98011,47.7759,-122.214,2650,21167,21530,0.9065263157894737,4928400,564062500,559134100
335000.0,4,2.5,1750,8476,1.0,0,0,3,7,1240,510,1983,0.0,98058,47.4447,-122.137,1660,7875,6726,0.7935346861727229,3062500,71842576,68780076
415000.0,3,2.5,1710,4920,2.0,0,0,2,7,1710,0,1990,0.0,98126,47.5347,-122.376,1500,4920,3210,0.6524390243902439,2924100,24206400,21282300
1100000.0,6,3.25,3560,107362,1.5,0,0,3,8,2760,800,1963,0.0,98005,47.6356,-122.15,3210,35001,103802,0.96684115422589,12673600,11526599044,11513925444
1440000.0,2,2.5,2720,16637,1.0,0,3,2,10,2160,560,1953,0.0,98118,47.5499,-122.264,2880,7320,13917,0.8365089859950712,7398400,276789769,269391369
180000.0,3,1.0,1010,10215,1.0,0,0,2,6,1010,0,1955,0.0,98146,47.4872,-122.345,1320,10245,9205,0.9011257953989231,1020100,104346225,103326125
335000.0,4,2.5,1830,4500,2.0,0,0,2,7,1830,0,2004,0.0,98038,47.3504,-122.005,2080,5100,2670,0.5933333333333334,3348900,20250000,16901100
835000.0,4,3.0,4480,42717,2.0,0,0,2,9,4480,0,1987,0.0,98077,47.7711,-122.088,3140,41632,38237,0.8951237212351054,20070400,1824742089,1804671689
592500.0,4,1.5,2080,4400,1.5,0,0,2,7,2080,0,1925,0.0,98122,47.606,-122.29899999999999,1680,4400,2320,0.5272727272727272,4326400,19360000,15033600
418900.0,3,1.5,1470,11112,1.0,0,0,2,7,1470,0,1954,0.0,98155,47.7462,-122.294,1460,11407,9642,0.8677105831533477,2160900,123476544,121315644
340000.0,3,1.0,1600,7324,1.0,0,0,3,7,1600,0,1958,0.0,98056,47.5054,-122.19,1430,7249,5724,0.7815401419989078,2560000,53640976,51080976
545000.0,3,2.0,1340,7200,1.5,0,0,3,7,1340,0,1923,0.0,98118,47.5601,-122.265,1630,5760,5860,0.8138888888888889,1795600,51840000,50044400
1380000.0,5,3.5,3680,8680,2.0,0,0,2,9,3680,0,2003,0.0,98033,47.6575,-122.197,2020,8847,5000,0.576036866359447,13542400,75342400,61800000
183750.0,3,2.5,1770,3451,2.0,0,0,2,7,1770,0,2004,0.0,98055,47.4325,-122.197,1490,2138,1681,0.48710518690234716,3132900,11909401,8776501
295000.0,4,2.0,980,10640,1.0,0,0,4,7,980,0,1978,0.0,98045,47.4462,-121.773,1230,9750,9660,0.9078947368421053,960400,113209600,112249200
625000.0,4,3.0,2530,5625,1.0,0,0,2,8,1470,1060,1976,0.0,98034,47.7094,-122.23299999999999,1840,7070,3095,0.5502222222222222,6400900,31640625,25239725
290000.0,4,3.0,2390,4500,2.0,0,0,2,7,2390,0,1974,0.0,98055,47.4872,-122.204,1320,4500,2110,0.4688888888888889,5712100,20250000,14537900
760000.0,4,2.5,3600,155509,2.0,0,0,2,9,3600,0,2004,0.0,98010,47.3538,-121.986,3410,34412,151909,0.9768502144570411,12960000,24183049081,24170089081
560000.0,4,2.5,3270,24750,1.0,0,0,3,8,1690,1580,1979,0.0,98056,47.5221,-122.178,1520,13480,21480,0.8678787878787879,10692900,612562500,601869600
475000.0,5,2.5,2300,28480,2.0,0,0,2,6,2300,0,1994,0.0,98053,47.6403,-121.964,1880,26720,26180,0.9192415730337079,5290000,811110400,805820400
620000.0,3,1.0,1710,4050,1.5,0,0,2,7,1710,0,1909,0.0,98103,47.6732,-122.331,1790,4896,2340,0.5777777777777777,2924100,16402500,13478400
330000.0,4,2.0,1170,4000,1.0,0,0,2,7,1170,0,1955,0.0,98144,47.5797,-122.305,1720,4000,2830,0.7075,1368900,16000000,14631100
620000.0,3,2.25,1990,6256,1.0,0,0,2,7,1390,600,1960,0.0,98033,47.6903,-122.206,2080,9300,4266,0.6819053708439897,3960100,39137536,35177436
320000.0,4,1.75,1710,10480,1.5,0,0,3,6,1710,0,1969,0.0,98059,47.4743,-122.14299999999999,1750,10480,8770,0.8368320610687023,2924100,109830400,106906300
525000.0,3,2.5,1740,2350,2.0,0,0,2,8,1120,620,1996,0.0,98112,47.6206,-122.29700000000001,1750,3802,610,0.25957446808510637,3027600,5522500,2494900
802500.0,4,3.75,3320,8030,2.0,0,0,2,10,3320,0,2005,0.0,98075,47.5818,-121.97200000000001,3740,8030,4710,0.5865504358655044,11022400,64480900,53458500
569500.0,4,1.0,1960,3194,2.0,0,0,2,7,1960,0,1907,0.0,98144,47.6005,-122.296,1870,4200,1234,0.3863494051346274,3841600,10201636,6360036
850000.0,6,3.5,2820,5400,1.0,0,0,2,8,1620,1200,1958,0.0,98117,47.6791,-122.374,1560,2276,2580,0.4777777777777778,7952400,29160000,21207600
630000.0,3,1.0,1590,4080,1.5,0,0,2,7,1590,0,1922,0.0,98105,47.662,-122.32600000000001,1570,4080,2490,0.6102941176470589,2528100,16646400,14118300
454800.0,4,2.25,2490,10720,1.0,0,1,3,7,1400,1090,1979,0.0,98074,47.6137,-122.06,3080,10720,8230,0.7677238805970149,6200100,114918400,108718300
177000.0,3,1.0,870,5200,1.0,0,0,4,6,870,0,1969,0.0,98042,47.3695,-122.081,870,5200,4330,0.8326923076923077,756900,27040000,26283100
275000.0,3,1.75,1860,15681,1.0,0,0,3,7,1860,0,1971,0.0,98023,47.3191,-122.339,1860,22979,13821,0.8813851157451693,3459600,245893761,242434161
460000.0,3,2.0,2930,29136,2.0,0,0,2,8,2240,690,1990,0.0,98010,47.3102,-122.042,2110,29362,26206,0.8994371224601867,8584900,848906496,840321596
729000.0,3,1.0,1580,3840,2.0,0,0,2,8,1580,0,1908,0.0,98102,47.6192,-122.319,1680,2624,2260,0.5885416666666666,2496400,14745600,12249200
935000.0,4,3.25,4110,15488,2.0,0,2,2,11,4110,0,1995,0.0,98006,47.5493,-122.117,4190,14973,11378,0.73463326446281,16892100,239878144,222986044
481450.0,3,2.0,1410,4800,1.0,0,0,2,7,1410,0,1940,0.0,98117,47.6852,-122.37799999999999,1190,3840,3390,0.70625,1988100,23040000,21051900
860000.0,3,2.0,2090,4190,1.5,0,0,3,8,1490,600,1930,0.0,98122,47.6178,-122.28399999999999,2090,6270,2100,0.5011933174224343,4368100,17556100,13188000
274000.0,3,1.75,1400,8364,1.0,0,0,3,7,1400,0,1958,0.0,98056,47.4918,-122.178,1210,8160,6964,0.8326159732185557,1960000,69956496,67996496
499000.0,3,3.5,1690,1432,2.0,0,0,2,7,1360,330,2008,0.0,98199,47.6513,-122.4,1650,2788,-258,-0.18016759776536312,2856100,2050624,-805476
696500.0,5,2.25,3210,61419,1.5,0,0,2,8,3210,0,1979,0.0,98077,47.7632,-122.09,2820,48351,58209,0.9477360425926831,10304100,3772293561,3761989461
390000.0,3,1.0,1190,85226,1.5,0,0,4,5,1190,0,1935,0.0,98070,47.365,-122.462,1360,46960,84036,0.986037124821064,1416100,7263471076,7262054976
265000.0,3,1.0,960,9748,1.0,0,0,2,5,960,0,1922,0.0,98065,47.5259,-121.815,1600,9958,8788,0.9015182601559294,921600,95023504,94101904
470000.0,4,2.25,2380,17199,2.0,0,0,2,8,1530,850,1979,0.0,98028,47.7668,-122.27,2280,11529,14819,0.8616198616198616,5664400,295805601,290141201
168500.0,2,1.0,1020,7742,1.0,0,0,3,6,1020,0,1935,0.0,98168,47.498999999999995,-122.301,1510,7742,6722,0.8682510979075174,1040400,59938564,58898164
220000.0,3,1.75,1290,8250,1.0,0,0,2,7,1290,0,1983,0.0,98001,47.3353,-122.27,1410,7823,6960,0.8436363636363636,1664100,68062500,66398400
295000.0,3,2.0,1830,17321,1.0,0,0,3,7,1100,730,1948,0.0,98178,47.5072,-122.272,1450,10706,15491,0.8943479013913747,3348900,300017041,296668141
1480000.0,5,4.0,4770,31570,2.0,0,0,2,12,4770,0,1990,0.0,98006,47.5468,-122.12299999999999,4520,32070,26800,0.848907190370605,22752900,996664900,973912000
1300000.0,2,2.5,2910,19449,2.0,1,4,4,9,1940,970,1985,0.0,98177,47.7729,-122.39299999999999,2540,23598,16539,0.8503779114607435,8468100,378263601,369795501
285000.0,3,1.0,950,10723,1.0,0,0,3,6,950,0,1959,0.0,98059,47.4899,-122.133,1520,10723,9773,0.9114053902825702,902500,114982729,114080229
294950.0,3,1.0,1160,8950,1.0,0,0,2,7,1160,0,1968,0.0,98133,47.7499,-122.338,1210,8193,7790,0.870391061452514,1345600,80102500,78756900
1470000.0,4,4.0,4930,22093,2.0,0,3,2,12,4930,0,2004,0.0,98075,47.5874,-121.965,4630,18889,17163,0.7768523966867333,24304900,488100649,463795749
565500.0,3,1.75,1780,5850,1.0,0,0,4,7,980,800,1944,0.0,98116,47.5589,-122.39200000000001,1550,5850,4070,0.6957264957264957,3168400,34222500,31054100
230000.0,3,2.0,1410,10625,1.0,0,0,2,7,1410,0,1980,0.0,98042,47.3649,-122.117,1410,9744,9215,0.8672941176470588,1988100,112890625,110902525
569950.0,4,3.5,2700,443440,1.5,0,0,2,8,2700,0,1948,1997.0,98042,47.333,-122.098,3210,298182,440740,0.9939112394010464,7290000,196639033600,196631743600
721000.0,2,1.5,1790,4250,1.0,0,0,2,7,920,870,1915,2014.0,98112,47.6367,-122.301,1910,4250,2460,0.5788235294117647,3204100,18062500,14858400
565000.0,3,2.5,4040,8653,2.0,0,0,2,9,2900,1140,2006,0.0,98019,47.7378,-121.975,3360,8653,4613,0.53310990407951,16321600,74874409,58552809
438000.0,3,1.75,1990,9885,1.0,0,0,3,7,1030,960,1978,0.0,98052,47.6722,-122.162,1560,10000,7895,0.7986848760748609,3960100,97713225,93753125
369900.0,3,1.75,2150,19127,1.0,0,0,2,7,1650,500,1978,0.0,98168,47.5061,-122.324,1550,15000,16977,0.887593454279291,4622500,365842129,361219629
405000.0,4,2.5,1850,9136,2.0,0,0,2,8,1850,0,1997,0.0,98059,47.4943,-122.15700000000001,1930,7873,7286,0.7975043782837128,3422500,83466496,80043996
282000.0,3,2.5,1680,15711,1.0,0,0,2,7,1240,440,1994,0.0,98031,47.423,-122.171,1420,8588,14031,0.8930685506969639,2822400,246835521,244013121
380950.0,2,1.0,1430,7819,1.0,0,0,2,7,1110,320,1944,0.0,98125,47.7307,-122.302,1380,7473,6389,0.8171121626806497,2044900,61136761,59091861
349810.0,3,1.0,960,8855,1.0,0,0,3,7,960,0,1958,0.0,98155,47.7689,-122.32799999999999,1250,8855,7895,0.8915866741953699,921600,78411025,77489425
690000.0,4,2.5,2700,8810,2.0,0,0,2,9,2700,0,2004,0.0,98052,47.7041,-122.116,2730,5100,6110,0.6935300794551645,7290000,77616100,70326100
653000.0,2,1.5,1290,5141,1.0,0,0,3,7,1050,240,1947,0.0,98115,47.6878,-122.29,1290,5406,3851,0.7490760552421708,1664100,26429881,24765781
526500.0,3,2.5,1860,43170,2.0,0,0,2,8,1860,0,1986,0.0,98072,47.7712,-122.13600000000001,2270,40835,41310,0.9569145239749827,3459600,1863648900,1860189300
1040000.0,4,3.5,4320,8490,2.0,0,0,2,10,3280,1040,2005,0.0,98029,47.5568,-122.029,4030,11008,4170,0.4911660777385159,18662400,72080100,53417700
335000.0,3,1.0,2130,3825,1.5,0,0,2,7,2130,0,1917,0.0,98118,47.5506,-122.281,1780,5150,1695,0.44313725490196076,4536900,14630625,10093725
570000.0,2,1.75,2870,102366,2.0,0,2,3,8,1770,0,1994,0.0,98027,47.4847,-122.0,2960,108900,99496,0.9719633472051267,8236900,10478797956,10470561056
1080000.0,5,3.5,3740,11340,2.0,0,0,2,10,3740,0,2013,0.0,98052,47.6628,-122.14299999999999,2040,8715,7600,0.6701940035273368,13987600,128595600,114608000
475000.0,3,2.5,2130,8022,2.0,0,0,2,8,2130,0,1985,0.0,98052,47.7252,-122.10600000000001,2130,7605,5892,0.7344801795063575,4536900,64352484,59815584
315000.0,4,2.0,1210,4250,1.0,0,0,3,7,1210,0,1941,0.0,98108,47.5275,-122.321,1210,6000,3040,0.7152941176470589,1464100,18062500,16598400
405000.0,6,2.0,2800,29985,1.0,0,0,4,7,1400,0,1954,0.0,98058,47.4398,-122.08,1980,29985,27185,0.9066199766549942,7840000,899100225,891260225
562000.0,5,2.25,3040,8111,2.0,0,0,2,8,3040,0,1984,0.0,98052,47.7157,-122.103,2020,8304,5071,0.6252003452102084,9241600,65788321,56546721
295000.0,3,2.5,1570,6932,2.0,0,0,2,7,1570,0,1993,0.0,98038,47.3902,-122.04899999999999,1570,6271,5362,0.7735141373341027,2464900,48052624,45587724
383000.0,3,2.25,2090,15000,1.0,0,0,2,7,2090,0,1961,0.0,98045,47.4885,-121.78299999999999,1690,14400,12910,0.8606666666666667,4368100,225000000,220631900
242000.0,3,2.25,1690,7292,1.0,0,0,2,7,1250,440,1985,0.0,98003,47.2639,-122.303,1670,7747,5602,0.7682391662095447,2856100,53173264,50317164
352500.0,3,1.5,1470,17577,1.0,0,0,4,7,1470,0,1967,0.0,98059,47.4695,-122.116,2300,13832,16107,0.9163679808841099,2160900,308950929,306790029
239950.0,4,1.0,1460,6000,1.0,0,0,3,7,730,730,1941,0.0,98178,47.4952,-122.22399999999999,1190,6000,4540,0.7566666666666667,2131600,36000000,33868400
998000.0,4,2.5,3030,6820,2.0,0,0,2,9,2530,500,1947,2000.0,98105,47.6695,-122.266,2070,6820,3790,0.5557184750733137,9180900,46512400,37331500
515000.0,3,1.75,1190,4500,1.0,0,0,2,6,1190,0,1922,2012.0,98116,47.5576,-122.38799999999999,1820,4500,3310,0.7355555555555555,1416100,20250000,18833900
590000.0,5,1.0,1840,6710,1.5,0,0,2,7,1840,0,1920,0.0,98126,47.5686,-122.37799999999999,1410,4880,4870,0.7257824143070045,3385600,45024100,41638500
1160000.0,4,3.75,3560,13959,2.0,0,0,3,9,3560,0,1972,0.0,98040,47.5575,-122.211,3320,11834,10399,0.7449674045418726,12673600,194853681,182180081
289000.0,3,1.75,1580,9750,1.0,0,0,4,7,1580,0,1954,0.0,98148,47.427,-122.331,1460,9750,8170,0.837948717948718,2496400,95062500,92566100
424000.0,3,1.5,1230,7200,1.0,0,0,2,7,1230,0,1953,0.0,98125,47.7281,-122.311,1400,6240,5970,0.8291666666666667,1512900,51840000,50327100
199000.0,4,2.0,1440,9477,1.0,0,0,2,5,1440,0,1943,0.0,98056,47.5093,-122.182,1440,9546,8037,0.8480531813865148,2073600,89813529,87739929
730000.0,4,3.5,4420,7902,2.0,0,0,2,10,3350,1070,2004,0.0,98065,47.5327,-121.86,3440,7851,3482,0.44064793723108076,19536400,62441604,42905204
244000.0,3,1.0,910,5250,1.0,0,0,3,6,910,0,1971,0.0,98166,47.4729,-122.352,1650,10442,4340,0.8266666666666667,828100,27562500,26734400
240000.0,2,1.0,670,10920,1.0,0,0,2,6,670,0,1942,0.0,98146,47.5128,-122.37200000000001,900,7425,10250,0.9386446886446886,448900,119246400,118797500
797000.0,4,2.75,2650,8610,2.0,0,0,2,8,2650,0,1959,2007.0,98008,47.6155,-122.12100000000001,1680,8316,5960,0.6922183507549361,7022500,74132100,67109600
350000.0,4,2.25,2220,6953,2.0,0,0,3,8,2220,0,1999,0.0,98038,47.3509,-122.041,2240,6716,4733,0.6807133611390767,4928400,48344209,43415809
415000.0,3,1.75,1640,6435,1.0,0,0,2,7,1190,450,1972,0.0,98034,47.7197,-122.21700000000001,1770,6930,4795,0.7451437451437452,2689600,41409225,38719625
378510.0,2,1.0,770,5185,1.0,0,0,2,7,770,0,1947,0.0,98126,47.5459,-122.37899999999999,1260,6550,4415,0.8514946962391514,592900,26884225,26291325
1200000.0,4,3.5,3960,6654,2.0,0,0,2,10,2850,1110,2006,0.0,98199,47.6461,-122.389,2840,6400,2694,0.4048692515779982,15681600,44275716,28594116
379900.0,2,1.5,1140,7620,1.0,0,0,3,6,1140,0,1925,0.0,98106,47.5277,-122.351,1300,7620,6480,0.8503937007874016,1299600,58064400,56764800
620000.0,3,2.5,2480,9041,2.0,0,0,2,7,2480,0,2004,0.0,98053,47.6797,-122.035,2480,6500,6561,0.7256940603915496,6150400,81739681,75589281
524500.0,3,1.5,1580,3172,1.0,0,0,3,8,900,680,1946,0.0,98117,47.6796,-122.39299999999999,1580,5000,1592,0.501891551071879,2496400,10061584,7565184
270000.0,4,2.75,1990,7252,1.0,0,0,2,7,1270,720,1999,0.0,98002,47.2839,-122.20200000000001,2100,7535,5262,0.7255929398786541,3960100,52591504,48631404
236000.0,4,2.25,1830,9485,1.0,0,0,3,7,1200,630,1989,0.0,98023,47.2995,-122.387,1730,10109,7655,0.8070637849235636,3348900,89965225,86616325
308500.0,2,2.0,840,14564,1.5,0,0,4,6,840,0,1942,0.0,98106,47.5499,-122.36,1430,7920,13724,0.9423235374897007,705600,212110096,211404496
989900.0,5,2.25,3320,11350,1.0,0,0,4,8,1660,1660,1963,0.0,98040,47.5749,-122.213,3320,11085,8030,0.707488986784141,11022400,128822500,117800100
299000.0,4,2.25,2050,26000,2.0,0,0,3,8,2050,0,1977,0.0,98042,47.3423,-122.06299999999999,2330,31100,23950,0.9211538461538461,4202500,676000000,671797500
295000.0,2,1.75,1560,43748,2.0,0,0,2,8,1560,0,1967,2000.0,98065,47.5729,-121.676,1000,24602,42188,0.9643412270275212,2433600,1913887504,1911453904
110000.0,2,1.0,800,15000,1.0,0,0,2,6,800,0,1927,0.0,98168,47.4932,-122.316,1170,15000,14200,0.9466666666666667,640000,225000000,224360000
295950.0,2,1.0,1190,6200,1.0,0,0,2,7,1190,0,1948,0.0,98133,47.7634,-122.34,1470,7800,5010,0.8080645161290323,1416100,38440000,37023900
270000.0,3,1.75,1300,4127,1.0,0,0,3,6,650,650,1918,0.0,98106,47.5353,-122.352,1420,4000,2827,0.6850012115338018,1690000,17032129,15342129
712000.0,4,2.5,3400,247421,2.0,0,0,2,9,3400,0,2001,0.0,98010,47.3623,-121.971,3180,222156,244021,0.9862582400038801,11560000,61217151241,61205591241
475000.0,2,1.5,1170,1250,3.0,0,0,2,8,1170,0,2000,0.0,98107,47.6719,-122.38,1310,1308,80,0.064,1368900,1562500,193600
410000.0,4,2.5,2510,5258,2.0,0,0,2,7,2510,0,2001,0.0,98056,47.4818,-122.18799999999999,2570,5119,2748,0.5226321795359452,6300100,27646564,21346464
588000.0,4,2.25,2510,19550,1.0,0,0,3,9,1810,700,1977,0.0,98034,47.7041,-122.241,2450,19250,17040,0.871611253196931,6300100,382202500,375902400
420000.0,3,2.5,2390,3903,2.0,0,0,2,8,1970,420,2006,0.0,98072,47.7515,-122.17399999999999,2390,3431,1513,0.38765052523699717,5712100,15233409,9521309
355000.0,4,2.25,2200,3404,2.0,0,0,2,8,2200,0,2005,0.0,98038,47.3895,-122.03399999999999,2200,3449,1204,0.3537015276145711,4840000,11587216,6747216
446000.0,2,1.0,2550,21675,1.0,0,1,3,7,1610,940,1958,0.0,98198,47.4013,-122.319,2030,10591,19125,0.8823529411764706,6502500,469805625,463303125
765000.0,4,2.25,2560,12100,1.0,0,0,3,8,1760,800,1976,0.0,98052,47.631,-122.10799999999999,2240,12100,9540,0.7884297520661157,6553600,146410000,139856400
967500.0,3,3.75,3250,5797,2.0,0,2,3,8,2370,880,1951,0.0,98199,47.6481,-122.405,1840,5797,2547,0.4393651888908056,10562500,33605209,23042709
381000.0,2,2.0,1340,4447,1.0,0,0,2,8,1340,0,2004,0.0,98053,47.7175,-122.03299999999999,1350,4458,3107,0.6986732628738476,1795600,19775809,17980209
490000.0,3,2.25,2840,107157,2.0,0,0,3,9,2840,0,1983,0.0,98092,47.2848,-122.118,2600,215622,104317,0.9734968317515421,8065600,11482622649,11474557049
716000.0,4,2.25,2480,9780,1.0,0,0,3,8,1900,580,1975,0.0,98052,47.6388,-122.09899999999999,2640,9780,7300,0.7464212678936605,6150400,95648400,89498000
605000.0,5,3.5,3060,8862,2.0,0,0,2,8,3060,0,1989,0.0,98056,47.5322,-122.185,2680,8398,5802,0.6547054840893703,9363600,78535044,69171444
312200.0,4,2.5,2910,8596,2.0,0,0,2,8,2910,0,2004,0.0,98003,47.2596,-122.304,2770,8602,5686,0.6614704513727315,8468100,73891216,65423116
327000.0,4,1.0,1900,9000,1.0,0,0,3,7,1290,610,1948,0.0,98166,47.4629,-122.361,1950,10800,7100,0.7888888888888889,3610000,81000000,77390000
229950.0,4,1.75,1300,21000,1.0,0,0,3,7,1300,0,1969,0.0,98001,47.3067,-122.285,2120,9920,19700,0.9380952380952381,1690000,441000000,439310000
160000.0,3,1.5,1480,7000,1.0,0,0,2,7,1000,480,1980,0.0,98023,47.2866,-122.368,1470,7022,5520,0.7885714285714286,2190400,49000000,46809600
255000.0,3,1.0,1250,9472,1.0,0,0,3,6,1250,0,1972,0.0,98059,47.495,-122.154,1590,9600,8222,0.8680320945945946,1562500,89718784,88156284
530000.0,4,2.5,2000,4700,1.5,0,0,3,7,1220,780,1944,0.0,98117,47.6902,-122.368,1560,4700,2700,0.574468085106383,4000000,22090000,18090000
239000.0,3,1.5,1330,6540,1.0,0,0,2,7,900,430,1971,0.0,98188,47.4239,-122.292,1400,11500,5210,0.7966360856269113,1768900,42771600,41002700
285000.0,3,2.25,1840,6214,1.0,0,0,3,7,1270,570,1983,0.0,98031,47.4043,-122.185,1840,6214,4374,0.7038944319279047,3385600,38613796,35228196
537000.0,4,2.0,1560,7104,1.5,0,0,2,7,1140,420,1945,0.0,98105,47.6714,-122.28,1850,7105,5544,0.7804054054054054,2433600,50466816,48033216
530000.0,3,2.5,3150,21893,2.0,0,0,2,9,3150,0,2006,0.0,98014,47.6455,-121.90100000000001,2280,21886,18743,0.8561183940072169,9922500,479303449,469380949
213675.0,3,2.25,1560,6013,2.0,0,0,2,7,1560,0,1990,0.0,98023,47.2862,-122.352,1640,6290,4453,0.7405621154165973,2433600,36156169,33722569
530000.0,5,2.5,2910,9636,1.0,0,0,3,7,1690,1220,1964,0.0,98008,47.5803,-122.119,2830,10385,6726,0.6980074719800747,8468100,92852496,84384396
780000.0,3,2.5,2940,15875,2.0,0,0,2,10,2940,0,1994,0.0,98075,47.5947,-122.016,2980,15875,12935,0.8148031496062992,8643600,252015625,243372025
390000.0,3,1.0,950,3621,1.0,0,0,3,6,950,0,1947,0.0,98144,47.575,-122.289,1540,4080,2671,0.7376415354874344,902500,13111641,12209141
450000.0,2,1.0,1200,4000,1.0,0,0,2,7,1070,130,1940,0.0,98126,47.5766,-122.37799999999999,1770,4000,2800,0.7,1440000,16000000,14560000
420000.0,2,1.0,1000,5375,1.0,0,0,2,7,1000,0,1953,0.0,98118,47.5404,-122.26799999999999,1380,5000,4375,0.813953488372093,1000000,28890625,27890625
550000.0,3,2.0,1490,3880,1.0,0,0,2,7,1490,0,1959,0.0,98107,47.662,-122.363,1490,3880,2390,0.615979381443299,2220100,15054400,12834300
110000.0,2,1.0,600,6120,1.0,0,0,2,5,600,0,1943,0.0,98168,47.4997,-122.31700000000001,1060,6120,5520,0.9019607843137255,360000,37454400,37094400
700000.0,2,1.75,2320,5500,1.5,0,2,2,8,1720,600,1925,2000.0,98144,47.58600000000001,-122.292,2380,5000,3180,0.5781818181818181,5382400,30250000,24867600
807500.0,4,2.5,3190,24170,2.0,0,0,2,10,3190,0,2002,0.0,98074,47.6209,-122.052,2110,26321,20980,0.868018204385602,10176100,584188900,574012800
179000.0,2,1.0,990,8760,1.0,0,0,2,7,990,0,1977,0.0,98003,47.3302,-122.305,1560,11880,7770,0.886986301369863,980100,76737600,75757500
1610000.0,4,2.75,5470,18200,2.0,1,4,2,11,3730,1740,1992,0.0,98118,47.5316,-122.26299999999999,3620,15100,12730,0.6994505494505494,29920900,331240000,301319100
655000.0,4,2.75,2890,46609,2.0,0,0,3,9,2890,0,1981,0.0,98077,47.7454,-122.061,2880,68824,43719,0.9379948078697248,8352100,2172398881,2164046781
472500.0,3,2.0,1790,6800,1.0,0,0,3,7,1240,550,1964,0.0,98133,47.728,-122.339,1470,6800,5010,0.736764705882353,3204100,46240000,43035900
299000.0,4,2.5,2350,6958,2.0,0,0,2,9,2350,0,1998,0.0,98092,47.3321,-122.17200000000001,2480,6395,4608,0.6622592699051452,5522500,48413764,42891264
740000.0,4,2.5,3430,10157,2.0,0,0,2,10,3430,0,2000,0.0,98034,47.723,-122.15799999999999,3480,10157,6727,0.6623018607856651,11764900,103164649,91399749
860000.0,3,1.75,2600,15064,1.0,0,0,3,8,1700,900,1967,0.0,98004,47.64,-122.204,2940,14984,12464,0.8274030801911842,6760000,226924096,220164096
620000.0,4,3.0,2130,6325,1.0,0,0,4,7,1440,690,1948,0.0,98116,47.5683,-122.396,1240,6325,4195,0.6632411067193675,4536900,40005625,35468725
410000.0,3,1.75,1660,5987,1.0,0,0,2,7,960,700,1982,0.0,98146,47.5107,-122.381,1510,6000,4327,0.7227325872724236,2755600,35844169,33088569
343000.0,5,3.5,2473,9282,2.0,0,1,4,7,2473,0,1963,0.0,98198,47.3966,-122.30799999999999,2040,10920,6809,0.73357035121741,6115729,86155524,80039795
465000.0,2,2.75,1430,1425,2.0,0,0,2,7,995,435,2006,0.0,98112,47.621,-122.29799999999999,1500,1749,-5,-0.0035087719298245615,2044900,2030625,-14275
273950.0,3,2.25,1570,3109,2.0,0,0,2,8,1570,0,2002,0.0,98092,47.3258,-122.186,1680,3590,1539,0.49501447410743005,2464900,9665881,7200981
825000.0,2,1.0,1240,42247,1.0,0,1,3,7,1240,0,1915,0.0,98056,47.5169,-122.20100000000001,1550,12459,41007,0.9706488034653348,1537600,1784809009,1783271409
255000.0,3,2.5,1720,6200,2.0,0,0,2,7,1720,0,2014,0.0,98022,47.2137,-121.98899999999999,1710,9520,4480,0.7225806451612903,2958400,38440000,35481600
250000.0,3,2.0,1140,11161,1.0,0,0,3,7,1140,0,1998,0.0,98022,47.208999999999996,-122.012,1720,8587,10021,0.8978586148194606,1299600,124567921,123268321
635000.0,4,3.25,2690,7200,2.0,0,3,2,9,1720,970,1978,0.0,98155,47.7341,-122.288,2400,8845,4510,0.6263888888888889,7236100,51840000,44603900
240000.0,3,1.75,1520,9600,1.0,0,0,2,8,1520,0,1966,0.0,98023,47.3263,-122.365,2060,9600,8080,0.8416666666666667,2310400,92160000,89849600
670000.0,4,2.25,2040,7031,2.0,0,0,2,8,2040,0,2012,0.0,98033,47.7016,-122.17,1670,7031,4991,0.709856350448016,4161600,49434961,45273361
713414.0,3,2.5,2830,6000,1.0,0,3,2,9,1730,1100,1954,0.0,98126,47.5751,-122.37799999999999,2040,5300,3170,0.5283333333333333,8008900,36000000,27991100
245000.0,3,1.5,1340,7391,1.0,0,0,3,7,1340,0,1966,0.0,98198,47.3837,-122.31700000000001,1300,7391,6051,0.8186984169936409,1795600,54626881,52831281
600000.0,4,2.5,2520,10850,1.0,0,0,3,8,1680,840,1968,0.0,98155,47.7751,-122.28399999999999,2590,10800,8330,0.7677419354838709,6350400,117722500,111372100
270000.0,3,2.5,1660,5550,2.0,0,0,2,7,1660,0,2002,0.0,98198,47.375,-122.304,1810,5550,3890,0.7009009009009008,2755600,30802500,28046900
190000.0,2,1.0,880,6900,1.0,0,0,2,6,880,0,1943,0.0,98056,47.4903,-122.191,1060,8000,6020,0.8724637681159421,774400,47610000,46835600
435000.0,3,2.0,980,5000,1.0,0,0,2,6,980,0,1940,0.0,98144,47.595,-122.30799999999999,1970,3025,4020,0.804,960400,25000000,24039600
560000.0,4,1.0,1360,5814,1.5,0,0,1,6,1360,0,1900,0.0,98122,47.6038,-122.314,1010,5814,4454,0.7660818713450293,1849600,33802596,31952996
998000.0,3,3.75,3710,34412,2.0,0,0,2,10,2910,800,1978,0.0,98075,47.5888,-122.04,2390,34412,30702,0.8921887713588283,13764100,1184185744,1170421644
725000.0,3,1.0,940,8377,1.0,0,0,3,7,940,0,1952,0.0,98004,47.5974,-122.2,1710,6900,7437,0.8877879909275397,883600,70174129,69290529
210000.0,2,1.0,970,8874,1.0,0,0,2,7,970,0,1968,0.0,98056,47.4943,-122.178,1340,8175,7904,0.8906919089474871,940900,78747876,77806976
513000.0,3,2.25,1500,1312,3.0,0,0,2,8,1500,0,2007,0.0,98103,47.6534,-122.346,1500,1282,-188,-0.14329268292682926,2250000,1721344,-528656
290000.0,5,2.5,2780,9652,1.0,0,0,3,8,1390,1390,1967,0.0,98001,47.3444,-122.271,1790,9652,6872,0.7119767923746374,7728400,93161104,85432704
1260000.0,3,2.5,3110,9930,1.0,0,1,2,8,1640,1470,1954,0.0,98039,47.6112,-122.226,3650,14399,6820,0.6868076535750252,9672100,98604900,88932800
330000.0,3,2.25,1860,11227,2.0,0,0,2,7,1860,0,1995,0.0,98038,47.3879,-122.031,1820,8800,9367,0.8343279593836288,3459600,126045529,122585929
189000.0,3,1.0,1010,7560,1.0,0,0,2,6,1010,0,1958,0.0,98058,47.4497,-122.176,1170,7560,6550,0.8664021164021164,1020100,57153600,56133500
907500.0,3,2.25,2850,6281,2.0,0,2,3,7,1900,950,1947,0.0,98115,47.6911,-122.32600000000001,1680,7006,3431,0.5462505970386881,8122500,39450961,31328461
410000.0,3,2.25,2280,200811,1.0,0,0,2,7,2280,0,1978,0.0,98014,47.6522,-121.941,2280,206038,198531,0.9886460403065569,5198400,40325057721,40319859321
1050000.0,4,3.0,3080,10757,2.0,0,3,4,8,3080,0,1961,0.0,98006,47.5671,-122.15899999999999,2810,10757,7677,0.7136748163986242,9486400,115713049,106226649
622100.0,4,2.5,2280,14290,1.5,0,0,3,7,1510,770,1942,0.0,98125,47.7054,-122.29700000000001,2140,9890,12010,0.8404478656403079,5198400,204204100,199005700
250000.0,3,1.5,2030,14400,1.0,0,0,3,7,1310,720,1969,0.0,98001,47.2639,-122.285,1330,14400,12370,0.8590277777777777,4120900,207360000,203239100
1180000.0,4,3.0,2570,4000,2.0,0,0,2,8,1750,820,1909,0.0,98115,47.6743,-122.31299999999999,1970,4000,1430,0.3575,6604900,16000000,9395100
925000.0,3,2.75,3640,10300,1.0,0,0,3,9,2060,1580,1979,0.0,98006,47.5612,-122.146,3110,10625,6660,0.6466019417475728,13249600,106090000,92840400
554000.0,3,2.0,1760,4046,1.0,0,0,2,7,960,800,1931,0.0,98117,47.6876,-122.381,1500,4046,2286,0.565002471576866,3097600,16370116,13272516
545000.0,3,2.5,2760,17377,2.0,0,0,2,9,2760,0,2002,0.0,98056,47.4929,-122.18799999999999,1940,8504,14617,0.8411693618000806,7617600,301960129,294342529
660000.0,3,2.5,2650,11250,2.0,0,0,2,9,2650,0,2005,0.0,98155,47.7644,-122.29,2200,10013,8600,0.7644444444444445,7022500,126562500,119540000
1900000.0,5,4.5,5160,44315,2.0,0,0,2,12,5160,0,1996,0.0,98005,47.6568,-122.154,4760,44315,39155,0.883560871036895,26625600,1963819225,1937193625
260000.0,4,2.0,1480,8625,1.0,0,0,3,7,1480,0,1974,0.0,98055,47.461999999999996,-122.193,2130,8502,7145,0.8284057971014492,2190400,74390625,72200225
219900.0,3,1.0,860,6664,1.0,0,0,2,6,860,0,1944,0.0,98178,47.4931,-122.24700000000001,1150,6857,5804,0.8709483793517407,739600,44408896,43669296
373500.0,4,2.5,2610,4978,2.0,0,0,2,8,2610,0,2004,0.0,98038,47.3438,-122.04,2470,5024,2368,0.47569304941743673,6812100,24780484,17968384
380000.0,2,1.0,1470,81021,1.0,0,0,3,6,1470,0,1949,0.0,98027,47.4771,-122.03,2600,69696,79551,0.9818565557077794,2160900,6564402441,6562241541
1060000.0,4,2.5,4570,16015,2.0,0,2,2,11,4570,0,1990,0.0,98074,47.6246,-122.06700000000001,4490,17668,11445,0.7146425226350297,20884900,256480225,235595325
2600000.0,3,3.0,3410,16015,2.0,1,4,3,10,2220,1190,1973,0.0,98040,47.5721,-122.23899999999999,3760,16572,12605,0.7870746175460506,11628100,256480225,244852125
450000.0,3,2.25,1760,10013,2.0,0,0,3,8,1760,0,1983,0.0,98056,47.5336,-122.189,1810,9768,8253,0.82422850294617,3097600,100260169,97162569
379950.0,3,1.75,2040,12065,1.0,0,0,2,8,2040,0,1987,0.0,98038,47.3756,-122.044,2010,11717,10025,0.8309158723580605,4161600,145564225,141402625
834800.0,3,3.5,3470,4171,3.0,0,0,2,9,3470,0,2008,0.0,98034,47.71100000000001,-122.229,3430,4268,701,0.16806521217933348,12040900,17397241,5356341
365000.0,2,1.0,680,4800,1.0,0,0,2,6,680,0,1917,0.0,98122,47.6084,-122.304,1610,4800,4120,0.8583333333333333,462400,23040000,22577600
465000.0,2,2.0,1494,19271,2.0,1,4,2,7,1494,0,1943,1997.0,98070,47.4728,-122.49700000000001,1494,43583,17777,0.9224741840070573,2232036,371371441,369139405
452000.0,3,1.5,1250,4000,1.0,0,0,2,7,1250,0,1955,0.0,98117,47.6916,-122.37899999999999,1030,4000,2750,0.6875,1562500,16000000,14437500
840000.0,3,3.0,3570,6250,2.0,0,2,2,10,2710,860,1985,0.0,98116,47.5624,-122.399,2550,7596,2680,0.4288,12744900,39062500,26317600
465000.0,4,2.0,2000,6250,1.5,0,0,2,7,1480,520,1930,0.0,98136,47.5532,-122.389,1110,6250,4250,0.68,4000000,39062500,35062500
295000.0,3,2.5,2030,4867,2.0,0,0,2,7,2030,0,2003,0.0,98042,47.3747,-122.12799999999999,2030,5000,2837,0.5829052804602425,4120900,23687689,19566789
396000.0,3,1.0,1390,6160,1.0,0,0,3,7,1390,0,1949,0.0,98133,47.7289,-122.338,1230,6160,4770,0.7743506493506493,1932100,37945600,36013500
397000.0,2,1.0,1030,12350,1.5,0,0,2,7,1030,0,1942,0.0,98115,47.6984,-122.324,1790,6900,11320,0.9165991902834008,1060900,152522500,151461600
240000.0,3,1.0,1280,9000,1.5,0,0,3,6,1280,0,1954,0.0,98146,47.4915,-122.338,1430,4500,7720,0.8577777777777778,1638400,81000000,79361600
300523.0,3,2.5,2370,6840,2.0,0,0,2,9,2370,0,1987,0.0,98119,47.6503,-122.366,1590,4400,4470,0.6535087719298246,5616900,46785600,41168700
215500.0,3,2.0,1380,9000,2.0,0,0,1,7,1380,0,1946,0.0,98001,47.2613,-122.24799999999999,1460,9732,7620,0.8466666666666667,1904400,81000000,79095600
552500.0,5,3.0,2320,7229,1.0,0,0,3,8,1370,0,1986,0.0,98052,47.696999999999996,-122.09700000000001,2090,7554,4909,0.6790704108452068,5382400,52258441,46876041
375000.0,5,1.5,2050,9360,1.0,0,0,2,7,1520,530,1968,0.0,98055,47.43600000000001,-122.195,1840,9383,7310,0.780982905982906,4202500,87609600,83407100
160000.0,3,1.0,1210,103237,1.0,0,0,1,6,1210,0,1918,1960.0,98070,47.4208,-122.445,1880,40510,102027,0.9882793959530013,1464100,10657878169,10656414069
1070000.0,4,2.5,3270,35445,2.0,0,0,2,11,3270,0,1989,0.0,98006,47.548,-122.12100000000001,4180,32130,32175,0.9077443927211172,10692900,1256348025,1245655125
952000.0,3,2.5,2450,4400,2.0,0,0,3,9,1800,650,1922,0.0,98102,47.6439,-122.319,2220,5500,1950,0.4431818181818182,6002500,19360000,13357500
523460.0,5,1.75,1890,5000,1.5,0,0,2,7,1090,800,1906,0.0,98107,47.6711,-122.37200000000001,1610,5000,3110,0.622,3572100,25000000,21427900
305950.0,4,2.5,2007,4968,2.0,0,0,2,9,2007,0,2009,0.0,98092,47.3301,-122.191,2189,5852,2961,0.5960144927536232,4028049,24681024,20652975
220000.0,3,2.5,1430,9044,2.0,0,0,2,7,1430,0,1991,0.0,98022,47.1956,-121.986,1580,8624,7614,0.8418841220698806,2044900,81793936,79749036
289000.0,2,1.75,2056,52333,1.0,0,0,3,7,1048,1008,1980,0.0,98001,47.2592,-122.291,2220,6458,50277,0.9607131255613093,4227136,2738742889,2734515753
648000.0,5,2.5,2210,10772,1.0,0,2,2,9,1430,780,1964,0.0,98155,47.7383,-122.288,2720,9858,8562,0.7948384701076866,4884100,116035984,111151884
825000.0,5,1.75,2330,6000,1.5,0,0,2,8,2080,250,1937,0.0,98199,47.6461,-122.39200000000001,2150,6000,3670,0.6116666666666667,5428900,36000000,30571100
400000.0,4,2.0,2070,10800,2.0,0,0,2,7,2070,0,1982,0.0,98011,47.7264,-122.23700000000001,1880,10800,8730,0.8083333333333333,4284900,116640000,112355100
420000.0,2,2.5,1480,1369,3.0,0,0,2,7,1480,0,2009,0.0,98052,47.676,-122.12100000000001,1390,1337,-111,-0.08108108108108109,2190400,1874161,-316239
389000.0,2,1.75,1160,4848,2.0,0,1,3,7,1160,0,1949,0.0,98118,47.542,-122.265,1990,7440,3688,0.7607260726072608,1345600,23503104,22157504
865000.0,4,2.5,2520,4950,2.0,0,0,2,8,2520,0,1906,2002.0,98117,47.6814,-122.359,1810,3500,2430,0.4909090909090909,6350400,24502500,18152100
345000.0,2,1.0,1770,16660,1.0,0,3,2,8,1220,550,1957,0.0,98023,47.3346,-122.354,2790,20504,14890,0.8937575030012005,3132900,277555600,274422700
700000.0,3,2.5,3110,123710,2.0,0,0,2,8,2430,680,1995,0.0,98038,47.3879,-122.00200000000001,2420,92782,120600,0.9748605609894108,9672100,15304164100,15294492000
550000.0,3,2.5,1680,10455,2.0,0,0,2,8,1680,0,1982,0.0,98052,47.7229,-122.11,1860,10063,8775,0.8393113342898135,2822400,109307025,106484625
201500.0,3,1.0,1320,5000,1.5,0,0,2,7,1320,0,1912,0.0,98116,47.5711,-122.38600000000001,1320,4179,3680,0.736,1742400,25000000,23257600
459000.0,3,1.0,1320,5000,1.5,0,0,2,7,1320,0,1912,0.0,98116,47.5711,-122.38600000000001,1320,4179,3680,0.736,1742400,25000000,23257600
327000.0,3,2.5,1810,7350,1.0,0,0,2,8,1310,500,1984,0.0,98058,47.4434,-122.125,2240,7350,5540,0.7537414965986394,3276100,54022500,50746400
540000.0,1,1.0,1140,6700,1.5,0,0,2,7,1140,0,1920,0.0,98103,47.6958,-122.35700000000001,1350,6700,5560,0.8298507462686567,1299600,44890000,43590400
805000.0,5,2.5,4600,19831,1.0,0,3,2,9,2300,2300,1956,2015.0,98177,47.7608,-122.37799999999999,2890,19831,15231,0.7680399374716353,21160000,393268561,372108561
521000.0,3,2.0,1840,6000,1.0,0,0,3,6,1840,0,1908,1944.0,98136,47.5508,-122.39200000000001,2010,6000,4160,0.6933333333333334,3385600,36000000,32614400
375000.0,3,1.5,2000,7294,1.0,0,0,2,7,1520,480,1965,0.0,98118,47.5297,-122.26700000000001,2000,6000,5294,0.7258020290649849,4000000,53202436,49202436
235000.0,3,1.75,1480,6592,1.0,0,0,3,7,1080,400,1978,0.0,98023,47.2982,-122.37799999999999,1660,7150,5112,0.7754854368932039,2190400,43454464,41264064
240000.0,4,2.5,2040,11841,2.0,0,0,2,7,2040,0,1994,0.0,98042,47.3691,-122.074,1730,8808,9801,0.827717253610337,4161600,140209281,136047681
575000.0,4,2.25,2060,12155,1.0,0,0,3,8,2060,0,1968,0.0,98008,47.6378,-122.117,2360,8625,10095,0.8305224187577128,4243600,147744025,143500425
1520000.0,6,3.5,3720,11690,2.0,0,0,2,10,3720,0,2003,0.0,98040,47.5699,-122.226,3030,11686,7970,0.6817792985457656,13838400,136656100,122817700
394500.0,4,2.5,3002,6042,2.0,0,0,2,8,3002,0,2004,0.0,98055,47.4231,-122.186,2566,6390,3040,0.5031446540880503,9012004,36505764,27493760
174950.0,3,1.0,1060,5200,1.0,0,0,4,6,1060,0,1970,0.0,98042,47.3636,-122.09299999999999,1380,5200,4140,0.7961538461538461,1123600,27040000,25916400
383000.0,4,2.0,1830,21183,1.0,0,0,3,7,1060,770,1966,0.0,98059,47.4826,-122.12799999999999,1950,6120,19353,0.9136099702591701,3348900,448719489,445370589
249950.0,3,2.0,1550,15040,1.0,0,0,3,6,1550,0,1958,0.0,98059,47.4873,-122.09899999999999,1510,41416,13490,0.8969414893617021,2402500,226201600,223799100
431000.0,3,2.5,1690,2752,2.0,0,0,2,8,1690,0,1979,0.0,98052,47.6332,-122.10799999999999,1690,2855,1062,0.3859011627906977,2856100,7573504,4717404
459900.0,3,1.75,2580,11000,1.0,0,0,3,7,1290,1290,1951,0.0,98006,47.5646,-122.181,2280,17643,8420,0.7654545454545455,6656400,121000000,114343600
475000.0,5,2.5,2510,8050,1.0,0,0,3,7,1490,1020,1977,0.0,98034,47.7212,-122.17200000000001,1840,8471,5540,0.6881987577639752,6300100,64802500,58502400
605000.0,3,2.25,1290,2500,2.0,0,0,3,8,1290,0,1987,0.0,98112,47.6229,-122.29799999999999,1700,3750,1210,0.484,1664100,6250000,4585900
234950.0,4,2.0,1450,7560,1.0,0,0,2,7,1450,0,1967,0.0,98001,47.3375,-122.27600000000001,1430,7560,6110,0.8082010582010583,2102500,57153600,55051100
419000.0,4,2.5,2690,7947,2.0,0,0,2,8,2690,0,1993,0.0,98058,47.4248,-122.15299999999999,2160,8328,5257,0.6615074871020511,7236100,63154809,55918709
910000.0,4,3.25,3340,10890,1.5,0,0,2,9,2240,1100,1963,2000.0,98052,47.6677,-122.13600000000001,2880,9794,7550,0.6932966023875115,11155600,118592100,107436500
392000.0,4,2.5,2600,8921,2.0,0,0,2,8,2600,0,1991,0.0,98058,47.4423,-122.178,2550,8683,6321,0.7085528528191907,6760000,79584241,72824241
915000.0,3,2.5,3140,9808,2.0,0,0,2,9,2500,640,2001,0.0,98052,47.6383,-122.09700000000001,2370,10014,6668,0.6798531810766721,9859600,96196864,86337264
630000.0,3,3.25,3800,13995,2.0,0,3,2,9,3800,0,1983,0.0,98011,47.7741,-122.20299999999999,2480,8434,10195,0.728474455162558,14440000,195860025,181420025
416100.0,4,1.75,2320,5490,1.0,0,3,2,8,1160,1160,1956,0.0,98178,47.5091,-122.241,2240,7200,3170,0.5774134790528234,5382400,30140100,24757700
285000.0,4,2.5,2360,7350,1.0,0,0,3,7,1440,920,1965,0.0,98001,47.3417,-122.277,1450,7305,4990,0.6789115646258503,5569600,54022500,48452900
353000.0,4,1.5,1100,9600,1.0,0,0,3,6,1100,0,1960,0.0,98033,47.7,-122.175,1100,9630,8500,0.8854166666666666,1210000,92160000,90950000
297950.0,3,2.0,1390,5127,1.0,0,0,2,8,1390,0,1990,0.0,98055,47.4504,-122.206,1960,5019,3737,0.7288862882777453,1932100,26286129,24354029
750000.0,2,2.0,2180,21392,2.0,0,0,2,8,2180,0,1934,1979.0,98034,47.7162,-122.24600000000001,2890,22000,19212,0.8980927449513837,4752400,457617664,452865264
525000.0,3,3.0,1730,1074,3.5,0,0,2,8,1730,0,2006,0.0,98107,47.6692,-122.39200000000001,1370,1185,-656,-0.6108007448789572,2992900,1153476,-1839424
495000.0,5,1.75,2760,18112,1.0,0,0,2,8,1510,1250,1968,0.0,98155,47.7363,-122.29799999999999,1720,8482,15352,0.8476148409893993,7617600,328044544,320426944
710000.0,3,1.75,2430,11448,1.0,0,1,4,7,1620,810,1949,0.0,98117,47.6971,-122.391,2140,8144,9018,0.7877358490566038,5904900,131056704,125151804
310000.0,3,2.0,2010,12950,1.0,0,0,2,8,2010,0,1953,0.0,98034,47.7222,-122.229,1490,10181,10940,0.8447876447876448,4040100,167702500,163662400
205000.0,5,1.75,1730,5200,1.0,0,0,3,7,1050,680,1978,0.0,98042,47.3628,-122.089,1350,5200,3470,0.6673076923076923,2992900,27040000,24047100
530000.0,3,3.0,2450,211266,1.5,0,3,2,8,2450,0,2004,0.0,98022,47.2215,-122.06700000000001,2300,263492,208816,0.9884032451979968,6002500,44633322756,44627320256
725000.0,4,2.5,3300,28433,2.0,0,0,2,9,3300,0,1998,0.0,98059,47.5072,-122.11200000000001,3550,26386,25133,0.883937678050153,10890000,808435489,797545489
195000.0,2,1.0,720,9520,1.0,0,0,3,6,720,0,1947,0.0,98155,47.7678,-122.316,1450,8612,8800,0.9243697478991597,518400,90630400,90112000
401000.0,3,2.0,1240,11172,1.0,0,0,2,7,1000,240,1984,0.0,98074,47.6364,-122.037,1330,14102,9932,0.8890082348728965,1537600,124813584,123275984
1030000.0,5,2.5,3050,8200,1.0,0,4,3,8,1650,1400,1962,0.0,98006,47.5647,-122.155,2970,8792,5150,0.6280487804878049,9302500,67240000,57937500
251000.0,3,1.5,1590,21600,1.5,0,0,3,7,1590,0,1971,0.0,98022,47.2159,-121.96600000000001,1780,21600,20010,0.9263888888888889,2528100,466560000,464031900
667500.0,3,2.0,2040,4841,1.0,0,0,3,7,1020,1020,1949,0.0,98115,47.6778,-122.302,1600,4841,2801,0.5785994629208842,4161600,23435281,19273681
300000.0,4,2.5,1840,5550,2.0,0,0,2,8,1840,0,2004,0.0,98031,47.3937,-122.18299999999999,2030,5500,3710,0.6684684684684684,3385600,30802500,27416900
610000.0,4,2.25,1960,9021,2.0,0,0,3,8,1960,0,1973,0.0,98052,47.6349,-122.096,1960,9975,7061,0.782729187451502,3841600,81378441,77536841
1040000.0,4,5.0,4110,43560,2.0,0,0,3,11,4110,0,1978,0.0,98005,47.6353,-122.18,3650,43995,39450,0.9056473829201102,16892100,1897473600,1880581500
430000.0,3,2.25,1830,19965,1.0,0,0,2,8,1400,430,1976,0.0,98072,47.7412,-122.088,1830,17250,18135,0.9083395942900075,3348900,398601225,395252325
455000.0,2,1.0,1330,92782,1.0,0,0,1,6,1330,0,1950,0.0,98014,47.6624,-121.868,1280,168141,91452,0.98566532301524,1768900,8608499524,8606730624
600000.0,5,2.0,2190,9072,1.0,0,0,4,7,1110,0,1965,0.0,98052,47.6696,-122.149,1660,8327,6882,0.7585978835978836,4796100,82301184,77505084
638000.0,3,3.25,1720,1587,2.5,0,2,2,9,1410,310,2004,0.0,98122,47.6187,-122.29899999999999,1490,1620,-133,-0.08380592312539382,2958400,2518569,-439831
561000.0,3,1.75,1710,5000,1.0,0,0,3,7,1360,350,1918,0.0,98136,47.5492,-122.389,1490,6250,3290,0.658,2924100,25000000,22075900
625000.0,3,2.5,2180,5000,1.0,0,0,3,8,1240,940,1977,0.0,98116,47.5828,-122.396,2000,5000,2820,0.564,4752400,25000000,20247600
263950.0,3,1.75,1700,11613,1.0,0,0,4,7,1180,520,1977,0.0,98092,47.2874,-122.18700000000001,1500,12377,9913,0.8536123310083527,2890000,134861769,131971769
740000.0,3,2.5,2960,9350,2.0,0,2,3,9,2960,0,1978,0.0,98008,47.6218,-122.094,2960,11745,6390,0.6834224598930482,8761600,87422500,78660900
234999.0,3,1.0,1330,8912,1.0,0,0,2,6,1330,0,1948,0.0,98188,47.4493,-122.274,1200,8913,7582,0.8507630161579892,1768900,79423744,77654844
380000.0,4,2.5,1940,3200,2.0,0,0,2,8,1940,0,2004,0.0,98058,47.4583,-122.118,1900,3200,1260,0.39375,3763600,10240000,6476400
329500.0,3,2.25,1500,9656,1.0,0,0,2,7,1170,330,1989,0.0,98019,47.7327,-121.98200000000001,1690,9656,8156,0.8446561723280862,2250000,93238336,90988336
464950.0,4,2.5,2230,64438,1.0,0,0,3,7,1230,1000,1978,0.0,98027,47.4754,-122.007,2230,71002,62208,0.9653930910332412,4972900,4152255844,4147282944
500000.0,3,2.25,1700,9008,1.0,0,0,2,8,1340,360,1985,0.0,98125,47.7161,-122.31700000000001,2340,8003,7308,0.8112788632326821,2890000,81144064,78254064
415000.0,4,1.5,1840,11367,1.5,0,0,3,7,1840,0,1950,0.0,98177,47.7656,-122.35799999999999,1690,9800,9527,0.8381279141374153,3385600,129208689,125823089
437500.0,3,2.25,2100,205603,2.0,0,0,2,8,2100,0,1983,0.0,98070,47.3668,-122.505,2396,187308,203503,0.9897861412528027,4410000,42272593609,42268183609
599000.0,7,2.5,2580,5750,1.0,0,0,3,7,1880,0,1901,0.0,98122,47.6025,-122.294,2280,5750,3170,0.551304347826087,6656400,33062500,26406100
367000.0,4,2.5,2350,8182,2.0,0,0,2,8,2350,0,1997,0.0,98042,47.3697,-122.10600000000001,2330,7000,5832,0.7127841603519922,5522500,66945124,61422624
530000.0,2,1.0,760,3000,1.0,0,0,2,6,760,0,1922,0.0,98107,47.6633,-122.35700000000001,1630,3600,2240,0.7466666666666667,577600,9000000,8422400
989000.0,5,3.5,3280,4000,2.0,0,0,2,9,2440,840,2003,0.0,98117,47.68899999999999,-122.396,1980,4000,720,0.18,10758400,16000000,5241600
462600.0,3,2.0,1320,4000,1.0,0,0,3,6,1020,300,1940,0.0,98118,47.5515,-122.262,2410,6212,2680,0.67,1742400,16000000,14257600
875000.0,3,2.5,1690,10592,1.0,0,0,2,8,1690,0,1973,2009.0,98040,47.58,-122.23100000000001,2260,9945,8902,0.8404456193353474,2856100,112190464,109334364
335000.0,3,2.25,2060,47318,1.0,0,2,3,8,1600,460,1976,0.0,98001,47.2758,-122.265,1870,19663,45258,0.9564647702776956,4243600,2238993124,2234749524
393000.0,4,2.0,1450,5456,1.0,0,0,4,7,1450,0,1951,0.0,98108,47.5442,-122.29700000000001,980,6100,4006,0.7342375366568915,2102500,29767936,27665436
1340000.0,4,3.0,2760,4905,2.0,0,1,3,9,1840,920,1938,0.0,98105,47.6591,-122.27,3200,5424,2145,0.43730886850152906,7617600,24059025,16441425
590000.0,3,2.5,2830,5788,2.0,0,0,2,9,2830,0,2001,0.0,98028,47.7604,-122.235,2500,5802,2958,0.5110573600552868,8008900,33500944,25492044
671000.0,4,2.75,1890,1475,2.0,0,0,2,9,1200,690,2015,0.0,98199,47.6472,-122.383,1650,1682,-415,-0.28135593220338984,3572100,2175625,-1396475
925000.0,3,3.25,2610,4500,1.5,0,0,3,9,1660,950,1909,0.0,98103,47.6701,-122.339,2110,4500,1890,0.42,6812100,20250000,13437900
245000.0,3,2.25,1900,7250,1.0,0,0,2,7,1250,650,1967,0.0,98146,47.4869,-122.344,1560,9420,5350,0.7379310344827587,3610000,52562500,48952500
392500.0,3,1.0,930,6572,1.0,0,0,2,7,930,0,1952,0.0,98115,47.6889,-122.301,960,5840,5642,0.8584905660377359,864900,43191184,42326284
505000.0,4,2.0,2730,12000,1.0,0,0,3,8,1410,1320,1998,0.0,98155,47.7733,-122.271,2730,9039,9270,0.7725,7452900,144000000,136547100
702000.0,4,2.5,2650,6240,2.0,0,0,2,8,2650,0,2013,0.0,98053,47.6885,-122.021,2640,6524,3590,0.5753205128205128,7022500,38937600,31915100
337000.0,2,1.0,1010,4000,1.0,0,0,2,7,1010,0,1947,0.0,98136,47.5311,-122.382,1480,4366,2990,0.7475,1020100,16000000,14979900
920000.0,4,2.5,3550,10233,2.0,0,0,2,9,3550,0,1996,0.0,98027,47.5499,-122.1,3310,9157,6683,0.6530831623179908,12602500,104714289,92111789
495500.0,3,1.75,2130,6360,1.0,0,0,2,7,1720,410,1959,0.0,98125,47.7059,-122.301,1540,6361,4230,0.6650943396226415,4536900,40449600,35912700
245000.0,2,1.75,1840,7230,1.0,0,0,2,7,1570,270,1938,0.0,98030,47.3815,-122.228,1282,6769,5390,0.7455048409405256,3385600,52272900,48887300
395000.0,2,1.0,1320,1824,1.5,0,0,3,6,1320,0,1909,0.0,98144,47.585,-122.294,1320,4000,504,0.27631578947368424,1742400,3326976,1584576
335000.0,3,1.0,990,6315,1.0,0,0,2,7,990,0,1970,0.0,98034,47.7116,-122.214,1450,6702,5325,0.8432304038004751,980100,39879225,38899125
187000.0,2,1.75,1020,10346,1.0,0,0,3,6,1020,0,1983,0.0,98022,47.1958,-122.00200000000001,1160,8610,9326,0.9014111734003479,1040400,107039716,105999316
450000.0,4,2.0,1570,7320,1.0,0,0,3,7,1570,0,1960,0.0,98007,47.5967,-122.14,1530,8800,5750,0.7855191256830601,2464900,53582400,51117500
280000.0,4,2.25,1930,7207,1.0,0,0,3,7,1360,570,1988,0.0,98030,47.3783,-122.182,1760,7207,5277,0.7322048008880255,3724900,51940849,48215949
1380000.0,5,4.0,3760,22763,1.0,0,3,3,11,1910,1850,1969,0.0,98040,47.5333,-122.22,3730,11201,19003,0.8348196634889953,14137600,518154169,504016569
265000.0,2,1.0,1000,31505,1.0,0,0,2,6,1000,0,1960,0.0,98019,47.7659,-121.899,1560,22597,30505,0.9682590065069037,1000000,992565025,991565025
795000.0,3,1.75,1930,9600,1.0,0,0,2,8,1930,0,1958,0.0,98040,47.5747,-122.23700000000001,2350,9840,7670,0.7989583333333333,3724900,92160000,88435100
510000.0,3,1.5,2240,3800,2.0,0,0,2,8,1370,870,1929,0.0,98115,47.6887,-122.307,1690,4275,1560,0.4105263157894737,5017600,14440000,9422400
699900.0,4,2.5,2190,11500,1.0,0,0,3,8,1430,760,1972,0.0,98006,47.5668,-122.147,2580,9700,9310,0.8095652173913044,4796100,132250000,127453900
839000.0,4,2.75,2400,12469,1.0,0,2,3,8,1760,640,1958,0.0,98008,47.5861,-122.11200000000001,2400,10400,10069,0.8075226561873446,5760000,155475961,149715961
396000.0,4,1.75,1970,12409,1.0,0,0,3,7,1220,750,1968,0.0,98028,47.7489,-122.236,1690,10720,10439,0.8412442581996937,3880900,153983281,150102381
365000.0,3,2.25,2860,8458,2.0,0,0,2,7,2860,0,1983,0.0,98058,47.4269,-122.148,1760,8458,5598,0.6618585954126271,8179600,71537764,63358164
440000.0,3,2.25,1900,7225,1.0,0,0,2,8,1220,680,1970,0.0,98008,47.6394,-122.113,1900,7399,5325,0.7370242214532872,3610000,52200625,48590625
405000.0,4,2.5,2090,6667,2.0,0,0,2,8,2090,0,1997,0.0,98058,47.4648,-122.15,2250,6165,4577,0.6865156742162892,4368100,44448889,40080789
295000.0,3,1.5,850,2500,1.0,0,0,2,7,850,0,1986,0.0,98106,47.5677,-122.36,850,5000,1650,0.66,722500,6250000,5527500
275000.0,4,2.5,1840,1562,2.0,0,0,2,7,1400,440,2004,0.0,98106,47.5345,-122.36399999999999,1840,1766,-278,-0.17797695262483995,3385600,2439844,-945756
295000.0,2,1.0,820,288367,1.0,0,0,2,6,820,0,1930,0.0,98042,47.4196,-122.165,1580,8154,287547,0.9971564013912826,672400,83155526689,83154854289
1500000.0,5,3.5,4370,12240,2.0,0,0,2,11,3270,1100,1990,0.0,98004,47.582,-122.199,2980,12800,7870,0.6429738562091504,19096900,149817600,130720700
795000.0,3,3.5,3190,10223,2.0,0,0,2,10,2560,630,1994,0.0,98052,47.6968,-122.102,3120,9735,7033,0.687958524894845,10176100,104509729,94333629
650000.0,5,3.5,3480,36615,2.0,0,0,3,8,2490,990,1983,0.0,98075,47.5741,-122.05,2540,35910,33135,0.9049569848422777,12110400,1340658225,1328547825
260000.0,3,1.0,1690,13184,1.0,0,0,3,7,1690,0,1959,0.0,98166,47.476000000000006,-122.34299999999999,1130,13451,11494,0.8718143203883495,2856100,173817856,170961756
382000.0,2,2.5,1650,2710,2.0,0,2,2,8,1650,0,2008,0.0,98065,47.5173,-121.87799999999999,1760,2992,1060,0.39114391143911437,2722500,7344100,4621600
790100.0,4,2.5,2590,9341,2.0,0,0,2,8,2590,0,1985,0.0,98052,47.6496,-122.11399999999999,2280,9510,6751,0.7227277593405417,6708100,87254281,80546181
220000.0,4,2.5,2160,8005,2.0,0,0,2,7,2160,0,1993,0.0,98001,47.2668,-122.23100000000001,1790,8016,5845,0.7301686445971268,4665600,64080025,59414425
799000.0,4,3.5,3500,8547,2.0,0,0,2,9,2500,1000,1994,0.0,98006,47.5613,-122.126,2350,10270,5047,0.5904995904995906,12250000,73051209,60801209
1480000.0,4,2.25,3920,7200,2.0,0,0,2,10,3120,800,1928,0.0,98144,47.5731,-122.28399999999999,3400,7200,3280,0.45555555555555555,15366400,51840000,36473600
367300.0,4,2.75,2190,14937,2.0,0,0,2,8,2190,0,1993,0.0,98001,47.3535,-122.273,1920,11360,12747,0.8533842136975296,4796100,223113969,218317869
805000.0,4,2.0,1890,4500,1.5,0,0,2,7,1490,400,1907,1993.0,98103,47.6684,-122.35600000000001,1640,4010,2610,0.58,3572100,20250000,16677900
730000.0,2,1.0,1860,3400,1.0,0,0,2,7,1010,850,1920,0.0,98105,47.6714,-122.329,1540,3997,1540,0.45294117647058824,3459600,11560000,8100400
402000.0,3,2.0,1720,7704,1.0,0,0,3,7,1160,560,1969,0.0,98011,47.7368,-122.195,1620,7600,5984,0.7767393561786086,2958400,59351616,56393216
750000.0,4,2.75,2600,4674,1.0,0,0,2,8,1560,1040,1976,0.0,98115,47.6782,-122.286,2600,6099,2074,0.44373127941805734,6760000,21846276,15086276
458000.0,3,1.5,1570,12196,1.0,0,0,3,7,1570,0,1972,0.0,98045,47.4866,-121.786,1740,12196,10626,0.8712692686126599,2464900,148742416,146277516
898000.0,3,2.5,3530,9753,2.0,0,0,2,10,3530,0,1997,0.0,98006,47.5539,-122.103,3220,9234,6223,0.6380600840766943,12460900,95121009,82660109
308000.0,4,2.5,1960,5642,2.0,0,0,2,7,1960,0,1998,0.0,98092,47.3167,-122.18700000000001,1870,5250,3682,0.652605459057072,3841600,31832164,27990564
385000.0,3,2.5,2230,8296,2.0,0,0,2,7,2230,0,2004,0.0,98058,47.4386,-122.116,2480,5940,6066,0.7311957569913211,4972900,68823616,63850716
1020000.0,4,3.0,2720,4800,1.5,0,0,4,8,1790,930,1928,0.0,98105,47.6595,-122.28299999999999,2260,4800,2080,0.43333333333333335,7398400,23040000,15641600
1430000.0,5,3.0,2840,6240,2.0,0,0,4,9,2440,400,1905,0.0,98112,47.6285,-122.309,2940,6000,3400,0.5448717948717948,8065600,38937600,30872000
240000.0,3,1.75,1260,7362,1.0,0,0,2,7,1260,0,1984,0.0,98038,47.3602,-122.052,1530,7232,6102,0.8288508557457213,1587600,54199044,52611444
217000.0,3,1.5,1860,8505,1.0,0,0,3,7,1860,0,1967,0.0,98023,47.3106,-122.365,1810,8262,6645,0.781305114638448,3459600,72335025,68875425
972000.0,4,1.75,2010,6300,1.0,0,2,4,8,1610,400,1937,0.0,98199,47.6457,-122.412,3290,6300,4290,0.680952380952381,4040100,39690000,35649900
361280.0,2,1.0,820,6400,1.0,0,0,3,7,820,0,1944,0.0,98126,47.55,-122.37899999999999,1490,6400,5580,0.871875,672400,40960000,40287600
385000.0,3,1.75,1220,1450,1.0,0,0,2,6,620,600,1905,0.0,98119,47.6361,-122.368,1660,2960,230,0.15862068965517243,1488400,2102500,614100
475000.0,3,2.5,2220,60984,2.0,0,0,3,8,2220,0,1987,0.0,98027,47.4802,-122.052,1930,55333,58764,0.9635970090515545,4928400,3719048256,3714119856
724950.0,4,2.5,2860,3638,1.5,0,2,4,7,1720,1140,1924,0.0,98107,47.6631,-122.361,1760,3880,778,0.21385376580538756,8179600,13235044,5055444
935000.0,5,4.5,4230,9701,2.0,0,0,2,10,4230,0,1999,0.0,98006,47.5444,-122.131,4130,12253,5471,0.5639624780950417,17892900,94109401,76216501
169950.0,3,1.0,840,8470,1.0,0,0,3,6,840,0,1961,0.0,98023,47.3275,-122.338,840,8450,7630,0.9008264462809917,705600,71740900,71035300
585000.0,3,2.5,2290,5089,2.0,0,0,2,9,2290,0,2001,0.0,98006,47.5443,-122.17200000000001,2290,7984,2799,0.5500098251129888,5244100,25897921,20653821
585000.0,3,2.5,2290,5089,2.0,0,0,2,9,2290,0,2001,0.0,98006,47.5443,-122.17200000000001,2290,7984,2799,0.5500098251129888,5244100,25897921,20653821
480000.0,5,3.5,3480,12821,2.0,0,2,2,10,2890,590,2004,0.0,98092,47.2641,-122.215,3400,9870,9341,0.7285703143280555,12110400,164378041,152267641
635000.0,4,2.5,4260,36360,1.5,0,0,3,8,4100,160,1935,0.0,98155,47.763999999999996,-122.302,2430,17888,32100,0.8828382838283828,18147600,1322049600,1303902000
368750.0,3,2.5,2230,5717,2.0,0,0,2,7,2230,0,2004,0.0,98058,47.4388,-122.117,2230,5194,3487,0.6099352807416477,4972900,32684089,27711189
432500.0,6,2.0,3080,5500,2.0,0,0,0,7,3080,0,1900,0.0,98122,47.6031,-122.296,1830,5000,2420,0.44,9486400,30250000,20763600
589000.0,3,2.5,2250,4337,2.0,0,0,2,8,2250,0,2004,0.0,98075,47.5908,-122.01700000000001,2250,4721,2087,0.48120820843901313,5062500,18809569,13747069
840000.0,4,3.25,3160,6327,2.0,0,0,2,9,2280,880,2004,0.0,98027,47.536,-122.066,3160,5946,3167,0.5005531847637111,9985600,40030929,30045329
316500.0,3,2.5,1770,3873,2.0,0,0,2,7,1770,0,2005,0.0,98058,47.4648,-122.14399999999999,2280,4330,2103,0.5429899302865996,3132900,15000129,11867229
536000.0,4,2.5,2880,8833,2.0,0,0,2,7,2880,0,2006,0.0,98065,47.5388,-121.89,2570,5234,5953,0.6739499603758632,8294400,78021889,69727489
563750.0,4,2.75,2690,25000,1.0,0,0,2,8,1750,940,1978,0.0,98029,47.5537,-122.02600000000001,2640,28250,22310,0.8924,7236100,625000000,617763900
152500.0,4,1.0,1730,7350,1.5,0,0,3,6,1730,0,1970,0.0,98003,47.3467,-122.307,1440,7752,5620,0.7646258503401361,2992900,54022500,51029600
267950.0,4,1.0,1730,7350,1.5,0,0,3,6,1730,0,1970,0.0,98003,47.3467,-122.307,1440,7752,5620,0.7646258503401361,2992900,54022500,51029600
1640000.0,5,4.0,4780,118047,2.0,0,0,2,11,4780,0,1994,0.0,98077,47.7243,-122.052,4040,31760,113267,0.959507653731141,22848400,13935094209,13912245809
269950.0,4,2.5,2540,8400,2.0,0,0,4,7,2540,0,1977,0.0,98032,47.3754,-122.277,1600,8050,5860,0.6976190476190476,6451600,70560000,64108400
731688.0,4,3.0,2630,5772,2.0,0,0,2,9,2630,0,2006,0.0,98052,47.6952,-122.133,3460,6158,3142,0.5443520443520443,6916900,33315984,26399084
240000.0,3,1.5,1890,9000,1.0,0,0,2,7,1190,700,1959,0.0,98188,47.4425,-122.272,2060,9000,7110,0.79,3572100,81000000,77427900
555950.0,2,1.0,1220,5040,1.0,0,0,2,7,1220,0,1961,0.0,98117,47.6957,-122.36399999999999,1420,5040,3820,0.7579365079365079,1488400,25401600,23913200
289000.0,2,1.0,710,6300,1.0,0,0,2,6,710,0,1942,0.0,98126,47.5155,-122.374,740,6300,5590,0.8873015873015873,504100,39690000,39185900
525000.0,3,2.5,2970,11985,1.0,0,0,2,9,1770,1200,1995,0.0,98074,47.6359,-122.052,2990,12049,9015,0.7521902377972466,8820900,143640225,134819325
745000.0,3,2.5,2970,11985,1.0,0,0,2,9,1770,1200,1995,0.0,98074,47.6359,-122.052,2990,12049,9015,0.7521902377972466,8820900,143640225,134819325
397000.0,2,1.0,1000,7664,1.0,0,2,2,7,1000,0,1939,0.0,98115,47.7001,-122.311,1570,6350,6664,0.8695198329853863,1000000,58736896,57736896
233000.0,3,1.0,1980,8505,1.0,0,0,2,7,1030,950,1965,0.0,98106,47.538000000000004,-122.353,1830,8505,6525,0.7671957671957672,3920400,72335025,68414625
625000.0,4,2.25,1920,8259,2.0,0,0,3,8,1920,0,1979,0.0,98027,47.5616,-122.088,2030,8910,6339,0.7675263349073738,3686400,68211081,64524681
535000.0,3,2.0,2740,23505,2.0,0,4,2,10,2740,0,1988,0.0,98001,47.318999999999996,-122.26,2800,16400,20765,0.8834290576473091,7507600,552485025,544977425
270000.0,3,2.25,1740,7345,1.0,0,0,2,7,1380,360,1973,0.0,98032,47.3663,-122.285,1770,8250,5605,0.7631041524846834,3027600,53949025,50921425
360000.0,3,1.75,1300,7770,1.0,0,0,2,7,1300,0,1967,0.0,98034,47.7347,-122.19200000000001,1520,7600,6470,0.8326898326898327,1690000,60372900,58682900
1110000.0,4,1.5,2740,4000,2.0,0,0,4,9,1930,0,1905,0.0,98109,47.6343,-122.352,1680,4000,1260,0.315,7507600,16000000,8492400
970000.0,4,1.75,4060,4000,2.0,0,3,2,10,2890,1170,1953,1995.0,98199,47.6375,-122.389,1860,4000,-60,-0.015,16483600,16000000,-483600
915000.0,5,2.5,3490,18850,1.0,0,4,3,9,1840,1650,1958,0.0,98005,47.5955,-122.176,2690,11625,15360,0.8148541114058355,12180100,355322500,343142400
412000.0,4,1.75,1430,10500,1.0,0,0,3,7,1130,300,1960,0.0,98007,47.6083,-122.132,2070,8640,9070,0.8638095238095238,2044900,110250000,108205100
265000.0,4,1.75,1860,9112,1.0,0,0,3,7,1110,750,1963,0.0,98032,47.3792,-122.28200000000001,1570,9112,7252,0.795873573309921,3459600,83028544,79568944
426000.0,4,2.25,2120,7700,1.0,0,0,3,7,1490,630,1976,0.0,98034,47.7207,-122.165,1890,8203,5580,0.7246753246753247,4494400,59290000,54795600
266000.0,4,2.25,1860,12693,1.0,0,0,2,8,1140,720,1978,0.0,98023,47.3114,-122.395,1950,8740,10833,0.8534625384069959,3459600,161112249,157652649
325000.0,3,2.0,2330,4950,1.5,0,0,2,6,1430,900,1900,0.0,98118,47.5585,-122.29,1160,5115,2620,0.5292929292929293,5428900,24502500,19073600
615000.0,3,1.75,1670,5100,1.0,0,2,4,7,990,680,1954,0.0,98144,47.5898,-122.291,2140,4452,3430,0.6725490196078432,2788900,26010000,23221100
310000.0,3,1.75,2130,7140,1.0,0,0,2,8,1580,550,1979,0.0,98023,47.3074,-122.34100000000001,2180,7906,5010,0.7016806722689075,4536900,50979600,46442700
340000.0,4,1.75,1900,7313,1.0,0,0,2,7,1900,0,1973,0.0,98034,47.7311,-122.23200000000001,1420,7384,5413,0.7401887050458088,3610000,53479969,49869969
562500.0,2,1.0,1170,2800,1.5,0,0,3,5,1170,0,1905,0.0,98103,47.6574,-122.345,1660,4996,1630,0.5821428571428572,1368900,7840000,6471100
447000.0,2,1.0,980,1600,2.0,0,0,2,8,980,0,2010,0.0,98119,47.63800000000001,-122.375,1180,1600,620,0.3875,960400,2560000,1599600
2450000.0,7,4.25,4670,23115,2.0,0,2,2,11,4670,0,1992,0.0,98039,47.6183,-122.227,3240,13912,18445,0.7979666882976422,21808900,534303225,512494325
250000.0,4,1.5,2500,6300,1.0,0,0,3,7,1500,1000,1961,0.0,98032,47.3781,-122.28399999999999,1720,8925,3800,0.6031746031746031,6250000,39690000,33440000
633000.0,4,2.5,2020,8044,2.0,0,0,2,8,2020,0,1990,0.0,98074,47.6247,-122.04299999999999,2320,7328,6024,0.748881153654898,4080400,64705936,60625536
310000.0,3,2.0,1290,886,3.0,0,0,2,7,1290,0,2004,0.0,98125,47.7161,-122.295,1270,1152,-404,-0.45598194130925507,1664100,784996,-879104
439000.0,2,1.75,1620,113862,1.5,0,0,2,7,1620,0,1995,0.0,98045,47.4821,-121.719,1560,54806,112242,0.9857722506191706,2624400,12964555044,12961930644
470000.0,3,3.25,1710,2381,2.0,0,0,2,8,1360,350,2003,0.0,98029,47.5477,-122.00399999999999,1420,1163,671,0.2818143637127257,2924100,5669161,2745061
270000.0,3,2.5,1720,8550,1.0,0,0,3,7,1720,0,1968,0.0,98002,47.2837,-122.20700000000001,1460,8550,6830,0.7988304093567251,2958400,73102500,70144100
299500.0,3,1.75,1820,8813,2.0,0,0,2,7,1820,0,1994,0.0,98003,47.2622,-122.303,1780,7349,6993,0.7934868943606036,3312400,77668969,74356569
227000.0,3,1.0,1130,10018,1.0,0,0,3,6,1130,0,1954,0.0,98032,47.3733,-122.275,1770,7700,8888,0.8872030345378319,1276900,100360324,99083424
735000.0,4,2.75,3040,2415,2.0,0,4,2,8,3040,0,1966,0.0,98118,47.5188,-122.256,2620,2433,-625,-0.2587991718426501,9241600,5832225,-3409375
537000.0,3,3.0,2410,7479,2.0,0,2,2,7,2410,0,1942,1988.0,98155,47.7394,-122.288,2610,7479,5069,0.6777644070062843,5808100,55935441,50127341
699000.0,4,2.5,2440,14470,1.0,0,0,3,9,1660,780,1970,0.0,98005,47.6401,-122.16799999999999,2810,15564,12030,0.8313752591568763,5953600,209380900,203427300
330000.0,2,1.0,800,4533,1.0,0,0,2,6,600,200,1929,0.0,98115,47.6979,-122.325,1720,6800,3733,0.8235164350319877,640000,20548089,19908089
229000.0,3,1.0,1030,7800,1.0,0,0,2,7,1030,0,1954,0.0,98168,47.473,-122.324,1630,12664,6770,0.867948717948718,1060900,60840000,59779100
200000.0,3,1.0,1480,5600,1.0,0,0,3,6,940,540,1947,0.0,98178,47.5045,-122.27,1350,11100,4120,0.7357142857142858,2190400,31360000,29169600
522500.0,3,1.75,1710,9707,1.0,0,0,3,8,1710,0,1966,0.0,98008,47.62300000000001,-122.105,1820,8700,7997,0.8238384670856084,2924100,94225849,91301749
1300000.0,3,2.75,3450,5350,1.5,0,3,3,9,2590,860,1925,0.0,98199,47.6389,-122.40700000000001,2910,5350,1900,0.35514018691588783,11902500,28622500,16720000
2000000.0,3,3.25,2610,16387,2.0,0,4,2,9,2610,0,2006,0.0,98125,47.7175,-122.27799999999999,2590,12958,13777,0.8407274058705071,6812100,268533769,261721669
200000.0,2,0.75,780,55764,1.0,0,0,3,4,780,0,1945,0.0,98058,47.442,-122.105,1620,30847,54984,0.9860124811706478,608400,3109623696,3109015296
352000.0,3,1.75,1260,7200,1.0,0,0,2,7,1260,0,1971,0.0,98034,47.7189,-122.178,1460,7200,5940,0.825,1587600,51840000,50252400
855000.0,4,3.0,2590,6250,2.0,0,2,2,9,2240,350,1964,0.0,98115,47.6774,-122.26700000000001,2260,6780,3660,0.5856,6708100,39062500,32354400
267000.0,3,2.5,1580,12250,2.0,0,0,2,8,1580,0,1993,0.0,98198,47.3771,-122.315,1560,9900,10670,0.8710204081632653,2496400,150062500,147566100
484000.0,2,1.75,1660,6000,1.0,0,0,2,7,1160,500,1942,0.0,98105,47.6624,-122.291,1660,4000,4340,0.7233333333333334,2755600,36000000,33244400
402000.0,4,2.75,2950,15540,1.0,0,0,3,8,2120,830,1974,0.0,98042,47.3845,-122.152,2840,17136,12590,0.8101673101673101,8702500,241491600,232789100
905000.0,4,2.25,2240,5000,2.0,0,0,2,8,1770,470,1900,2014.0,98122,47.6027,-122.295,2120,5000,2760,0.552,5017600,25000000,19982400
274000.0,4,1.75,1940,7500,1.0,0,0,3,7,1720,220,1966,0.0,98030,47.3736,-122.215,2000,9000,5560,0.7413333333333333,3763600,56250000,52486400
475000.0,3,1.75,1850,26445,1.0,0,0,3,7,1850,0,1962,1977.0,98010,47.3412,-122.051,2110,23280,24595,0.9300434864813765,3422500,699338025,695915525
1540000.0,4,4.5,5770,10050,1.0,0,3,4,9,3160,2610,1949,0.0,98115,47.677,-122.275,2950,6700,4280,0.42587064676616915,33292900,101002500,67709600
628000.0,4,2.0,2280,6010,1.0,0,0,2,7,1140,1140,1900,0.0,98122,47.6034,-122.289,2240,6200,3730,0.6206322795341098,5198400,36120100,30921700
675000.0,6,1.75,2740,6360,1.0,0,3,2,8,1370,1370,1953,0.0,98146,47.5062,-122.385,2150,6600,3620,0.5691823899371069,7507600,40449600,32942000
429900.0,4,3.25,3760,4675,2.0,0,0,2,8,2740,1020,2007,0.0,98038,47.3862,-122.04799999999999,3280,4033,915,0.19572192513368983,14137600,21855625,7718025
260000.0,3,1.5,1580,8184,1.0,0,0,2,7,1140,440,1954,0.0,98148,47.4294,-122.331,1540,9476,6604,0.8069403714565004,2496400,66977856,64481456
690000.0,3,1.75,1600,4400,1.0,0,0,2,7,1030,570,1941,0.0,98112,47.6348,-122.281,2150,4000,2800,0.6363636363636364,2560000,19360000,16800000
1080000.0,4,2.25,2100,12172,1.0,0,0,4,9,2100,0,1961,0.0,98040,47.5458,-122.227,2400,10713,10072,0.8274728885967795,4410000,148157584,143747584
360000.0,4,2.5,2610,7333,2.0,0,0,2,8,2610,0,1988,0.0,98003,47.2721,-122.29299999999999,2280,9033,4723,0.6440747306695759,6812100,53772889,46960789
499000.0,3,1.75,1840,5000,1.0,0,0,3,7,920,920,1910,0.0,98117,47.6808,-122.376,1220,5000,3160,0.632,3385600,25000000,21614400
159000.0,3,1.0,1320,6534,1.0,0,0,2,7,1320,0,1952,0.0,98055,47.4806,-122.223,2140,7405,5214,0.797979797979798,1742400,42693156,40950756
430000.0,3,1.75,1540,8100,1.0,0,0,3,7,940,600,1947,0.0,98133,47.748999999999995,-122.351,1840,8100,6560,0.8098765432098766,2371600,65610000,63238400
1050000.0,5,2.75,2520,18625,1.0,0,0,2,8,1660,860,1959,0.0,98004,47.6409,-122.20700000000001,3000,16624,16105,0.8646979865771812,6350400,346890625,340540225
725000.0,5,2.5,3780,20000,1.0,0,1,3,9,1890,1890,1978,0.0,98155,47.7603,-122.273,2840,19908,16220,0.811,14288400,400000000,385711600
150000.0,3,1.0,1200,9527,1.0,0,0,2,7,1200,0,1959,0.0,98168,47.5112,-122.316,1510,9457,8327,0.8740421958643855,1440000,90763729,89323729
840000.0,4,2.25,2720,8712,2.0,0,0,3,9,2720,0,1976,0.0,98006,47.5616,-122.15299999999999,2470,8714,5992,0.6877869605142333,7398400,75898944,68500544
499000.0,4,2.5,3100,5700,2.0,0,0,2,9,3100,0,2011,0.0,98038,47.3696,-122.05799999999999,3060,6000,2600,0.45614035087719296,9610000,32490000,22880000
285000.0,3,1.75,1630,4000,1.0,0,0,2,7,1100,530,1968,0.0,98106,47.5351,-122.353,1300,4000,2370,0.5925,2656900,16000000,13343100
340000.0,4,2.5,1910,7201,1.0,0,0,2,7,1210,700,1987,0.0,98198,47.3908,-122.316,1690,7554,5291,0.7347590612414943,3648100,51854401,48206301
405100.0,4,2.0,1580,7300,1.0,0,0,3,7,1580,0,1955,0.0,98155,47.7598,-122.32799999999999,1180,9450,5720,0.7835616438356164,2496400,53290000,50793600
464000.0,3,2.5,1690,4898,2.0,0,0,2,7,1690,0,2003,0.0,98053,47.6834,-122.038,2220,4933,3208,0.6549612086565946,2856100,23990404,21134304
723000.0,4,2.25,1960,8680,1.0,0,0,3,8,1290,670,1959,0.0,98004,47.6076,-122.19200000000001,2160,8680,6720,0.7741935483870968,3841600,75342400,71500800
430000.0,8,3.25,4300,10441,2.0,0,0,3,8,2800,1500,1979,0.0,98059,47.4786,-122.131,1780,10457,6141,0.5881620534431568,18490000,109014481,90524481
645000.0,3,1.75,1840,4255,1.0,0,0,2,7,940,900,1907,2005.0,98116,47.58,-122.39200000000001,1600,4255,2415,0.5675675675675675,3385600,18105025,14719425
1580000.0,4,2.75,3480,19991,2.0,0,2,3,10,2630,850,1979,0.0,98004,47.6354,-122.214,3770,20271,16511,0.8259216647491371,12110400,399640081,387529681
925000.0,5,3.0,2710,4200,2.0,0,0,2,7,1890,820,1919,0.0,98115,47.6754,-122.307,2150,4200,1490,0.3547619047619048,7344100,17640000,10295900
759000.0,4,1.75,2100,4750,1.0,0,0,2,7,1340,760,1975,0.0,98103,47.6695,-122.333,1700,4125,2650,0.5578947368421052,4410000,22562500,18152500
690000.0,4,2.0,1760,7800,1.0,0,0,2,8,1760,0,1954,0.0,98117,47.6945,-122.38,1950,7800,6040,0.7743589743589744,3097600,60840000,57742400
358800.0,4,2.5,2155,8140,2.0,0,0,2,8,2155,0,1996,0.0,98031,47.4204,-122.20100000000001,2155,7245,5985,0.7352579852579852,4644025,66259600,61615575
683000.0,5,1.5,1720,4000,1.5,0,0,2,7,1520,200,1925,0.0,98112,47.6197,-122.287,2280,4000,2280,0.57,2958400,16000000,13041600
650000.0,3,1.0,1430,4240,1.5,0,0,2,7,1430,0,1924,0.0,98103,47.6595,-122.337,1660,4240,2810,0.6627358490566038,2044900,17977600,15932700
288000.0,5,2.75,2790,4807,1.5,0,0,3,7,2140,650,1949,0.0,98002,47.3098,-122.223,1056,4807,2017,0.4195964218847514,7784100,23107249,15323149
209950.0,3,1.5,1180,7300,1.0,0,0,3,7,1180,0,1968,0.0,98002,47.2857,-122.197,2030,8424,6120,0.8383561643835616,1392400,53290000,51897600
939000.0,3,3.5,2450,9248,2.0,0,4,2,8,1960,490,1933,0.0,98136,47.5476,-122.397,2620,10207,6798,0.7350778546712803,6002500,85525504,79523004
320000.0,3,1.0,1330,5850,1.0,0,0,2,7,930,400,1954,0.0,98108,47.5498,-122.29799999999999,1440,5850,4520,0.7726495726495727,1768900,34222500,32453600
283748.0,3,2.25,1940,9560,2.0,0,0,2,7,1940,0,1989,0.0,98023,47.2998,-122.387,1800,9560,7620,0.797071129707113,3763600,91393600,87630000
370000.0,3,2.25,1600,7620,1.0,0,0,2,7,1280,320,1987,0.0,98011,47.773999999999994,-122.208,1600,8215,6020,0.7900262467191601,2560000,58064400,55504400
399950.0,4,2.75,3210,41689,1.0,0,0,3,8,1610,1600,1989,0.0,98042,47.3493,-122.06200000000001,2100,41384,38479,0.9230012713185732,10304100,1737972721,1727668621
360000.0,5,2.5,2880,6902,1.0,0,0,2,8,1680,1200,1976,0.0,98058,47.4332,-122.14399999999999,2080,5586,4022,0.5827296435815705,8294400,47637604,39343204
365000.0,2,1.5,1160,8060,1.0,0,0,3,7,1160,0,1950,0.0,98136,47.5146,-122.38600000000001,1500,8060,6900,0.8560794044665012,1345600,64963600,63618000
396900.0,3,2.0,1360,3120,2.0,0,0,2,7,1360,0,1989,0.0,98115,47.6943,-122.307,1360,3120,1760,0.5641025641025641,1849600,9734400,7884800
321000.0,3,2.5,2014,4500,2.0,0,0,2,7,2014,0,2005,0.0,98001,47.3371,-122.256,2014,4500,2486,0.5524444444444444,4056196,20250000,16193804
245000.0,3,2.0,1440,7008,1.0,0,0,2,7,1440,0,1985,0.0,98030,47.3702,-122.182,1680,7200,5568,0.7945205479452054,2073600,49112064,47038464
502000.0,2,1.0,1570,4704,1.5,0,1,2,8,1570,0,1931,0.0,98136,47.5256,-122.39200000000001,1820,4704,3134,0.6662414965986394,2464900,22127616,19662716
257000.0,4,2.75,2330,7642,1.0,0,0,2,8,1800,530,1990,0.0,98023,47.2946,-122.37,2320,7933,5312,0.6951059931954986,5428900,58400164,52971264
423000.0,4,1.75,1880,7303,1.0,0,0,2,7,1010,870,1976,0.0,98034,47.7129,-122.20299999999999,1710,7200,5423,0.7425715459400246,3534400,53333809,49799409
485000.0,4,2.25,1850,9911,1.0,0,0,3,7,1850,0,1957,0.0,98008,47.6019,-122.116,1650,8670,8061,0.8133387145595803,3422500,98227921,94805421
500000.0,4,2.5,2230,8560,2.0,0,0,2,8,2230,0,2002,0.0,98059,47.4877,-122.14299999999999,2400,7756,6330,0.7394859813084113,4972900,73273600,68300700
442000.0,2,1.0,990,4313,1.5,0,2,3,6,990,0,1917,0.0,98126,47.5677,-122.38,1480,5750,3323,0.7704613957801993,980100,18601969,17621869
475000.0,3,1.75,1720,3825,1.5,0,0,2,7,1720,0,1925,0.0,98105,47.666000000000004,-122.32700000000001,2000,3825,2105,0.550326797385621,2958400,14630625,11672225
625000.0,4,2.25,3230,9935,2.0,0,0,2,8,3230,0,1986,0.0,98028,47.7685,-122.257,2820,9722,6705,0.6748867639657775,10432900,98704225,88271325
194000.0,3,1.0,1180,6050,1.0,0,0,2,6,820,360,1944,0.0,98178,47.4945,-122.249,1070,6050,4870,0.8049586776859504,1392400,36602500,35210100
410000.0,3,2.25,1450,19206,2.0,0,0,2,7,1450,0,1989,0.0,98074,47.62,-122.052,1710,21485,17756,0.9245027595543059,2102500,368870436,366767936
1030000.0,4,2.5,2370,10858,2.0,0,0,2,9,2370,0,2003,0.0,98004,47.6336,-122.19200000000001,2510,21673,8488,0.7817277583348683,5616900,117896164,112279264
490000.0,4,2.5,2570,6157,2.0,0,0,2,7,2570,0,2006,0.0,98065,47.5389,-121.89,2060,5292,3587,0.5825889231768718,6604900,37908649,31303749
348500.0,4,1.75,1870,7575,1.0,0,0,2,7,1480,390,1972,0.0,98034,47.7205,-122.21799999999999,1670,7575,5705,0.7531353135313531,3496900,57380625,53883725
380000.0,3,1.0,1220,3000,1.5,0,0,2,6,1220,0,1901,0.0,98103,47.6506,-122.346,1350,3000,1780,0.5933333333333334,1488400,9000000,7511600
660000.0,3,2.0,1770,2150,3.0,0,0,2,8,1770,0,1999,0.0,98122,47.6102,-122.314,2010,3200,380,0.17674418604651163,3132900,4622500,1489600
525000.0,3,1.0,1500,6800,1.0,0,0,2,7,1500,0,1943,0.0,98105,47.6706,-122.26799999999999,1500,6800,5300,0.7794117647058824,2250000,46240000,43990000
235000.0,3,2.0,1110,8724,1.0,0,0,3,7,1110,0,1990,0.0,98002,47.3056,-122.206,1390,7750,7614,0.8727647867950481,1232100,76108176,74876076
1210000.0,4,3.75,4980,18069,2.0,0,3,2,11,4980,0,2006,0.0,98065,47.5348,-121.85600000000001,4080,14577,13089,0.724389838950689,24800400,326488761,301688361
397950.0,4,1.75,2360,8116,1.0,0,0,3,7,1180,1180,1916,1970.0,98133,47.7635,-122.335,1670,8160,5756,0.7092163627402661,5569600,65869456,60299856
268000.0,3,1.75,1600,7711,1.0,0,0,2,7,1600,0,1999,0.0,98002,47.284,-122.20200000000001,2100,7711,6111,0.7925042147581377,2560000,59459521,56899521
525000.0,3,1.0,1450,4000,1.0,0,1,3,8,950,500,1948,0.0,98118,47.5554,-122.266,1880,4000,2550,0.6375,2102500,16000000,13897500
549950.0,3,2.5,2680,5860,2.0,0,0,2,8,2680,0,2001,0.0,98011,47.7557,-122.223,2680,5860,3180,0.5426621160409556,7182400,34339600,27157200
370000.0,3,1.75,1150,6600,1.5,0,0,3,6,1150,0,1970,0.0,98033,47.6709,-122.185,1530,6600,5450,0.8257575757575758,1322500,43560000,42237500
299000.0,4,2.25,1870,6693,2.0,0,0,2,7,1870,0,1996,0.0,98003,47.2774,-122.29899999999999,1650,6518,4823,0.7206036157179142,3496900,44796249,41299349
715000.0,6,2.75,3400,5000,2.0,0,2,2,8,2860,540,1977,0.0,98107,47.6728,-122.36200000000001,1800,5000,1600,0.32,11560000,25000000,13440000
430000.0,4,1.5,1810,7200,1.0,0,0,2,7,1810,0,1966,0.0,98034,47.7207,-122.186,2060,7200,5390,0.7486111111111111,3276100,51840000,48563900
345000.0,3,1.75,1860,7191,1.0,0,0,3,7,1260,600,1975,0.0,98058,47.4338,-122.16799999999999,1850,7490,5331,0.7413433458489779,3459600,51710481,48250881
1600000.0,3,3.25,3790,19000,2.0,0,4,2,10,3790,0,1985,0.0,98177,47.724,-122.37299999999999,2740,18628,15210,0.8005263157894736,14364100,361000000,346635900
534640.0,3,2.5,2130,3500,1.0,0,0,3,8,1210,920,1994,0.0,98072,47.736000000000004,-122.15899999999999,2030,3710,1370,0.3914285714285714,4536900,12250000,7713100
1230000.0,3,2.5,2860,4500,2.0,0,2,2,8,1980,880,1915,0.0,98119,47.6463,-122.37100000000001,2310,4500,1640,0.36444444444444446,8179600,20250000,12070400
351000.0,4,2.5,2370,7274,2.0,0,0,2,7,2370,0,1997,0.0,98031,47.3982,-122.171,2090,7656,4904,0.6741820181468243,5616900,52911076,47294176
745000.0,4,2.25,2290,10409,2.0,0,0,2,8,2290,0,1972,0.0,98005,47.6351,-122.16799999999999,2040,10409,8119,0.7799980785858391,5244100,108347281,103103181
320000.0,2,1.0,1120,5329,1.0,0,1,2,6,750,370,1929,0.0,98126,47.5421,-122.37799999999999,1530,5330,4209,0.7898292362544568,1254400,28398241,27143841
555700.0,3,2.0,1810,12420,1.0,0,0,3,7,1810,0,1957,0.0,98008,47.5888,-122.12700000000001,2230,12330,10610,0.8542673107890499,3276100,154256400,150980300
690000.0,4,2.5,3220,35400,2.0,0,0,2,9,3220,0,1991,0.0,98072,47.7547,-122.11399999999999,3050,35252,32180,0.9090395480225989,10368400,1253160000,1242791600
449000.0,3,1.75,1660,9697,1.0,0,0,3,7,1660,0,1952,0.0,98155,47.7564,-122.286,2060,20624,8037,0.8288130349592657,2755600,94031809,91276209
308500.0,2,1.0,850,6174,1.0,0,0,3,7,850,0,1950,0.0,98155,47.7352,-122.32799999999999,1100,6174,5324,0.862325882734046,722500,38118276,37395776
340000.0,4,2.5,2665,5868,2.0,0,0,2,9,2665,0,2006,0.0,98030,47.3831,-122.185,2665,6092,3203,0.5458418541240627,7102225,34433424,27331199
937750.0,4,2.75,2580,3560,1.5,0,0,4,7,1710,870,1917,0.0,98115,47.6753,-122.304,1980,3800,980,0.2752808988764045,6656400,12673600,6017200
725126.0,4,2.5,3200,12369,2.0,0,0,2,10,3200,0,1998,0.0,98059,47.5273,-122.14299999999999,3770,12960,9169,0.7412887056350553,10240000,152992161,142752161
135000.0,3,1.0,840,3000,1.0,0,0,2,5,840,0,1943,0.0,98178,47.494,-122.275,1010,6000,2160,0.72,705600,9000000,8294400
635000.0,4,2.5,2970,7961,1.0,0,0,2,8,2020,950,1969,0.0,98125,47.7118,-122.29,1410,7959,4991,0.6269312900389399,8820900,63377521,54556621
245500.0,2,1.0,790,7500,1.0,0,0,2,6,790,0,1950,0.0,98011,47.7644,-122.198,1970,8970,6710,0.8946666666666667,624100,56250000,55625900
230000.0,6,1.5,2140,36509,1.5,0,0,3,8,2140,0,1903,0.0,98001,47.2668,-122.25200000000001,1710,12000,34369,0.9413843161960065,4579600,1332907081,1328327481
1770000.0,3,2.5,2580,14603,1.0,0,2,3,9,2580,0,1951,0.0,98004,47.6199,-122.212,2410,14347,12023,0.8233239745257823,6656400,213247609,206591209
425000.0,5,2.5,2180,7875,1.0,0,0,3,7,1200,980,1955,0.0,98133,47.7543,-122.34100000000001,1840,5105,5695,0.7231746031746031,4752400,62015625,57263225
220000.0,2,1.0,1060,10423,1.5,0,0,2,7,1060,0,1965,0.0,98125,47.705,-122.31299999999999,2240,10200,9363,0.8983018324858486,1123600,108638929,107515329
370000.0,3,2.0,1860,9100,1.5,0,0,2,8,1860,0,1939,2006.0,98155,47.7522,-122.304,1620,9519,7240,0.7956043956043956,3459600,82810000,79350400
390000.0,3,2.0,1840,16815,1.0,0,0,4,7,960,880,1972,0.0,98059,47.4837,-122.11,1810,16732,14975,0.8905738923580137,3385600,282744225,279358625
239000.0,3,1.75,1340,16480,1.0,0,0,3,7,1340,0,1968,0.0,98042,47.364,-122.162,1520,10451,15140,0.9186893203883495,1795600,271590400,269794800
345000.0,4,2.25,2320,7350,2.0,0,0,2,8,2320,0,1973,0.0,98058,47.4512,-122.131,2170,7350,5030,0.6843537414965987,5382400,54022500,48640100
289000.0,3,2.5,2110,8304,1.0,0,0,3,7,2110,0,1985,0.0,98030,47.3558,-122.17299999999999,1680,7508,6194,0.7459055876685935,4452100,68956416,64504316
285000.0,5,1.5,1840,8050,1.5,0,0,3,7,1840,0,1962,0.0,98198,47.3668,-122.31200000000001,1690,8151,6210,0.7714285714285715,3385600,64802500,61416900
147400.0,3,2.0,1080,9225,1.0,0,0,1,7,1080,0,1955,0.0,98146,47.4842,-122.346,1410,9840,8145,0.8829268292682927,1166400,85100625,83934225
600000.0,2,1.0,1290,4636,1.0,0,0,2,7,1290,0,1924,0.0,98112,47.6393,-122.301,1940,4635,3346,0.7217428817946505,1664100,21492496,19828396
245000.0,3,2.25,2210,10794,1.0,0,0,2,7,1540,670,1967,0.0,98178,47.4911,-122.22399999999999,2230,10753,8584,0.7952566240503983,4884100,116510436,111626336
520000.0,3,2.25,2210,10794,1.0,0,0,2,7,1540,670,1967,0.0,98178,47.4911,-122.22399999999999,2230,10753,8584,0.7952566240503983,4884100,116510436,111626336
352500.0,3,2.25,1410,14110,1.0,0,2,2,7,1170,240,1987,0.0,98065,47.5336,-121.76,1560,18336,12700,0.9000708717221828,1988100,199092100,197104000
448000.0,5,3.5,3740,24684,2.0,0,0,2,9,2760,980,1998,0.0,98038,47.3832,-122.057,2880,26023,20944,0.8484848484848485,13987600,609299856,595312256
270000.0,4,2.75,2440,7150,1.0,0,0,2,7,1200,1240,1963,1985.0,98032,47.3662,-122.28200000000001,1790,7150,4710,0.6587412587412588,5953600,51122500,45168900
872500.0,3,2.5,2040,6000,1.0,0,0,2,8,1840,200,1951,0.0,98109,47.6334,-122.35,1820,4920,3960,0.66,4161600,36000000,31838400
2150000.0,4,3.25,3840,6214,1.5,0,3,3,10,2590,1250,1939,0.0,98199,47.6388,-122.406,3280,5915,2374,0.38204055358867073,14745600,38613796,23868196
225000.0,3,1.5,1660,7221,1.0,0,0,2,7,980,680,1962,0.0,98168,47.4962,-122.32,1770,8083,5561,0.7701149425287356,2755600,52142841,49387241
735000.0,4,2.0,1640,6000,1.5,0,0,3,9,1640,0,1911,0.0,98119,47.6505,-122.375,1900,6000,4360,0.7266666666666667,2689600,36000000,33310400
375000.0,3,1.0,1310,8400,1.0,0,0,2,7,1310,0,1972,1989.0,98034,47.7253,-122.197,1680,8000,7090,0.844047619047619,1716100,70560000,68843900
169000.0,3,1.75,1720,9775,1.0,0,0,2,8,1720,0,1978,0.0,98032,47.3731,-122.286,1970,8400,8055,0.8240409207161126,2958400,95550625,92592225
279950.0,3,1.75,1720,9775,1.0,0,0,2,8,1720,0,1978,0.0,98032,47.3731,-122.286,1970,8400,8055,0.8240409207161126,2958400,95550625,92592225
1950000.0,4,2.75,4020,18745,2.0,0,4,3,10,2830,1190,1989,0.0,98004,47.6042,-122.21,3150,20897,14725,0.7855428114163777,16160400,351375025,335214625
310000.0,3,2.25,1960,2345,2.0,0,0,2,7,1750,210,2003,0.0,98118,47.5419,-122.288,1760,1958,385,0.16417910447761194,3841600,5499025,1657425
975000.0,4,2.5,3240,35083,2.0,0,0,3,9,3240,0,1978,0.0,98005,47.6337,-122.154,3340,24501,31843,0.9076475785993217,10497600,1230816889,1220319289
650000.0,10,2.0,3610,11914,2.0,0,0,3,7,3010,600,1958,0.0,98006,47.5705,-122.175,2040,11914,8304,0.6969951317777405,13032100,141943396,128911296
930000.0,2,1.5,1800,4500,1.0,0,2,2,7,1000,800,1942,0.0,98109,47.6305,-122.34700000000001,2270,3840,2700,0.6,3240000,20250000,17010000
412000.0,4,1.5,1960,5000,1.0,0,0,2,7,980,980,1912,0.0,98106,47.5688,-122.363,1300,5000,3040,0.608,3841600,25000000,21158400
225000.0,3,1.0,1250,10200,1.0,0,0,2,6,1250,0,1965,0.0,98178,47.4902,-122.256,1800,8283,8950,0.8774509803921569,1562500,104040000,102477500
507000.0,3,2.5,2120,7201,2.0,0,0,2,8,2120,0,2003,0.0,98133,47.7174,-122.337,1930,7206,5081,0.7055964449382031,4494400,51854401,47360001
1760000.0,4,4.0,3860,67953,2.0,0,2,3,12,3860,0,1927,0.0,98177,47.7469,-122.37799999999999,4410,128066,64093,0.9431960325519109,14899600,4617610209,4602710609
230000.0,3,2.5,1340,3011,2.0,0,0,2,7,1340,0,1995,0.0,98038,47.3839,-122.038,1060,3232,1671,0.5549651278644968,1795600,9066121,7270521
316000.0,1,2.0,1780,188465,2.0,0,0,2,10,1780,0,2001,0.0,98045,47.4506,-121.76799999999999,1780,21094,186685,0.9905552755153477,3168400,35519056225,35515887825
616200.0,5,3.25,3920,4832,2.0,0,0,2,9,3030,890,2014,0.0,98065,47.5202,-121.885,2660,4832,912,0.18874172185430463,15366400,23348224,7981824
509900.0,3,1.75,1690,53578,1.0,0,0,2,8,1690,0,1984,0.0,98053,47.6546,-122.04899999999999,2290,52707,51888,0.9684572025831498,2856100,2870602084,2867745984
370000.0,4,2.5,2570,7753,2.0,0,0,2,8,2570,0,1987,0.0,98058,47.4237,-122.162,2140,7615,5183,0.6685154133883658,6604900,60109009,53504109
619100.0,3,1.75,1870,7030,1.0,0,0,2,7,1870,0,1977,0.0,98033,47.6999,-122.17,1820,7500,5160,0.7339971550497866,3496900,49420900,45924000
805000.0,3,2.25,2860,11250,1.0,0,1,4,8,2290,570,1956,0.0,98166,47.4534,-122.37200000000001,2030,11250,8390,0.7457777777777778,8179600,126562500,118382900
612125.0,2,1.5,1670,6000,1.0,0,0,2,7,1090,580,1950,0.0,98119,47.6517,-122.374,1670,6000,4330,0.7216666666666667,2788900,36000000,33211100
350000.0,2,1.5,1070,937,3.0,0,0,2,8,1070,0,2003,0.0,98115,47.6761,-122.3,1100,3200,-133,-0.14194236926360726,1144900,877969,-266931
225000.0,2,1.0,940,15000,1.0,0,0,2,7,940,0,1960,0.0,98055,47.4312,-122.195,1450,15000,14060,0.9373333333333334,883600,225000000,224116400
335000.0,3,2.5,2588,5701,2.0,0,0,2,8,2588,0,2008,0.0,98042,47.3449,-122.15100000000001,2389,5702,3113,0.54604455358709,6697744,32501401,25803657
972800.0,5,3.25,3500,10457,2.0,0,0,2,11,3500,0,2001,0.0,98059,47.5198,-122.15700000000001,3500,11734,6957,0.6652959739887156,12250000,109348849,97098849
500000.0,3,1.75,1690,48096,1.0,0,0,2,7,1690,0,1973,0.0,98053,47.6745,-122.061,2070,35160,46406,0.9648619427811045,2856100,2313225216,2310369116
2200000.0,4,3.75,3790,7200,2.0,0,0,2,10,2530,1260,1931,0.0,98112,47.6264,-122.289,3250,7200,3410,0.4736111111111111,14364100,51840000,37475900
415000.0,3,1.5,1090,8400,1.0,0,0,3,7,1090,0,1966,0.0,98008,47.6219,-122.115,1320,8400,7310,0.8702380952380953,1188100,70560000,69371900
399000.0,3,3.0,2240,10479,2.0,0,0,3,7,1710,530,1950,0.0,98106,47.5529,-122.35600000000001,1530,5244,8239,0.7862391449565799,5017600,109809441,104791841
376000.0,2,1.0,1150,4000,1.0,0,0,2,7,1150,0,1947,0.0,98199,47.6575,-122.39399999999999,1150,4288,2850,0.7125,1322500,16000000,14677500
340000.0,3,2.0,1870,3378,1.0,0,0,2,7,1120,750,1913,0.0,98136,47.5371,-122.39299999999999,1870,1872,1508,0.44641799881586736,3496900,11410884,7913984
490000.0,5,2.75,2990,7200,2.0,0,0,2,8,2990,0,1997,0.0,98059,47.4955,-122.16,2710,7620,4210,0.5847222222222223,8940100,51840000,42899900
374000.0,4,2.5,2580,6260,2.0,0,0,2,7,2580,0,2004,0.0,98056,47.4858,-122.185,2160,3600,3680,0.5878594249201278,6656400,39187600,32531200
852000.0,4,1.0,2220,3588,1.5,0,0,3,7,1470,750,1927,0.0,98115,47.6854,-122.30799999999999,1740,3588,1368,0.38127090301003347,4928400,12873744,7945344
473000.0,3,2.25,1620,12309,2.0,0,0,2,7,1620,0,1987,0.0,98074,47.6188,-122.029,2030,13963,10689,0.868388983670485,2624400,151511481,148887081
540000.0,3,1.75,2590,25992,1.0,0,0,2,8,1970,620,1968,0.0,98029,47.5521,-122.03,2590,29250,23402,0.9003539550630963,6708100,675584064,668875964
431000.0,2,2.0,1390,12530,1.0,0,0,2,8,970,420,1959,0.0,98155,47.7499,-122.29,1940,12530,11140,0.8890662410215483,1932100,157000900,155068800
435000.0,4,3.0,2270,7245,1.0,0,0,2,7,1410,860,1979,0.0,98155,47.7722,-122.315,1740,7571,4975,0.6866804692891649,5152900,52490025,47337125
1050000.0,4,3.0,2920,33976,1.0,0,3,4,8,1460,1460,1964,0.0,98008,47.6164,-122.104,2970,15210,31056,0.9140569813986343,8526400,1154368576,1145842176
450000.0,3,2.75,1250,892,2.0,0,0,2,8,1040,0,2010,0.0,98116,47.5826,-122.387,1250,1296,-358,-0.4013452914798206,1562500,795664,-766836
157500.0,3,1.0,1100,27008,1.0,0,0,2,6,960,140,1935,0.0,98178,47.4963,-122.249,1280,8890,25908,0.959271327014218,1210000,729432064,728222064
244000.0,3,1.75,1500,7475,1.0,0,0,3,8,1500,0,1976,0.0,98023,47.3155,-122.365,1940,7475,5975,0.7993311036789298,2250000,55875625,53625625
550000.0,3,2.5,2800,10603,2.0,0,0,2,9,2800,0,2001,0.0,98011,47.7528,-122.195,2580,10603,7803,0.7359237951523154,7840000,112423609,104583609
975000.0,4,2.5,3420,183387,2.0,0,0,2,10,3420,0,2000,0.0,98053,47.633,-121.97200000000001,2260,34613,179967,0.9813509136416431,11696400,33630791769,33619095369
426500.0,4,2.75,2100,88426,1.0,0,0,2,6,2100,0,1990,0.0,98038,47.398999999999994,-122.01100000000001,2150,63162,86326,0.9762513287946983,4410000,7819157476,7814747476
350000.0,3,1.0,1790,3876,1.5,0,0,4,7,1090,0,1904,0.0,98144,47.575,-122.288,1360,4080,2086,0.5381836945304438,3204100,15023376,11819276
615000.0,3,1.0,1790,3876,1.5,0,0,4,7,1090,700,1904,0.0,98144,47.575,-122.288,1360,4080,2086,0.5381836945304438,3204100,15023376,11819276
542000.0,3,2.25,2220,12056,2.0,0,0,2,8,2220,0,1985,0.0,98052,47.7148,-122.101,2320,12025,9836,0.8158593231585932,4928400,145347136,140418736
710000.0,4,1.75,2000,6000,1.0,0,3,4,7,1000,1000,1956,0.0,98109,47.6428,-122.348,2610,4377,4000,0.6666666666666666,4000000,36000000,32000000
289950.0,3,2.5,1770,9450,1.0,0,0,2,8,1770,0,1988,0.0,98001,47.3196,-122.272,2200,8582,7680,0.8126984126984127,3132900,89302500,86169600
1900000.0,4,2.75,4280,12668,2.0,0,0,2,9,3900,380,1947,2008.0,98004,47.6185,-122.219,3590,12670,8388,0.6621408272813388,18318400,160478224,142159824
528000.0,2,1.0,1260,5100,1.5,0,0,3,7,1120,140,1925,0.0,98117,47.6805,-122.384,1260,5100,3840,0.7529411764705882,1587600,26010000,24422400
471000.0,2,1.0,840,5100,1.0,0,0,3,7,840,0,1949,0.0,98117,47.6779,-122.384,1550,5100,4260,0.8352941176470589,705600,26010000,25304400
250000.0,4,2.75,1830,6643,2.0,0,0,2,8,1830,0,2001,0.0,98001,47.2601,-122.286,2400,6472,4813,0.7245220532891766,3348900,44129449,40780549
155000.0,3,1.5,970,8400,1.0,0,0,2,7,970,0,1966,0.0,98003,47.3284,-122.331,1230,8400,7430,0.8845238095238095,940900,70560000,69619100
515000.0,4,1.5,1740,8160,1.5,0,0,3,7,1400,340,1946,0.0,98177,47.7243,-122.363,1600,8160,6420,0.7867647058823529,3027600,66585600,63558000
336600.0,3,2.25,1654,8464,2.0,0,0,2,7,1654,0,1995,0.0,98038,47.3618,-122.03299999999999,1975,8515,6810,0.8045841209829868,2735716,71639296,68903580
915000.0,3,2.25,2390,2750,2.0,0,0,4,8,1580,810,1925,0.0,98109,47.6339,-122.354,2200,5160,360,0.13090909090909092,5712100,7562500,1850400
350000.0,2,1.75,1080,7242,2.0,0,0,3,7,1080,0,1984,0.0,98034,47.7065,-122.235,1800,7321,6162,0.8508699254349628,1166400,52446564,51280164
1300000.0,4,1.75,2610,21600,1.0,0,0,3,8,2610,0,1966,0.0,98004,47.6245,-122.227,2920,20330,18990,0.8791666666666667,6812100,466560000,459747900
175000.0,3,1.0,1070,6164,1.0,0,0,2,7,1070,0,1967,0.0,98001,47.3377,-122.291,1320,7920,5094,0.8264114211550941,1144900,37994896,36849996
545000.0,2,2.0,1430,3880,1.0,0,0,3,7,1430,0,1949,0.0,98117,47.6844,-122.39200000000001,1430,3880,2450,0.6314432989690721,2044900,15054400,13009500
475000.0,4,3.0,2400,5400,2.0,0,2,3,7,1600,800,1965,0.0,98178,47.5099,-122.26,2400,5400,3000,0.5555555555555556,5760000,29160000,23400000
390000.0,2,1.0,670,11505,1.0,0,0,2,5,670,0,2003,0.0,98059,47.498999999999995,-122.15700000000001,2180,11505,10835,0.9417644502390266,448900,132365025,131916125
645000.0,4,2.5,2860,14000,2.0,0,0,2,8,2860,0,1995,0.0,98019,47.7306,-121.973,2650,14564,11140,0.7957142857142857,8179600,196000000,187820400
410000.0,3,1.5,2270,8187,1.0,0,0,3,8,1420,850,1954,0.0,98155,47.7573,-122.27799999999999,2020,14092,5917,0.7227311591547575,5152900,67026969,61874069
480000.0,4,2.5,2180,9861,2.0,0,2,2,8,2180,0,1997,0.0,98045,47.4817,-121.802,2390,9761,7681,0.7789270865023831,4752400,97239321,92486921
725000.0,3,1.75,1860,6000,2.0,0,2,3,8,1860,0,1959,0.0,98144,47.5981,-122.288,3030,7119,4140,0.69,3459600,36000000,32540400
1150000.0,6,4.5,6040,219542,2.0,0,0,2,11,4100,1940,1996,0.0,98029,47.5622,-122.00299999999999,2010,32362,213502,0.972488179938235,36481600,48198689764,48162208164
300000.0,2,1.0,1010,11919,1.0,0,0,2,6,1010,0,1947,0.0,98155,47.7461,-122.322,1220,11240,10909,0.9152613474284755,1020100,142062561,141042461
752000.0,4,2.5,2570,8178,1.0,0,2,2,8,1710,860,1961,0.0,98118,47.5483,-122.26100000000001,2050,7500,5608,0.6857422352653461,6604900,66879684,60274784
585000.0,4,2.5,1950,3720,2.0,0,0,2,8,1950,0,2004,0.0,98029,47.5503,-121.99700000000001,1720,3720,1770,0.47580645161290325,3802500,13838400,10035900
678700.0,3,1.75,1970,10548,1.0,0,0,3,8,1300,670,1973,0.0,98033,47.6669,-122.179,2500,8548,8578,0.8132347364429275,3880900,111260304,107379404
603000.0,4,2.25,2110,11155,2.0,0,0,2,9,2110,0,1975,0.0,98074,47.6386,-122.05799999999999,2660,11900,9045,0.8108471537427163,4452100,124434025,119981925
715000.0,3,1.75,1650,7276,1.5,0,4,3,7,1150,500,1928,0.0,98117,47.6989,-122.399,2300,8088,5626,0.7732270478284772,2722500,52940176,50217676
1400000.0,4,3.0,3520,128502,2.0,0,2,3,10,3520,0,1981,0.0,98072,47.7448,-122.117,3260,79714,124982,0.9726074302345489,12390400,16512764004,16500373604
1090000.0,3,2.5,2840,7500,2.0,0,3,2,11,2840,0,1997,0.0,98034,47.7049,-122.22399999999999,2580,5918,4660,0.6213333333333333,8065600,56250000,48184400
467500.0,2,1.75,1490,4800,1.0,0,0,3,7,750,740,1918,0.0,98136,47.5496,-122.391,1400,6000,3310,0.6895833333333333,2220100,23040000,20819900
359000.0,3,2.25,1650,7218,1.0,0,0,2,7,1230,420,1985,0.0,98133,47.7237,-122.335,1690,7459,5568,0.771404821280133,2722500,52099524,49377024
745000.0,4,2.0,1960,4520,1.0,0,0,2,8,960,1000,1922,2001.0,98116,47.58,-122.405,1680,4520,2560,0.5663716814159292,3841600,20430400,16588800
450000.0,3,2.25,2450,42180,1.0,0,0,3,7,2450,0,1978,2000.0,98042,47.3549,-122.111,1440,42180,39730,0.9419155998103367,6002500,1779152400,1773149900
935000.0,3,2.0,1720,2000,1.5,0,0,2,8,1060,660,1910,2000.0,98109,47.6384,-122.35,1590,4000,280,0.14,2958400,4000000,1041600
615000.0,3,2.5,1980,3128,2.0,0,0,2,8,1890,90,2009,0.0,98027,47.5456,-122.016,2160,2240,1148,0.3670076726342711,3920400,9784384,5863984
1030000.0,3,2.5,4110,35741,2.0,0,0,2,7,4110,0,1976,0.0,98033,47.6642,-122.171,2710,8865,31631,0.8850060155004057,16892100,1277419081,1260526981
283500.0,4,2.5,1990,5577,2.0,0,0,2,7,1990,0,1999,0.0,98092,47.3191,-122.191,2020,6400,3587,0.6431773354850278,3960100,31102929,27142829
340000.0,2,1.0,860,7102,1.0,0,0,2,6,860,0,1947,0.0,98177,47.7042,-122.369,1450,7102,6242,0.8789073500422416,739600,50438404,49698804
370000.0,4,2.5,2320,9264,2.0,0,0,2,8,2320,0,1994,0.0,98188,47.4449,-122.274,2320,9129,6944,0.7495682210708118,5382400,85821696,80439296
1150000.0,3,2.5,4190,9624,2.0,0,0,2,10,4190,0,1999,0.0,98006,47.5642,-122.12700000000001,3650,8321,5434,0.5646300914380715,17556100,92621376,75065276
265000.0,4,1.0,1940,9533,1.0,0,0,2,7,1080,860,1962,0.0,98031,47.4139,-122.208,1940,8839,7593,0.7964963809923424,3763600,90878089,87114489
480000.0,4,2.25,2520,2370,2.0,0,0,2,8,1690,830,1908,0.0,98122,47.6109,-122.303,1530,2370,-150,-0.06329113924050633,6350400,5616900,-733500
667500.0,3,2.0,1880,3800,1.0,0,0,4,7,1030,850,1927,0.0,98115,47.6841,-122.309,1700,3800,1920,0.5052631578947369,3534400,14440000,10905600
1400000.0,3,2.5,2910,10044,2.0,0,0,3,10,2910,0,1989,0.0,98004,47.5845,-122.199,2420,12287,7134,0.7102747909199522,8468100,100881936,92413836
2300000.0,7,4.75,5310,8816,2.0,0,0,2,10,3650,1660,2013,0.0,98004,47.6221,-122.208,2920,10610,3506,0.39768602540834846,28196100,77721856,49525756
465000.0,3,2.25,2670,7500,1.0,0,0,3,7,1640,1030,1966,0.0,98166,47.4608,-122.354,1970,9598,4830,0.644,7128900,56250000,49121100
192500.0,1,1.0,470,63737,1.0,0,2,4,5,470,0,1924,0.0,98022,47.2163,-121.984,1350,46762,63267,0.9926259472519886,220900,4062405169,4062184269
345000.0,3,1.0,1060,5600,1.0,0,0,3,6,760,300,1943,0.0,98146,47.5116,-122.37899999999999,1310,5600,4540,0.8107142857142857,1123600,31360000,30236400
439800.0,3,1.5,1120,6900,1.0,0,0,4,7,1120,0,1956,0.0,98007,47.6023,-122.132,1300,7000,5780,0.8376811594202899,1254400,47610000,46355600
468000.0,4,1.75,2250,8580,1.0,0,0,3,7,1330,920,1958,0.0,98011,47.7633,-122.199,2250,10032,6330,0.7377622377622378,5062500,73616400,68553900
775000.0,4,2.5,2070,8473,1.0,0,0,3,8,1250,820,1976,0.0,98033,47.6608,-122.19,2070,9499,6403,0.755694559188009,4284900,71791729,67506829
684680.0,4,2.25,2370,9360,2.0,0,0,3,8,2370,0,1979,0.0,98052,47.6518,-122.12299999999999,2370,9720,6990,0.7467948717948718,5616900,87609600,81992700
910000.0,4,3.5,3570,27699,2.0,0,0,2,11,3570,0,1990,0.0,98052,47.7173,-122.098,3800,35880,24129,0.8711144806671721,12744900,767234601,754489701
3640000.0,4,3.25,4830,22257,2.0,1,4,3,11,4830,0,1990,0.0,98039,47.6409,-122.241,3820,25582,17427,0.7829896212427551,23328900,495374049,472045149
375000.0,3,1.75,1160,22470,1.0,0,0,3,7,1160,0,1976,0.0,98028,47.7595,-122.23,1940,15999,21310,0.9483756119270138,1345600,504900900,503555300
250000.0,3,2.5,1610,6600,2.0,0,0,2,7,1610,0,1994,0.0,98003,47.2827,-122.302,1660,7689,4990,0.7560606060606061,2592100,43560000,40967900
3070000.0,5,3.0,4150,7500,2.5,0,4,4,11,3510,640,1909,0.0,98119,47.6303,-122.36200000000001,2250,4050,3350,0.44666666666666666,17222500,56250000,39027500
442500.0,4,2.25,1840,7575,1.0,0,0,3,7,1390,450,1973,0.0,98034,47.7328,-122.198,1820,7500,5735,0.7570957095709571,3385600,57380625,53995025
900000.0,3,3.5,4080,217697,1.5,0,3,2,10,4080,0,2000,0.0,98092,47.2604,-122.139,2710,217790,213617,0.9812583545018995,16646400,47391983809,47375337409
699000.0,3,2.0,1820,4080,2.0,0,2,2,8,1820,0,1937,1987.0,98107,47.6735,-122.40100000000001,2160,5400,2260,0.553921568627451,3312400,16646400,13334000
360000.0,4,2.0,2680,18768,1.0,0,0,4,8,2680,0,1965,0.0,98001,47.3182,-122.279,1230,15750,16088,0.8572037510656436,7182400,352237824,345055424
1680000.0,4,4.75,4790,25412,2.0,0,0,2,12,4790,0,1999,0.0,98074,47.603,-122.012,3830,16314,20622,0.8115063749409728,22944100,645769744,622825644
675000.0,5,2.0,2420,21000,1.5,0,0,2,8,2420,0,1966,0.0,98033,47.677,-122.165,1940,8085,18580,0.8847619047619047,5856400,441000000,435143600
345000.0,2,1.0,1130,8081,1.0,0,0,3,7,1130,0,1921,0.0,98133,47.7064,-122.355,1220,7800,6951,0.8601658210617498,1276900,65302561,64025661
229000.0,4,1.0,1320,5000,1.5,0,0,2,7,1320,0,1928,0.0,98106,47.5457,-122.363,1640,5164,3680,0.736,1742400,25000000,23257600
300000.0,3,1.0,1290,12415,1.5,0,0,2,6,1290,0,1908,0.0,98070,47.3719,-122.461,1620,12415,11125,0.896093435360451,1664100,154132225,152468125
392500.0,3,3.25,1600,1289,3.0,0,0,2,8,1600,0,1998,0.0,98117,47.6957,-122.375,1600,1376,-311,-0.24127230411171452,2560000,1661521,-898479
552000.0,3,1.0,1120,2300,1.0,0,0,3,7,820,300,1912,0.0,98117,47.6797,-122.384,1430,5100,1180,0.5130434782608696,1254400,5290000,4035600
457000.0,2,1.75,2060,7192,1.0,0,0,2,7,1420,640,1940,0.0,98125,47.7038,-122.31700000000001,1860,7140,5132,0.7135706340378198,4243600,51724864,47481264
518000.0,4,2.5,2830,13760,2.0,0,0,2,8,2830,0,1993,0.0,98019,47.7334,-121.97,2350,14029,10930,0.7943313953488372,8008900,189337600,181328700
237000.0,3,2.0,1210,6634,1.0,0,0,3,7,1210,0,1985,0.0,98031,47.4097,-122.193,1560,7200,5424,0.8176062707265601,1464100,44009956,42545856
399950.0,3,2.25,1560,11997,1.0,0,0,2,7,1260,300,1988,0.0,98065,47.5378,-121.742,1820,36590,10437,0.8699674918729683,2433600,143928009,141494409
605000.0,3,2.25,2260,17114,2.0,0,0,2,7,2260,0,1990,0.0,98155,47.7537,-122.296,2360,14893,14854,0.8679443730279304,5107600,292888996,287781396
295000.0,4,2.5,1850,8198,2.0,0,0,2,7,1850,0,1993,0.0,98031,47.4079,-122.186,1850,7924,6348,0.7743352037082215,3422500,67207204,63784704
513000.0,4,2.5,1930,8040,1.0,0,0,2,7,1380,550,1978,0.0,98034,47.7283,-122.21799999999999,2080,7200,6110,0.7599502487562189,3724900,64641600,60916700
772500.0,4,2.5,3230,4290,2.0,0,0,2,9,3230,0,2004,0.0,98033,47.6874,-122.161,3220,5083,1060,0.24708624708624707,10432900,18404100,7971200
765000.0,4,2.5,3230,4290,2.0,0,0,2,9,3230,0,2004,0.0,98033,47.6874,-122.161,3220,5083,1060,0.24708624708624707,10432900,18404100,7971200
696950.0,4,2.75,2450,5376,1.5,0,0,3,7,1550,900,1920,0.0,98117,47.6865,-122.396,1920,5264,2926,0.5442708333333334,6002500,28901376,22898876
329000.0,3,1.0,1200,5650,1.5,0,0,2,7,1200,0,1928,0.0,98178,47.5065,-122.249,1610,5650,4450,0.7876106194690266,1440000,31922500,30482500
339999.0,3,2.5,2360,8093,2.0,0,0,2,8,2360,0,1995,0.0,98092,47.3257,-122.17,1860,6762,5733,0.7083899666378352,5569600,65496649,59927049
364500.0,3,1.0,1060,9506,1.0,0,0,2,7,1060,0,1959,0.0,98125,47.7317,-122.31,1520,8469,8446,0.8884914790658531,1123600,90364036,89240436
607500.0,5,1.75,2220,6000,1.5,0,0,2,7,1420,800,1923,0.0,98199,47.648,-122.384,1550,1715,3780,0.63,4928400,36000000,31071600
550000.0,3,1.0,880,6664,1.0,0,0,2,6,880,0,1961,0.0,98033,47.6855,-122.199,1690,6564,5784,0.8679471788715486,774400,44408896,43634496
479900.0,4,2.0,2510,9750,1.0,0,0,2,8,1630,880,1960,0.0,98028,47.7438,-122.229,1980,9750,7240,0.7425641025641025,6300100,95062500,88762400
1120000.0,4,4.0,2530,1774,3.0,0,2,2,9,2100,430,2013,0.0,98119,47.6362,-122.369,2160,2400,-756,-0.42615558060879366,6400900,3147076,-3253824
192000.0,2,1.0,700,10540,1.0,0,0,2,6,700,0,1953,0.0,98166,47.438,-122.336,890,10540,9840,0.9335863377609108,490000,111091600,110601600
250000.0,3,2.0,1500,5200,1.0,0,0,2,7,1060,440,1977,0.0,98042,47.3653,-122.09,1640,5200,3700,0.7115384615384616,2250000,27040000,24790000
340000.0,3,2.0,1130,9879,2.0,0,0,2,6,1130,0,1996,0.0,98053,47.635,-121.964,1900,14907,8749,0.8856159530316834,1276900,97594641,96317741
340000.0,3,2.0,1420,6060,1.0,0,0,4,7,830,0,1942,0.0,98146,47.5102,-122.37200000000001,1420,6360,4640,0.7656765676567657,2016400,36723600,34707200
635250.0,3,2.25,2210,22040,1.0,0,0,4,8,1510,700,1976,0.0,98004,47.5904,-122.194,2470,14258,19830,0.8997277676950998,4884100,485761600,480877500
324800.0,2,1.0,1170,5043,1.0,0,0,2,6,880,290,1949,0.0,98108,47.5492,-122.302,1430,5692,3873,0.7679952409280191,1368900,25431849,24062949
78000.0,2,1.0,780,16344,1.0,0,0,0,5,780,0,1942,0.0,98168,47.4739,-122.28,1700,10387,15564,0.9522760646108663,608400,267126336,266517936
400000.0,4,1.75,1770,12875,1.0,0,0,2,8,1770,0,1988,0.0,98028,47.7438,-122.24700000000001,2150,12875,11105,0.8625242718446602,3132900,165765625,162632725
640500.0,3,1.0,1070,4505,1.0,0,2,3,7,1070,0,1919,0.0,98136,47.5305,-122.384,1380,4505,3435,0.7624861265260822,1144900,20295025,19150125
570000.0,3,2.0,1930,10929,1.0,0,0,2,8,1260,670,1964,0.0,98155,47.7657,-122.272,2030,8750,8999,0.8234056180803367,3724900,119443041,115718141
1330000.0,3,1.5,1940,2885,1.5,0,2,2,8,1940,0,1900,0.0,98119,47.6308,-122.369,2550,3600,945,0.3275563258232236,3763600,8323225,4559625
330490.0,3,2.75,1440,7350,1.0,0,0,3,7,1040,400,1980,0.0,98058,47.4431,-122.13799999999999,1510,7350,5910,0.8040816326530612,2073600,54022500,51948900
325000.0,3,2.5,1740,5267,2.0,0,0,2,7,1740,0,1999,0.0,98038,47.3777,-122.023,2180,5000,3527,0.6696411619517753,3027600,27741289,24713689
335000.0,3,2.5,1740,5267,2.0,0,0,2,7,1740,0,1999,0.0,98038,47.3777,-122.023,2180,5000,3527,0.6696411619517753,3027600,27741289,24713689
314000.0,5,2.75,2210,13500,1.0,0,0,4,7,1460,750,1963,0.0,98188,47.4468,-122.28200000000001,1590,10850,11290,0.8362962962962963,4884100,182250000,177365900
625000.0,4,2.0,2190,3622,1.5,0,0,4,8,1990,200,1925,0.0,98115,47.6887,-122.31200000000001,1450,3082,1432,0.39536167863059085,4796100,13118884,8322784
809000.0,3,2.5,2590,7720,2.0,0,0,2,9,2590,0,1988,0.0,98007,47.659,-122.146,2600,9490,5130,0.6645077720207254,6708100,59598400,52890300
535000.0,3,2.5,2790,19485,2.0,0,0,2,9,2790,0,1990,0.0,98059,47.4688,-122.124,2580,17859,16695,0.8568129330254042,7784100,379665225,371881125
275000.0,5,1.75,2180,9178,1.0,0,0,2,7,1140,1040,1963,0.0,98188,47.4364,-122.28,2140,9261,6998,0.7624754848550882,4752400,84235684,79483284
358000.0,4,2.75,2580,11900,1.0,0,0,3,7,1620,960,1967,0.0,98058,47.4475,-122.15899999999999,1570,9375,9320,0.7831932773109244,6656400,141610000,134953600
297975.0,3,2.25,2820,8100,1.0,0,0,3,7,1720,1100,1947,0.0,98168,47.4944,-122.304,1040,8100,5280,0.6518518518518519,7952400,65610000,57657600
492000.0,2,1.75,1300,22239,1.0,0,0,3,7,1300,0,1945,1986.0,98059,47.4801,-122.09200000000001,1300,14810,20939,0.9415441341786951,1690000,494573121,492883121
210000.0,2,1.0,720,8040,1.0,0,0,2,6,720,0,1943,0.0,98166,47.4662,-122.359,2300,9500,7320,0.9104477611940298,518400,64641600,64123200
622500.0,3,2.5,2260,4550,1.5,0,0,3,7,1380,880,1928,0.0,98126,47.5714,-122.376,1870,4582,2290,0.5032967032967033,5107600,20702500,15594900
550000.0,3,2.5,1550,1092,3.0,0,0,2,8,1390,160,2004,0.0,98102,47.6355,-122.324,1550,1079,-458,-0.4194139194139194,2402500,1192464,-1210036
190000.0,3,1.75,1390,7700,1.0,0,0,4,7,1390,0,1965,0.0,98058,47.4559,-122.18299999999999,1260,7700,6310,0.8194805194805195,1932100,59290000,57357900
340000.0,4,2.5,2380,9362,2.0,0,0,2,8,2380,0,2000,0.0,98023,47.3148,-122.34899999999999,2190,9840,6982,0.7457808160649434,5664400,87647044,81982644
678000.0,3,2.5,2640,5964,2.0,0,0,2,9,2640,0,2003,0.0,98052,47.7043,-122.12799999999999,2680,5211,3324,0.5573440643863179,6969600,35569296,28599696
275000.0,5,2.0,2260,11970,1.0,0,0,3,7,1250,0,1962,0.0,98031,47.3896,-122.21799999999999,1950,11970,9710,0.8111946532999165,5107600,143280900,138173300
493000.0,3,2.75,1720,6720,1.0,0,0,3,7,1270,450,1947,0.0,98122,47.6138,-122.29799999999999,1690,3248,5000,0.7440476190476191,2958400,45158400,42200000
147000.0,3,1.0,1070,14000,1.0,0,0,2,7,1070,0,1960,0.0,98178,47.4971,-122.279,920,12500,12930,0.9235714285714286,1144900,196000000,194855100
334000.0,3,2.25,2000,7225,2.0,0,0,3,7,2000,0,1985,0.0,98030,47.349,-122.167,1950,7464,5225,0.7231833910034602,4000000,52200625,48200625
605000.0,4,2.5,2800,10786,1.0,0,0,2,8,1420,1380,1970,0.0,98008,47.5959,-122.116,2140,10788,7986,0.7404042277025774,7840000,116337796,108497796
365000.0,3,1.75,1450,61419,1.0,0,0,3,8,1450,0,1976,0.0,98092,47.3343,-122.16,2256,82328,59969,0.9763916703300282,2102500,3772293561,3770191061
345000.0,3,1.0,1620,10610,1.0,0,0,3,6,1620,0,1958,0.0,98059,47.474,-122.125,1680,10795,8990,0.8473138548539114,2624400,112572100,109947700
999000.0,3,2.5,2710,23292,1.0,0,4,2,9,2080,630,1956,0.0,98177,47.7608,-122.374,2430,20000,20582,0.883651038983342,7344100,542517264,535173164
470000.0,2,1.75,1520,4220,1.0,0,0,3,7,840,680,1910,0.0,98117,47.6876,-122.366,1120,5700,2700,0.6398104265402843,2310400,17808400,15498000
599000.0,5,2.75,2730,22572,1.0,0,0,2,7,2080,650,1968,1992.0,98075,47.5951,-122.037,2260,15458,19842,0.8790536948431685,7452900,509495184,502042284
255000.0,3,2.25,1740,10378,1.0,0,0,4,7,1740,0,1977,0.0,98042,47.3815,-122.09,1420,10167,8638,0.8323376373096936,3027600,107702884,104675284
295000.0,4,1.75,1800,28650,1.0,0,0,3,7,1800,0,1975,0.0,98031,47.3926,-122.166,1800,5234,26850,0.93717277486911,3240000,820822500,817582500
550000.0,4,3.5,4150,16197,2.0,0,0,2,10,4150,0,2006,0.0,98003,47.3423,-122.18299999999999,3618,15210,12047,0.7437797122923998,17222500,262342809,245120309
1310000.0,5,3.5,3270,4080,2.0,0,0,2,9,2180,0,2011,0.0,98115,47.6754,-122.32700000000001,1410,4080,810,0.19852941176470587,10692900,16646400,5953500
225000.0,2,1.0,1070,6000,1.0,0,0,3,5,1070,0,1922,0.0,98178,47.495,-122.227,1910,6000,4930,0.8216666666666667,1144900,36000000,34855100
520000.0,4,0.75,1960,8277,1.0,1,4,3,7,1320,640,1923,1986.0,98198,47.3648,-122.325,1940,8402,6317,0.7631992267729854,3841600,68508729,64667129
345000.0,3,3.25,1600,1882,2.0,0,0,2,8,1360,240,2000,0.0,98133,47.7151,-122.355,1390,1379,282,0.14984059511158343,2560000,3541924,981924
475000.0,4,1.75,1650,7775,1.0,0,0,3,7,1150,500,1950,0.0,98133,47.715,-122.354,1390,7200,6125,0.7877813504823151,2722500,60450625,57728125
497500.0,5,1.5,2170,8610,1.0,0,0,3,7,1230,940,1959,0.0,98008,47.6111,-122.126,1670,8610,6440,0.7479674796747967,4708900,74132100,69423200
649500.0,3,3.0,3730,383328,1.5,0,0,3,9,2230,1500,1990,0.0,98038,47.4257,-122.03,1940,217800,379598,0.9902694298355456,13912900,146940355584,146926442684
734500.0,4,2.75,3280,6845,2.0,0,0,2,10,3280,0,2003,0.0,98052,47.7042,-122.10700000000001,3280,7467,3565,0.5208181154127101,10758400,46854025,36095625
276000.0,3,1.0,870,8040,1.0,0,0,2,7,870,0,1953,0.0,98177,47.7048,-122.368,1440,8040,7170,0.8917910447761194,756900,64641600,63884700
235000.0,2,1.0,900,28800,1.0,0,0,0,6,900,0,1928,0.0,98065,47.5245,-121.822,1360,7200,27900,0.96875,810000,829440000,828630000
325000.0,2,1.0,1400,10800,1.0,0,0,3,7,1400,0,1974,0.0,98011,47.7726,-122.21,1560,11280,9400,0.8703703703703703,1960000,116640000,114680000
425000.0,4,2.75,1680,9545,1.0,0,0,3,7,1080,600,1979,0.0,98028,47.739,-122.243,1890,9545,7865,0.8239916186485071,2822400,91107025,88284625
307000.0,4,2.0,2390,23972,2.0,0,0,2,7,1720,670,1949,0.0,98023,47.3197,-122.34299999999999,1950,22750,21582,0.9003003504088103,5712100,574656784,568944684
635000.0,3,2.5,2300,5500,1.5,0,0,3,8,2000,300,1921,0.0,98144,47.5785,-122.29299999999999,2100,5000,3200,0.5818181818181818,5290000,30250000,24960000
223000.0,3,1.75,1340,7473,1.0,0,0,3,7,1340,0,1973,0.0,98002,47.3087,-122.206,1510,8240,6133,0.8206878094473438,1795600,55845729,54050129
425000.0,3,2.75,2600,10874,2.0,0,0,2,9,2600,0,1994,0.0,98042,47.3815,-122.146,2800,11504,8274,0.7608975537980504,6760000,118243876,111483876
190000.0,3,2.25,1640,7730,1.0,0,0,3,7,1220,420,1989,0.0,98038,47.3576,-122.039,1560,7566,6090,0.7878395860284605,2689600,59752900,57063300
275000.0,4,1.75,1960,6177,1.0,0,0,3,8,1960,0,1967,0.0,98023,47.3131,-122.383,2010,8162,4217,0.6826938643354379,3841600,38155329,34313729
450000.0,3,2.5,1480,1961,2.0,0,0,2,8,1480,0,2005,0.0,98029,47.5478,-122.0,1400,1138,481,0.24528301886792453,2190400,3845521,1655121
1470000.0,4,3.25,5010,34460,2.0,0,0,2,12,5010,0,1988,0.0,98006,47.5469,-122.12700000000001,4760,34460,29450,0.8546140452698782,25100100,1187491600,1162391500
550000.0,4,2.0,1540,5000,1.5,0,0,3,7,1540,0,1913,0.0,98105,47.6713,-122.3,1790,4000,3460,0.692,2371600,25000000,22628400
835000.0,4,2.75,4030,10240,2.0,0,2,2,8,3310,720,1943,0.0,98177,47.7168,-122.365,2490,7680,6210,0.6064453125,16240900,104857600,88616700
900000.0,6,3.0,3020,13783,2.0,0,0,2,8,3020,0,1952,0.0,98040,47.5722,-122.226,1720,13500,10763,0.7808895015598927,9120400,189971089,180850689
290000.0,2,2.0,1590,9375,1.0,0,0,2,7,910,680,1983,0.0,98055,47.4585,-122.205,1560,8524,7785,0.8304,2528100,87890625,85362525
1040000.0,4,2.5,2910,9131,2.0,0,0,2,10,2910,0,2014,0.0,98033,47.6826,-122.186,1880,11212,6221,0.681305442996386,8468100,83375161,74907061
780000.0,4,2.5,3020,15164,1.0,0,0,3,8,1730,1290,1976,0.0,98004,47.5882,-122.19200000000001,2600,11556,12144,0.8008441044579266,9120400,229946896,220826496
572500.0,3,2.0,2290,11200,2.0,0,0,2,9,2290,0,1979,0.0,98052,47.6517,-122.124,2250,10000,8910,0.7955357142857142,5244100,125440000,120195900
389000.0,3,1.75,2180,9220,1.0,0,0,3,7,1090,1090,1938,0.0,98001,47.3547,-122.285,2050,22400,7040,0.7635574837310195,4752400,85008400,80256000
350000.0,4,1.75,2740,10086,1.0,0,0,2,7,1440,1300,1972,0.0,98168,47.5112,-122.329,1710,9840,7346,0.7283363077533215,7507600,101727396,94219796
476000.0,4,2.5,2740,33158,2.0,0,0,2,9,2740,0,1993,0.0,98042,47.3333,-122.074,2740,36074,30418,0.917365341697328,7507600,1099452964,1091945364
1050000.0,2,3.0,2330,3600,2.0,0,0,4,10,1870,460,1927,1979.0,98112,47.6316,-122.28200000000001,2950,7200,1270,0.3527777777777778,5428900,12960000,7531100
287000.0,3,2.25,2300,7200,1.0,0,0,3,8,1550,750,1978,0.0,98003,47.324,-122.32799999999999,2000,7350,4900,0.6805555555555556,5290000,51840000,46550000
707500.0,4,4.0,1550,6596,1.5,0,0,4,7,1550,0,1907,0.0,98107,47.6711,-122.398,1830,4850,5046,0.7650090964220739,2402500,43507216,41104716
464500.0,4,2.5,1750,11381,1.0,0,0,3,7,1610,0,1947,0.0,98155,47.7425,-122.321,1080,11375,9631,0.8462349529918285,3062500,129527161,126464661
720000.0,3,1.5,2180,5000,1.0,0,3,3,8,1090,1090,1941,0.0,98116,47.5787,-122.402,2070,5000,2820,0.564,4752400,25000000,20247600
319000.0,3,2.5,1610,8544,2.0,0,0,4,7,1610,0,1994,0.0,98038,47.3714,-122.054,1840,8190,6934,0.8115636704119851,2592100,72999936,70407836
330000.0,3,1.0,1570,9136,1.0,0,0,2,7,1570,0,1953,0.0,98133,47.7688,-122.337,1380,9127,7566,0.8281523642732049,2464900,83466496,81001596
120750.0,3,1.75,1140,9628,1.0,0,0,3,7,1140,0,1969,0.0,98023,47.2933,-122.37200000000001,1510,9633,8488,0.8815953469048609,1299600,92698384,91398784
195000.0,3,1.75,1140,9628,1.0,0,0,3,7,1140,0,1969,0.0,98023,47.2933,-122.37200000000001,1510,9633,8488,0.8815953469048609,1299600,92698384,91398784
650000.0,4,1.5,2480,6383,1.0,0,0,2,7,1380,1100,1946,0.0,98119,47.6445,-122.374,1440,6000,3903,0.6114679617734607,6150400,40742689,34592289
530000.0,3,1.75,1690,8190,1.0,0,0,3,8,1690,0,1958,0.0,98005,47.5857,-122.17200000000001,1840,8705,6500,0.7936507936507936,2856100,67076100,64220000
825000.0,4,3.0,2910,8027,1.0,0,0,4,8,1800,1110,1970,0.0,98117,47.6939,-122.391,2390,7660,5117,0.6374735268468917,8468100,64432729,55964629
436000.0,4,2.0,1600,15044,1.0,0,0,2,7,1600,0,1972,0.0,98034,47.72,-122.21600000000001,1660,8102,13444,0.8936453070991758,2560000,226321936,223761936
658000.0,2,1.0,1010,14244,1.0,1,4,0,5,1010,0,1926,0.0,98136,47.5476,-122.399,1820,15792,13234,0.929092951418141,1020100,202891536,201871436
547500.0,3,2.0,1850,9570,1.0,0,0,3,7,950,900,1940,0.0,98115,47.696999999999996,-122.322,1430,6380,7720,0.8066875653082549,3422500,91584900,88162400
762000.0,3,1.75,2150,2527,2.0,0,0,3,8,1400,750,1906,0.0,98103,47.6629,-122.329,1610,3663,377,0.14918876137712703,4622500,6385729,1763229
340000.0,3,1.75,2650,7378,1.0,0,0,2,7,1460,1190,1952,0.0,98155,47.7525,-122.315,1600,7616,4728,0.6408240715641095,7022500,54434884,47412384
880000.0,4,1.75,2510,5800,1.0,0,2,3,9,1830,680,1953,0.0,98199,47.648,-122.41,2190,5800,3290,0.5672413793103448,6300100,33640000,27339900
1220000.0,4,2.5,3240,3600,2.0,0,0,2,9,2060,1180,2008,0.0,98109,47.6405,-122.35600000000001,1820,3600,360,0.1,10497600,12960000,2462400
1950000.0,4,2.5,3440,14554,2.0,0,4,2,8,2170,1270,2012,0.0,98155,47.7364,-122.286,3170,11810,11114,0.763638862168476,11833600,211818916,199985316
382500.0,3,2.0,1150,6249,1.0,0,0,2,7,1150,0,1952,2006.0,98155,47.7489,-122.28399999999999,2470,7751,5099,0.8159705552888462,1322500,39050001,37727501
344500.0,3,1.75,1890,9535,1.0,0,0,2,7,1210,680,1976,0.0,98055,47.4872,-122.223,2040,11108,7645,0.8017829050865234,3572100,90916225,87344125
375000.0,4,2.75,1430,7403,1.0,0,0,2,7,1030,400,1982,0.0,98106,47.5346,-122.344,1480,7663,5973,0.8068350668647846,2044900,54804409,52759509
276000.0,1,0.75,370,1801,1.0,0,0,4,5,370,0,1923,0.0,98117,47.6778,-122.389,1340,5000,1431,0.7945585785674625,136900,3243601,3106701
500000.0,5,3.25,3130,12087,2.0,0,0,2,8,2180,950,1975,0.0,98027,47.5336,-122.052,2410,10350,8957,0.74104409696368,9796900,146095569,136298669
330000.0,4,2.5,2105,6093,2.0,0,0,2,8,2105,0,2003,0.0,98042,47.3531,-122.147,1930,8022,3988,0.6545215821434432,4431025,37124649,32693624
328000.0,3,1.0,890,5965,1.0,0,0,2,7,890,0,1950,0.0,98155,47.7518,-122.279,1930,7500,5075,0.8507963118189439,792100,35581225,34789125
450000.0,3,1.5,1340,7200,1.0,0,0,2,7,1340,0,1972,0.0,98034,47.718,-122.193,1730,8820,5860,0.8138888888888889,1795600,51840000,50044400
840500.0,4,2.25,2290,12174,1.0,1,4,2,7,1490,800,1948,0.0,98178,47.5114,-122.245,2290,9379,9884,0.8118942007557088,5244100,148206276,142962176
679000.0,3,2.5,2770,9350,2.0,0,3,2,8,2770,0,1957,2000.0,98056,47.5253,-122.20100000000001,2660,9695,6580,0.7037433155080214,7672900,87422500,79749600
270000.0,3,1.5,1890,9450,1.0,0,0,2,7,1090,800,1957,0.0,98146,47.4829,-122.34100000000001,1470,8100,7560,0.8,3572100,89302500,85730400
757500.0,5,2.25,3160,8065,2.0,0,0,2,8,3160,0,1977,0.0,98027,47.5678,-122.089,2540,7917,4905,0.6081835089894606,9985600,65044225,55058625
524950.0,2,2.5,1830,2856,2.0,0,0,2,7,1830,0,2005,0.0,98029,47.5524,-121.99600000000001,1850,2667,1026,0.3592436974789916,3348900,8156736,4807836
424900.0,4,2.75,2950,49658,1.0,0,0,3,8,2950,0,1960,1998.0,98010,47.3596,-121.92200000000001,1720,54672,46708,0.9405936606387691,8702500,2465916964,2457214464
551100.0,3,1.0,1430,8640,1.0,0,0,4,7,1430,0,1954,0.0,98006,47.571999999999996,-122.147,1430,9840,7210,0.8344907407407407,2044900,74649600,72604700
421000.0,3,2.0,1420,12655,1.0,0,0,4,7,1420,0,1968,0.0,98056,47.5309,-122.186,2020,9655,11235,0.8877913868036349,2016400,160149025,158132625
635000.0,4,1.75,2460,7560,2.0,0,0,3,8,2460,0,1952,0.0,98177,47.7256,-122.367,2760,8918,5100,0.6746031746031746,6051600,57153600,51102000
255000.0,3,1.0,1340,6120,1.5,0,0,3,7,1340,0,1920,0.0,98108,47.5272,-122.322,1260,6000,4780,0.7810457516339869,1795600,37454400,35658800
419950.0,4,1.0,1530,7920,1.0,0,0,2,7,1030,500,1955,0.0,98166,47.4544,-122.36,1690,7920,6390,0.8068181818181818,2340900,62726400,60385500
325000.0,6,3.0,2650,12870,1.0,0,0,3,7,2650,0,1977,0.0,98022,47.2069,-121.98899999999999,1450,8668,10220,0.7940947940947941,7022500,165636900,158614400
281000.0,4,2.25,1677,3600,2.0,0,0,2,7,1677,0,2012,0.0,98092,47.32,-122.178,1677,3600,1923,0.5341666666666667,2812329,12960000,10147671
655275.0,3,1.75,2050,11856,1.0,0,0,2,7,1460,590,1962,0.0,98006,47.5735,-122.162,2670,11856,9806,0.8270917678812416,4202500,140564736,136362236
861000.0,3,2.0,2520,3959,1.0,0,0,4,8,1270,1250,1931,0.0,98105,47.6693,-122.289,1660,3959,1439,0.36347562515786813,6350400,15673681,9323281
850000.0,3,3.5,2620,11148,2.0,0,4,3,9,2060,560,1977,0.0,98008,47.5845,-122.115,2590,10796,8528,0.7649802655184786,6864400,124277904,117413504
246000.0,3,2.5,1650,6675,1.0,0,0,2,8,1290,360,1990,0.0,98023,47.2899,-122.37200000000001,1880,6675,5025,0.7528089887640449,2722500,44555625,41833125
380000.0,2,1.0,700,4836,1.0,0,0,3,6,700,0,1926,0.0,98125,47.7139,-122.288,1190,7050,4136,0.8552522746071133,490000,23386896,22896896
813000.0,4,2.5,3430,7508,2.0,0,0,2,10,3430,0,1998,0.0,98052,47.6866,-122.11,3110,8741,4078,0.5431539690996271,11764900,56370064,44605164
990000.0,4,2.5,3140,11049,2.0,0,0,2,10,3140,0,1988,0.0,98004,47.5817,-122.19200000000001,2750,11049,7909,0.7158113856457597,9859600,122080401,112220801
650000.0,3,2.5,2350,3750,2.0,0,0,2,7,1740,610,2003,0.0,98117,47.6767,-122.365,1590,4700,1400,0.37333333333333335,5522500,14062500,8540000
273000.0,4,3.0,1990,6180,2.0,0,0,2,7,1990,0,1990,0.0,98023,47.3083,-122.36,1910,6180,4190,0.6779935275080906,3960100,38192400,34232300
398000.0,4,2.5,2050,14724,2.0,0,0,2,7,2050,0,1989,0.0,98019,47.73,-121.969,1920,12841,12674,0.8607715294756859,4202500,216796176,212593676
200000.0,2,1.0,930,8665,1.0,0,0,3,6,930,0,1938,0.0,98168,47.4822,-122.318,1630,12375,7735,0.8926716676283901,864900,75082225,74217325
839000.0,3,1.0,1230,12305,1.0,0,0,2,7,1230,0,1955,1990.0,98004,47.6095,-122.195,2100,7960,11075,0.9000406338886632,1512900,151413025,149900125
502000.0,3,2.5,1870,9135,1.0,0,0,2,7,1250,620,1984,0.0,98074,47.6269,-122.06,1550,9100,7265,0.7952928297755884,3496900,83448225,79951325
305000.0,3,2.25,2110,7665,1.0,0,0,3,7,1360,750,1973,0.0,98023,47.3082,-122.37200000000001,1660,8436,5555,0.7247227658186562,4452100,58752225,54300125
574950.0,5,3.25,3160,10000,2.0,0,0,3,8,3160,0,1980,0.0,98027,47.52,-122.04700000000001,2130,10000,6840,0.684,9985600,100000000,90014400
311000.0,3,1.0,1120,8631,1.0,0,0,2,7,1120,0,1942,0.0,98125,47.7077,-122.314,1350,7714,7511,0.870235198702352,1254400,74494161,73239761
1650000.0,3,2.25,2750,6203,1.0,1,4,4,7,1620,1130,1959,0.0,98074,47.6163,-122.068,2570,7009,3453,0.5566661292922779,7562500,38477209,30914709
387000.0,3,1.0,1230,9568,1.0,0,0,4,7,1230,0,1962,0.0,98056,47.538999999999994,-122.179,1270,9575,8338,0.8714464882943144,1512900,91546624,90033724
375000.0,3,1.5,1190,20672,1.5,0,3,2,7,1190,0,1948,0.0,98166,47.4459,-122.359,2150,16239,19482,0.9424342105263158,1416100,427331584,425915484
175000.0,2,1.0,740,3434,1.0,0,0,4,6,740,0,1920,0.0,98022,47.2088,-121.992,1160,6000,2694,0.7845078625509609,547600,11792356,11244756
248000.0,4,2.5,1770,5855,2.0,0,0,2,7,1770,0,2003,0.0,98038,47.3483,-122.053,1790,5679,4085,0.6976942783945346,3132900,34281025,31148125
336750.0,4,2.25,1720,7803,1.0,0,0,2,8,1350,370,1955,0.0,98146,47.5119,-122.337,1720,7803,6083,0.7795719595027554,2958400,60886809,57928409
685000.0,4,2.5,2770,45514,2.0,0,0,3,9,2770,0,1989,0.0,98077,47.7751,-122.088,2940,49495,42744,0.9391396053961418,7672900,2071524196,2063851296
645000.0,4,2.75,2330,3917,2.0,0,0,2,9,2330,0,2004,0.0,98029,47.5527,-121.99,2620,4400,1587,0.40515700791422005,5428900,15342889,9913989
279000.0,3,2.5,1660,7388,2.0,0,0,2,7,1660,0,2003,0.0,98038,47.3865,-122.027,2240,6228,5728,0.7753113156469952,2755600,54582544,51826944
479000.0,2,2.5,1730,1037,3.5,0,0,2,8,1730,0,2008,0.0,98118,47.5594,-122.285,1280,1026,-693,-0.6682738669238187,2992900,1075369,-1917531
466000.0,3,2.25,1880,7279,1.0,0,0,2,7,1280,600,1962,0.0,98155,47.7574,-122.322,2020,8274,5399,0.74172276411595,3534400,52983841,49449441
361500.0,4,2.75,2190,6740,2.0,0,0,2,7,2190,0,1995,0.0,98038,47.3804,-122.027,1950,7150,4550,0.6750741839762612,4796100,45427600,40631500
404000.0,3,1.75,1720,7202,1.0,0,0,2,7,1720,0,1995,0.0,98056,47.5044,-122.19,1720,7625,5482,0.7611774507081366,2958400,51868804,48910404
319000.0,4,3.25,2360,8344,2.0,0,0,2,8,2360,0,1990,0.0,98058,47.4403,-122.126,1860,8410,5984,0.7171620325982742,5569600,69622336,64052736
320000.0,3,1.5,1490,10132,1.0,0,0,3,6,1490,0,1969,0.0,98059,47.4779,-122.145,1720,9915,8642,0.8529411764705882,2220100,102657424,100437324
1310000.0,4,3.75,3490,5625,2.0,0,0,2,9,2610,880,2014,0.0,98103,47.6685,-122.33200000000001,1940,5000,2135,0.37955555555555553,12180100,31640625,19460525
1000000.0,3,2.75,2370,8900,1.0,0,4,3,9,1670,700,1971,0.0,98006,47.5648,-122.156,2840,8956,6530,0.7337078651685394,5616900,79210000,73593100
660000.0,4,2.5,2290,9120,2.0,0,0,3,8,2290,0,1977,0.0,98006,47.5613,-122.12799999999999,2290,9120,6830,0.7489035087719298,5244100,83174400,77930300
546000.0,4,3.0,1790,3600,1.5,0,0,2,8,1790,0,1901,0.0,98122,47.6117,-122.31299999999999,1770,3119,1810,0.5027777777777778,3204100,12960000,9755900
300000.0,4,1.75,1820,5015,1.0,0,0,3,6,1190,630,1926,0.0,98108,47.5569,-122.31,1530,9130,3195,0.6370887337986042,3312400,25150225,21837825
500000.0,2,1.5,1760,12000,1.0,0,0,3,7,1760,0,1964,0.0,98052,47.6288,-122.109,2200,12088,10240,0.8533333333333334,3097600,144000000,140902400
381500.0,4,2.5,2430,5556,2.0,0,0,3,8,2430,0,2003,0.0,98042,47.3762,-122.126,2430,5556,3126,0.562634989200864,5904900,30869136,24964236
990000.0,3,2.25,2630,12899,2.0,0,0,3,9,2630,0,1966,0.0,98040,47.5479,-122.23299999999999,3140,15320,10269,0.7961082254438329,6916900,166384201,159467301
278226.0,4,2.5,2390,4639,2.0,0,0,2,8,2390,0,2006,0.0,98038,47.3527,-121.999,2390,4521,2249,0.48480275921534816,5712100,21520321,15808221
340000.0,2,1.75,1500,4158,1.0,0,0,3,7,1220,280,1947,0.0,98103,47.7006,-122.35,1270,4081,2658,0.6392496392496393,2250000,17288964,15038964
305000.0,4,2.5,2510,12000,1.0,0,0,2,8,1520,990,1977,0.0,98023,47.3086,-122.384,2210,8320,9490,0.7908333333333334,6300100,144000000,137699900
760000.0,4,2.5,2420,10285,1.0,0,4,2,8,1700,720,1958,0.0,98146,47.4871,-122.36,2540,9900,7865,0.7647058823529411,5856400,105781225,99924825
195000.0,4,1.5,2170,9948,2.0,0,0,2,7,2170,0,1952,0.0,98148,47.4263,-122.331,1500,9750,7778,0.7818657016485726,4708900,98962704,94253804
564000.0,4,1.75,1960,6138,1.0,0,0,3,7,1260,700,1960,0.0,98115,47.6968,-122.29899999999999,2000,7057,4178,0.6806777451938743,3841600,37675044,33833444
539500.0,4,2.25,2280,8550,1.0,0,0,2,8,1660,620,1977,0.0,98034,47.701,-122.23100000000001,2590,9500,6270,0.7333333333333333,5198400,73102500,67904100
299980.0,4,1.5,1580,10230,1.0,0,0,2,6,790,790,1945,2008.0,98178,47.5002,-122.24600000000001,1130,6955,8650,0.8455522971652004,2496400,104652900,102156500
290000.0,4,2.5,1850,5674,2.0,0,0,2,7,1850,0,1993,0.0,98042,47.3536,-122.14200000000001,1750,6875,3824,0.6739513570673247,3422500,32194276,28771776
257000.0,2,1.0,770,11084,1.0,0,0,3,6,770,0,1947,0.0,98155,47.7482,-122.321,1010,11084,10314,0.9305304944063515,592900,122855056,122262156
518500.0,4,3.0,2120,5520,1.5,0,0,2,8,1420,700,1985,0.0,98125,47.7085,-122.286,2020,8700,3400,0.6159420289855072,4494400,30470400,25976000
657000.0,4,2.75,3060,35380,1.0,0,0,2,9,1810,1250,1982,0.0,98074,47.6198,-122.038,1980,10425,32320,0.9135104578858112,9363600,1251744400,1242380800
590000.0,3,2.25,2680,41250,2.0,0,0,2,7,2680,0,1984,0.0,98045,47.4817,-121.749,1940,47044,38570,0.935030303030303,7182400,1701562500,1694380100
526000.0,4,1.75,2220,6350,1.0,0,0,2,7,1110,1110,1959,0.0,98125,47.7136,-122.29,1950,8100,4130,0.6503937007874016,4928400,40322500,35394100
254500.0,2,1.0,1150,11250,1.0,0,0,2,6,1150,0,1920,0.0,98178,47.486000000000004,-122.264,1100,11400,10100,0.8977777777777778,1322500,126562500,125240000
575000.0,2,1.0,980,3663,1.0,0,0,4,7,980,0,1909,0.0,98105,47.6645,-122.288,1620,3706,2683,0.7324597324597325,960400,13417569,12457169
464550.0,3,1.5,1690,10500,1.0,0,0,3,7,1690,0,1967,0.0,98033,47.7018,-122.165,1570,10500,8810,0.839047619047619,2856100,110250000,107393900
409950.0,3,1.75,1320,6030,1.0,0,0,3,7,1320,0,1969,0.0,98052,47.6993,-122.13,1840,6565,4710,0.7810945273631841,1742400,36360900,34618500
100000.0,2,1.0,910,22000,1.0,0,0,2,6,910,0,1956,0.0,98001,47.2777,-122.25200000000001,1326,9891,21090,0.9586363636363636,828100,484000000,483171900
365000.0,2,1.5,820,1270,2.0,0,0,2,7,820,0,2009,0.0,98144,47.5925,-122.295,1130,1201,450,0.3543307086614173,672400,1612900,940500
208000.0,3,1.0,1300,7420,1.0,0,0,3,6,1300,0,1960,0.0,98002,47.2899,-122.219,1250,7420,6120,0.8247978436657682,1690000,55056400,53366400
497950.0,4,2.5,1950,3000,2.0,0,0,2,7,1550,400,1998,0.0,98118,47.565,-122.281,1540,4300,1050,0.35,3802500,9000000,5197500
405000.0,5,3.5,3672,9742,2.0,0,0,2,9,3006,666,2006,0.0,98092,47.3255,-122.19200000000001,2140,9118,6070,0.6230753438718949,13483584,94906564,81422980
568000.0,3,2.5,2740,22499,2.0,0,0,2,9,2740,0,1994,0.0,98058,47.4597,-122.15299999999999,2710,22499,19759,0.8782168096359838,7507600,506205001,498697401
334000.0,2,1.0,890,6000,1.0,0,0,2,6,890,0,1941,0.0,98118,47.5437,-122.281,1090,5900,5110,0.8516666666666667,792100,36000000,35207900
235000.0,3,2.0,1090,8400,1.0,0,0,3,6,1090,0,1961,0.0,98168,47.4942,-122.322,1100,10850,7310,0.8702380952380953,1188100,70560000,69371900
295000.0,2,1.0,1170,10621,1.0,0,0,2,7,1170,0,1963,0.0,98045,47.497,-121.78,1340,9832,9451,0.8898408812729498,1368900,112805641,111436741
610000.0,4,3.0,2600,29539,1.0,0,0,2,8,2600,0,1994,0.0,98028,47.746,-122.23100000000001,1810,11600,26939,0.9119807711838587,6760000,872552521,865792521
453500.0,4,1.75,2000,6032,1.0,0,2,2,7,1300,700,1959,0.0,98146,47.5132,-122.389,1930,6032,4032,0.6684350132625995,4000000,36385024,32385024
1220000.0,4,3.75,3520,3944,1.5,0,0,4,8,2200,1320,1913,0.0,98109,47.6424,-122.348,2310,4725,424,0.1075050709939148,12390400,15555136,3164736
175000.0,2,1.0,1410,7000,1.0,0,0,2,7,1410,0,1968,0.0,98055,47.4908,-122.223,1540,6000,5590,0.7985714285714286,1988100,49000000,47011900
335000.0,2,1.0,1410,7000,1.0,0,0,2,7,1410,0,1968,0.0,98055,47.4908,-122.223,1540,6000,5590,0.7985714285714286,1988100,49000000,47011900
275000.0,3,1.5,1950,7620,1.0,0,0,3,7,1010,940,1956,0.0,98166,47.4594,-122.346,1850,7620,5670,0.7440944881889764,3802500,58064400,54261900
400000.0,2,1.0,980,2130,1.0,0,0,3,6,860,120,1918,0.0,98117,47.6769,-122.366,980,2800,1150,0.539906103286385,960400,4536900,3576500
915000.0,3,2.75,3390,7000,1.0,0,3,3,8,1740,1650,1979,0.0,98116,47.5701,-122.40799999999999,1770,6500,3610,0.5157142857142857,11492100,49000000,37507900
619850.0,4,2.5,2270,9247,1.0,0,0,4,8,1500,770,1972,0.0,98006,47.5602,-122.176,2270,9163,6977,0.7545149778306478,5152900,85507009,80354109
225900.0,3,1.0,1510,8800,1.0,0,0,3,7,1010,500,1963,0.0,98003,47.32899999999999,-122.33,1290,8470,7290,0.8284090909090909,2280100,77440000,75159900
525000.0,2,1.5,960,7200,1.0,0,0,2,7,960,0,1910,1987.0,98199,47.648999999999994,-122.40299999999999,1550,6000,6240,0.8666666666666667,921600,51840000,50918400
215000.0,4,2.25,1900,9600,1.0,0,0,3,7,1900,0,1967,0.0,98031,47.4208,-122.2,2040,9600,7700,0.8020833333333334,3610000,92160000,88550000
802000.0,3,2.5,2580,13096,2.0,0,0,2,9,2580,0,1986,0.0,98052,47.6616,-122.14399999999999,2580,7988,10516,0.8029932803909591,6656400,171505216,164848816
330000.0,4,2.5,2340,11784,2.0,0,0,2,9,2340,0,1997,0.0,98042,47.38399999999999,-122.149,2250,10760,9444,0.8014256619144603,5475600,138862656,133387056
549800.0,3,2.25,1580,11680,1.0,0,0,3,7,1580,0,1958,0.0,98005,47.5872,-122.17,2270,10948,10100,0.8647260273972602,2496400,136422400,133926000
195500.0,4,1.0,1230,8636,1.5,0,0,3,6,1230,0,1954,0.0,98002,47.3231,-122.219,1168,8316,7406,0.8575729504400186,1512900,74580496,73067596
338000.0,3,2.5,1590,7819,2.0,0,0,2,7,1590,0,1992,0.0,98055,47.4367,-122.199,1790,7733,6229,0.7966491878756874,2528100,61136761,58608661
3200000.0,4,3.25,7000,28206,1.0,1,4,3,12,3500,3500,1991,0.0,98075,47.5928,-122.086,4913,14663,21206,0.7518258526554634,49000000,795578436,746578436
480000.0,4,2.25,1770,7000,1.0,0,0,4,7,1770,0,1972,0.0,98034,47.7193,-122.21799999999999,1780,6500,5230,0.7471428571428571,3132900,49000000,45867100
383000.0,4,2.5,1850,8310,1.0,0,0,2,7,1200,650,1962,0.0,98155,47.7717,-122.29,1840,10080,6460,0.7773766546329723,3422500,69056100,65633600
257000.0,3,1.75,1430,7210,1.0,0,0,2,7,1430,0,1975,0.0,98031,47.4189,-122.16799999999999,1220,7777,5780,0.8016643550624133,2044900,51984100,49939200
335000.0,4,2.75,2190,9209,2.0,0,0,3,8,2190,0,1996,0.0,98092,47.3341,-122.18799999999999,2430,6687,7019,0.7621891627755457,4796100,84805681,80009581
422000.0,4,2.5,2310,6650,2.0,0,2,2,8,2310,0,2012,0.0,98166,47.4513,-122.26700000000001,1800,9819,4340,0.6526315789473685,5336100,44222500,38886400
560000.0,3,1.75,2000,10182,1.0,0,0,4,7,1400,600,1963,0.0,98033,47.6616,-122.175,2050,10182,8182,0.8035749361618543,4000000,103673124,99673124
680000.0,4,2.75,3620,35429,2.0,0,0,2,10,3620,0,2006,0.0,98058,47.4238,-122.098,3310,54193,31809,0.8978238166473793,13104400,1255214041,1242109641
320000.0,2,1.0,1210,7040,1.0,0,0,2,7,1210,0,1952,0.0,98155,47.745,-122.29700000000001,1210,7205,5830,0.828125,1464100,49561600,48097500
665000.0,3,2.5,2330,15536,1.0,0,2,2,10,2330,0,1996,0.0,98074,47.655,-122.087,3320,17461,13206,0.8500257466529351,5428900,241367296,235938396
751000.0,3,2.5,2840,6854,2.0,0,0,2,9,2840,0,2002,0.0,98075,47.6006,-121.978,2840,7398,4014,0.5856434199007878,8065600,46977316,38911716
320000.0,6,2.75,2410,10763,1.0,0,0,4,7,1310,1100,1957,0.0,98188,47.4429,-122.28200000000001,1310,10746,8353,0.7760847347393849,5808100,115842169,110034069
290000.0,4,1.75,1820,22043,2.5,0,0,3,7,1820,0,1918,0.0,98155,47.7606,-122.28,1880,19961,20223,0.9174341060654176,3312400,485893849,482581449
250000.0,4,2.0,1470,7412,1.0,0,0,2,7,1470,0,1967,0.0,98198,47.3702,-122.318,1390,7825,5942,0.8016729627630869,2160900,54937744,52776844
423000.0,3,1.75,1100,10005,1.0,0,0,4,7,1100,0,1964,0.0,98056,47.5374,-122.17299999999999,1340,9709,8905,0.8900549725137431,1210000,100100025,98890025
601002.0,4,2.5,2050,8094,1.0,0,0,2,8,1050,1000,1976,0.0,98052,47.6614,-122.13799999999999,1990,9020,6044,0.746725969854213,4202500,65512836,61310336
352900.0,2,1.5,1240,1892,2.0,0,0,2,7,1240,0,2002,0.0,98144,47.5915,-122.295,1220,1740,652,0.34460887949260044,1537600,3579664,2042064
509950.0,3,2.5,2210,70567,2.0,0,3,2,9,2210,0,1995,0.0,98014,47.6087,-121.895,2000,73616,68357,0.9686822452421103,4884100,4979701489,4974817389
360000.0,2,1.75,1340,1050,3.0,0,0,2,8,1340,0,2009,0.0,98133,47.7053,-122.34299999999999,1340,1090,-290,-0.2761904761904762,1795600,1102500,-693100
1080000.0,4,2.75,2580,8100,2.0,0,1,3,8,1780,800,1964,0.0,98040,47.5387,-122.215,2840,10006,5520,0.6814814814814815,6656400,65610000,58953600
349950.0,3,2.5,2390,6441,2.0,0,0,2,7,2390,0,2002,0.0,98038,47.3659,-122.029,2180,7346,4051,0.6289396056512964,5712100,41486481,35774381
395000.0,4,2.5,2250,6840,2.0,0,0,2,9,2250,0,1987,0.0,98058,47.4398,-122.15100000000001,2480,7386,4590,0.6710526315789473,5062500,46785600,41723100
273500.0,3,1.5,2000,15265,1.0,0,0,2,8,1540,460,1967,0.0,98032,47.387,-122.281,1920,15265,13265,0.8689813298395022,4000000,233020225,229020225
700000.0,4,1.75,1870,6000,1.0,0,0,4,8,1670,200,1949,0.0,98199,47.6435,-122.399,1710,6000,4130,0.6883333333333334,3496900,36000000,32503100
699000.0,3,2.5,2370,10968,2.0,0,0,3,9,2370,0,1985,0.0,98033,47.6679,-122.17200000000001,2380,8144,8598,0.7839168490153173,5616900,120297024,114680124
537000.0,4,2.25,2640,8800,1.0,0,0,2,8,1620,1020,1980,0.0,98072,47.7552,-122.148,2500,11700,6160,0.7,6969600,77440000,70470400
405000.0,3,1.5,1240,9975,1.0,0,0,2,6,1240,0,1977,0.0,98024,47.5667,-121.905,1390,10735,8735,0.8756892230576441,1537600,99500625,97963025
269500.0,2,1.0,800,1200,2.0,0,0,2,7,800,0,1999,0.0,98103,47.6969,-122.34700000000001,806,1200,400,0.3333333333333333,640000,1440000,800000
260000.0,4,2.5,2050,12500,1.0,0,0,2,7,1300,750,1965,0.0,98198,47.42,-122.319,1790,7900,10450,0.836,4202500,156250000,152047500
266750.0,3,2.25,1650,10000,2.0,0,0,2,7,1650,0,1988,0.0,98198,47.3862,-122.315,1420,10000,8350,0.835,2722500,100000000,97277500
1800000.0,5,3.75,4320,39094,2.0,1,4,2,8,4320,0,1938,0.0,98155,47.7519,-122.27600000000001,1920,7750,34774,0.8894971095308744,18662400,1528340836,1509678436
779000.0,2,2.25,2130,5920,1.0,0,0,2,8,1830,300,1950,0.0,98115,47.6792,-122.275,2130,7192,3790,0.6402027027027027,4536900,35046400,30509500
500000.0,3,2.5,2840,48716,1.0,0,3,2,9,1870,970,1994,0.0,98014,47.6832,-121.915,2710,43676,45876,0.9417029312751457,8065600,2373248656,2365183056
365000.0,4,1.75,3080,32997,1.5,0,0,3,7,3080,0,1950,0.0,98168,47.49800000000001,-122.321,1980,5711,29917,0.9066581810467619,9486400,1088802009,1079315609
724000.0,2,1.0,1560,5000,1.5,0,1,3,7,1560,0,1942,0.0,98117,47.7006,-122.38600000000001,2620,5400,3440,0.688,2433600,25000000,22566400
890000.0,4,2.75,3220,15467,2.0,0,0,2,11,3220,0,1994,0.0,98077,47.7128,-122.083,3670,16641,12247,0.7918148315769057,10368400,239228089,228859689
431000.0,4,2.5,1450,3600,1.5,0,0,2,7,1250,200,1902,0.0,98144,47.5985,-122.29799999999999,1680,3600,2150,0.5972222222222222,2102500,12960000,10857500
242000.0,2,1.0,960,21850,1.0,0,0,2,6,960,0,1947,0.0,98032,47.4122,-122.26700000000001,1020,21850,20890,0.9560640732265446,921600,477422500,476500900
415000.0,4,2.5,2670,8279,2.0,0,0,2,7,2670,0,1999,0.0,98148,47.4292,-122.32799999999999,2290,7504,5609,0.6774972822804687,7128900,68541841,61412941
727160.0,7,3.75,2310,5000,2.0,0,0,2,8,2310,0,1984,0.0,98117,47.6781,-122.376,1360,1552,2690,0.538,5336100,25000000,19663900
1110000.0,4,3.25,3520,19354,1.0,0,2,3,9,2010,1510,1978,0.0,98006,47.5572,-122.147,2630,19354,15834,0.8181254521029244,12390400,374577316,362186916
265000.0,2,1.75,1090,3272,1.0,0,0,4,8,1090,0,1970,0.0,98198,47.3794,-122.32,1160,5475,2182,0.6668704156479217,1188100,10705984,9517884
519000.0,3,1.75,2000,5680,1.0,0,0,3,7,1080,920,1903,0.0,98117,47.6805,-122.366,1230,4535,3680,0.647887323943662,4000000,32262400,28262400
262000.0,4,1.5,1840,9009,2.0,0,0,2,7,1840,0,1965,0.0,98198,47.40600000000001,-122.318,1390,8025,7169,0.7957597957597957,3385600,81162081,77776481
1190000.0,4,2.5,3160,13194,2.0,0,0,4,10,3160,0,1965,0.0,98040,47.5472,-122.23299999999999,3490,13194,10034,0.7604971956950128,9985600,174081636,164096036
295000.0,3,1.75,1520,6559,1.0,0,0,3,7,1170,350,1992,0.0,98038,47.35,-122.037,1520,6095,5039,0.7682573563043147,2310400,43020481,40710081
615000.0,3,1.75,2110,56192,1.0,0,0,2,7,1480,630,1978,0.0,98072,47.7701,-122.13799999999999,2570,46609,54082,0.9624501708428246,4452100,3157540864,3153088764
1100000.0,4,2.75,3410,7750,1.0,0,4,4,8,1710,1700,1958,0.0,98116,47.5718,-122.406,3080,8525,4340,0.56,11628100,60062500,48434400
575000.0,4,2.5,2630,6247,2.0,0,0,2,8,2630,0,1992,0.0,98029,47.5662,-122.0,2130,4668,3617,0.5789979190011205,6916900,39025009,32108109
388000.0,3,1.75,1350,2325,3.0,0,0,2,7,1350,0,1999,0.0,98103,47.6965,-122.35,1520,1652,975,0.41935483870967744,1822500,5405625,3583125
750500.0,4,2.5,2860,9159,1.0,0,0,3,8,1530,1330,1989,0.0,98033,47.6923,-122.2,2070,8680,6299,0.6877388361174801,8179600,83887281,75707681
527500.0,3,1.75,2310,78844,1.0,0,0,2,8,1760,550,1977,0.0,98027,47.5406,-122.066,2830,6230,76534,0.9707016386789102,5336100,6216376336,6211040236
503000.0,3,2.0,2590,108900,2.0,0,0,2,8,1980,610,1988,0.0,98038,47.4088,-122.055,3170,108900,106310,0.9762167125803489,6708100,11859210000,11852501900
1050000.0,4,3.5,3500,4000,2.0,0,0,2,10,2560,940,2000,0.0,98112,47.628,-122.29899999999999,1910,4000,500,0.125,12250000,16000000,3750000
325000.0,2,1.0,800,7260,1.0,0,0,2,7,800,0,1953,0.0,98126,47.5359,-122.367,1010,7440,6460,0.8898071625344353,640000,52707600,52067600
402000.0,3,1.75,1580,6127,1.5,0,0,4,7,1580,0,1947,0.0,98125,47.7192,-122.32,1500,6128,4547,0.7421250204015015,2496400,37540129,35043729
370000.0,3,1.5,1560,6774,1.0,0,0,3,6,1060,500,1927,0.0,98133,47.7024,-122.35,1320,3844,5214,0.7697077059344553,2433600,45887076,43453476
329950.0,3,1.0,1750,7800,1.0,0,0,3,7,1150,600,1956,0.0,98166,47.4596,-122.34299999999999,1750,7560,6050,0.7756410256410257,3062500,60840000,57777500
135000.0,2,1.0,600,6120,1.0,0,0,2,5,600,0,1943,1989.0,98168,47.5,-122.31700000000001,1090,6120,5520,0.9019607843137255,360000,37454400,37094400
482500.0,4,3.0,1630,7626,1.0,0,0,4,7,1110,520,1990,0.0,98125,47.7168,-122.30799999999999,1630,8082,5996,0.7862575399947548,2656900,58155876,55498976
259000.0,4,1.5,1260,7248,1.5,0,0,4,7,1260,0,1955,0.0,98188,47.433,-122.292,1300,7732,5988,0.8261589403973509,1587600,52533504,50945904
210000.0,3,2.25,2140,9775,1.0,0,0,3,7,1470,670,1978,0.0,98023,47.306000000000004,-122.37899999999999,2050,8625,7635,0.781074168797954,4579600,95550625,90971025
459000.0,4,2.75,2790,6600,2.0,0,0,2,9,2790,0,2000,0.0,98058,47.4362,-122.109,2900,6752,3810,0.5772727272727273,7784100,43560000,35775900
375000.0,3,1.75,2530,35150,1.0,0,0,3,7,1800,730,1977,0.0,98042,47.3913,-122.12100000000001,2460,36386,32620,0.928022759601707,6400900,1235522500,1229121600
295000.0,3,2.25,1330,7200,1.0,0,0,2,7,900,430,1974,0.0,98146,47.5102,-122.36399999999999,1380,9570,5870,0.8152777777777778,1768900,51840000,50071100
910000.0,3,2.0,2700,6120,1.0,0,0,3,8,1350,1350,1962,0.0,98115,47.6731,-122.32700000000001,1700,4590,3420,0.5588235294117647,7290000,37454400,30164400
470000.0,4,1.0,1740,37238,1.5,0,0,3,7,1740,0,1932,0.0,98024,47.5651,-121.902,1810,18352,35498,0.953273537783984,3027600,1386668644,1383641044
565000.0,4,2.0,2070,7980,1.5,0,0,3,7,2070,0,1940,0.0,98146,47.5092,-122.38600000000001,1600,7980,5910,0.7406015037593985,4284900,63680400,59395500
339950.0,4,2.25,2670,9040,1.0,0,0,2,8,2170,0,1955,0.0,98148,47.4666,-122.32600000000001,1880,2648,6370,0.7046460176991151,7128900,81721600,74592700
547000.0,5,3.0,2200,103237,1.0,0,0,2,7,1160,1040,1971,0.0,98072,47.7726,-122.111,2300,103237,101037,0.9786898108236388,4840000,10657878169,10653038169
125000.0,2,1.0,810,8382,1.0,0,0,3,5,810,0,1942,0.0,98146,47.5033,-122.35799999999999,1040,8382,7572,0.9033643521832498,656100,70257924,69601824
2300000.0,4,4.75,3970,9778,2.0,0,2,3,11,3390,580,1928,0.0,98119,47.6312,-122.366,3970,8460,5808,0.5939865003068112,15760900,95609284,79848384
348000.0,3,2.5,2370,7500,1.0,0,3,2,8,1620,750,1979,0.0,98198,47.4091,-122.331,1960,8062,5130,0.684,5616900,56250000,50633100
175000.0,3,1.0,1460,11880,1.0,0,0,1,7,1460,0,1961,0.0,98030,47.3762,-122.219,1310,9315,10420,0.877104377104377,2131600,141134400,139002800
439950.0,3,2.5,1770,2875,2.0,0,0,2,8,1770,0,1990,0.0,98116,47.5631,-122.397,1770,3833,1105,0.3843478260869565,3132900,8265625,5132725
230000.0,3,1.0,1120,32250,1.0,0,0,3,6,1120,0,1934,0.0,98070,47.446999999999996,-122.48200000000001,1010,335289,31130,0.9652713178294574,1254400,1040062500,1038808100
207000.0,3,2.5,1520,2550,2.0,0,0,2,7,1520,0,2005,0.0,98108,47.5245,-122.33,1460,2550,1030,0.403921568627451,2310400,6502500,4192100
320000.0,5,2.5,3020,21441,1.0,0,0,3,8,1510,1510,1978,0.0,98042,47.3392,-122.131,1610,16445,18421,0.8591483606175085,9120400,459716481,450596081
1090000.0,5,3.25,5600,107157,2.0,0,0,2,10,3440,2160,1988,0.0,98072,47.7341,-122.102,3470,75794,101557,0.9477402316227591,31360000,11482622649,11451262649
510000.0,4,1.5,1320,14250,1.0,0,0,3,7,1320,0,1954,0.0,98033,47.7016,-122.199,1720,14250,12930,0.9073684210526316,1742400,203062500,201320100
730000.0,4,1.0,1870,4992,1.5,0,0,3,7,1670,200,1940,0.0,98199,47.6437,-122.396,2160,5239,3122,0.6254006410256411,3496900,24920064,21423164
750000.0,3,3.75,2460,7630,1.0,0,0,4,8,1940,520,1976,0.0,98177,47.7147,-122.37299999999999,2000,7326,5170,0.6775884665792923,6051600,58216900,52165300
237000.0,3,1.5,960,7400,1.0,0,0,2,7,960,0,1962,0.0,98198,47.3798,-122.306,1640,8060,6440,0.8702702702702703,921600,54760000,53838400
560000.0,3,2.5,3440,103672,2.0,0,0,2,9,3440,0,1990,0.0,98038,47.3895,-121.986,2710,112820,100232,0.9668184273477892,11833600,10747883584,10736049984
745000.0,3,2.75,3010,12432,1.0,0,0,3,8,1890,1120,1970,0.0,98052,47.6392,-122.10799999999999,2500,12432,9422,0.7578828828828829,9060100,154554624,145494524
1830000.0,3,3.75,6030,39317,2.0,0,0,2,11,4440,1590,1991,0.0,98004,47.6055,-122.21,4040,12333,33287,0.8466312282218887,36360900,1545826489,1509465589
180000.0,3,2.25,1990,6350,2.0,0,0,2,7,1990,0,1967,0.0,98198,47.3822,-122.316,1220,6250,4360,0.6866141732283465,3960100,40322500,36362400
309950.0,3,2.25,1990,6350,2.0,0,0,2,7,1990,0,1967,0.0,98198,47.3822,-122.316,1220,6250,4360,0.6866141732283465,3960100,40322500,36362400
715000.0,4,1.0,1710,6050,1.5,0,0,2,7,1410,300,1913,0.0,98118,47.5569,-122.288,1560,4950,4340,0.7173553719008264,2924100,36602500,33678400
620000.0,4,2.25,1890,4300,1.5,0,0,2,7,1350,540,1918,0.0,98103,47.6649,-122.337,1830,3800,2410,0.5604651162790698,3572100,18490000,14917900
330000.0,3,2.5,1990,9995,2.0,0,0,2,7,1990,0,1996,0.0,98198,47.383,-122.305,1680,7511,8005,0.8009004502251126,3960100,99900025,95939925
525000.0,4,1.75,1600,7400,1.0,0,0,2,7,1210,390,1973,0.0,98125,47.7111,-122.309,1640,7500,5800,0.7837837837837838,2560000,54760000,52200000
611000.0,6,2.5,3820,53173,1.0,0,0,3,9,2040,1780,1974,0.0,98027,47.5209,-122.052,2510,15314,49353,0.92815902807816,14592400,2827367929,2812775529
294000.0,4,2.5,2210,8465,1.0,0,0,2,8,1490,720,1990,0.0,98092,47.2647,-122.221,2210,7917,6255,0.7389249852333136,4884100,71656225,66772125
463000.0,3,1.75,2020,11095,1.0,0,0,3,7,1480,540,1975,0.0,98034,47.7351,-122.18299999999999,2030,10710,9075,0.8179360072104551,4080400,123099025,119018625
320900.0,3,2.0,1770,7251,1.0,0,0,3,8,1770,0,1990,0.0,98031,47.4087,-122.17,2560,7210,5481,0.755895738518825,3132900,52577001,49444101
369950.0,4,2.5,2050,4502,2.0,0,0,2,7,2050,0,2005,0.0,98059,47.5002,-122.15,2480,4504,2452,0.5446468236339405,4202500,20268004,16065504
565000.0,4,2.75,3130,139392,2.0,0,0,3,9,3130,0,1981,0.0,98030,47.3535,-122.19,2720,104544,136262,0.9775453397612488,9796900,19430129664,19420332764
589500.0,4,1.5,3520,4933,1.5,0,0,3,8,2270,1250,1929,0.0,98108,47.5655,-122.315,1710,5400,1413,0.28643827285627405,12390400,24334489,11944089
400000.0,4,1.75,1810,9750,2.0,0,0,3,7,1810,0,1977,0.0,98155,47.7681,-122.311,1570,10000,7940,0.8143589743589743,3276100,95062500,91786400
458000.0,3,2.25,2150,9900,1.0,0,0,2,8,1450,700,1977,0.0,98052,47.6647,-122.149,2170,9500,7750,0.7828282828282829,4622500,98010000,93387500
436000.0,4,2.5,2495,5751,2.0,0,0,2,7,2495,0,2002,0.0,98019,47.7243,-121.95700000000001,2490,6300,3256,0.5661624065379934,6225025,33074001,26848976
310000.0,3,2.0,1290,6150,1.0,0,1,4,6,1290,0,1950,0.0,98118,47.5181,-122.257,1960,6150,4860,0.7902439024390244,1664100,37822500,36158400
398000.0,5,2.5,3004,5700,2.0,0,0,2,9,3004,0,2006,0.0,98030,47.3801,-122.185,2665,5700,2696,0.4729824561403509,9024016,32490000,23465984
625000.0,4,2.25,2070,7200,1.0,0,0,4,8,1390,680,1977,0.0,98033,47.696999999999996,-122.169,2110,8400,5130,0.7125,4284900,51840000,47555100
1010000.0,5,3.25,4050,35600,2.0,0,0,2,12,4050,0,1990,0.0,98006,47.5465,-122.12200000000001,4770,33880,31550,0.8862359550561798,16402500,1267360000,1250957500
435000.0,2,1.0,960,6250,1.0,0,0,3,6,740,220,1940,0.0,98126,47.5378,-122.375,1090,6000,5290,0.8464,921600,39062500,38140900
250000.0,3,2.25,1900,9990,1.0,0,0,2,7,1300,600,1961,0.0,98003,47.3478,-122.29799999999999,1900,9990,8090,0.8098098098098098,3610000,99800100,96190100
430000.0,3,1.5,1450,7316,1.0,0,0,2,7,1450,0,1961,0.0,98133,47.7725,-122.34899999999999,1440,7316,5866,0.8018042646254784,2102500,53523856,51421356
790000.0,4,3.5,2720,3000,2.0,0,0,2,9,2250,470,2014,0.0,98136,47.5371,-122.38799999999999,1600,4600,280,0.09333333333333334,7398400,9000000,1601600
1680000.0,5,5.25,4830,18707,2.0,0,1,4,9,3930,900,1952,1998.0,98040,47.5858,-122.24700000000001,2880,10520,13877,0.7418078794034318,23328900,349951849,326622949
250000.0,4,2.75,1920,7102,1.0,0,0,2,7,1130,790,1992,0.0,98106,47.538999999999994,-122.35600000000001,1830,6440,5182,0.7296536186989581,3686400,50438404,46752004
1120000.0,5,1.5,2540,6660,2.0,0,3,3,8,2340,200,1954,0.0,98136,47.5144,-122.39299999999999,2460,9000,4120,0.6186186186186187,6451600,44355600,37904000
383900.0,3,1.5,1600,8040,1.0,0,0,3,7,1050,550,1965,0.0,98133,47.7471,-122.337,1810,7819,6440,0.8009950248756219,2560000,64641600,62081600
330000.0,4,2.5,2210,5929,2.0,0,0,2,8,2210,0,2004,0.0,98042,47.35,-122.139,2200,5901,3719,0.6272558610220947,4884100,35153041,30268941
624000.0,3,2.5,2510,47044,1.0,0,0,3,7,1910,600,1975,0.0,98072,47.7531,-122.14,2510,42803,44534,0.946645693393419,6300100,2213137936,2206837836
383000.0,5,2.0,2280,5750,1.0,0,0,3,8,1140,1140,1951,0.0,98116,47.5672,-122.39,1780,5750,3470,0.6034782608695652,5198400,33062500,27864100
687000.0,4,3.25,4400,186846,2.0,0,0,3,9,4400,0,1993,0.0,98022,47.1593,-121.95700000000001,2280,186846,182446,0.9764511951018486,19360000,34911427716,34892067716
558000.0,4,3.25,3160,8876,2.0,0,0,2,9,2460,700,1997,0.0,98056,47.5153,-122.178,2900,10000,5716,0.64398377647589,9985600,78783376,68797776
275000.0,3,2.0,1380,3500,2.0,0,0,2,7,1380,0,1971,0.0,98118,47.5558,-122.27,1620,3900,2120,0.6057142857142858,1904400,12250000,10345600
687500.0,5,2.75,3320,10500,1.0,0,0,3,7,2020,1300,1963,0.0,98033,47.692,-122.166,1840,10425,7180,0.6838095238095238,11022400,110250000,99227600
275000.0,3,2.5,1870,6821,2.0,0,0,2,7,1870,0,1989,0.0,98023,47.3065,-122.35799999999999,1970,6821,4951,0.7258466500513121,3496900,46526041,43029141
700000.0,3,3.5,3030,11550,2.0,0,2,2,8,3030,0,1971,0.0,98146,47.5051,-122.381,2340,10560,8520,0.7376623376623377,9180900,133402500,124221600
342500.0,2,1.75,1210,7507,1.0,0,0,2,7,1210,0,1982,0.0,98034,47.7078,-122.234,1840,7500,6297,0.8388171040362329,1464100,56355049,54890949
483500.0,4,2.5,2740,45732,2.0,0,0,2,8,2740,0,1995,0.0,98077,47.74,-122.04799999999999,2080,43560,42992,0.940085716784746,7507600,2091415824,2083908224
190000.0,3,1.75,1350,7370,1.0,0,0,3,6,1350,0,1912,0.0,98118,47.5336,-122.27799999999999,1440,6000,6020,0.8168249660786974,1822500,54316900,52494400
300000.0,3,1.75,1350,7370,1.0,0,0,3,6,1350,0,1912,0.0,98118,47.5336,-122.27799999999999,1440,6000,6020,0.8168249660786974,1822500,54316900,52494400
540000.0,3,2.0,1470,1691,2.0,0,0,2,8,1000,0,2007,0.0,98115,47.6743,-122.316,1660,4000,221,0.13069189828503844,2160900,2859481,698581
140000.0,3,1.75,1270,8991,2.0,0,0,2,7,1270,0,1981,0.0,98042,47.3563,-122.149,1270,8993,7721,0.8587476365254143,1612900,80838081,79225181
275000.0,4,1.75,1680,19405,1.0,0,0,3,7,1560,120,1959,0.0,98055,47.4552,-122.20200000000001,2000,12900,17725,0.9134243751610409,2822400,376554025,373731625
370000.0,3,2.75,2120,7650,1.0,0,0,3,7,2120,0,1958,0.0,98056,47.4923,-122.178,1180,7650,5530,0.722875816993464,4494400,58522500,54028100
227000.0,2,1.0,1040,9100,1.0,0,0,3,7,1040,0,1937,0.0,98133,47.7407,-122.34700000000001,1950,13228,8060,0.8857142857142857,1081600,82810000,81728400
312000.0,4,1.0,1730,8706,1.0,0,0,3,7,1010,720,1962,0.0,98058,47.4586,-122.175,1369,8418,6976,0.8012864691017689,2992900,75794436,72801536
260000.0,2,1.0,1410,5650,1.5,0,0,2,6,1410,0,1918,0.0,98118,47.5159,-122.258,1430,5650,4240,0.7504424778761062,1988100,31922500,29934400
797000.0,3,2.5,1370,1911,2.0,0,0,2,9,1370,0,1907,2011.0,98109,47.6375,-122.354,1630,2090,541,0.28309785452642594,1876900,3651921,1775021
640000.0,6,2.0,2840,228690,1.5,0,0,2,6,2720,120,1948,0.0,98019,47.7158,-121.96600000000001,2330,228690,225850,0.9875814421268967,8065600,52299116100,52291050500
605000.0,4,1.75,3280,35160,1.0,0,0,2,7,2080,1200,1976,0.0,98053,47.6728,-122.061,2510,31331,31880,0.906712172923777,10758400,1236225600,1225467200
329950.0,3,2.25,2070,7995,1.0,0,0,2,7,1350,720,1987,0.0,98031,47.403,-122.175,1620,6799,5925,0.7410881801125704,4284900,63920025,59635125
180000.0,2,1.0,960,87991,1.5,0,0,2,5,960,0,1946,0.0,98014,47.63,-121.9,1940,392040,87031,0.9890897932743121,921600,7742416081,7741494481
220000.0,3,2.25,1470,7518,1.0,0,0,2,7,1160,310,1985,0.0,98003,47.2725,-122.3,1720,8300,6048,0.8044692737430168,2160900,56520324,54359424
723000.0,4,2.25,2430,4748,1.5,0,0,2,8,1630,800,1928,0.0,98116,47.5904,-122.389,2430,4748,2318,0.4882055602358888,5904900,22543504,16638604
375000.0,3,1.75,1430,8412,1.0,0,0,3,7,1070,360,1928,0.0,98125,47.7218,-122.29899999999999,1490,8410,6982,0.8300047551117451,2044900,70761744,68716844
388000.0,3,1.75,1760,9277,1.0,0,0,3,7,1760,0,1962,0.0,98146,47.4977,-122.35799999999999,1760,7650,7517,0.8102834968200927,3097600,86062729,82965129
249950.0,5,2.0,1730,7375,1.0,0,0,3,6,1730,0,1944,0.0,98178,47.4953,-122.238,1550,7125,5645,0.7654237288135594,2992900,54390625,51397725
390000.0,5,1.75,2290,7900,1.0,0,0,3,7,1190,1100,1965,0.0,98133,47.7577,-122.35799999999999,1870,8250,5610,0.710126582278481,5244100,62410000,57165900
705000.0,4,1.75,1690,11739,1.0,0,0,3,8,1690,0,1959,0.0,98040,47.552,-122.219,2300,11600,10049,0.8560354374307863,2856100,137804121,134948021
590000.0,4,2.5,3220,7875,1.5,0,0,3,8,3220,0,1966,0.0,98008,47.62600000000001,-122.12,1600,7875,4655,0.5911111111111111,10368400,62015625,51647225
292000.0,4,1.75,2130,11097,1.0,0,0,2,7,1370,760,1952,0.0,98166,47.4629,-122.35600000000001,1850,11097,8967,0.8080562314138956,4536900,123143409,118606509
506000.0,3,2.5,2100,213008,1.0,0,0,2,8,2100,0,1990,0.0,98092,47.2984,-122.14399999999999,1330,214315,210908,0.9901412153534139,4410000,45372408064,45367998064
907500.0,4,2.5,2770,8642,2.0,0,0,3,9,2770,0,1987,0.0,98007,47.6599,-122.146,2670,9000,5872,0.6794723443647304,7672900,74684164,67011264
2270000.0,4,3.25,4040,18916,1.0,0,0,3,9,4040,0,1954,0.0,98039,47.6155,-122.238,3000,18831,14876,0.786424191160922,16321600,357815056,341493456
319500.0,4,2.75,2500,5100,1.5,0,0,3,7,1420,1080,1907,0.0,98108,47.523,-122.33200000000001,1430,5100,2600,0.5098039215686274,6250000,26010000,19760000
265000.0,5,1.75,1580,5292,1.0,0,0,2,6,980,600,1913,0.0,98118,47.5677,-122.29,1600,2976,3712,0.7014361300075586,2496400,28005264,25508864
237000.0,3,1.0,1130,10650,1.0,0,0,2,7,1130,0,1954,0.0,98188,47.4363,-122.286,1320,10650,9520,0.8938967136150234,1276900,113422500,112145600
235000.0,5,1.0,1500,9282,1.5,0,0,4,6,1500,0,1966,0.0,98168,47.4702,-122.281,1520,9639,7782,0.8383968972204267,2250000,86155524,83905524
740000.0,4,2.25,2230,6000,1.5,0,2,2,8,1810,420,1928,0.0,98199,47.6464,-122.391,2840,6000,3770,0.6283333333333333,4972900,36000000,31027100
359000.0,3,1.5,1550,4980,1.0,0,0,2,7,1080,470,1978,0.0,98133,47.7035,-122.34,940,4980,3430,0.6887550200803213,2402500,24800400,22397900
334950.0,4,2.5,2230,5500,2.0,0,0,2,7,2230,0,1999,0.0,98038,47.3533,-122.023,1910,5500,3270,0.5945454545454546,4972900,30250000,25277100
259950.0,2,1.0,790,8100,1.0,0,0,2,6,790,0,1947,0.0,98125,47.7159,-122.305,1420,8100,7310,0.9024691358024691,624100,65610000,64985900
253000.0,4,2.5,2230,4541,2.0,0,0,2,7,2230,0,2006,0.0,98042,47.3848,-122.1,2800,4860,2311,0.5089187403655583,4972900,20620681,15647781
561000.0,3,2.25,1710,4140,2.0,0,0,2,8,1710,0,2004,0.0,98029,47.5498,-121.99700000000001,1730,3680,2430,0.5869565217391305,2924100,17139600,14215500
455000.0,2,1.5,1260,5100,1.0,0,0,2,7,1260,0,1941,0.0,98115,47.6914,-122.288,1640,5100,3840,0.7529411764705882,1587600,26010000,24422400
675000.0,4,2.5,2420,18470,1.0,0,0,2,8,920,1500,1968,0.0,98005,47.6001,-122.176,2690,13800,16050,0.8689767190037899,5856400,341140900,335284500
267000.0,3,1.5,1090,8160,1.0,0,0,2,7,1090,0,1967,0.0,98058,47.4551,-122.175,1260,7560,7070,0.866421568627451,1188100,66585600,65397500
368000.0,4,2.5,2689,5724,2.0,0,0,2,9,2689,0,2006,0.0,98030,47.3799,-122.184,2665,5700,3035,0.5302236198462613,7230721,32764176,25533455
599995.0,3,1.0,1620,3000,1.5,0,0,4,7,1620,0,1928,0.0,98103,47.6888,-122.34700000000001,1420,3060,1380,0.46,2624400,9000000,6375600
342500.0,3,1.0,940,10500,1.0,0,0,3,7,940,0,1966,0.0,98034,47.7268,-122.229,1660,10500,9560,0.9104761904761904,883600,110250000,109366400
252000.0,4,1.75,1940,13370,1.0,0,0,3,8,1940,0,1974,0.0,98023,47.3215,-122.369,2405,11769,11430,0.8548990276738968,3763600,178756900,174993300
247200.0,3,1.0,1590,11200,1.0,0,0,3,7,1590,0,1961,0.0,98092,47.2894,-122.18799999999999,1560,9750,9610,0.8580357142857142,2528100,125440000,122911900
910000.0,3,3.5,3020,4082,2.0,0,0,2,9,2080,940,1954,2004.0,98199,47.651,-122.40899999999999,2060,5102,1062,0.26016658500734935,9120400,16662724,7542324
419950.0,4,1.75,1870,16549,1.0,0,0,2,8,1870,0,1969,0.0,98072,47.7482,-122.083,1870,10804,14679,0.8870022357846395,3496900,273869401,270372501
160000.0,3,1.0,880,8976,1.0,0,0,3,6,880,0,1966,0.0,98023,47.3056,-122.368,990,8760,8096,0.9019607843137255,774400,80568576,79794176
799950.0,4,3.5,3030,5494,3.0,0,0,2,9,3030,0,2014,0.0,98052,47.7103,-122.109,2910,5314,2464,0.4484892610120131,9180900,30184036,21003136
400000.0,3,2.25,2140,11266,2.0,0,0,2,7,2140,0,1986,0.0,98019,47.7267,-121.96600000000001,2000,14174,9126,0.8100479318302858,4579600,126922756,122343156
210000.0,5,2.0,2050,10200,1.0,0,0,2,6,1430,620,1956,0.0,98198,47.4136,-122.333,1940,8625,8150,0.7990196078431373,4202500,104040000,99837500
475000.0,5,2.0,2050,10200,1.0,0,0,2,6,1430,620,1956,0.0,98198,47.4136,-122.333,1940,8625,8150,0.7990196078431373,4202500,104040000,99837500
355900.0,3,2.5,2090,3821,2.0,0,0,2,7,2090,0,2008,0.0,98038,47.3655,-122.01700000000001,2040,4200,1731,0.45302276890866267,4368100,14600041,10231941
420000.0,3,2.25,2520,26943,1.0,0,0,2,7,1760,760,1977,0.0,98028,47.7728,-122.25,2300,10004,24423,0.9064692127825409,6350400,725925249,719574849
710000.0,4,2.5,2630,8580,1.0,0,0,3,9,1700,930,1977,0.0,98005,47.5916,-122.166,2430,10240,5950,0.6934731934731935,6916900,73616400,66699500
518000.0,4,1.75,2560,15000,1.0,0,0,2,7,1880,680,1974,0.0,98075,47.5952,-122.053,2210,15150,12440,0.8293333333333334,6553600,225000000,218446400
375000.0,3,1.0,1200,5404,1.0,0,0,2,6,1200,0,1937,0.0,98117,47.6969,-122.368,1200,5987,4204,0.7779422649888971,1440000,29203216,27763216
185000.0,3,1.5,1010,7755,1.0,0,0,2,6,1010,0,1953,0.0,98148,47.4238,-122.33200000000001,1270,8350,6745,0.8697614442295294,1020100,60140025,59119925
402000.0,3,2.5,1520,3425,2.0,0,0,2,7,1520,0,1986,0.0,98052,47.6801,-122.161,1640,3425,1905,0.5562043795620438,2310400,11730625,9420225
585000.0,3,1.75,2170,153767,1.0,0,0,2,7,2170,0,1976,0.0,98042,47.3694,-122.065,2840,49500,151597,0.9858877392418399,4708900,23644290289,23639581389
500000.0,4,2.0,1980,4500,2.0,0,0,3,7,1980,0,1910,0.0,98107,47.6728,-122.37899999999999,1550,2541,2520,0.56,3920400,20250000,16329600
1720000.0,4,2.5,3070,7207,2.0,0,0,3,10,2670,400,1927,0.0,98112,47.6325,-122.29,3190,7523,4137,0.5740252532260303,9424900,51940849,42515949
1680000.0,5,3.5,5170,7197,3.0,1,4,2,11,3520,1650,1998,0.0,98155,47.7561,-122.271,3020,12880,2027,0.2816451299152425,26728900,51796809,25067909
570000.0,2,2.0,1140,690,2.0,0,0,2,8,760,0,2014,0.0,98112,47.6205,-122.3,1480,1171,-450,-0.6521739130434783,1299600,476100,-823500
680000.0,8,2.75,2530,4800,2.0,0,0,3,7,1390,1140,1901,0.0,98112,47.6241,-122.305,1540,4800,2270,0.47291666666666665,6400900,23040000,16639100
345000.0,3,2.25,1690,14615,2.0,0,0,3,7,1690,0,1979,0.0,98045,47.4492,-121.78,1390,11360,12925,0.8843653780362641,2856100,213598225,210742125
355000.0,4,2.5,2150,3600,2.0,0,0,2,7,2150,0,2010,0.0,98038,47.3658,-122.01899999999999,2220,3915,1450,0.4027777777777778,4622500,12960000,8337500
390000.0,3,1.5,1180,7700,1.0,0,0,3,7,1180,0,1959,0.0,98007,47.6133,-122.133,1510,8800,6520,0.8467532467532467,1392400,59290000,57897600
128000.0,3,1.0,1400,9690,1.0,0,0,2,7,1400,0,1969,0.0,98023,47.3201,-122.398,1280,9600,8290,0.8555211558307534,1960000,93896100,91936100
448500.0,3,1.75,1300,4800,2.0,0,1,3,7,1300,0,1912,0.0,98136,47.5457,-122.383,1300,4800,3500,0.7291666666666666,1690000,23040000,21350000
346000.0,3,1.75,1590,9636,1.5,0,0,3,6,1590,0,1953,0.0,98155,47.754,-122.321,1800,9975,8046,0.8349937733499377,2528100,92852496,90324396
779000.0,3,1.75,1990,5600,1.0,0,1,2,8,1330,660,1941,0.0,98199,47.65,-122.415,2630,6780,3610,0.6446428571428572,3960100,31360000,27399900
335000.0,3,1.75,1510,9720,1.0,0,0,2,7,1510,0,1948,0.0,98028,47.7728,-122.258,1520,10037,8210,0.8446502057613169,2280100,94478400,92198300
1850000.0,4,3.25,2910,1880,2.0,0,3,4,9,1830,1080,1914,0.0,98122,47.61600000000001,-122.28200000000001,3100,8200,-1030,-0.5478723404255319,8468100,3534400,-4933700
799990.0,3,2.5,2850,21780,2.0,0,0,2,10,2850,0,1994,0.0,98053,47.6455,-122.04,3020,21798,18930,0.8691460055096418,8122500,474368400,466245900
1080000.0,3,2.5,2830,56628,2.0,0,0,2,11,2830,0,2001,0.0,98011,47.7409,-122.198,2830,16430,53798,0.9500247227519955,8008900,3206730384,3198721484
371000.0,2,1.5,1110,1189,3.0,0,0,2,8,1110,0,2000,0.0,98107,47.6711,-122.37700000000001,1420,1311,79,0.06644238856181665,1232100,1413721,181621
620000.0,4,2.5,1900,9775,1.0,0,0,4,7,1900,0,1967,0.0,98033,47.6856,-122.16799999999999,1990,10500,7875,0.8056265984654731,3610000,95550625,91940625
343000.0,4,1.75,2290,10290,1.0,0,0,2,7,1340,950,1960,0.0,98146,47.5045,-122.369,1800,7605,8000,0.7774538386783285,5244100,105884100,100640000
265000.0,3,1.0,1010,14948,1.0,0,0,4,6,1010,0,1969,0.0,98059,47.4772,-122.14399999999999,1510,9600,13938,0.9324324324324325,1020100,223442704,222422604
1000000.0,5,2.5,4670,15857,2.0,0,0,2,11,4670,0,1998,0.0,98074,47.63,-122.01100000000001,3810,14824,11187,0.7054928422778584,21808900,251444449,229635549
825000.0,3,2.5,3400,38400,1.0,0,4,2,8,1870,1530,1955,2015.0,98177,47.7611,-122.37200000000001,3400,24338,35000,0.9114583333333334,11560000,1474560000,1463000000
889000.0,4,3.5,4070,10976,2.0,0,0,2,10,4070,0,2004,0.0,98075,47.5805,-121.97,4080,10106,6906,0.6291909620991254,16564900,120472576,103907676
305000.0,3,2.25,1630,10962,1.0,0,0,3,8,1100,530,1977,0.0,98030,47.3801,-122.166,1830,8470,9332,0.8513045064769202,2656900,120165444,117508544
407000.0,2,2.5,1700,6635,2.0,0,0,3,8,1700,0,1976,0.0,98052,47.6655,-122.13,1700,6635,4935,0.7437829691032404,2890000,44023225,41133225
613000.0,5,2.5,2070,12000,1.0,0,0,3,7,1340,730,1967,0.0,98008,47.62600000000001,-122.104,2090,12000,9930,0.8275,4284900,144000000,139715100
1640000.0,3,3.5,4660,21164,2.0,1,4,2,12,4660,0,1975,1990.0,98166,47.4418,-122.354,3140,24274,16504,0.7798147798147799,21715600,447914896,426199296
645000.0,3,3.75,2050,6000,2.0,0,0,4,7,1550,500,1910,0.0,98103,47.6873,-122.33200000000001,1780,4000,3950,0.6583333333333333,4202500,36000000,31797500
1160000.0,4,3.5,4680,9700,2.0,0,0,2,10,3360,1320,2005,0.0,98006,47.5703,-122.165,2800,12343,5020,0.5175257731958763,21902400,94090000,72187600
610000.0,3,2.25,2320,38186,2.0,0,0,2,8,2320,0,1980,0.0,98053,47.6645,-122.068,2875,37523,35866,0.9392447493845912,5382400,1458170596,1452788196
450000.0,3,2.5,3800,13071,2.0,0,0,2,10,2730,1070,1994,0.0,98023,47.3076,-122.397,2980,11110,9271,0.7092800856858695,14440000,170851041,156411041
300000.0,3,2.0,720,7598,1.0,0,0,4,6,720,0,1947,0.0,98106,47.5483,-122.36,1080,7209,6878,0.9052382205843643,518400,57729604,57211204
1120000.0,5,2.75,4400,18500,1.0,0,3,4,9,2250,2150,1963,0.0,98028,47.7424,-122.26299999999999,3290,19257,14100,0.7621621621621621,19360000,342250000,322890000
418200.0,3,2.5,2260,74297,2.0,0,0,2,9,2260,0,1992,0.0,98022,47.2704,-122.01299999999999,3110,98000,72037,0.9695815443423018,5107600,5520044209,5514936609
250000.0,3,2.5,1650,2802,2.0,0,0,2,7,1650,0,2004,0.0,98055,47.4328,-122.196,1490,2084,1152,0.41113490364025695,2722500,7851204,5128704
619000.0,3,2.5,2560,43608,2.0,0,0,2,9,2560,0,2002,0.0,98077,47.7614,-122.02600000000001,3000,54088,41048,0.9412951751972115,6553600,1901657664,1895104064
500000.0,4,3.0,3720,15048,3.0,0,0,2,7,3720,0,1979,2014.0,98059,47.5116,-122.14399999999999,2020,15180,11328,0.7527910685805422,13838400,226442304,212603904
465000.0,4,2.5,2590,16437,2.0,0,0,2,8,2590,0,1986,0.0,98038,47.3714,-122.059,2320,15625,13847,0.8424286670316968,6708100,270174969,263466869
322000.0,4,1.0,1750,68841,1.0,0,0,2,7,1750,0,1942,0.0,98058,47.4442,-122.081,1550,32799,67091,0.9745791025696896,3062500,4739083281,4736020781
276900.0,3,2.5,1620,7320,2.0,0,0,2,7,1620,0,1989,0.0,98038,47.3617,-122.054,1550,7686,5700,0.7786885245901639,2624400,53582400,50958000
660000.0,3,2.25,1700,12615,1.0,0,0,3,7,1300,400,1990,0.0,98033,47.6965,-122.197,1950,13163,10915,0.8652397938961554,2890000,159138225,156248225
480000.0,3,2.5,2450,28185,2.0,0,0,2,9,2450,0,1990,0.0,98058,47.4665,-122.12200000000001,2440,33541,25735,0.9130743303175448,6002500,794394225,788391725
925000.0,3,1.75,1610,10796,1.0,0,0,2,7,1070,540,1951,0.0,98004,47.6272,-122.208,1940,10796,9186,0.8508706928492034,2592100,116553616,113961516
825000.0,3,3.0,3730,35900,1.0,0,0,2,9,2960,770,1979,0.0,98008,47.5814,-122.12200000000001,2280,16026,32170,0.8961002785515321,13912900,1288810000,1274897100
326000.0,2,1.0,1210,7440,1.0,0,0,2,6,780,430,1940,0.0,98155,47.7376,-122.322,1070,7440,6230,0.8373655913978495,1464100,55353600,53889500
205000.0,3,1.0,1300,9880,1.0,0,0,3,7,1300,0,1959,0.0,98003,47.3352,-122.29700000000001,2140,9600,8580,0.868421052631579,1690000,97614400,95924400
150000.0,2,1.0,850,54000,1.5,0,0,0,4,850,0,1950,0.0,98023,47.2959,-122.37700000000001,1550,14440,53150,0.9842592592592593,722500,2916000000,2915277500
593567.0,3,2.5,1770,3205,2.0,0,0,2,9,1770,0,2005,0.0,98052,47.6658,-122.084,2120,4134,1435,0.44773790951638065,3132900,10272025,7139125
440000.0,3,2.5,2060,11231,2.0,0,0,2,8,2060,0,1987,0.0,98072,47.7571,-122.141,2140,10224,9171,0.8165791113881221,4243600,126135361,121891761
751000.0,3,2.5,3090,13316,2.0,0,0,2,10,3090,0,1992,0.0,98075,47.588,-122.079,2980,14437,10226,0.7679483328326825,9548100,177315856,167767756
295000.0,2,1.75,1050,6500,1.5,0,2,3,6,1050,0,1925,0.0,98055,47.4727,-122.2,1320,10075,5450,0.8384615384615385,1102500,42250000,41147500
422500.0,3,2.0,1300,2250,2.0,0,0,2,7,1300,0,1988,0.0,98103,47.6923,-122.33200000000001,1300,4500,950,0.4222222222222222,1690000,5062500,3372500
480000.0,3,1.0,1160,8800,1.0,0,0,3,7,1160,0,1959,0.0,98008,47.6112,-122.12799999999999,1750,8400,7640,0.8681818181818182,1345600,77440000,76094400
890900.0,4,2.5,3420,6233,2.0,0,0,2,9,3420,0,2006,0.0,98027,47.5416,-121.99799999999999,3350,5000,2813,0.45130755655382643,11696400,38850289,27153889
672500.0,4,2.75,2620,6707,2.0,0,0,2,9,2620,0,2000,0.0,98075,47.5965,-122.038,2590,6530,4087,0.6093633517220814,6864400,44983849,38119449
605000.0,4,1.5,1880,3500,1.0,0,0,3,7,1080,800,1926,0.0,98103,47.6835,-122.34700000000001,1690,3500,1620,0.46285714285714286,3534400,12250000,8715600
1680000.0,5,3.25,4560,19080,1.0,0,0,4,9,2490,2070,1963,0.0,98004,47.6291,-122.226,3390,20140,14520,0.7610062893081762,20793600,364046400,343252800
565000.0,4,2.5,2330,7936,2.0,0,0,2,9,2330,0,1987,0.0,98074,47.6269,-122.03,2460,8137,5606,0.7064012096774194,5428900,62980096,57551196
725000.0,4,1.75,2350,7574,1.0,0,0,2,8,1720,630,1979,0.0,98027,47.5634,-122.087,2220,8496,5224,0.6897280168999208,5522500,57365476,51842976
640000.0,3,3.0,1560,1466,3.0,0,0,2,8,1560,0,2006,0.0,98103,47.6604,-122.352,1530,2975,-94,-0.06412005457025921,2433600,2149156,-284444
253750.0,4,1.0,1380,7110,1.5,0,0,2,6,1380,0,1939,0.0,98030,47.3846,-122.226,1430,7110,5730,0.8059071729957806,1904400,50552100,48647700
799950.0,6,2.75,3040,36721,1.0,0,3,3,9,1760,1280,1958,0.0,98166,47.4488,-122.35600000000001,2420,21075,33681,0.9172135835080744,9241600,1348431841,1339190241
595000.0,4,1.5,1350,8113,1.0,0,0,3,7,1350,0,1959,0.0,98004,47.5807,-122.196,1930,8113,6763,0.8336003944286947,1822500,65820769,63998269
850000.0,4,2.5,3180,11652,2.0,0,1,2,9,3180,0,1977,0.0,98040,47.567,-122.212,3110,15183,8472,0.7270854788877446,10112400,135769104,125656704
366000.0,3,2.5,1790,4065,2.0,0,0,2,8,1790,0,2009,0.0,98019,47.7344,-121.965,2480,4252,2275,0.5596555965559655,3204100,16524225,13320125
715000.0,4,3.0,1986,6000,2.0,0,2,3,8,1746,240,1922,0.0,98136,47.5374,-122.39,1930,6200,4014,0.669,3944196,36000000,32055804
300000.0,4,2.5,2400,7215,2.0,0,0,2,8,2400,0,1992,0.0,98023,47.2944,-122.37100000000001,2220,7760,4815,0.6673596673596673,5760000,52056225,46296225
960000.0,4,3.0,4590,9150,2.0,0,0,2,10,3490,1100,1981,0.0,98177,47.7234,-122.37200000000001,2910,12348,4560,0.49836065573770494,21068100,83722500,62654400
812000.0,3,2.0,1970,3420,2.0,0,3,4,8,1970,0,1913,0.0,98103,47.6762,-122.354,1770,3420,1450,0.4239766081871345,3880900,11696400,7815500
234950.0,3,1.0,1360,9948,1.0,0,0,2,6,1360,0,1977,0.0,98010,47.3422,-122.053,1670,8475,8588,0.8632891033373542,1849600,98962704,97113104
656500.0,4,2.0,2710,4750,1.0,0,0,3,7,1460,1250,1919,0.0,98115,47.6756,-122.305,1700,3800,2040,0.42947368421052634,7344100,22562500,15218400
255000.0,2,1.5,920,1598,2.0,0,0,2,7,920,0,1995,0.0,98133,47.7081,-122.34200000000001,1110,1598,678,0.42428035043804757,846400,2553604,1707204
538000.0,3,2.75,2000,7204,1.0,0,0,4,7,1250,750,1960,0.0,98006,47.565,-122.116,2480,17633,5204,0.722376457523598,4000000,51897616,47897616
260000.0,3,2.25,1920,9680,1.0,0,0,3,7,1300,620,1961,0.0,98031,47.412,-122.195,1500,9516,7760,0.8016528925619835,3686400,93702400,90016000
546200.0,3,2.5,2678,6607,2.0,0,0,2,9,2678,0,1998,0.0,98028,47.738,-122.235,2780,6607,3929,0.5946723172392917,7171684,43652449,36480765
280500.0,3,1.0,1220,4541,1.0,0,0,2,7,890,330,1952,0.0,98108,47.5387,-122.294,1670,3429,3321,0.7313367099757763,1488400,20620681,19132281
295000.0,3,1.75,1440,4000,1.0,0,0,3,7,1050,390,1979,0.0,98106,47.5329,-122.354,1560,4000,2560,0.64,2073600,16000000,13926400
700000.0,4,1.75,2420,520,1.5,0,0,2,7,2420,0,1900,0.0,98112,47.6209,-122.302,1200,1170,-1900,-3.6538461538461537,5856400,270400,-5586000
560000.0,3,2.0,2090,15790,1.0,0,0,2,9,2090,0,1992,0.0,98034,47.7296,-122.199,1820,8770,13700,0.8676377454084864,4368100,249324100,244956000
912000.0,4,2.75,4030,10888,2.0,0,0,2,10,4030,0,1997,0.0,98075,47.5651,-122.03399999999999,3720,10756,6858,0.6298677443056576,16240900,118548544,102307644
437000.0,3,1.75,1310,9282,1.0,0,0,3,7,1310,0,1976,0.0,98052,47.6844,-122.111,1310,8748,7972,0.8588666235725059,1716100,86155524,84439424
447000.0,3,2.5,1800,3074,2.0,0,0,2,7,1800,0,2003,0.0,98072,47.7631,-122.149,1610,2929,1274,0.41444372153545866,3240000,9449476,6209476
500000.0,4,1.0,1160,20100,1.0,0,0,3,6,820,340,1913,0.0,98056,47.5175,-122.20100000000001,1670,10200,18940,0.9422885572139303,1345600,404010000,402664400
508300.0,3,1.0,1160,5969,1.0,0,0,2,7,880,280,1930,0.0,98115,47.6844,-122.306,1550,5120,4809,0.8056625900485843,1345600,35628961,34283361
485000.0,3,1.5,1870,7853,1.0,0,0,2,7,1300,570,1962,0.0,98125,47.7045,-122.281,1870,8300,5983,0.7618744428880683,3496900,61669609,58172709
540000.0,7,5.75,3700,7647,2.0,0,1,2,8,3700,0,1948,1984.0,98155,47.7393,-122.289,2510,7479,3947,0.5161501242317249,13690000,58476609,44786609
356000.0,3,2.25,2280,8765,2.0,0,0,2,8,2280,0,1977,0.0,98058,47.4419,-122.133,1920,8265,6485,0.739874500855676,5198400,76825225,71626825
525000.0,4,2.0,1720,6099,1.0,0,0,3,7,860,860,1949,0.0,98115,47.6765,-122.287,1100,5671,4379,0.7179865551729792,2958400,37197801,34239401
962800.0,4,2.75,3630,11775,2.0,0,0,2,10,3630,0,1999,0.0,98074,47.6378,-122.066,3800,12451,8145,0.6917197452229299,13176900,138650625,125473725
315000.0,4,2.5,2040,6300,2.0,0,0,2,8,2040,0,2003,0.0,98031,47.3918,-122.185,2260,5877,4260,0.6761904761904762,4161600,39690000,35528400
525000.0,3,2.25,1750,1879,3.0,0,0,2,8,1750,0,2001,0.0,98107,47.6722,-122.391,1750,3155,129,0.06865353911655135,3062500,3530641,468141
325000.0,2,2.25,1550,2285,2.0,0,0,2,8,1550,0,2007,0.0,98106,47.5398,-122.369,1550,2135,735,0.32166301969365424,2402500,5221225,2818725
965800.0,4,1.75,2500,8725,1.0,0,0,3,8,1500,1000,1966,0.0,98004,47.6304,-122.205,1900,8998,6225,0.7134670487106017,6250000,76125625,69875625
550000.0,4,1.0,1440,3600,1.5,0,0,3,7,1440,0,1924,0.0,98116,47.5694,-122.385,1010,5175,2160,0.6,2073600,12960000,10886400
182200.0,4,1.0,1130,13927,1.5,0,0,2,6,1130,0,1929,0.0,98168,47.4939,-122.3,1800,8274,12797,0.9188626409133338,1276900,193961329,192684429
315000.0,3,1.0,1210,8505,1.5,0,0,2,7,1210,0,1958,0.0,98106,47.5389,-122.353,1430,8505,7295,0.8577307466196356,1464100,72335025,70870925
500000.0,2,1.0,960,5000,1.0,0,0,3,7,960,0,1900,0.0,98107,47.6755,-122.367,1330,5000,4040,0.808,921600,25000000,24078400
480000.0,5,2.5,2160,7737,2.0,0,0,2,7,2160,0,1998,0.0,98065,47.5381,-121.87200000000001,2460,7737,5577,0.7208220240403257,4665600,59861169,55195569
1690000.0,3,1.75,3400,8965,1.0,0,2,4,9,1820,1580,1957,0.0,98105,47.6569,-122.273,3200,8500,5565,0.6207473508087005,11560000,80371225,68811225
525000.0,5,3.25,3960,321908,2.0,0,0,3,9,2690,1270,1989,0.0,98038,47.3984,-122.055,2360,96703,317948,0.9876983485964934,15681600,103624760464,103609078864
407500.0,4,2.5,1900,9075,2.0,0,0,2,7,1900,0,1988,0.0,98133,47.7776,-122.352,1800,8460,7175,0.790633608815427,3610000,82355625,78745625
443000.0,4,3.0,2620,35124,2.0,0,0,2,9,2620,0,1987,0.0,98092,47.3067,-122.116,2920,35807,32504,0.9254071290285845,6864400,1233695376,1226830976
1260000.0,4,2.5,3150,13700,2.0,0,0,3,9,3150,0,1966,0.0,98040,47.5309,-122.22399999999999,3200,11900,10550,0.7700729927007299,9922500,187690000,177767500
642000.0,3,1.0,1040,4480,1.0,0,0,2,7,870,170,1924,0.0,98109,47.6461,-122.35600000000001,1730,4200,3440,0.7678571428571429,1081600,20070400,18988800
520000.0,3,1.75,1540,7558,1.0,0,0,2,8,1540,0,1964,0.0,98052,47.6707,-122.156,1540,7863,6018,0.79624239216724,2371600,57123364,54751764
750000.0,3,2.0,1820,5000,1.5,0,0,3,8,1720,100,1941,0.0,98116,47.5845,-122.395,2220,7200,3180,0.636,3312400,25000000,21687600
855000.0,5,1.5,1930,4500,1.5,0,0,2,8,1930,0,1929,0.0,98112,47.6401,-122.303,2083,4500,2570,0.5711111111111111,3724900,20250000,16525100
275000.0,4,1.0,1430,27153,1.5,0,0,3,5,1430,0,1934,0.0,98065,47.5372,-121.744,1880,27153,25723,0.9473354693772327,2044900,737285409,735240509
265000.0,5,2.75,2920,5250,1.5,0,0,4,7,1800,1120,1911,0.0,98002,47.3072,-122.221,1220,5250,2330,0.4438095238095238,8526400,27562500,19036100
894400.0,3,2.5,3100,45738,2.0,0,0,2,10,3100,0,1991,0.0,98053,47.6854,-122.04799999999999,3340,45738,42638,0.9322226594953867,9610000,2091964644,2082354644
546000.0,2,1.0,1200,12856,1.0,0,0,3,6,1200,0,1948,0.0,98027,47.5321,-122.03399999999999,1740,6098,11656,0.9066583696328563,1440000,165276736,163836736
699950.0,2,2.5,2390,7489,1.0,0,0,2,8,2390,0,2007,0.0,98053,47.7243,-122.03200000000001,2170,7489,5099,0.6808652690612899,5712100,56085121,50373021
435000.0,3,2.0,1270,10713,1.0,0,0,3,7,1270,0,1969,0.0,98034,47.7247,-122.181,1620,8250,9443,0.8814524409595819,1612900,114768369,113155469
259500.0,4,1.5,1300,7200,1.0,0,0,3,7,1300,0,1970,0.0,98031,47.4179,-122.181,1420,7200,5900,0.8194444444444444,1690000,51840000,50150000
359950.0,4,3.25,2290,4785,2.0,0,0,2,9,2290,0,2007,0.0,98038,47.3833,-122.037,2290,4785,2495,0.5214211076280042,5244100,22896225,17652125
517000.0,3,1.75,1740,10000,1.0,0,0,2,7,1740,0,1976,2009.0,98074,47.617,-122.05799999999999,1350,7500,8260,0.826,3027600,100000000,96972400
579000.0,3,1.0,1590,5400,1.0,0,1,2,8,1280,310,1948,0.0,98118,47.5509,-122.26100000000001,2140,7161,3810,0.7055555555555556,2528100,29160000,26631900
525000.0,4,2.0,2420,10735,1.5,0,0,2,7,2420,0,1967,0.0,98052,47.6899,-122.12200000000001,1570,9540,8315,0.7745691662785282,5856400,115240225,109383825
320000.0,4,2.5,2130,9653,1.0,0,0,2,7,1500,630,1978,0.0,98031,47.4068,-122.175,2000,7988,7523,0.7793432093649643,4536900,93180409,88643509
635000.0,4,1.75,1950,13320,1.0,0,0,3,8,1370,580,1969,0.0,98007,47.6196,-122.139,2120,12051,11370,0.8536036036036037,3802500,177422400,173619900
400000.0,4,2.5,2150,5397,2.0,0,0,2,8,2150,0,1998,0.0,98058,47.4644,-122.15100000000001,2260,5080,3247,0.6016305354826755,4622500,29127609,24505109
455000.0,3,1.75,1270,7700,1.0,0,0,3,7,1270,0,1968,0.0,98052,47.6711,-122.148,1510,7700,6430,0.8350649350649351,1612900,59290000,57677100
572000.0,3,1.75,1850,22767,1.5,0,4,4,6,1850,0,1908,0.0,98074,47.6144,-122.06700000000001,2700,17906,20917,0.9187420389159748,3422500,518336289,514913789
650000.0,2,1.5,1440,136778,1.0,0,0,3,8,1140,300,1956,0.0,98072,47.7608,-122.118,1740,21600,135338,0.9894719911096814,2073600,18708221284,18706147684
162500.0,3,1.5,1390,7417,1.0,0,0,2,7,1390,0,1967,0.0,98001,47.3369,-122.275,1390,7665,6027,0.81259269246326,1932100,55011889,53079789
400000.0,2,2.5,1340,1240,2.0,0,0,2,8,1150,190,2008,0.0,98052,47.6858,-122.102,1280,1312,-100,-0.08064516129032258,1795600,1537600,-258000
268300.0,3,1.0,1190,9000,1.0,0,0,2,7,1190,0,1968,0.0,98028,47.77,-122.264,1960,7200,7810,0.8677777777777778,1416100,81000000,79583900
989000.0,6,4.5,3830,4800,3.0,0,0,2,9,3050,780,1919,2004.0,98119,47.6404,-122.361,1990,4800,970,0.20208333333333334,14668900,23040000,8371100
342000.0,3,1.75,1780,10409,1.0,0,0,2,7,1280,500,1981,0.0,98058,47.4627,-122.16799999999999,1780,7415,8629,0.8289941396868095,3168400,108347281,105178881
315000.0,4,2.5,3130,5999,2.0,0,0,2,7,3130,0,2006,0.0,98042,47.3837,-122.09899999999999,3020,5997,2869,0.47824637439573264,9796900,35988001,26191101
485000.0,4,2.75,1830,8384,1.0,0,0,2,7,1320,510,1979,0.0,98034,47.733000000000004,-122.22,2190,7695,6554,0.7817270992366412,3348900,70291456,66942556
277500.0,4,2.5,2550,7500,1.0,0,0,2,8,1750,800,1976,0.0,98023,47.3165,-122.38600000000001,2260,8800,4950,0.66,6502500,56250000,49747500
1300000.0,4,3.5,3790,90169,2.0,0,0,2,11,3790,0,1998,0.0,98053,47.6587,-122.022,3410,46951,86379,0.9579678159899744,14364100,8130448561,8116084461
385000.0,4,1.75,1800,10890,1.5,0,0,3,6,1800,0,1912,0.0,98027,47.5312,-122.04,1530,9818,9090,0.8347107438016529,3240000,118592100,115352100
426000.0,2,1.0,1630,7680,1.0,0,0,2,7,830,800,1947,0.0,98125,47.7092,-122.291,1250,7740,6050,0.7877604166666666,2656900,58982400,56325500
310000.0,4,2.0,1870,6000,1.5,0,0,2,7,1870,0,1956,0.0,98125,47.7155,-122.315,1520,7169,4130,0.6883333333333334,3496900,36000000,32503100
449000.0,4,2.0,1870,6000,1.5,0,0,2,7,1870,0,1956,0.0,98125,47.7155,-122.315,1520,7169,4130,0.6883333333333334,3496900,36000000,32503100
375000.0,2,1.0,980,3915,1.0,0,0,3,7,980,0,1919,0.0,98118,47.5589,-122.29,1425,1576,2935,0.7496807151979565,960400,15327225,14366825
1190000.0,3,2.25,2860,10625,1.0,0,4,2,10,1920,940,1976,0.0,98115,47.6915,-122.273,2860,8075,7765,0.7308235294117648,8179600,112890625,104711025
468000.0,3,2.25,1470,5597,2.0,0,0,2,7,1470,0,1985,0.0,98029,47.5674,-122.01899999999999,1610,5217,4127,0.737359299624799,2160900,31326409,29165509
336000.0,1,1.0,1160,5000,2.0,0,0,2,7,1160,0,2000,0.0,98144,47.5883,-122.311,2060,5000,3840,0.768,1345600,25000000,23654400
392000.0,4,2.75,1940,6555,2.0,0,0,2,8,1940,0,1990,0.0,98038,47.3701,-122.041,1840,6912,4615,0.704042715484363,3763600,42968025,39204425
412500.0,4,2.25,1630,7969,1.0,0,0,2,7,1100,530,1977,0.0,98034,47.7336,-122.19,1580,7440,6339,0.7954573974149831,2656900,63504961,60848061
545000.0,4,2.5,2755,11612,2.0,0,0,2,8,2755,0,2001,0.0,98019,47.7394,-121.965,2820,12831,8857,0.7627454357561143,7590025,134838544,127248519
133000.0,5,2.0,1430,5600,1.5,0,0,2,6,1430,0,1947,0.0,98118,47.5192,-122.266,1860,5980,4170,0.7446428571428572,2044900,31360000,29315100
440000.0,5,2.0,1430,5600,1.5,0,0,2,6,1430,0,1947,0.0,98118,47.5192,-122.266,1860,5980,4170,0.7446428571428572,2044900,31360000,29315100
294450.0,4,2.25,1400,7341,1.0,0,0,2,7,1300,100,1961,0.0,98155,47.7565,-122.305,2090,7410,5941,0.8092902874267811,1960000,53890281,51930281
335000.0,4,2.5,2520,7205,2.0,0,0,2,8,2520,0,1987,0.0,98003,47.343,-122.316,2350,7632,4685,0.6502428868841083,6350400,51912025,45561625
362000.0,3,1.0,1290,10125,1.0,0,0,3,7,1290,0,1956,0.0,98028,47.7641,-122.265,1760,14460,8835,0.8725925925925926,1664100,102515625,100851525
322000.0,3,1.75,1400,18002,1.0,0,0,2,6,1400,0,1977,0.0,98019,47.725,-121.96700000000001,2240,14068,16602,0.9222308632374181,1960000,324072004,322112004
230500.0,2,1.0,740,8853,1.0,0,0,2,6,740,0,1943,0.0,98166,47.4793,-122.336,850,8775,8113,0.9164125155314583,547600,78375609,77828009
380000.0,4,2.0,1710,9996,1.0,0,0,2,7,1710,0,1950,0.0,98108,47.5472,-122.3,1550,6768,8286,0.8289315726290516,2924100,99920016,96995916
292000.0,4,2.75,2414,7693,2.0,0,0,2,8,2414,0,2006,0.0,98002,47.3046,-122.22200000000001,1500,7177,5279,0.6862082412582867,5827396,59182249,53354853
172500.0,3,1.0,1040,7500,1.0,0,0,3,6,1040,0,1954,0.0,98198,47.4206,-122.316,1270,8000,6460,0.8613333333333333,1081600,56250000,55168400
784000.0,4,2.75,3540,7091,1.5,0,1,3,8,1970,1570,1947,0.0,98199,47.6467,-122.39399999999999,2200,6000,3551,0.5007756310816528,12531600,50282281,37750681
525000.0,4,2.75,2530,11549,1.0,0,0,2,7,1700,830,1942,0.0,98033,47.6557,-122.197,2530,10000,9019,0.7809334141484111,6400900,133379401,126978501
600000.0,3,2.5,2320,7609,2.0,0,0,2,8,2320,0,2003,0.0,98027,47.5391,-122.069,2590,4000,5289,0.6950979103692995,5382400,57896881,52514481
435000.0,3,2.5,2530,16102,2.0,0,0,2,9,2530,0,1989,0.0,98038,47.371,-122.055,2370,14957,13572,0.8428766612843125,6400900,259274404,252873504
359900.0,5,2.75,2790,7600,1.5,0,0,3,7,2790,0,1965,0.0,98056,47.4999,-122.165,1480,7600,4810,0.6328947368421053,7784100,57760000,49975900
700000.0,4,1.75,1950,7139,1.0,1,4,2,7,1150,800,1957,0.0,98178,47.5121,-122.24799999999999,1600,13122,5189,0.7268525003501891,3802500,50965321,47162821
280000.0,3,2.0,1020,889,2.0,0,0,2,7,720,300,2009,0.0,98126,47.5434,-122.375,1130,972,-131,-0.14735658042744657,1040400,790321,-250079
655000.0,4,2.5,3110,24466,2.0,0,0,2,9,3110,0,1997,0.0,98059,47.4898,-122.12700000000001,3080,22185,21356,0.872884819749857,9672100,598585156,588913056
2480000.0,4,5.0,5310,16909,1.0,0,4,2,12,3090,2220,1992,0.0,98006,47.5515,-122.113,5220,15701,11599,0.6859660535809332,28196100,285914281,257718181
499950.0,3,2.5,2580,23925,2.0,0,0,2,9,2580,0,2001,0.0,98023,47.2978,-122.376,1660,8460,21345,0.8921630094043888,6656400,572405625,565749225
540000.0,3,2.5,1380,1021,2.0,0,0,2,8,1160,220,2008,0.0,98122,47.6148,-122.309,1440,1021,-359,-0.3516160626836435,1904400,1042441,-861959
970000.0,4,2.75,3980,9209,2.0,0,0,2,11,3980,0,2002,0.0,98074,47.6286,-122.064,3800,9333,5229,0.5678140949071561,15840400,84805681,68965281
330000.0,4,2.5,2080,7000,1.0,0,0,3,8,1400,680,1989,0.0,98058,47.4252,-122.163,2090,7082,4920,0.7028571428571428,4326400,49000000,44673600
474000.0,3,1.75,1530,8000,2.0,0,0,2,7,1530,0,1978,0.0,98052,47.6971,-122.13,1530,7500,6470,0.80875,2340900,64000000,61659100
670000.0,4,1.75,1930,9310,1.0,0,0,3,9,1930,0,1968,0.0,98008,47.6158,-122.10799999999999,2110,10290,7380,0.7926960257787325,3724900,86676100,82951200
1300000.0,4,3.25,2330,9687,2.0,0,3,2,9,2330,0,1918,0.0,98112,47.6264,-122.28299999999999,3880,9017,7357,0.759471456591308,5428900,93837969,88409069
1160000.0,4,2.5,3860,10361,2.0,0,2,3,10,2940,920,1985,0.0,98006,47.5517,-122.147,3720,13155,6501,0.6274490879258758,14899600,107350321,92450721
440000.0,4,2.5,2880,8061,2.0,0,0,2,9,2880,0,1988,0.0,98058,47.43899999999999,-122.152,2650,7660,5181,0.6427242277633048,8294400,64979721,56685321
411000.0,2,2.5,1590,2088,2.0,0,0,2,9,1590,0,1997,0.0,98033,47.6897,-122.175,2320,3174,498,0.23850574712643677,2528100,4359744,1831644
500000.0,3,1.5,2150,4000,1.5,0,0,2,7,1470,680,1928,0.0,98144,47.5733,-122.31200000000001,1750,4000,1850,0.4625,4622500,16000000,11377500
1340000.0,4,1.75,2300,13342,1.5,1,4,2,7,2300,0,1934,1958.0,98125,47.7308,-122.28200000000001,2500,13342,11042,0.827612052166092,5290000,178008964,172718964
696000.0,6,3.25,2900,6400,2.0,0,0,3,8,2300,600,1977,0.0,98199,47.6464,-122.40100000000001,2480,6400,3500,0.546875,8410000,40960000,32550000
465000.0,3,2.25,1970,11088,1.0,0,0,3,8,1180,790,1967,0.0,98155,47.7651,-122.277,1970,10470,9118,0.8223304473304474,3880900,122943744,119062844
518000.0,4,2.5,1740,7500,1.0,0,0,3,7,1220,520,1976,0.0,98052,47.6927,-122.124,1790,7350,5760,0.768,3027600,56250000,53222400
251000.0,3,1.75,1220,7250,1.0,0,0,2,7,1220,0,1962,0.0,98045,47.4887,-121.78399999999999,1700,15251,6030,0.8317241379310345,1488400,52562500,51074100
255000.0,3,2.0,1290,13282,1.0,0,0,2,7,1290,0,1978,0.0,98030,47.3787,-122.169,1290,12357,11992,0.9028760728805902,1664100,176411524,174747424
319000.0,2,1.0,780,8271,1.0,0,0,3,6,780,0,1924,0.0,98115,47.7,-122.3,2220,8271,7491,0.9056945955749003,608400,68409441,67801041
719000.0,4,2.75,2210,3400,1.5,0,0,4,7,1470,0,1926,0.0,98115,47.6826,-122.311,1500,3400,1190,0.35,4884100,11560000,6675900
1520000.0,5,3.5,5930,13288,2.0,0,2,2,11,3920,2010,1996,0.0,98027,47.5542,-122.09700000000001,3860,12062,7358,0.5537326911499096,35164900,176570944,141406044
322000.0,4,2.5,1950,4553,2.0,0,0,2,7,1950,0,2000,0.0,98056,47.5066,-122.175,1780,4598,2603,0.5717109598067208,3802500,20729809,16927309
205000.0,4,1.0,1340,7920,1.0,0,0,3,7,1340,0,1970,0.0,98001,47.2845,-122.26700000000001,1090,9600,6580,0.8308080808080808,1795600,62726400,60930800
229000.0,3,1.0,1590,6240,1.0,0,0,2,7,1060,530,1956,0.0,98146,47.4936,-122.337,1410,6240,4650,0.7451923076923077,2528100,38937600,36409500
395000.0,3,2.25,1780,9672,1.0,0,0,2,8,1350,430,1960,0.0,98133,47.7774,-122.35,1860,10080,7892,0.8159636062861869,3168400,93547584,90379184
183000.0,2,1.0,760,7272,1.0,0,0,3,7,760,0,1980,0.0,98003,47.3205,-122.33,1370,7866,6512,0.8954895489548955,577600,52881984,52304384
583500.0,3,1.75,1720,7800,1.0,0,0,3,7,1170,550,1978,0.0,98052,47.6928,-122.125,1760,7276,6080,0.7794871794871795,2958400,60840000,57881600
312000.0,3,2.5,2070,25710,1.0,0,0,4,6,2070,0,1917,0.0,98022,47.2032,-121.964,1350,17998,23640,0.9194865810968494,4284900,661004100,656719200
539000.0,3,1.75,1790,9860,1.0,0,0,3,7,1410,380,1978,0.0,98052,47.6989,-122.12,1820,9555,8070,0.8184584178498986,3204100,97219600,94015500
409000.0,4,2.75,3230,12651,2.0,0,0,3,8,3230,0,2002,0.0,98001,47.3157,-122.251,2550,12081,9421,0.7446842146865861,10432900,160047801,149614901
510250.0,3,1.75,1400,4000,1.0,0,0,2,7,870,530,1951,0.0,98117,47.6913,-122.381,1400,4000,2600,0.65,1960000,16000000,14040000
535000.0,2,2.0,1370,3827,1.0,0,0,2,7,1020,350,1952,0.0,98199,47.652,-122.404,1550,5102,2457,0.6420172458845048,1876900,14645929,12769029
280000.0,3,2.5,1600,7936,2.0,0,0,2,7,1600,0,1996,0.0,98038,47.3673,-122.01700000000001,1830,7936,6336,0.7983870967741935,2560000,62980096,60420096
286000.0,3,1.0,950,8400,1.0,0,0,2,7,950,0,1958,0.0,98056,47.5104,-122.166,1250,8400,7450,0.8869047619047619,902500,70560000,69657500
710000.0,3,2.75,2210,7660,1.0,0,1,3,7,1460,750,1968,0.0,98116,47.5619,-122.4,2110,8750,5450,0.7114882506527415,4884100,58675600,53791500
395000.0,2,1.0,930,6380,1.0,0,0,3,7,930,0,1940,0.0,98115,47.6915,-122.321,1180,6380,5450,0.85423197492163,864900,40704400,39839500
237500.0,2,1.0,810,8494,1.0,0,0,2,6,810,0,1949,0.0,98155,47.7389,-122.324,1050,7975,7684,0.9046385684012244,656100,72148036,71491936
464000.0,3,2.0,1630,6550,1.0,0,0,4,7,850,780,1912,0.0,98126,47.5452,-122.37899999999999,1440,6550,4920,0.751145038167939,2656900,42902500,40245600
495000.0,3,1.75,1770,10080,1.0,0,0,2,8,1770,0,1968,0.0,98125,47.7218,-122.306,1860,10456,8310,0.8244047619047619,3132900,101606400,98473500
257500.0,1,1.0,710,6060,1.0,0,0,3,6,710,0,1916,0.0,98118,47.5621,-122.28299999999999,1440,4545,5350,0.8828382838283828,504100,36723600,36219500
570000.0,4,3.5,3990,23544,1.0,0,2,2,10,2300,1690,1999,0.0,98023,47.3245,-122.38,3410,15932,19554,0.8305300713557594,15920100,554319936,538399836
362000.0,3,2.5,2310,7485,2.0,0,0,2,8,2310,0,1986,0.0,98058,47.43899999999999,-122.135,2310,8142,5175,0.6913827655310621,5336100,56025225,50689125
640000.0,3,1.75,1620,6000,1.0,0,0,4,7,1040,580,1947,0.0,98103,47.6878,-122.331,1330,4700,4380,0.73,2624400,36000000,33375600
172500.0,3,1.0,1140,8800,1.0,0,0,2,7,1140,0,1972,0.0,98001,47.2629,-122.275,1270,13560,7660,0.8704545454545455,1299600,77440000,76140400
596000.0,2,1.0,1040,4880,1.0,0,0,2,7,1040,0,1910,1975.0,98115,47.6809,-122.311,1500,4590,3840,0.7868852459016393,1081600,23814400,22732800
840000.0,4,2.5,2170,9796,1.0,0,0,3,8,1650,520,1980,0.0,98006,47.5505,-122.152,2350,9796,7626,0.7784810126582279,4708900,95961616,91252716
1600000.0,3,2.25,3370,23065,1.0,1,4,2,10,1920,1450,1980,0.0,98028,47.7434,-122.26299999999999,3410,19688,19695,0.8538911771081725,11356900,531994225,520637325
435000.0,2,1.5,901,1245,3.0,0,0,2,7,901,0,2001,0.0,98115,47.6774,-122.325,1138,1137,344,0.27630522088353415,811801,1550025,738224
251000.0,2,1.0,840,7870,1.0,0,0,2,6,840,0,1949,0.0,98155,47.7389,-122.32600000000001,1442,8131,7030,0.8932655654383735,705600,61936900,61231300
282500.0,4,1.0,1650,9750,1.0,0,0,3,7,1650,0,1964,0.0,98059,47.4991,-122.164,1650,10112,8100,0.8307692307692308,2722500,95062500,92340000
265000.0,3,2.25,1380,7226,1.0,0,0,3,7,1140,240,1987,0.0,98042,47.3677,-122.09100000000001,1640,7823,5846,0.8090229725989483,1904400,52215076,50310676
330000.0,3,1.0,910,10240,1.0,0,0,3,6,910,0,1969,0.0,98053,47.6729,-122.064,1140,10720,9330,0.9111328125,828100,104857600,104029500
435000.0,2,1.0,1230,3800,1.0,0,0,2,7,1230,0,1928,0.0,98115,47.6797,-122.292,1610,3800,2570,0.6763157894736842,1512900,14440000,12927100
827235.0,3,1.75,1740,8560,1.0,0,0,2,8,1500,240,1948,0.0,98199,47.6475,-122.40899999999999,2240,5800,6820,0.7967289719626168,3027600,73273600,70246000
249950.0,4,1.0,1290,5000,1.5,0,0,2,7,1290,0,1957,0.0,98146,47.51300000000001,-122.35799999999999,1440,2500,3710,0.742,1664100,25000000,23335900
400000.0,3,2.5,1950,18533,2.0,0,0,2,8,1950,0,1988,0.0,98024,47.5647,-121.90299999999999,1810,18401,16583,0.8947822802568391,3802500,343472089,339669589
300499.0,4,2.5,2150,7944,2.0,0,0,2,8,2150,0,1990,0.0,98092,47.25899999999999,-122.215,2170,8319,5794,0.7293554884189325,4622500,63107136,58484636
449000.0,4,2.0,1560,5220,1.0,0,0,2,7,1560,0,1959,0.0,98115,47.6905,-122.305,1300,5220,3660,0.7011494252873564,2433600,27248400,24814800
500000.0,2,1.0,1120,3220,1.0,0,0,3,7,1120,0,1923,0.0,98103,47.6588,-122.344,1440,3220,2100,0.6521739130434783,1254400,10368400,9114000
865000.0,3,1.5,1790,7526,1.0,0,0,2,7,1790,0,1953,2014.0,98004,47.6387,-122.20700000000001,2080,10943,5736,0.7621578527770396,3204100,56640676,53436576
899950.0,4,3.5,3290,5414,2.0,0,1,2,9,2360,930,2006,0.0,98034,47.7074,-122.219,1820,9609,2124,0.3923162172146287,10824100,29311396,18487296
370000.0,4,1.0,1540,9541,1.5,0,0,3,7,1540,0,1961,0.0,98034,47.7104,-122.213,1290,9541,8001,0.8385913426265591,2371600,91030681,88659081
442500.0,5,3.25,4240,226097,2.0,0,0,2,8,3410,830,1980,0.0,98053,47.6472,-122.01700000000001,2980,217800,221857,0.9812469869126967,17977600,51119853409,51101875809
310000.0,3,1.0,1010,9945,1.0,0,0,3,6,1010,0,1973,0.0,98065,47.5324,-121.76299999999999,1390,12710,8935,0.8984414278531926,1020100,98903025,97882925
1570000.0,4,2.75,2970,12750,1.5,0,1,3,7,2130,840,1918,0.0,98004,47.6135,-122.213,1980,15300,9780,0.7670588235294118,8820900,162562500,153741600
245000.0,4,2.25,2190,9113,2.0,0,0,2,7,2190,0,1986,0.0,98001,47.3241,-122.275,1570,8306,6923,0.7596839679578624,4796100,83046769,78250669
254950.0,2,1.0,700,8100,1.0,0,0,2,6,700,0,1949,0.0,98155,47.7492,-122.311,1230,8100,7400,0.9135802469135802,490000,65610000,65120000
510000.0,6,4.5,3300,7480,2.0,0,0,2,8,3300,0,1980,0.0,98052,47.6796,-122.104,2470,7561,4180,0.5588235294117647,10890000,55950400,45060400
299950.0,3,2.25,1370,5000,2.0,0,0,2,7,1370,0,1990,0.0,98019,47.7372,-121.98100000000001,1600,7724,3630,0.726,1876900,25000000,23123100
379950.0,4,2.5,2680,4500,2.0,0,0,2,8,2680,0,2011,0.0,98038,47.3561,-122.056,2010,4500,1820,0.40444444444444444,7182400,20250000,13067600
350000.0,3,1.0,1390,4820,1.0,0,0,3,7,910,480,1926,0.0,98133,47.70399999999999,-122.34299999999999,1320,4820,3430,0.7116182572614108,1932100,23232400,21300300
300000.0,3,2.5,1700,3575,2.0,0,0,2,7,1700,0,2000,0.0,98108,47.5418,-122.295,1590,3380,1875,0.5244755244755245,2890000,12780625,9890625
994000.0,3,2.25,2510,6339,1.5,0,2,4,8,1810,700,1932,0.0,98199,47.6496,-122.391,1820,5741,3829,0.6040384918756901,6300100,40182921,33882821
315000.0,3,1.5,1700,8067,1.0,0,0,2,7,1250,450,1956,0.0,98155,47.7384,-122.324,1340,7869,6367,0.7892649064088261,2890000,65076489,62186489
480500.0,4,2.5,2180,11200,1.0,0,0,3,8,2180,0,1968,0.0,98072,47.7476,-122.086,1790,11200,9020,0.8053571428571429,4752400,125440000,120687600
373000.0,3,1.0,1770,5720,1.5,0,0,3,7,1140,630,1926,0.0,98126,47.5546,-122.37700000000001,1500,4406,3950,0.6905594405594405,3132900,32718400,29585500
728000.0,4,2.5,3290,5951,2.0,0,0,2,9,3290,0,2003,0.0,98075,47.5999,-121.976,3240,6159,2661,0.4471517392034952,10824100,35414401,24590301
415000.0,4,3.5,3040,7125,2.0,0,1,2,8,2240,800,2002,0.0,98178,47.492,-122.225,2220,7800,4085,0.5733333333333334,9241600,50765625,41524025
427500.0,4,2.5,2460,5091,2.0,0,0,2,9,2460,0,2003,0.0,98058,47.45,-122.12100000000001,2490,4750,2631,0.5167943429581615,6051600,25918281,19866681
339300.0,3,2.0,970,10000,1.0,0,0,4,7,970,0,1972,0.0,98074,47.6205,-122.06299999999999,1230,7500,9030,0.903,940900,100000000,99059100
313000.0,3,1.75,1320,6205,1.0,0,0,4,7,1320,0,1948,0.0,98133,47.7412,-122.34299999999999,1210,6205,4885,0.7872683319903304,1742400,38502025,36759625
431500.0,3,3.5,1900,1612,2.0,0,0,2,8,1430,470,2008,0.0,98136,47.544,-122.385,1780,1525,-288,-0.17866004962779156,3610000,2598544,-1011456
415000.0,3,1.5,1220,835,1.5,0,0,3,6,1220,0,1950,0.0,98103,47.6981,-122.34100000000001,1360,1251,-385,-0.46107784431137727,1488400,697225,-791175
490000.0,3,1.75,1470,9750,1.0,0,0,3,7,1470,0,1978,0.0,98052,47.6975,-122.12,1800,9600,8280,0.8492307692307692,2160900,95062500,92901600
1430000.0,4,5.0,4630,24054,2.0,0,3,2,11,4630,0,2005,0.0,98075,47.586999999999996,-121.96600000000001,4630,17584,19424,0.8075164213852166,21436900,578594916,557158016
275000.0,3,1.5,1400,9750,1.0,0,0,3,6,1400,0,1964,0.0,98030,47.3768,-122.17,1160,9750,8350,0.8564102564102564,1960000,95062500,93102500
325000.0,2,1.0,1070,5080,1.0,0,0,4,6,1070,0,1942,0.0,98106,47.5224,-122.35,900,5080,4010,0.7893700787401575,1144900,25806400,24661500
1180000.0,5,3.75,3630,6000,1.5,0,0,2,9,2470,1160,2004,0.0,98033,47.6816,-122.199,2560,7560,2370,0.395,13176900,36000000,22823100
690000.0,4,1.5,1970,4590,2.5,0,0,2,7,1970,0,1909,0.0,98103,47.666000000000004,-122.33200000000001,1900,4590,2620,0.5708061002178649,3880900,21068100,17187200
410000.0,4,2.0,2010,9474,2.0,0,0,2,7,2010,0,1953,2003.0,98166,47.4234,-122.34200000000001,2140,10164,7464,0.7878404053198227,4040100,89756676,85716576
960000.0,4,2.5,2820,5934,1.0,0,3,4,9,1770,1050,1952,0.0,98116,47.5706,-122.40299999999999,2230,6000,3114,0.5247724974721941,7952400,35212356,27259956
299250.0,3,2.5,2530,8669,2.0,0,0,2,9,2530,0,1990,0.0,98023,47.3073,-122.395,2530,9469,6139,0.70815549659707,6400900,75151561,68750661
239000.0,2,1.0,710,14000,1.0,0,0,3,6,710,0,1953,0.0,98166,47.4379,-122.337,1500,10540,13290,0.9492857142857143,504100,196000000,195495900
235000.0,2,1.0,1210,9400,1.0,0,0,1,6,1210,0,1949,0.0,98106,47.5342,-122.36,1580,6026,8190,0.8712765957446809,1464100,88360000,86895900
587000.0,3,2.25,2370,217800,2.0,0,0,2,7,2370,0,1979,0.0,98053,47.6364,-121.984,3100,86248,215430,0.9891184573002755,5616900,47436840000,47431223100
431000.0,4,2.5,2300,6087,2.0,0,0,2,7,2300,0,2001,0.0,98056,47.5125,-122.19200000000001,1770,5907,3787,0.6221455561031707,5290000,37051569,31761569
1640000.0,3,2.5,3110,6765,2.0,0,1,3,9,2550,560,1946,0.0,98115,47.6886,-122.27600000000001,2630,7626,3655,0.5402808573540281,9672100,45765225,36093125
285000.0,3,1.75,1990,6500,1.0,0,0,2,7,1090,900,1961,0.0,98055,47.488,-122.221,2150,6500,4510,0.6938461538461539,3960100,42250000,38289900
778000.0,3,3.0,2630,10156,1.0,0,0,3,9,2630,0,1987,0.0,98006,47.5481,-122.156,2660,10455,7526,0.7410397794407247,6916900,103144336,96227436
415000.0,3,1.0,1300,7975,1.0,0,0,3,7,1300,0,1958,0.0,98008,47.611000000000004,-122.12200000000001,1570,9075,6675,0.8369905956112853,1690000,63600625,61910625
550285.0,2,1.75,1680,4500,1.0,0,0,2,8,1680,0,2004,0.0,98053,47.7132,-122.03200000000001,1670,4500,2820,0.6266666666666667,2822400,20250000,17427600
910000.0,3,2.25,2180,9865,1.0,0,0,3,8,1660,0,1966,0.0,98040,47.5358,-122.235,2600,10034,7685,0.7790167257982767,4752400,97318225,92565825
860000.0,3,2.5,2770,9136,2.0,0,0,2,10,2770,0,1991,0.0,98006,47.5605,-122.115,2890,8442,6366,0.6968038528896673,7672900,83466496,75793596
765000.0,3,1.75,2120,5000,2.0,0,0,2,7,1980,140,1920,2010.0,98103,47.6666,-122.331,2020,5000,2880,0.576,4494400,25000000,20505600
782000.0,4,2.5,2830,20345,2.0,0,0,2,10,1980,850,1979,0.0,98004,47.6462,-122.191,2830,13732,17515,0.8608994839026788,8008900,413919025,405910125
525000.0,3,3.5,1370,1764,2.0,0,0,2,8,1180,190,2000,0.0,98119,47.6511,-122.368,1400,1398,394,0.2233560090702948,1876900,3111696,1234796
745000.0,3,2.5,2810,435600,2.0,0,0,2,9,2810,0,1995,0.0,98045,47.4816,-121.70100000000001,2380,92007,432790,0.9935491276400368,7896100,189747360000,189739463900
470000.0,3,3.5,3520,35512,2.0,0,2,2,8,2760,760,2005,0.0,98022,47.2416,-121.979,2860,39614,31992,0.9008785762559135,12390400,1261102144,1248711744
345000.0,3,1.75,1990,5650,1.0,0,1,2,7,1320,670,1963,0.0,98178,47.5086,-122.25200000000001,2130,5650,3660,0.647787610619469,3960100,31922500,27962400
279000.0,3,2.25,2070,7800,1.0,0,0,2,7,1170,900,1964,0.0,98003,47.3431,-122.305,1570,8400,5730,0.7346153846153847,4284900,60840000,56555100
500000.0,3,1.5,1320,8100,1.0,0,0,3,7,1320,0,1951,0.0,98177,47.7194,-122.37100000000001,1480,8100,6780,0.837037037037037,1742400,65610000,63867600
237000.0,3,1.0,1300,8160,1.0,0,0,3,7,1300,0,1960,0.0,98056,47.511,-122.17200000000001,1290,8970,6860,0.8406862745098039,1690000,66585600,64895600
200500.0,3,1.75,1260,9346,1.0,0,0,3,7,1260,0,1963,0.0,98030,47.3713,-122.186,1800,9705,8086,0.8651829659747485,1587600,87347716,85760116
387500.0,4,1.75,2400,9900,1.0,0,0,2,7,1250,1150,1957,0.0,98166,47.4631,-122.36200000000001,1960,9900,7500,0.7575757575757576,5760000,98010000,92250000
392500.0,4,2.0,1950,8040,1.0,0,0,2,7,1950,0,1961,0.0,98125,47.7074,-122.29,1950,8092,6090,0.7574626865671642,3802500,64641600,60839100
305000.0,3,2.0,1430,12430,1.0,0,0,3,7,1430,0,1957,0.0,98056,47.4903,-122.178,1200,8250,11000,0.8849557522123894,2044900,154504900,152460000
981000.0,4,2.5,2110,10100,1.0,0,2,2,8,2110,0,1968,2005.0,98006,47.567,-122.15100000000001,2230,10100,7990,0.7910891089108911,4452100,102010000,97557900
680000.0,4,2.5,2980,8770,2.0,0,0,2,10,2980,0,1990,0.0,98075,47.5814,-122.029,2940,9238,5790,0.6602052451539339,8880400,76912900,68032500
276000.0,4,2.5,2068,7242,2.0,0,0,3,7,2068,0,1976,0.0,98001,47.3318,-122.281,1560,7524,5174,0.7144435238884286,4276624,52446564,48169940
655500.0,4,3.5,3380,8330,2.0,0,0,2,8,3380,0,2000,0.0,98177,47.7741,-122.37899999999999,2220,8330,4950,0.5942376950780313,11424400,69388900,57964500
555000.0,5,2.75,2810,13144,1.0,0,0,2,8,1440,1370,1964,0.0,98007,47.6199,-122.141,2480,13144,10334,0.7862142422398052,7896100,172764736,164868636
235000.0,2,1.0,930,10505,1.0,0,0,2,6,930,0,1930,0.0,98148,47.4337,-122.329,1520,8881,9575,0.9114707282246549,864900,110355025,109490125
325000.0,3,1.0,1300,8879,1.0,0,0,2,7,920,380,1950,0.0,98155,47.7465,-122.32600000000001,1530,6960,7579,0.8535871156661786,1690000,78836641,77146641
268950.0,3,1.0,1320,8100,1.0,0,0,2,6,880,440,1943,0.0,98166,47.4697,-122.351,1000,8100,6780,0.837037037037037,1742400,65610000,63867600
264500.0,3,1.5,1580,14040,1.0,0,0,2,7,1050,530,1980,0.0,98001,47.2932,-122.26700000000001,2240,12000,12460,0.8874643874643875,2496400,197121600,194625200
240000.0,3,2.5,1620,5250,2.0,0,0,2,8,1620,0,1987,0.0,98003,47.3538,-122.301,1650,5250,3630,0.6914285714285714,2624400,27562500,24938100
819000.0,3,2.5,2750,226512,2.0,0,0,2,9,2750,0,2000,0.0,98070,47.4376,-122.456,1250,211266,223762,0.9878593628593628,7562500,51307686144,51300123644
850000.0,2,1.5,2210,5000,1.0,0,2,2,8,1530,680,1951,0.0,98122,47.6122,-122.288,2700,5000,2790,0.558,4884100,25000000,20115900
294950.0,4,2.25,1740,9600,1.0,0,2,2,7,1160,580,1957,0.0,98188,47.431999999999995,-122.27600000000001,1630,9600,7860,0.81875,3027600,92160000,89132400
693000.0,3,2.25,2120,13644,2.0,0,0,3,9,1420,700,1973,0.0,98040,47.5574,-122.214,2950,17060,11524,0.8446203459396071,4494400,186158736,181664336
478000.0,4,2.5,2780,7290,2.0,0,0,2,8,2780,0,1989,0.0,98059,47.50899999999999,-122.15700000000001,2450,7738,4510,0.6186556927297668,7728400,53144100,45415700
222000.0,2,1.0,830,6893,1.0,0,0,2,7,830,0,1950,0.0,98125,47.7234,-122.32799999999999,1470,7200,6063,0.879587987813724,688900,47513449,46824549
635000.0,4,2.5,2070,11286,2.0,0,0,2,8,2070,0,1996,0.0,98056,47.5284,-122.17299999999999,2440,10826,9216,0.8165869218500797,4284900,127373796,123088896
469000.0,3,3.25,1390,1278,2.0,0,0,2,8,1140,250,2005,0.0,98107,47.6735,-122.375,1390,1256,-112,-0.08763693270735524,1932100,1633284,-298816
350000.0,4,2.5,2610,5866,2.0,0,0,2,8,2610,0,2005,0.0,98038,47.3441,-122.04,2480,5188,3256,0.5550630753494715,6812100,34409956,27597856
180000.0,5,1.0,1460,11726,1.5,0,0,2,6,1290,170,1936,0.0,98146,47.5039,-122.361,1460,10450,10266,0.8754903632952413,2131600,137499076,135367476
490000.0,4,2.25,3390,39356,1.0,0,0,3,8,1640,1750,1964,0.0,98027,47.46100000000001,-121.992,2160,38061,35966,0.9138631974794187,11492100,1548894736,1537402636
360000.0,3,1.5,1360,6000,1.0,0,0,2,6,860,500,1911,0.0,98103,47.6846,-122.345,1560,3000,4640,0.7733333333333333,1849600,36000000,34150400
630000.0,4,2.5,2807,9430,2.0,0,0,2,8,2807,0,1996,0.0,98028,47.7449,-122.223,2028,11056,6623,0.7023329798515376,7879249,88924900,81045651
615000.0,4,1.0,1340,2006,1.5,0,0,2,7,1340,0,1931,0.0,98119,47.6357,-122.37299999999999,2040,3625,666,0.3320039880358923,1795600,4024036,2228436
279950.0,3,2.25,1340,7202,2.0,0,0,3,7,1340,0,1989,0.0,98038,47.3563,-122.039,1470,7395,5862,0.8139405720633157,1795600,51868804,50073204
317000.0,3,1.0,1160,8813,1.0,0,0,2,7,1160,0,1952,0.0,98125,47.7257,-122.329,1200,7615,7653,0.8683762623397254,1345600,77668969,76323369
618000.0,4,2.25,2470,7350,1.0,0,0,2,7,1600,870,1978,0.0,98052,47.6936,-122.12799999999999,1970,7700,4880,0.6639455782312925,6100900,54022500,47921600
620000.0,5,1.75,2000,8713,1.0,0,2,2,7,1000,1000,1962,0.0,98008,47.5882,-122.117,2040,8449,6713,0.7704579364168483,4000000,75916369,71916369
345000.0,3,1.0,1110,6250,1.0,0,0,2,7,1110,0,1956,0.0,98115,47.6977,-122.292,2010,6944,5140,0.8224,1232100,39062500,37830400
608000.0,3,1.5,2240,3750,1.0,0,0,2,7,1220,1020,1952,0.0,98103,47.6624,-122.336,1570,3400,1510,0.4026666666666667,5017600,14062500,9044900
325000.0,4,2.25,1920,11603,2.0,0,0,3,7,1920,0,1967,0.0,98058,47.4315,-122.169,1840,7350,9683,0.8345255537361027,3686400,134629609,130943209
475000.0,3,1.75,2270,13000,1.0,0,0,4,8,2270,0,1968,0.0,98058,47.4474,-122.14399999999999,2440,10000,10730,0.8253846153846154,5152900,169000000,163847100
154000.0,3,3.0,1530,9997,1.0,0,0,2,6,1020,510,1992,0.0,98001,47.2861,-122.25200000000001,1410,9997,8467,0.8469540862258678,2340900,99940009,97599109
1190000.0,5,3.0,3330,19126,2.0,0,0,3,11,2610,720,1977,0.0,98040,47.5485,-122.214,3330,16893,15796,0.8258914566558612,11088900,365803876,354714976
376950.0,4,2.5,2643,5750,2.0,0,0,2,8,2643,0,2012,0.0,98030,47.3519,-122.17299999999999,2406,5772,3107,0.5403478260869565,6985449,33062500,26077051
500000.0,2,2.0,1250,3360,1.0,0,0,2,7,1250,0,1957,0.0,98103,47.6526,-122.34899999999999,1250,3360,2110,0.6279761904761905,1562500,11289600,9727100
499950.0,3,2.5,3230,129578,1.0,0,0,3,8,2100,1130,1964,0.0,98014,47.681999999999995,-121.913,2760,62059,126348,0.9750729290465974,10432900,16790458084,16780025184
230000.0,3,1.0,880,9035,1.0,0,0,3,6,880,0,1967,0.0,98059,47.476000000000006,-122.15100000000001,1440,10350,8155,0.902600996126176,774400,81631225,80856825
652600.0,4,2.5,2220,5900,2.0,0,0,2,8,2220,0,2014,0.0,98117,47.6956,-122.36,1620,5900,3680,0.6237288135593221,4928400,34810000,29881600
185000.0,3,1.75,1130,7000,1.0,0,0,2,7,1130,0,1978,0.0,98023,47.306999999999995,-122.37200000000001,1830,8880,5870,0.8385714285714285,1276900,49000000,47723100
274950.0,3,1.0,1450,8820,1.0,0,0,2,6,1050,400,1958,0.0,98168,47.4698,-122.264,1510,8820,7370,0.8356009070294784,2102500,77792400,75689900
447000.0,2,1.0,760,6035,1.0,0,0,2,6,760,0,1920,0.0,98136,47.5443,-122.382,2110,6046,5275,0.8740679370339686,577600,36421225,35843625
129000.0,2,1.0,1150,30184,1.0,0,0,2,6,1150,0,1950,0.0,98055,47.4492,-122.2,1670,19684,29034,0.9619003445534058,1322500,911073856,909751356
436000.0,5,3.0,2720,9856,2.0,0,0,3,8,2720,0,1969,0.0,98059,47.4778,-122.146,1420,9685,7136,0.724025974025974,7398400,97140736,89742336
825000.0,3,1.75,2080,5000,2.0,0,0,4,8,2080,0,1906,0.0,98103,47.6717,-122.35600000000001,1820,5000,2920,0.584,4326400,25000000,20673600
225000.0,3,1.0,1080,16000,1.0,0,0,2,6,1080,0,1952,0.0,98001,47.2873,-122.251,1610,10007,14920,0.9325,1166400,256000000,254833600
265000.0,3,2.5,1890,6088,2.0,0,0,2,7,1890,0,1996,0.0,98002,47.2886,-122.21799999999999,1700,6600,4198,0.6895532194480947,3572100,37063744,33491644
765000.0,3,1.5,1500,5111,2.0,0,0,4,8,1500,0,1984,0.0,98122,47.6118,-122.28399999999999,2380,4519,3611,0.7065153590295441,2250000,26122321,23872321
509000.0,4,2.0,1960,2166,1.5,0,0,3,7,1260,700,1926,0.0,98103,47.6545,-122.344,1670,4000,206,0.0951061865189289,3841600,4691556,849956
762450.0,4,1.75,2570,8640,1.0,0,0,3,8,2570,0,1958,0.0,98005,47.5956,-122.17200000000001,2520,8800,6070,0.7025462962962963,6604900,74649600,68044700
465000.0,5,1.5,1830,9000,1.0,0,2,2,7,1030,800,1955,0.0,98155,47.7488,-122.292,2610,11175,7170,0.7966666666666666,3348900,81000000,77651100
564000.0,3,1.75,1980,6250,1.0,0,1,4,7,1090,890,1910,0.0,98136,47.553999999999995,-122.385,1980,6250,4270,0.6832,3920400,39062500,35142100
384500.0,2,1.0,1130,5236,1.0,0,0,3,6,1130,0,1942,0.0,98146,47.5103,-122.38600000000001,1010,5320,4106,0.7841864018334607,1276900,27415696,26138796
415000.0,3,2.0,2010,33090,1.5,0,2,4,8,2010,0,1986,0.0,98022,47.2133,-122.007,1840,22620,31080,0.9392565729827742,4040100,1094948100,1090908000
345000.0,2,1.75,1820,8409,1.0,0,0,3,6,910,910,1948,0.0,98155,47.7538,-122.32700000000001,1300,8409,6589,0.7835652277321917,3312400,70711281,67398881
465950.0,4,2.5,2340,6896,2.0,0,0,2,7,2340,0,2001,0.0,98059,47.4896,-122.14,2950,6775,4556,0.6606728538283063,5475600,47554816,42079216
325000.0,3,1.75,1780,11096,1.0,0,0,2,7,1210,570,1979,0.0,98074,47.617,-122.051,1780,10640,9316,0.8395818312905552,3168400,123121216,119952816
500000.0,3,1.75,1780,11096,1.0,0,0,2,7,1210,570,1979,0.0,98074,47.617,-122.051,1780,10640,9316,0.8395818312905552,3168400,123121216,119952816
450000.0,4,2.5,2450,20348,1.0,0,0,2,8,1410,1040,1978,0.0,98075,47.5887,-122.064,2450,50094,17898,0.8795950461961863,6002500,414041104,408038604
475000.0,4,3.0,2410,8284,1.0,0,0,4,7,1210,1200,1969,0.0,98034,47.7202,-122.22,2050,7940,5874,0.7090777402221149,5808100,68624656,62816556
1350000.0,5,1.75,3380,20021,1.0,0,0,3,8,1690,1690,1963,0.0,98004,47.6395,-122.211,3260,19809,16641,0.8311772638729334,11424400,400840441,389416041
747000.0,3,1.5,1710,5120,2.0,0,0,3,7,1710,0,1920,0.0,98115,47.6801,-122.305,1530,5170,3410,0.666015625,2924100,26214400,23290300
395000.0,3,1.75,1740,6220,1.0,0,0,3,6,1740,0,1954,0.0,98177,47.762,-122.36200000000001,1630,8418,4480,0.7202572347266881,3027600,38688400,35660800
505000.0,3,2.5,1995,1483,3.0,0,0,2,8,1760,235,2005,0.0,98102,47.6025,-122.31,1520,1173,-512,-0.3452461227242077,3980025,2199289,-1780736
215000.0,3,2.0,1760,9282,1.0,0,0,4,7,1100,660,1947,0.0,98001,47.3413,-122.29,1730,7500,7522,0.8103856927386339,3097600,86155524,83057924
775000.0,4,3.5,3970,210830,2.0,0,0,2,9,3970,0,2000,0.0,98045,47.4614,-121.713,1680,42665,206860,0.9811696627614666,15760900,44449288900,44433528000
540000.0,4,2.5,3000,5471,2.0,0,0,2,8,3000,0,2013,0.0,98059,47.4797,-122.126,2730,5471,2471,0.4516541765673551,9000000,29931841,20931841
392500.0,3,1.75,1540,8925,1.0,0,0,3,7,1540,0,1957,0.0,98133,47.7762,-122.337,1620,10397,7385,0.8274509803921568,2371600,79655625,77284025
987000.0,3,2.0,2160,15788,1.0,0,0,2,8,2160,0,1951,0.0,98004,47.6227,-122.20700000000001,2260,9787,13628,0.8631872308082088,4665600,249260944,244595344
1190000.0,3,2.0,2160,15788,1.0,0,0,2,8,2160,0,1951,0.0,98004,47.6227,-122.20700000000001,2260,9787,13628,0.8631872308082088,4665600,249260944,244595344
252500.0,3,2.0,1810,10684,2.0,0,0,2,8,1810,0,1987,0.0,98058,47.4619,-122.15299999999999,2140,9657,8874,0.8305877948333957,3276100,114147856,110871756
730000.0,3,3.5,2440,3502,2.0,0,0,2,7,1970,470,2000,0.0,98005,47.589,-122.165,2440,3417,1062,0.30325528269560253,5953600,12264004,6310404
497300.0,6,2.75,3200,9200,1.0,0,2,3,8,1600,1600,1953,0.0,98146,47.492,-122.36399999999999,2220,9500,6000,0.6521739130434783,10240000,84640000,74400000
640000.0,4,2.5,2970,34981,2.0,0,0,2,9,2970,0,1998,0.0,98077,47.7365,-122.037,3170,30277,32011,0.9150967668162717,8820900,1223670361,1214849461
580000.0,5,2.0,2290,7125,1.0,0,0,2,7,1190,1100,1964,0.0,98008,47.63399999999999,-122.119,1460,7920,4835,0.6785964912280702,5244100,50765625,45521525
377000.0,3,1.75,1820,34800,1.0,0,0,3,6,1820,0,1967,0.0,98027,47.4616,-121.98,2570,52707,32980,0.9477011494252874,3312400,1211040000,1207727600
1280000.0,4,3.5,3010,3600,2.0,0,0,2,9,2370,640,1999,0.0,98112,47.6341,-122.28399999999999,2650,4200,590,0.1638888888888889,9060100,12960000,3899900
396500.0,3,1.5,1360,1488,2.0,0,0,2,7,1120,240,2003,0.0,98199,47.6526,-122.384,1360,1573,128,0.08602150537634409,1849600,2214144,364544
300000.0,4,2.5,2080,2999,2.0,0,0,2,8,2080,0,1998,0.0,98059,47.4909,-122.15700000000001,1630,3148,919,0.3064354784928309,4326400,8994001,4667601
532000.0,3,1.0,1110,4800,1.5,0,0,2,7,1110,0,1946,0.0,98117,47.6857,-122.37799999999999,1510,4320,3690,0.76875,1232100,23040000,21807900
579000.0,2,1.75,1560,4500,1.0,0,0,2,8,1560,0,2004,0.0,98053,47.7128,-122.03200000000001,1860,4500,2940,0.6533333333333333,2433600,20250000,17816400
1400000.0,4,2.5,3520,7815,2.0,0,3,2,10,3140,380,1929,0.0,98199,47.6429,-122.412,2790,6644,4295,0.5495841330774153,12390400,61074225,48683825
571000.0,5,1.75,2280,43560,1.0,0,1,3,8,1380,900,1949,0.0,98166,47.4558,-122.36200000000001,1940,17664,41280,0.9476584022038568,5198400,1897473600,1892275200
301950.0,3,1.75,1370,9288,1.0,0,0,3,7,1370,0,1988,0.0,98059,47.4824,-122.152,1500,9864,7918,0.8524978466838932,1876900,86266944,84390044
660000.0,3,3.0,2340,2970,2.0,0,0,4,8,2160,180,1925,0.0,98103,47.6868,-122.348,1370,4000,630,0.21212121212121213,5475600,8820900,3345300
455000.0,4,2.5,3170,10688,2.0,0,2,2,9,3170,0,2001,0.0,98001,47.3179,-122.257,3100,12610,7518,0.7034056886227545,10048900,114233344,104184444
375000.0,3,1.75,1380,5060,1.0,0,0,2,7,1380,0,1986,0.0,98133,47.7059,-122.34100000000001,1030,5060,3680,0.7272727272727273,1904400,25603600,23699200
470000.0,4,2.5,2700,6769,2.0,0,0,2,9,2700,0,1999,0.0,98042,47.3753,-122.155,2880,7968,4069,0.6011227655488255,7290000,45819361,38529361
374990.0,3,2.5,1300,10484,2.0,0,0,2,8,1300,0,1983,0.0,98028,47.7768,-122.26799999999999,1380,7868,9184,0.876001526135063,1690000,109914256,108224256
541500.0,2,2.5,1900,3690,2.0,0,0,2,8,1900,0,2006,0.0,98053,47.7082,-122.01899999999999,1900,5153,1790,0.48509485094850946,3610000,13616100,10006100
782500.0,3,2.5,3750,7821,2.0,0,0,2,9,3750,0,2001,0.0,98074,47.6325,-122.064,3210,8405,4071,0.5205216724204066,14062500,61168041,47105541
264000.0,3,2.25,1552,3677,2.0,0,0,2,7,1552,0,2012,0.0,98092,47.3205,-122.178,1677,3677,2125,0.5779167799836824,2408704,13520329,11111625
640000.0,4,2.5,2500,7417,2.0,0,0,2,9,2500,0,1991,0.0,98074,47.6251,-122.02600000000001,2770,8188,4917,0.6629364972360793,6250000,55011889,48761889
660000.0,3,2.0,1770,8141,1.0,0,0,4,8,1770,0,1952,0.0,98177,47.7232,-122.37100000000001,1770,8100,6371,0.782581992384228,3132900,66275881,63142981
1370000.0,5,3.5,4210,17258,2.0,0,3,2,12,4210,0,1995,0.0,98006,47.553000000000004,-122.11399999999999,4630,17909,13048,0.7560551628230386,17724100,297838564,280114464
389950.0,3,2.5,2170,8140,2.0,0,0,2,9,2170,0,1994,0.0,98030,47.385,-122.169,2390,8100,5970,0.7334152334152334,4708900,66259600,61550700
226000.0,2,1.0,1510,19874,1.0,0,0,2,7,1510,0,1951,0.0,98146,47.4924,-122.34,1540,10000,18364,0.9240213344067626,2280100,394975876,392695776
390000.0,3,1.75,1870,40250,1.0,0,0,4,7,1870,0,1959,0.0,98038,47.4038,-122.036,1870,40250,38380,0.9535403726708075,3496900,1620062500,1616565600
485000.0,3,2.25,1570,8111,2.0,0,0,2,8,1570,0,1984,0.0,98074,47.6324,-122.02799999999999,1990,7875,6541,0.8064357045986932,2464900,65788321,63323421
840000.0,4,2.5,2480,4602,2.0,0,0,2,9,2480,0,2000,0.0,98052,47.6835,-122.161,3480,5739,2122,0.4611038678835289,6150400,21178404,15028004
600000.0,5,3.5,3580,21343,1.5,0,0,3,8,2140,1440,1937,0.0,98155,47.7646,-122.302,2430,21343,17763,0.8322635055990254,12816400,455523649,442707249
331000.0,2,1.0,1480,6210,1.0,0,0,2,7,1080,400,1950,0.0,98133,47.773999999999994,-122.351,1290,7509,4730,0.7616747181964574,2190400,38564100,36373700
780000.0,3,2.0,2610,6000,1.0,0,0,4,7,1310,1300,1941,0.0,98115,47.675,-122.289,2330,4800,3390,0.565,6812100,36000000,29187900
300000.0,3,1.75,1700,8481,2.0,0,0,2,7,1700,0,1993,0.0,98003,47.2623,-122.305,1830,6600,6781,0.7995519396297607,2890000,71927361,69037361
361810.0,3,1.75,1240,7620,1.0,0,0,2,7,1240,0,1968,2014.0,98166,47.4576,-122.348,1150,7620,6380,0.8372703412073491,1537600,58064400,56526800
467000.0,3,1.0,1660,6582,1.0,0,0,4,7,1000,660,1946,0.0,98133,47.7169,-122.353,1110,6584,4922,0.7477970221817077,2755600,43322724,40567124
399000.0,3,1.75,1620,10000,1.5,0,0,4,6,1620,0,1918,0.0,98178,47.5091,-122.262,1880,10000,8380,0.838,2624400,100000000,97375600
315450.0,3,1.75,1130,7500,1.5,0,0,3,7,1130,0,1908,0.0,98108,47.5254,-122.318,1240,6000,6370,0.8493333333333334,1276900,56250000,54973100
600000.0,3,1.0,1310,5000,1.5,0,0,2,7,1310,0,1906,0.0,98103,47.6624,-122.34700000000001,1530,4800,3690,0.738,1716100,25000000,23283900
247500.0,4,2.0,1710,5200,1.0,0,0,3,7,910,800,1977,0.0,98042,47.3634,-122.09,1560,5200,3490,0.6711538461538461,2924100,27040000,24115900
330000.0,3,1.0,2140,5037,1.0,0,0,2,7,2140,0,1957,0.0,98118,47.5494,-122.274,1630,6054,2897,0.5751439348818741,4579600,25371369,20791769
500000.0,4,2.25,2350,7210,1.5,0,0,3,7,2350,0,1972,0.0,98011,47.7407,-122.18299999999999,1930,7519,4860,0.6740638002773925,5522500,51984100,46461600
367500.0,3,1.0,1570,10050,1.0,0,0,2,7,1570,0,1963,0.0,98028,47.736000000000004,-122.23100000000001,2540,9940,8480,0.8437810945273632,2464900,101002500,98537600
560000.0,3,2.5,2780,32880,1.0,0,0,2,9,2780,0,1993,0.0,98045,47.4798,-121.727,2780,40091,30100,0.9154501216545012,7728400,1081094400,1073366000
655000.0,4,1.75,2540,7620,1.0,0,3,2,8,1320,1220,1948,0.0,98116,47.5709,-122.406,2540,8613,5080,0.6666666666666666,6451600,58064400,51612800
530000.0,5,2.75,2500,7140,1.0,0,0,3,7,1250,1250,1968,0.0,98008,47.6225,-122.10799999999999,2230,8400,4640,0.6498599439775911,6250000,50979600,44729600
270000.0,3,2.25,2080,26574,1.0,0,2,2,7,1380,700,1993,0.0,98002,47.2846,-122.19200000000001,1770,8140,24494,0.9217280048167381,4326400,706177476,701851076
437500.0,3,2.0,1760,2875,2.0,0,2,2,7,1290,470,1988,0.0,98126,47.5602,-122.37799999999999,1760,4830,1115,0.38782608695652177,3097600,8265625,5168025
575000.0,3,1.75,1760,10349,1.0,0,0,2,8,1760,0,1957,0.0,98005,47.6347,-122.17299999999999,1970,10933,8589,0.8299352594453571,3097600,107101801,104004201
278000.0,4,2.5,1940,6887,2.0,0,0,2,7,1940,0,1990,0.0,98023,47.2911,-122.353,1870,6144,4947,0.7183098591549296,3763600,47430769,43667169
568500.0,4,2.5,3010,6181,2.0,0,0,2,9,3010,0,2000,0.0,98056,47.5212,-122.19200000000001,2960,6515,3171,0.5130237825594564,9060100,38204761,29144661
280000.0,4,3.0,2460,9606,1.0,0,0,2,8,2460,0,2012,0.0,98168,47.4889,-122.31700000000001,1730,7500,7146,0.7439100562148657,6051600,92275236,86223636
250000.0,2,1.0,750,6350,1.0,0,0,2,5,750,0,1920,0.0,98103,47.6938,-122.35600000000001,920,6350,5600,0.8818897637795275,562500,40322500,39760000
247500.0,3,0.75,1300,72309,1.0,0,0,2,6,680,620,1950,1987.0,98006,47.567,-122.124,3080,8395,71009,0.9820216017369898,1690000,5228591481,5226901481
1250000.0,5,2.75,3710,13874,1.5,0,3,3,9,2340,1370,1977,0.0,98006,47.5686,-122.154,3370,13874,10164,0.7325933400605449,13764100,192487876,178723776
535000.0,4,2.5,2360,15008,1.0,0,0,2,9,1920,440,1986,0.0,98028,47.7363,-122.25399999999999,2680,15344,12648,0.8427505330490405,5569600,225240064,219670464
814842.0,3,2.5,3190,6899,2.0,0,0,2,9,3190,0,2014,0.0,98034,47.7153,-122.221,3190,6899,3709,0.5376141469778228,10176100,47596201,37420101
340000.0,4,2.5,2181,5521,2.0,0,0,2,8,2181,0,2006,0.0,98001,47.3503,-122.291,2333,5143,3340,0.6049628690454628,4756761,30481441,25724680
359950.0,3,1.75,1890,9100,2.0,0,0,3,7,1890,0,1952,0.0,98133,47.7676,-122.339,1640,9100,7210,0.7923076923076923,3572100,82810000,79237900
750000.0,3,1.75,2610,5544,1.5,0,0,2,8,1680,930,1934,0.0,98117,47.684,-122.376,1330,5074,2934,0.5292207792207793,6812100,30735936,23923836
1220000.0,4,2.0,3090,8125,2.5,0,0,4,8,3090,0,1918,0.0,98117,47.6851,-122.395,1560,6250,5035,0.6196923076923077,9548100,66015625,56467525
370000.0,2,1.0,860,5040,1.0,0,0,2,7,860,0,1956,0.0,98117,47.6977,-122.365,1570,5040,4180,0.8293650793650794,739600,25401600,24662000
329950.0,3,1.0,1000,9170,1.0,0,0,2,7,1000,0,1980,0.0,98058,47.4405,-122.134,1610,9170,8170,0.8909487459105779,1000000,84088900,83088900
500000.0,3,2.5,2760,35171,2.0,0,0,2,9,2760,0,1990,0.0,98058,47.465,-122.12299999999999,2720,35171,32411,0.9215262574279947,7617600,1236999241,1229381641
734000.0,4,2.5,3490,18521,2.0,0,0,3,9,3490,0,1990,0.0,98077,47.7406,-122.07,2850,18521,15031,0.8115652502564656,12180100,343027441,330847341
385000.0,4,2.5,2960,5054,2.0,0,0,2,9,2960,0,2006,0.0,98038,47.3601,-122.035,2960,5000,2094,0.4143252869014642,8761600,25542916,16781316
230000.0,2,1.0,1280,4635,1.0,0,0,2,6,840,440,1917,0.0,98118,47.5532,-122.28,1660,6180,3355,0.7238403451995685,1638400,21483225,19844825
1390000.0,4,3.5,3230,7200,1.0,0,1,2,10,1640,1590,2000,0.0,98033,47.6838,-122.212,2660,7200,3970,0.5513888888888889,10432900,51840000,41407100
210000.0,3,2.0,1830,4992,1.0,0,0,2,7,1230,600,1953,0.0,98118,47.5145,-122.27,2050,7740,3162,0.6334134615384616,3348900,24920064,21571164
293000.0,3,1.75,1420,13187,1.0,0,0,3,7,1420,0,1974,0.0,98059,47.4608,-122.065,1620,13824,11767,0.8923181921589444,2016400,173896969,171880569
465000.0,3,1.0,1580,3774,1.5,0,0,2,6,1580,0,1900,0.0,98117,47.6839,-122.361,1580,3860,2194,0.5813460519342872,2496400,14243076,11746676
449000.0,3,2.25,1960,44634,1.0,0,0,2,7,1130,830,1984,0.0,98028,47.7769,-122.25299999999999,1970,44634,42674,0.9560872877178832,3841600,1992193956,1988352356
325000.0,2,1.75,1670,10725,1.0,0,0,2,7,1670,0,1965,0.0,98178,47.4893,-122.229,1600,10725,9055,0.8442890442890443,2788900,115025625,112236725
180000.0,3,2.0,1670,7056,1.0,0,0,3,7,1670,0,1958,0.0,98002,47.3139,-122.212,1330,8415,5386,0.7633219954648526,2788900,49787136,46998236
650000.0,6,3.0,2960,5000,1.0,0,0,2,8,1790,1170,1968,0.0,98103,47.6971,-122.34100000000001,1280,1251,2040,0.408,8761600,25000000,16238400
665000.0,4,2.75,2420,7102,1.0,0,0,4,7,1670,750,1946,0.0,98177,47.7042,-122.37100000000001,1620,7102,4682,0.659250915235145,5856400,50438404,44582004
324450.0,3,2.0,1420,16000,1.0,0,0,2,7,1420,0,1966,0.0,98166,47.478,-122.35799999999999,1900,12630,14580,0.91125,2016400,256000000,253983600
588000.0,4,1.75,2170,5750,1.0,0,2,2,7,1370,800,1975,0.0,98116,47.5668,-122.383,1450,5750,3580,0.6226086956521739,4708900,33062500,28353600
200000.0,4,1.0,1310,5200,1.5,0,0,2,6,1160,150,1945,0.0,98126,47.5384,-122.37,1090,5180,3890,0.7480769230769231,1716100,27040000,25323900
383000.0,4,1.75,1830,11090,1.0,0,0,2,7,1060,770,1962,0.0,98028,47.7333,-122.24600000000001,1990,10917,9260,0.8349864743011722,3348900,122988100,119639200
499950.0,3,2.0,1360,2500,1.0,0,0,2,7,730,630,1986,0.0,98107,47.6753,-122.363,1630,5000,1140,0.456,1849600,6250000,4400400
549000.0,5,2.5,3440,12350,1.0,0,2,3,9,1760,1680,1976,0.0,98003,47.3427,-122.325,3440,12763,8910,0.7214574898785425,11833600,152522500,140688900
465000.0,5,3.0,2010,7264,1.0,0,0,2,7,1290,720,1990,0.0,98103,47.6945,-122.33,1510,7326,5254,0.7232929515418502,4040100,52765696,48725596
450000.0,3,2.5,2450,19744,2.0,0,0,2,10,2450,0,1990,0.0,98038,47.3746,-122.02600000000001,2650,19597,17294,0.8759116693679092,6002500,389825536,383823036
799900.0,4,2.5,3030,7800,2.0,0,0,2,9,1580,1450,1991,0.0,98033,47.68899999999999,-122.196,2840,7435,4770,0.6115384615384616,9180900,60840000,51659100
495000.0,4,2.5,2480,91911,1.0,0,2,3,7,1470,1010,1973,0.0,98027,47.4579,-121.98100000000001,2540,91911,89431,0.9730173755045642,6150400,8447631921,8441481521
1200000.0,3,3.5,4310,10842,2.0,0,2,2,10,3140,1170,1988,0.0,98177,47.7735,-122.38600000000001,2280,11106,6532,0.602471868658919,18576100,117548964,98972864
637000.0,4,2.5,2120,15000,2.0,0,0,3,8,2120,0,1983,0.0,98052,47.7159,-122.1,2170,15000,12880,0.8586666666666667,4494400,225000000,220505600
589000.0,4,1.0,2210,4366,2.0,0,0,2,8,2210,0,1901,0.0,98122,47.6105,-122.309,1740,1745,2156,0.49381584974805315,4884100,19061956,14177856
305000.0,3,1.75,1400,10350,1.0,0,0,3,7,1400,0,1976,0.0,98059,47.479,-122.132,1780,10457,8950,0.8647342995169082,1960000,107122500,105162500
600000.0,4,2.25,2760,5200,2.0,0,0,2,7,1790,970,1910,2003.0,98144,47.589,-122.31299999999999,1310,2059,2440,0.46923076923076923,7617600,27040000,19422400
587000.0,4,2.5,2550,6256,2.0,0,0,2,9,2550,0,1992,0.0,98072,47.7742,-122.166,2460,8256,3706,0.592391304347826,6502500,39137536,32635036
1430000.0,2,2.5,2220,4000,2.0,0,0,2,9,2220,0,2000,0.0,98112,47.6364,-122.28,1870,4000,1780,0.445,4928400,16000000,11071600
250000.0,4,1.0,1320,11212,1.0,0,0,4,6,1320,0,1914,0.0,98002,47.3098,-122.209,1060,6766,9892,0.8822689975026757,1742400,125708944,123966544
515000.0,3,3.0,2440,3202,2.0,0,0,3,8,1640,800,1982,0.0,98133,47.7152,-122.34200000000001,2440,3200,762,0.23797626483447845,5953600,10252804,4299204
833000.0,4,2.75,3780,10308,2.0,0,0,2,10,3780,0,1999,0.0,98075,47.589,-121.98299999999999,3500,10740,6528,0.6332945285215367,14288400,106254864,91966464
860000.0,3,3.25,4720,32467,2.0,0,2,2,10,3190,1530,1998,0.0,98059,47.508,-122.113,3260,26386,27747,0.854621615794499,22278400,1054106089,1031827689
550000.0,4,3.0,2360,6678,1.0,0,0,2,8,1760,600,1949,0.0,98115,47.6919,-122.31299999999999,1640,6380,4318,0.6466007786762503,5569600,44595684,39026084
180000.0,2,1.0,890,6000,1.0,0,0,1,6,890,0,1919,0.0,98178,47.4976,-122.225,1100,6000,5110,0.8516666666666667,792100,36000000,35207900
507000.0,4,1.75,1770,9375,1.0,0,0,3,7,1170,600,1968,0.0,98052,47.6935,-122.11200000000001,1540,9375,7605,0.8112,3132900,87890625,84757725
427000.0,3,2.0,1720,128066,1.0,0,0,2,7,1720,0,1994,0.0,98027,47.4487,-121.98100000000001,2360,111078,126346,0.9865694251401621,2958400,16400900356,16397941956
616950.0,3,3.5,2490,2722,2.0,0,0,2,8,2020,470,1999,0.0,98005,47.5893,-122.165,2490,2755,232,0.0852314474650992,6200100,7409284,1209184
372000.0,4,1.75,1890,10550,1.0,0,0,4,7,1010,880,1969,0.0,98056,47.5147,-122.193,1930,7291,8660,0.8208530805687204,3572100,111302500,107730400
290000.0,2,1.0,1020,6380,1.0,0,0,2,7,1020,0,1930,1973.0,98115,47.6971,-122.31700000000001,1380,6380,5360,0.8401253918495298,1040400,40704400,39664000
329990.0,4,2.75,2420,8438,2.0,0,0,2,8,2420,0,1997,0.0,98022,47.2089,-122.01100000000001,2270,8770,6018,0.7132021806115193,5856400,71199844,65343444
393500.0,3,1.75,1600,8156,1.0,0,0,4,7,1600,0,1948,0.0,98155,47.7397,-122.3,1200,8156,6556,0.803825404610103,2560000,66520336,63960336
1550000.0,5,3.25,3370,17458,1.0,0,2,4,10,2000,1370,1982,0.0,98040,47.5591,-122.229,4240,15202,14088,0.8069652881200595,11356900,304781764,293424864
240000.0,4,2.25,1720,8300,1.0,0,0,3,8,1720,0,1973,0.0,98023,47.3192,-122.385,2010,8000,6580,0.7927710843373494,2958400,68890000,65931600
285000.0,3,1.0,1090,8640,1.0,0,0,3,6,1090,0,1973,0.0,98166,47.458999999999996,-122.355,1260,8400,7550,0.8738425925925926,1188100,74649600,73461500
382500.0,3,1.5,1090,9862,1.0,0,0,2,8,1090,0,1987,0.0,98074,47.6256,-122.036,1710,9862,8772,0.8894747515716893,1188100,97259044,96070944
1930000.0,4,3.75,3600,16101,1.0,0,0,2,9,3600,0,1951,0.0,98112,47.6308,-122.287,3650,9506,12501,0.776411403018446,12960000,259242201,246282201
800000.0,3,2.5,2760,9471,1.0,0,2,2,8,1760,1000,1956,0.0,98115,47.676,-122.272,3040,6765,6711,0.7085840988280012,7617600,89699841,82082241
550000.0,4,3.5,2770,24140,2.0,0,0,2,8,2770,0,1967,0.0,98033,47.6585,-122.186,1720,16011,21370,0.8852526926263463,7672900,582739600,575066700
387846.0,4,1.75,2520,15205,1.0,0,0,3,7,2040,480,1954,0.0,98028,47.7642,-122.264,1680,10000,12685,0.8342650443932916,6350400,231192025,224841625
367500.0,4,2.0,1960,16015,1.0,0,0,2,7,1960,0,1980,0.0,98002,47.33,-122.22,1960,16015,14055,0.8776147361848268,3841600,256480225,252638625
780500.0,5,1.0,1760,4264,2.0,0,0,2,8,1760,0,1902,0.0,98112,47.6246,-122.31200000000001,2130,4264,2504,0.5872420262664165,3097600,18181696,15084096
680000.0,3,1.75,1090,6775,1.0,0,0,3,7,850,240,1950,0.0,98115,47.6934,-122.321,1580,5760,5685,0.8391143911439114,1188100,45900625,44712525
434400.0,5,1.75,1960,7875,1.0,0,0,3,7,1960,0,1968,0.0,98034,47.7256,-122.18,1800,7764,5915,0.7511111111111111,3841600,62015625,58174025
370000.0,2,1.0,1220,17172,1.0,0,0,3,6,1220,0,1947,0.0,98033,47.6934,-122.163,1510,12915,15952,0.9289541113440485,1488400,294877584,293389184
465000.0,3,1.75,1730,8073,1.0,0,0,2,8,1350,380,1971,0.0,98177,47.7694,-122.367,2500,8073,6343,0.7857054378793509,2992900,65173329,62180429
323000.0,3,2.0,1830,6925,1.0,0,0,3,8,1830,0,1979,0.0,98058,47.4445,-122.12299999999999,2010,7350,5095,0.7357400722021661,3348900,47955625,44606725
270000.0,4,2.5,1600,9921,2.0,0,0,2,7,1600,0,2009,0.0,98042,47.3678,-122.124,2140,5806,8321,0.8387259348855962,2560000,98426241,95866241
1320000.0,3,1.75,2040,42693,1.0,0,2,2,10,2040,0,1980,0.0,98052,47.6479,-122.12,2640,11957,40653,0.9522169910758204,4161600,1822692249,1818530649
560000.0,4,2.5,2710,6583,2.0,0,0,2,9,2710,0,2003,0.0,98059,47.4922,-122.141,2710,6583,3873,0.5883335865107094,7344100,43335889,35991789
450000.0,3,1.0,1140,4500,1.0,0,0,2,6,840,300,1907,0.0,98144,47.5897,-122.314,1150,3000,3360,0.7466666666666667,1299600,20250000,18950400
290000.0,2,1.0,930,7740,1.0,0,0,2,6,930,0,1924,0.0,98125,47.7091,-122.292,1250,7740,6810,0.8798449612403101,864900,59907600,59042700
354000.0,3,2.0,1010,21340,1.0,0,0,2,8,1010,0,1980,0.0,98074,47.6223,-122.04299999999999,1700,13045,20330,0.9526710402999062,1020100,455395600,454375500
705000.0,5,3.0,2380,5000,2.0,0,0,4,7,2380,0,1909,0.0,98107,47.6722,-122.389,1800,4650,2620,0.524,5664400,25000000,19335600
445000.0,3,2.25,1860,7200,1.0,0,0,3,7,1240,620,1977,0.0,98034,47.7332,-122.19200000000001,1560,7630,5340,0.7416666666666667,3459600,51840000,48380400
229900.0,3,1.0,1440,11925,1.0,0,0,2,7,1440,0,1968,0.0,98003,47.2738,-122.3,1440,10425,10485,0.879245283018868,2073600,142205625,140132025
610000.0,4,2.5,2980,5896,2.0,0,0,2,8,2980,0,2001,0.0,98053,47.6872,-122.036,2900,5712,2916,0.494572591587517,8880400,34762816,25882416
535000.0,3,3.25,2670,5108,2.0,0,2,2,9,2670,0,2000,0.0,98065,47.5342,-121.866,2670,6500,2438,0.47729052466718874,7128900,26091664,18962764
437400.0,3,1.75,2150,8925,1.0,0,0,3,7,2150,0,1960,0.0,98008,47.6253,-122.119,1100,7875,6775,0.7591036414565826,4622500,79655625,75033125
540000.0,5,2.75,3160,10059,2.0,0,0,2,10,1740,1420,1978,0.0,98011,47.7477,-122.21700000000001,3120,11557,6899,0.6858534645591013,9985600,101183481,91197881
570000.0,3,2.0,1890,29185,1.0,0,0,2,7,1470,420,1949,2013.0,98006,47.5621,-122.16799999999999,2580,11600,27295,0.9352407058420421,3572100,851764225,848192125
533000.0,3,2.5,2810,4607,2.0,0,0,2,8,2810,0,2004,0.0,98011,47.7735,-122.227,2540,4871,1797,0.3900586064684176,7896100,21224449,13328349
555000.0,3,2.5,2690,4819,2.0,0,0,2,7,2690,0,2004,0.0,98065,47.5302,-121.84899999999999,2360,4829,2129,0.4417929030919278,7236100,23222761,15986661
239950.0,3,1.75,1230,9600,1.0,0,0,3,7,1230,0,1984,0.0,98042,47.3675,-122.095,1330,8250,8370,0.871875,1512900,92160000,90647100
350000.0,3,1.0,950,9451,1.0,0,0,3,7,950,0,1977,0.0,98034,47.7308,-122.19,1480,8352,8501,0.8994815363453603,902500,89321401,88418901
245000.0,2,1.0,1200,4880,1.0,0,0,2,6,980,220,1943,0.0,98106,47.5276,-122.346,1040,4880,3680,0.7540983606557377,1440000,23814400,22374400
456000.0,4,1.75,1670,9886,1.0,0,0,4,7,1670,0,1947,0.0,98125,47.7249,-122.287,2590,9997,8216,0.8310742464090634,2788900,97732996,94944096
465000.0,4,2.25,2140,7701,1.0,0,0,3,7,1470,670,1977,0.0,98034,47.7213,-122.171,2130,8050,5561,0.7221140111673808,4579600,59305401,54725801
445000.0,2,1.75,1440,4660,1.0,0,2,2,8,1440,0,2008,0.0,98053,47.7092,-122.015,1680,4989,3220,0.6909871244635193,2073600,21715600,19642000
517850.0,5,2.75,3050,7500,1.0,0,0,3,8,1800,1250,1966,0.0,98034,47.7249,-122.18700000000001,2060,7848,4450,0.5933333333333334,9302500,56250000,46947500
329000.0,5,2.75,2570,7260,2.0,0,0,2,8,2570,0,1996,0.0,98092,47.2622,-122.212,2200,7421,4690,0.6460055096418733,6604900,52707600,46102700
512500.0,3,2.5,1840,2875,2.0,0,0,3,7,1840,0,1997,0.0,98116,47.562,-122.39299999999999,1240,5750,1035,0.36,3385600,8265625,4880025
365000.0,2,1.0,1250,8100,1.0,0,0,3,7,1250,0,1947,0.0,98125,47.7294,-122.329,1710,8100,6850,0.845679012345679,1562500,65610000,64047500
450500.0,3,1.0,1410,9384,1.0,0,0,2,7,1410,0,1948,0.0,98133,47.7161,-122.33,1990,9384,7974,0.8497442455242967,1988100,88059456,86071356
915000.0,3,1.0,1560,8232,1.0,0,0,2,7,1560,0,1952,0.0,98004,47.62300000000001,-122.205,1930,8286,6672,0.8104956268221575,2433600,67765824,65332224
205000.0,3,1.0,960,7314,1.0,0,0,4,6,960,0,1960,0.0,98002,47.2891,-122.221,990,7314,6354,0.8687448728465955,921600,53494596,52572996
314000.0,4,2.5,1870,8449,2.0,0,0,2,8,1870,0,1992,0.0,98188,47.4435,-122.274,2160,8113,6579,0.778672032193159,3496900,71385601,67888701
496000.0,2,1.0,900,9260,1.0,0,0,2,7,900,0,1946,0.0,98107,47.6695,-122.36,1230,6913,8360,0.9028077753779697,810000,85747600,84937600
329950.0,4,1.0,2050,7590,1.0,0,0,2,7,1280,770,1957,0.0,98178,47.4916,-122.22399999999999,2050,7800,5540,0.7299077733860343,4202500,57608100,53405600
375000.0,4,2.0,2400,6000,2.0,0,0,2,6,2400,0,1913,1945.0,98011,47.7607,-122.209,1780,8732,3600,0.6,5760000,36000000,30240000
623000.0,3,2.5,1850,7777,2.0,0,0,4,8,1850,0,1989,0.0,98033,47.6908,-122.169,1850,8482,5927,0.7621190690497621,3422500,60481729,57059229
310000.0,4,1.5,1220,9600,1.0,0,0,2,6,1220,0,1980,0.0,98014,47.6462,-121.90899999999999,1180,9000,8380,0.8729166666666667,1488400,92160000,90671600
532500.0,3,3.25,3140,37120,1.0,0,0,2,9,1760,0,1984,0.0,98065,47.5244,-121.84200000000001,2100,13500,33980,0.9154094827586207,9859600,1377894400,1368034800
960000.0,4,2.25,2410,4560,2.0,0,2,4,9,1800,610,1929,0.0,98117,47.6796,-122.402,2150,5100,2150,0.47149122807017546,5808100,20793600,14985500
598000.0,4,2.5,3130,40918,2.0,0,0,2,9,3130,0,1994,0.0,98045,47.4761,-121.723,2760,35440,37788,0.9235055476807273,9796900,1674282724,1664485824
683000.0,3,2.5,2300,9218,2.0,0,2,2,9,2300,0,1998,0.0,98027,47.5504,-122.07700000000001,2730,9930,6918,0.7504881753091777,5290000,84971524,79681524
425000.0,5,2.5,2840,9425,1.0,0,0,3,7,1590,1250,1962,0.0,98155,47.7609,-122.29700000000001,1900,11600,6585,0.6986737400530504,8065600,88830625,80765025
533000.0,5,2.75,1800,3780,1.5,0,0,2,7,1400,400,1926,0.0,98103,47.6831,-122.34299999999999,1400,3780,1980,0.5238095238095238,3240000,14288400,11048400
375000.0,3,1.0,1190,9486,1.0,0,0,3,7,1190,0,1953,0.0,98166,47.4319,-122.339,2100,10400,8296,0.8745519713261649,1416100,89984196,88568096
250500.0,3,2.0,1710,7225,2.0,0,0,3,7,1710,0,1988,0.0,98023,47.2917,-122.37299999999999,1710,7225,5515,0.7633217993079585,2924100,52200625,49276525
257000.0,4,1.75,1900,22896,1.5,0,0,2,7,1360,540,1922,1990.0,98010,47.3102,-122.023,1300,8960,20996,0.91701607267645,3610000,524226816,520616816
218000.0,3,1.0,880,18205,1.0,0,0,3,6,880,0,1945,0.0,98178,47.5013,-122.244,1110,16115,17325,0.9516616314199395,774400,331422025,330647625
460000.0,3,2.0,2060,4437,1.0,0,0,2,7,1030,1030,1929,0.0,98126,47.5705,-122.376,1750,4452,2377,0.5357223349109759,4243600,19686969,15443369
255544.0,3,1.0,1360,6186,1.5,0,0,3,6,760,600,1941,0.0,98133,47.7503,-122.334,1610,7453,4826,0.7801487229227287,1849600,38266596,36416996
560000.0,2,2.0,1680,4647,1.0,0,0,2,8,1680,0,2008,0.0,98053,47.7088,-122.015,1680,4950,2967,0.6384764364105875,2822400,21594609,18772209
480000.0,4,2.5,2980,4074,2.0,0,0,2,8,2980,0,2011,0.0,98019,47.733999999999995,-121.965,2320,4255,1094,0.26853215513009326,8880400,16597476,7717076
1300000.0,5,1.75,2130,19180,1.0,0,0,2,8,1500,630,1968,0.0,98004,47.63800000000001,-122.213,3650,19180,17050,0.8889468196037539,4536900,367872400,363335500
580000.0,3,2.75,2650,9752,1.0,0,0,2,9,2650,0,1989,0.0,98028,47.768,-122.259,3030,9910,7102,0.7282608695652174,7022500,95101504,88079004
475000.0,3,2.5,1700,9100,1.0,0,0,2,8,1160,540,1998,0.0,98126,47.5369,-122.37799999999999,1590,8374,7400,0.8131868131868132,2890000,82810000,79920000
1310000.0,4,2.5,2680,12215,1.0,1,4,2,9,1590,1090,1956,0.0,98166,47.4396,-122.353,2960,19964,9535,0.7805976258698322,7182400,149206225,142023825
700000.0,3,2.5,2530,623779,1.0,0,0,3,8,2530,0,1980,0.0,98038,47.4188,-121.949,2120,100623,621249,0.9959440763475526,6400900,389100240841,389093839941
590000.0,3,2.5,2520,10223,2.0,0,0,2,10,2520,0,1988,0.0,98074,47.631,-122.042,2630,10091,7703,0.7534970165313509,6350400,104509729,98159329
264500.0,3,2.5,1630,8346,1.0,0,0,2,8,1630,0,1990,0.0,98092,47.2622,-122.219,2110,8619,6716,0.8046968607716272,2656900,69655716,66998816
465000.0,2,1.0,730,2600,1.0,0,0,3,6,730,0,1918,0.0,98107,47.6751,-122.37899999999999,1480,3900,1870,0.7192307692307692,532900,6760000,6227100
290000.0,3,1.0,910,7620,1.0,0,2,2,7,910,0,1971,0.0,98106,47.5278,-122.34299999999999,1660,7620,6710,0.8805774278215223,828100,58064400,57236300
1820000.0,4,4.5,4510,12873,2.0,0,2,2,12,4510,0,1998,0.0,98033,47.6491,-122.20100000000001,2200,8528,8363,0.6496543152334343,20340100,165714129,145374029
416000.0,3,1.0,1110,12150,1.0,0,0,3,7,1110,0,1957,0.0,98008,47.6034,-122.12200000000001,1490,8200,11040,0.908641975308642,1232100,147622500,146390400
360000.0,4,2.0,1450,8940,1.0,0,0,2,7,1450,0,1962,0.0,98034,47.7304,-122.24,1310,8914,7490,0.8378076062639821,2102500,79923600,77821100
585083.0,5,2.75,2910,36250,1.0,0,0,2,8,1590,1320,1977,0.0,98075,47.5916,-122.07600000000001,2910,37376,33340,0.9197241379310345,8468100,1314062500,1305594400
840000.0,4,2.75,2600,2750,1.5,0,0,2,7,1620,980,1936,0.0,98119,47.6413,-122.35700000000001,1960,3705,150,0.05454545454545454,6760000,7562500,802500
81000.0,2,1.0,730,9975,1.0,0,0,0,5,730,0,1943,0.0,98168,47.4808,-122.315,860,9000,9245,0.9268170426065163,532900,99500625,98967725
1290000.0,3,2.25,2440,9200,1.0,0,1,3,8,2440,0,1950,0.0,98105,47.6629,-122.26899999999999,2750,6211,6760,0.7347826086956522,5953600,84640000,78686400
326000.0,4,1.75,2290,7380,1.0,0,0,2,7,1390,900,1963,0.0,98178,47.5034,-122.245,1170,7381,5090,0.6897018970189702,5244100,54464400,49220300
447000.0,2,1.0,720,7500,1.0,0,2,2,6,720,0,1925,0.0,98136,47.5185,-122.39200000000001,1390,5000,6780,0.904,518400,56250000,55731600
185000.0,3,1.0,940,7125,1.5,0,0,3,7,940,0,1958,0.0,98032,47.3756,-122.29700000000001,1170,7125,6185,0.8680701754385964,883600,50765625,49882025
439950.0,3,2.5,1540,7773,2.0,0,0,3,8,1540,0,1982,0.0,98034,47.722,-122.194,1630,7340,6233,0.8018782966679532,2371600,60419529,58047929
234000.0,3,1.5,1140,10300,1.5,0,0,3,6,1140,0,1967,0.0,98045,47.4452,-121.77,1250,9975,9160,0.8893203883495145,1299600,106090000,104790400
485000.0,4,2.5,2100,8886,2.0,0,0,3,7,2100,0,1964,0.0,98007,47.5947,-122.134,1840,9058,6786,0.763673193787981,4410000,78960996,74550996
750000.0,4,1.75,2670,6250,2.0,0,0,3,8,2020,650,1941,0.0,98199,47.6499,-122.391,1820,6250,3580,0.5728,7128900,39062500,31933600
865000.0,4,2.0,2750,5527,2.0,0,0,2,8,2130,620,1901,1987.0,98119,47.6513,-122.368,1290,1764,2777,0.5024425547313189,7562500,30547729,22985229
287500.0,4,2.5,2570,9000,1.0,0,0,3,8,1590,980,1979,0.0,98023,47.2986,-122.37200000000001,2120,8571,6430,0.7144444444444444,6604900,81000000,74395100
375000.0,3,1.75,1660,9673,1.0,0,0,2,7,1130,530,1976,0.0,98072,47.7628,-122.162,1260,9681,8013,0.8283882973224439,2755600,93566929,90811329
565000.0,3,2.25,1700,8800,1.0,0,0,4,7,850,850,1969,0.0,98033,47.6863,-122.189,2180,8960,7100,0.8068181818181818,2890000,77440000,74550000
260000.0,4,3.0,1530,8306,2.0,0,0,2,7,1530,0,2010,0.0,98042,47.3528,-122.146,1930,6925,6776,0.815795810257645,2340900,68989636,66648736
190000.0,3,1.0,1260,10900,1.0,0,0,3,6,1260,0,1943,0.0,98056,47.49100000000001,-122.18799999999999,1090,8137,9640,0.8844036697247707,1587600,118810000,117222400
399950.0,5,2.0,2760,6420,1.0,0,0,4,7,1380,1380,1964,0.0,98118,47.5396,-122.27600000000001,1400,7112,3660,0.5700934579439252,7617600,41216400,33598800
275000.0,3,2.5,1830,7062,2.0,0,0,2,7,1830,0,1990,0.0,98023,47.2895,-122.352,1820,6434,5232,0.7408666100254885,3348900,49871844,46522944
528000.0,3,2.75,2160,4086,1.0,0,0,2,7,1380,780,1987,0.0,98126,47.5352,-122.38,1300,4080,1926,0.4713656387665198,4665600,16695396,12029796
315000.0,3,2.0,1770,9685,1.0,0,0,2,5,1770,0,1948,0.0,98166,47.4753,-122.34200000000001,1520,11122,7915,0.8172431595250387,3132900,93799225,90666325
614306.0,2,2.25,2210,5500,1.0,0,0,3,8,1410,800,1968,0.0,98117,47.696999999999996,-122.39,2140,6600,3290,0.5981818181818181,4884100,30250000,25365900
1490000.0,3,3.5,4560,14608,2.0,0,2,2,12,4560,0,1990,0.0,98034,47.6995,-122.228,4050,14226,10048,0.687842278203724,20793600,213393664,192600064
590000.0,3,2.5,2110,3870,2.0,0,0,2,9,2110,0,2004,0.0,98029,47.5513,-121.994,2300,3870,1760,0.45478036175710596,4452100,14976900,10524800
261500.0,3,1.0,1130,3600,1.0,0,0,2,6,1130,0,1908,0.0,98144,47.5978,-122.29899999999999,1710,2231,2470,0.6861111111111111,1276900,12960000,11683100
300000.0,4,2.5,1960,9898,2.0,0,0,2,8,1960,0,2001,0.0,98030,47.3834,-122.16799999999999,2130,7662,7938,0.801980198019802,3841600,97970404,94128804
439000.0,3,2.25,2230,4551,1.5,0,2,4,8,1450,780,1928,0.0,98178,47.5078,-122.236,2060,7200,2321,0.5099978026807295,4972900,20711601,15738701
277554.0,5,2.25,2350,13000,1.0,0,0,2,7,2350,0,1961,0.0,98178,47.4939,-122.256,1570,11440,10650,0.8192307692307692,5522500,169000000,163477500
215000.0,3,2.0,1340,8505,1.0,0,0,2,6,1340,0,1931,0.0,98168,47.4727,-122.29700000000001,1370,9000,7165,0.842445620223398,1795600,72335025,70539425
1200000.0,2,2.25,2160,17861,2.0,1,4,3,9,2160,0,1956,0.0,98146,47.501999999999995,-122.385,2660,18530,15701,0.8790661217177089,4665600,319015321,314349721
420000.0,4,2.0,1700,6375,1.0,0,0,3,7,850,850,1950,0.0,98115,47.6973,-122.295,1470,8360,4675,0.7333333333333333,2890000,40640625,37750625
485000.0,3,2.5,1650,3436,2.0,0,0,2,7,1650,0,2003,0.0,98053,47.6819,-122.036,1680,3446,1786,0.519790454016298,2722500,11806096,9083596
202500.0,3,2.0,1540,8316,1.0,0,0,4,6,1540,0,1954,0.0,98002,47.323,-122.21600000000001,1250,8316,6776,0.8148148148148148,2371600,69155856,66784256
710000.0,5,3.25,3920,8572,2.0,0,0,2,9,3920,0,2007,0.0,98065,47.5427,-121.887,3335,7258,4652,0.5426971535230984,15366400,73479184,58112784
535000.0,4,2.5,3250,6933,2.0,0,0,2,8,3250,0,2009,0.0,98059,47.4956,-122.15100000000001,3030,5308,3683,0.5312274628587913,10562500,48066489,37503989
260000.0,4,1.75,1360,7700,1.0,0,0,3,7,1360,0,1966,0.0,98058,47.4558,-122.177,1321,7756,6340,0.8233766233766234,1849600,59290000,57440400
254000.0,3,2.0,1480,7480,1.0,0,0,3,7,1480,0,1992,0.0,98038,47.3542,-122.055,1680,7146,6000,0.8021390374331551,2190400,55950400,53760000
600000.0,4,2.5,2360,5226,2.0,0,0,2,8,2360,0,2001,0.0,98034,47.711999999999996,-122.229,2440,5156,2866,0.5484117872177574,5569600,27311076,21741476
285000.0,3,2.5,1800,2516,2.0,0,0,2,7,1800,0,2001,0.0,98108,47.5401,-122.29299999999999,1800,2562,716,0.2845786963434022,3240000,6330256,3090256
800000.0,4,3.75,2540,20662,2.0,0,0,2,10,2540,0,1998,0.0,98075,47.5882,-122.01,2490,37731,18122,0.8770690155841642,6451600,426918244,420466644
165000.0,3,1.0,1200,13100,1.0,0,0,2,6,1200,0,1943,0.0,98168,47.475,-122.258,1960,11285,11900,0.9083969465648855,1440000,171610000,170170000
216500.0,2,1.0,710,6960,1.0,0,0,3,6,710,0,1943,0.0,98178,47.4886,-122.24600000000001,940,7680,6250,0.8979885057471264,504100,48441600,47937500
387990.0,4,2.5,2640,5595,2.0,0,0,2,8,2640,0,2011,0.0,98038,47.3551,-122.054,1840,5011,2955,0.5281501340482574,6969600,31304025,24334425
500000.0,4,2.5,3010,5040,2.0,0,0,2,8,3010,0,2006,0.0,98133,47.708999999999996,-122.35,1090,5040,2030,0.4027777777777778,9060100,25401600,16341500
650000.0,4,2.5,2770,5612,2.0,0,0,2,7,2770,0,2001,0.0,98053,47.68600000000001,-122.036,2770,5177,2842,0.5064148253741981,7672900,31494544,23821644
646000.0,4,2.5,2310,4079,2.0,0,0,2,8,2310,0,2008,0.0,98117,47.6937,-122.361,1220,4800,1769,0.4336847266486884,5336100,16638241,11302141
323400.0,4,3.0,2060,9138,1.0,0,0,2,8,1430,630,1992,0.0,98092,47.32100000000001,-122.185,2250,7820,7078,0.774567739111403,4243600,83503044,79259444
300000.0,3,2.5,1880,4200,2.0,0,0,2,7,1880,0,2007,0.0,98038,47.36600000000001,-122.01700000000001,2090,4200,2320,0.5523809523809524,3534400,17640000,14105600
712500.0,5,2.0,2280,5400,1.5,0,0,3,7,1340,940,1947,0.0,98105,47.6674,-122.279,1770,5000,3120,0.5777777777777777,5198400,29160000,23961600
550000.0,3,1.75,1380,3402,1.5,0,0,2,7,1380,0,1900,2000.0,98122,47.6109,-122.302,1500,5496,2022,0.5943562610229277,1904400,11573604,9669204
400000.0,3,1.0,1180,7537,1.0,0,0,2,7,1180,0,1969,0.0,98034,47.7233,-122.221,1220,7425,6357,0.8434390340984477,1392400,56806369,55413969
255000.0,4,1.75,1650,7200,1.0,0,0,2,7,1100,550,1977,0.0,98031,47.3944,-122.18700000000001,1620,7374,5550,0.7708333333333334,2722500,51840000,49117500
660000.0,3,1.75,2030,9032,2.0,0,2,3,7,2030,0,1963,0.0,98008,47.58600000000001,-122.117,2350,8937,7002,0.775243578387954,4120900,81577024,77456124
925000.0,4,2.25,2110,6375,1.0,0,2,3,8,1600,0,1941,0.0,98115,47.6819,-122.272,2760,6375,4265,0.6690196078431373,4452100,40640625,36188525
534000.0,4,2.25,2130,7210,1.0,0,0,4,7,1330,800,1965,0.0,98008,47.629,-122.117,1310,7896,5080,0.7045769764216366,4536900,51984100,47447200
215000.0,3,1.0,1690,7700,1.0,0,0,3,7,1690,0,1969,0.0,98003,47.3444,-122.304,1590,7700,6010,0.7805194805194805,2856100,59290000,56433900
1950000.0,3,2.5,2510,12779,1.5,0,4,2,10,2510,0,1968,0.0,98034,47.6982,-122.23100000000001,2810,12225,10269,0.8035840050082166,6300100,163302841,157002741
1400000.0,5,4.25,3530,7924,2.0,0,0,2,10,3530,0,2001,0.0,98040,47.5894,-122.243,1750,9226,4394,0.5545179202423018,12460900,62789776,50328876
212000.0,3,1.75,1470,8350,1.0,0,0,2,7,1470,0,1990,0.0,98001,47.2587,-122.25299999999999,1590,8182,6880,0.8239520958083832,2160900,69722500,67561600
265000.0,3,1.75,1840,7300,1.0,0,0,2,8,1840,0,1966,0.0,98023,47.3122,-122.369,1920,8010,5460,0.7479452054794521,3385600,53290000,49904400
400000.0,3,1.75,1860,5750,1.5,0,0,4,6,1300,560,1918,0.0,98116,47.5586,-122.383,1550,5750,3890,0.6765217391304348,3459600,33062500,29602900
311500.0,4,2.5,1940,10133,2.0,0,0,2,8,1940,0,1992,0.0,98031,47.3877,-122.171,1940,7265,8193,0.808546333760979,3763600,102677689,98914089
2330000.0,4,3.5,4420,20759,2.0,0,0,2,11,4420,0,2003,0.0,98004,47.6354,-122.221,3020,20666,16339,0.7870803025193892,19536400,430936081,411399681
225000.0,2,1.0,800,6050,1.0,0,0,3,6,800,0,1944,0.0,98178,47.5001,-122.242,880,6050,5250,0.8677685950413223,640000,36602500,35962500
1250000.0,4,2.5,3700,21755,1.0,0,4,2,11,2620,1080,1988,0.0,98006,47.5662,-122.10799999999999,3480,13786,18055,0.8299241553665824,13690000,473280025,459590025
380000.0,3,1.0,1400,8710,1.0,0,0,3,7,1400,0,1948,0.0,98146,47.5066,-122.37700000000001,1460,8710,7310,0.8392652123995408,1960000,75864100,73904100
600000.0,4,2.5,2250,11370,2.0,0,0,2,8,2250,0,1991,0.0,98034,47.7115,-122.23899999999999,2190,9611,9120,0.8021108179419525,5062500,129276900,124214400
600000.0,3,2.25,2230,9053,2.0,0,0,3,9,2230,0,1987,0.0,98007,47.6594,-122.14399999999999,2390,8038,6823,0.7536728156412239,4972900,81956809,76983909
315000.0,3,2.5,1950,3000,2.0,0,0,2,7,1950,0,2001,0.0,98146,47.4938,-122.337,1620,6000,1050,0.35,3802500,9000000,5197500
847000.0,5,1.0,2550,4623,2.5,0,0,3,9,2550,0,1905,0.0,98122,47.6092,-122.294,1570,3875,2073,0.44841012329656066,6502500,21372129,14869629
730000.0,4,2.5,2750,10351,2.0,0,0,2,10,2750,0,1998,0.0,98075,47.5894,-121.98,3370,10351,7601,0.7343251859723698,7562500,107143201,99580701
1060000.0,4,2.0,2290,11137,1.0,0,0,3,8,2290,0,1955,0.0,98004,47.5887,-122.20100000000001,2300,10463,8847,0.7943790967046781,5244100,124032769,118788669
1620000.0,4,2.25,2350,17709,2.0,0,0,3,9,2350,0,1977,0.0,98039,47.6232,-122.236,3360,19855,15359,0.8672991134451409,5522500,313608681,308086181
664000.0,2,1.75,1720,5785,1.0,0,0,2,6,860,860,1948,2002.0,98118,47.5554,-122.274,1680,5184,4065,0.7026793431287813,2958400,33466225,30507825
454450.0,4,3.0,2810,6000,2.0,0,0,2,9,2810,0,2007,0.0,98038,47.3689,-122.057,2790,6000,3190,0.5316666666666666,7896100,36000000,28103900
341000.0,3,1.0,940,4200,1.0,0,0,2,7,940,0,1955,0.0,98103,47.6878,-122.35,1380,4080,3260,0.7761904761904762,883600,17640000,16756400
276693.0,4,1.0,1190,8875,1.5,0,0,3,7,1190,0,1946,0.0,98155,47.7487,-122.303,1190,8875,7685,0.8659154929577465,1416100,78765625,77349525
185000.0,2,1.0,1390,11340,1.0,0,0,3,7,1390,0,1969,0.0,98168,47.4969,-122.3,1200,10224,9950,0.8774250440917107,1932100,128595600,126663500
160000.0,2,2.5,1660,2258,2.0,0,0,2,7,1660,0,1981,0.0,98042,47.3793,-122.146,1740,2390,598,0.26483613817537643,2755600,5098564,2342964
270000.0,4,2.5,1920,8497,2.0,0,0,2,8,1920,0,1998,0.0,98092,47.2608,-122.209,1940,8436,6577,0.7740378957279039,3686400,72199009,68512609
300000.0,4,1.5,1460,8760,1.0,0,0,2,7,1460,0,1958,0.0,98166,47.4698,-122.36,1610,9375,7300,0.8333333333333334,2131600,76737600,74606000
264950.0,3,1.5,1370,10115,1.0,0,0,3,7,1370,0,1957,0.0,98022,47.2027,-122.0,1450,9282,8745,0.8645575877409788,1876900,102313225,100436325
209950.0,2,1.0,1050,6250,1.0,0,0,3,6,840,210,1943,0.0,98168,47.5024,-122.333,1310,12500,5200,0.832,1102500,39062500,37960000
850000.0,3,2.5,3360,8708,2.0,0,0,2,9,3360,0,2006,0.0,98053,47.7037,-122.016,1810,4764,5348,0.6141479099678456,11289600,75829264,64539664
645000.0,4,2.5,3160,11380,2.0,0,0,2,9,3160,0,1983,0.0,98074,47.6318,-122.039,2970,10385,8220,0.7223198594024605,9985600,129504400,119518800
855000.0,4,2.25,2480,36974,2.0,0,0,3,9,2480,0,1973,0.0,98005,47.6441,-122.154,3160,35070,34494,0.9329258397793043,6150400,1367076676,1360926276
632500.0,4,1.5,2720,37258,2.0,0,0,2,10,2720,0,1994,0.0,98077,47.7402,-122.035,3270,39714,34538,0.9269955445810296,7398400,1388158564,1380760164
289950.0,3,2.5,2070,5013,2.0,0,0,2,8,2070,0,1987,0.0,98023,47.3202,-122.395,1670,5013,2943,0.5870736086175943,4284900,25130169,20845269
850000.0,2,1.75,2170,25732,1.0,0,2,3,8,2170,0,1952,0.0,98177,47.7542,-122.37200000000001,3020,23135,23562,0.9156692056583242,4708900,662135824,657426924
565000.0,4,2.75,3260,4900,2.0,0,0,2,9,3260,0,2013,0.0,98059,47.4812,-122.12299999999999,3260,6132,1640,0.3346938775510204,10627600,24010000,13382400
792000.0,3,2.5,2250,19270,2.0,0,0,2,8,2250,0,1999,0.0,98074,47.6569,-122.088,2940,19541,17020,0.8832381940840685,5062500,371332900,366270400
260000.0,3,2.25,1950,9600,1.0,0,0,3,7,1200,750,1987,0.0,98092,47.2762,-122.148,1760,8850,7650,0.796875,3802500,92160000,88357500
585000.0,3,2.0,2220,209523,1.0,0,0,2,7,2220,0,1991,0.0,98019,47.7586,-121.911,1600,210830,207303,0.9894045045174038,4928400,43899887529,43894959129
295500.0,3,1.75,1330,10523,1.0,0,0,2,7,1000,330,1981,0.0,98055,47.4605,-122.206,1320,8775,9193,0.8736101872089709,1768900,110733529,108964629
329000.0,4,2.0,1190,7877,1.5,0,0,4,7,1190,0,1946,0.0,98155,47.7538,-122.322,1480,9975,6687,0.8489272565697601,1416100,62047129,60631029
750000.0,3,1.75,2770,15232,1.0,0,0,2,8,1570,1200,1976,0.0,98006,47.5706,-122.16,2340,11400,12462,0.8181460084033614,7672900,232013824,224340924
495000.0,4,2.5,2310,7555,2.0,0,0,2,9,2310,0,1997,0.0,98155,47.7544,-122.303,1980,8416,5245,0.6942422236929185,5336100,57078025,51741925
672500.0,3,1.75,1580,5750,1.0,0,2,3,8,1330,250,1947,0.0,98199,47.6339,-122.39200000000001,2480,5750,4170,0.7252173913043478,2496400,33062500,30566100
1310000.0,5,3.25,2800,3200,1.5,0,0,4,10,1910,890,1932,2002.0,98109,47.6421,-122.35,2450,3500,400,0.125,7840000,10240000,2400000
405000.0,3,2.5,1500,9636,2.0,0,0,2,7,1500,0,1994,0.0,98011,47.75,-122.176,1700,9656,8136,0.8443337484433375,2250000,92852496,90602496
620000.0,3,1.75,2140,5808,1.0,0,1,2,7,1070,1070,1947,0.0,98119,47.6435,-122.37299999999999,1930,5808,3668,0.6315426997245179,4579600,33732864,29153264
615000.0,4,2.25,2330,7020,1.0,0,0,3,8,1450,880,1973,0.0,98006,47.562,-122.139,2330,8500,4690,0.6680911680911681,5428900,49280400,43851500
887000.0,6,2.25,3830,11180,1.0,0,2,4,9,2440,1390,1962,0.0,98008,47.5849,-122.113,2500,10400,7350,0.6574239713774598,14668900,124992400,110323500
1060000.0,4,2.75,4510,5000,2.5,0,2,2,8,3270,1240,1941,2000.0,98117,47.6852,-122.4,2010,5000,490,0.098,20340100,25000000,4659900
753000.0,4,1.75,2160,39430,1.0,0,0,3,8,1660,500,1974,0.0,98005,47.6378,-122.185,2430,35329,37270,0.9452193761095612,4665600,1554724900,1550059300
1600000.0,3,2.25,3170,5000,2.0,0,0,4,10,2230,940,1975,0.0,98102,47.6349,-122.318,3170,5400,1830,0.366,10048900,25000000,14951100
3710000.0,4,3.5,5550,28078,2.0,0,2,3,12,3350,2200,2000,0.0,98039,47.6395,-122.234,2980,19602,22528,0.8023363487427879,30802500,788374084,757571584
365000.0,3,1.5,1520,8519,1.0,0,0,2,7,1520,0,1954,0.0,98133,47.7712,-122.339,1570,9000,6999,0.8215753022655241,2310400,72573361,70262961
870000.0,4,2.75,3410,23000,2.0,0,0,3,10,3410,0,1982,0.0,98006,47.5559,-122.149,2490,15512,19590,0.8517391304347826,11628100,529000000,517371900
321000.0,4,2.5,1830,9601,2.0,0,0,2,7,1830,0,2003,0.0,98038,47.3541,-122.015,1830,5892,7771,0.8093948547026352,3348900,92179201,88830301
280000.0,3,2.5,1550,4486,2.0,0,0,2,7,1550,0,2000,0.0,98001,47.3299,-122.26899999999999,1700,4487,2936,0.654480606330807,2402500,20124196,17721696
288000.0,3,2.5,1520,3593,2.0,0,0,2,7,1520,0,2004,0.0,98038,47.3842,-122.042,1610,3612,2073,0.5769551906484831,2310400,12909649,10599249
248500.0,3,2.0,1240,12285,1.0,0,0,2,7,620,620,1939,1991.0,98023,47.3219,-122.34100000000001,1560,11564,11045,0.899063899063899,1537600,150921225,149383625
330000.0,4,2.5,2380,13550,2.0,0,0,2,7,2380,0,1999,0.0,98188,47.4486,-122.288,1230,9450,11170,0.8243542435424355,5664400,183602500,177938100
740000.0,5,3.5,2720,11454,2.0,0,0,2,9,1830,890,1988,0.0,98052,47.6466,-122.119,2920,11310,8734,0.7625283743670334,7398400,131194116,123795716
445000.0,3,2.5,2210,8010,2.0,0,0,2,8,2210,0,1998,0.0,98045,47.4845,-121.775,2430,9600,5800,0.7240948813982522,4884100,64160100,59276000
198500.0,2,1.0,1050,9600,1.0,0,0,3,6,1050,0,1959,0.0,98023,47.3274,-122.346,990,8880,8550,0.890625,1102500,92160000,91057500
280000.0,7,2.5,1940,5458,2.0,0,0,2,7,1940,0,1994,0.0,98092,47.3191,-122.177,1710,5688,3518,0.6445584463173324,3763600,29789764,26026164
336500.0,3,2.25,1420,3433,2.0,0,0,3,7,1420,0,1981,0.0,98034,47.7245,-122.163,1150,3432,2013,0.5863676085056801,2016400,11785489,9769089
267000.0,3,2.5,1690,10336,2.0,0,0,3,7,1690,0,1989,0.0,98010,47.31100000000001,-122.00299999999999,1580,7700,8646,0.8364938080495357,2856100,106832896,103976796
315000.0,3,1.0,1160,9180,1.0,0,0,2,7,1160,0,1968,0.0,98077,47.7427,-122.072,1160,10282,8020,0.8736383442265795,1345600,84272400,82926800
545000.0,4,2.5,2040,7412,2.0,0,0,2,8,2040,0,1988,0.0,98074,47.6347,-122.02600000000001,2050,7830,5372,0.7247706422018348,4161600,54937744,50776144
274950.0,3,1.75,1840,16679,1.0,0,0,2,8,1840,0,1989,0.0,98001,47.3207,-122.275,1910,15571,14839,0.8896816355896636,3385600,278189041,274803441
500000.0,2,1.0,1440,7130,1.0,0,2,2,7,1210,230,1948,0.0,98115,47.6778,-122.26700000000001,1970,7130,5690,0.7980364656381487,2073600,50836900,48763300
299000.0,3,1.0,1390,9624,1.5,0,0,3,7,1390,0,1954,0.0,98155,47.7758,-122.301,1440,9624,8234,0.8555694098088114,1932100,92621376,90689276
420000.0,3,2.5,1470,1445,2.0,0,0,2,8,1160,310,2005,0.0,98029,47.5468,-121.99799999999999,1470,1525,-25,-0.01730103806228374,2160900,2088025,-72875
620000.0,3,2.5,1776,1248,3.0,0,0,2,8,1604,172,2006,0.0,98103,47.6539,-122.352,1780,1248,-528,-0.4230769230769231,3154176,1557504,-1596672
575950.0,3,2.25,1640,12000,1.0,0,0,2,7,1180,460,1967,0.0,98008,47.6252,-122.104,1620,12000,10360,0.8633333333333333,2689600,144000000,141310400
666500.0,4,2.5,2860,6600,2.0,0,0,2,9,2860,0,2000,0.0,98074,47.6067,-122.01700000000001,2790,6723,3740,0.5666666666666667,8179600,43560000,35380400
180000.0,4,1.5,1740,7292,1.0,0,0,2,7,1020,720,1962,0.0,98168,47.4787,-122.302,1740,7573,5552,0.7613823368074603,3027600,53173264,50145664
261350.0,3,1.75,1390,18200,1.0,0,0,3,7,1390,0,1962,0.0,98023,47.3208,-122.337,1810,9675,16810,0.9236263736263737,1932100,331240000,329307900
1030000.0,4,3.5,2730,5607,1.0,0,0,4,9,1660,1070,1948,0.0,98199,47.6387,-122.396,1720,5400,2877,0.5131086142322098,7452900,31438449,23985549
390000.0,3,1.75,1435,8960,1.0,0,0,3,8,1435,0,1969,0.0,98058,47.4525,-122.149,2030,9450,7525,0.83984375,2059225,80281600,78222375
253500.0,3,1.0,1640,12384,1.0,0,0,3,7,1090,550,1954,0.0,98003,47.3256,-122.29799999999999,1550,11200,10744,0.8675710594315246,2689600,153363456,150673856
625000.0,4,2.5,2630,48706,2.0,0,0,2,8,2630,0,1986,0.0,98072,47.775,-122.125,2680,48706,46076,0.9460025458875703,6916900,2372274436,2365357536
255000.0,4,2.5,1580,7800,1.0,0,0,3,7,1580,0,1959,0.0,98059,47.481,-122.163,1320,7800,6220,0.7974358974358975,2496400,60840000,58343600
257000.0,3,2.5,1740,3721,2.0,0,0,2,8,1740,0,2009,0.0,98002,47.3363,-122.213,2030,3794,1981,0.5323837678043537,3027600,13845841,10818241
869000.0,2,1.75,1900,13122,1.0,1,4,2,7,1100,800,1954,0.0,98178,47.5121,-122.24799999999999,1650,13160,11222,0.855204999237921,3610000,172186884,168576884
745000.0,4,2.5,3130,10860,2.0,0,0,2,10,3130,0,1990,0.0,98075,47.56,-122.04,3130,10860,7730,0.7117863720073665,9796900,117939600,108142700
1350000.0,4,3.5,3500,9525,2.0,0,0,2,10,3500,0,1999,0.0,98040,47.5641,-122.221,2630,9525,6025,0.6325459317585301,12250000,90725625,78475625
350000.0,3,1.75,2130,7500,1.0,0,0,3,7,1090,1040,1956,0.0,98166,47.4593,-122.34299999999999,1590,7500,5370,0.716,4536900,56250000,51713100
475000.0,3,2.5,950,1110,2.0,0,0,2,8,950,0,2003,0.0,98102,47.6226,-122.319,1230,1215,160,0.14414414414414414,902500,1232100,329600
540000.0,3,2.5,1720,11656,2.0,0,0,2,8,1720,0,1987,1999.0,98052,47.6791,-122.113,1890,10336,9936,0.8524365133836651,2958400,135862336,132903936
175000.0,2,1.0,830,2699,1.0,0,0,2,7,830,0,1996,0.0,98038,47.3839,-122.038,1030,3574,1869,0.6924786958132642,688900,7284601,6595701
100000.0,2,0.75,660,5240,1.0,0,0,3,4,660,0,1912,0.0,98032,47.3881,-122.234,850,5080,4580,0.8740458015267175,435600,27457600,27022000
890000.0,5,1.0,2590,4652,2.0,0,0,3,8,2310,280,1907,0.0,98122,47.6038,-122.294,2360,4650,2062,0.44325021496130695,6708100,21641104,14933004
280000.0,3,2.5,1600,4271,2.0,0,0,2,7,1600,0,2000,0.0,98001,47.3303,-122.26899999999999,1700,4746,2671,0.6253804729571529,2560000,18241441,15681441
1050000.0,4,4.25,4390,13833,2.0,0,3,2,10,3320,1070,2003,0.0,98029,47.5566,-122.02600000000001,3850,11652,9443,0.6826429552519337,19272100,191351889,172079789
486000.0,4,2.5,3560,12047,2.0,0,0,2,10,3560,0,1988,0.0,98023,47.3019,-122.34100000000001,3420,11250,8487,0.7044907445837137,12673600,145130209,132456609
670000.0,5,2.5,2860,68519,2.0,0,0,4,8,2860,0,1958,0.0,98065,47.5265,-121.835,1670,35910,65659,0.9582597527693049,8179600,4694853361,4686673761
480000.0,3,2.5,1640,7847,2.0,0,0,2,8,1640,0,1987,0.0,98029,47.5684,-122.01799999999999,1870,6079,6207,0.7910029310564547,2689600,61575409,58885809
440000.0,3,1.75,1500,6180,1.0,0,0,3,6,1060,440,1947,0.0,98118,47.5689,-122.28399999999999,1740,6180,4680,0.7572815533980582,2250000,38192400,35942400
1500000.0,3,3.25,3990,8505,2.0,0,2,2,9,2870,1120,1922,1999.0,98144,47.5744,-122.28299999999999,3640,8505,4515,0.5308641975308642,15920100,72335025,56414925
743700.0,4,2.5,2610,33206,2.0,0,0,2,10,2610,0,1988,0.0,98053,47.6662,-122.057,2870,28295,30596,0.9213997470336686,6812100,1102638436,1095826336
449950.0,3,1.75,1470,7590,1.0,0,0,2,7,1470,0,1988,0.0,98117,47.6964,-122.36200000000001,1700,5080,6120,0.8063241106719368,2160900,57608100,55447200
367000.0,2,1.0,700,2334,1.0,0,0,2,7,700,0,1945,0.0,98117,47.701,-122.39,2300,5000,1634,0.7000856898029134,490000,5447556,4957556
1190000.0,4,3.25,3960,12895,2.0,0,0,2,11,3960,0,2001,0.0,98059,47.5211,-122.15100000000001,3870,12040,8935,0.6929042264443582,15681600,166281025,150599425
201000.0,3,1.0,900,7576,1.0,0,0,3,6,900,0,1959,0.0,98002,47.2881,-122.22,1220,7452,6676,0.8812038014783526,810000,57395776,56585776
575000.0,3,1.75,2010,3800,2.0,0,0,1,7,2010,0,1922,0.0,98112,47.6408,-122.307,1540,3800,1790,0.4710526315789474,4040100,14440000,10399900
295000.0,3,2.5,1940,10350,1.0,0,0,2,7,1420,520,1979,0.0,98001,47.3385,-122.256,1810,7800,8410,0.81256038647343,3763600,107122500,103358900
190000.0,3,1.0,1510,8760,1.0,0,0,3,6,1510,0,1946,0.0,98002,47.3015,-122.21600000000001,1040,7828,7250,0.8276255707762558,2280100,76737600,74457500
742500.0,2,3.0,2020,5000,1.0,0,0,2,8,1350,670,1952,0.0,98117,47.6758,-122.375,1160,1118,2980,0.596,4080400,25000000,20919600
875000.0,6,3.5,4430,11453,2.0,0,0,2,9,3000,1430,2001,0.0,98056,47.5156,-122.204,2730,5661,7023,0.6132017811927006,19624900,131171209,111546309
1390000.0,4,3.5,4010,10880,2.0,0,3,3,11,3150,860,1990,0.0,98040,47.5359,-122.213,3530,17310,6870,0.6314338235294118,16080100,118374400,102294300
600000.0,4,2.25,3070,8400,2.0,0,0,3,8,3070,0,1970,0.0,98034,47.7316,-122.169,1880,8000,5330,0.6345238095238095,9424900,70560000,61135100
207000.0,3,1.5,1460,11100,1.0,0,0,2,7,1460,0,1956,0.0,98003,47.3253,-122.29799999999999,1460,11100,9640,0.8684684684684685,2131600,123210000,121078400
650000.0,4,2.75,3260,5335,2.0,0,0,2,9,3260,0,2003,0.0,98065,47.5414,-121.86399999999999,3180,5438,2075,0.3889409559512652,10627600,28462225,17834625
275000.0,2,1.0,830,5610,1.0,0,0,2,6,830,0,1922,0.0,98126,47.5674,-122.367,1310,2793,4780,0.8520499108734403,688900,31472100,30783200
1200000.0,4,2.5,2390,4200,2.0,0,0,2,9,2150,240,1924,0.0,98102,47.6272,-122.318,2800,5250,1810,0.430952380952381,5712100,17640000,11927900
262500.0,3,2.0,1130,7200,1.0,0,0,3,6,1130,0,1944,0.0,98166,47.4779,-122.34200000000001,1270,7500,6070,0.8430555555555556,1276900,51840000,50563100
399000.0,2,1.0,1120,8661,1.0,0,0,2,7,1120,0,1946,0.0,98125,47.7034,-122.307,1470,7205,7541,0.8706846784435978,1254400,75012921,73758521
139000.0,4,1.5,1410,10648,1.0,0,0,3,7,1410,0,1966,0.0,98030,47.3736,-122.18799999999999,1410,10522,9238,0.8675807663410969,1988100,113379904,111391804
575000.0,3,2.5,1750,4797,2.0,0,0,3,7,1750,0,1991,0.0,98033,47.6954,-122.199,1750,4293,3047,0.6351886595789035,3062500,23011209,19948709
580000.0,2,1.0,1040,3200,1.0,0,0,2,7,1040,0,1926,0.0,98103,47.6558,-122.334,1890,4000,2160,0.675,1081600,10240000,9158400
468000.0,3,2.25,1630,2490,2.0,0,0,2,7,1630,0,2004,0.0,98053,47.6807,-122.031,1630,2680,860,0.3453815261044177,2656900,6200100,3543200
230000.0,3,1.0,1380,10112,1.0,0,0,3,7,940,440,1963,0.0,98023,47.3196,-122.351,1240,10112,8732,0.8635284810126582,1904400,102252544,100348144
675000.0,4,4.0,3680,18804,2.0,0,0,2,10,3680,0,1990,0.0,98074,47.6193,-122.014,3200,15954,15124,0.8042969580940226,13542400,353590416,340048016
318000.0,3,1.0,1250,20040,1.0,0,0,2,7,1250,0,1970,0.0,98072,47.7514,-122.10799999999999,1640,19840,18790,0.937624750499002,1562500,401601600,400039100
332100.0,5,3.5,2660,6978,2.0,0,0,2,8,1980,680,1996,0.0,98092,47.2631,-122.212,2220,7294,4318,0.6188019489825165,7075600,48692484,41616884
175000.0,2,1.0,620,6600,1.0,0,0,2,6,620,0,1963,0.0,98168,47.4862,-122.33,1050,6600,5980,0.906060606060606,384400,43560000,43175600
817000.0,4,2.25,2600,10660,2.0,0,0,3,8,2600,0,1979,0.0,98006,47.5533,-122.156,3150,10660,8060,0.7560975609756098,6760000,113635600,106875600
1200000.0,4,3.0,2150,8119,2.0,0,0,2,8,2150,0,1953,2004.0,98039,47.6335,-122.236,1590,8119,5969,0.7351890626924498,4622500,65918161,61295661
525000.0,3,1.75,1470,6550,1.0,0,2,2,7,1070,400,1916,0.0,98126,47.5463,-122.381,1440,6550,5080,0.7755725190839695,2160900,42902500,40741600
189000.0,3,1.0,1380,7282,1.5,0,0,4,6,1380,0,1915,0.0,98002,47.3006,-122.223,860,4826,5902,0.810491623180445,1904400,53027524,51123124
629950.0,3,2.5,1680,1683,2.0,0,0,2,9,1120,560,2014,0.0,98119,47.6425,-122.374,1610,1618,3,0.0017825311942959,2822400,2832489,10089
641500.0,1,1.0,1000,9084,1.0,0,3,2,7,1000,0,1950,0.0,98146,47.5007,-122.382,1090,6536,8084,0.8899163364156759,1000000,82519056,81519056
490000.0,3,2.25,1630,7573,1.0,0,2,2,7,1230,400,1983,0.0,98034,47.7273,-122.211,1550,7695,5943,0.78476165324178,2656900,57350329,54693429
415000.0,3,1.75,1790,15142,1.0,0,0,2,7,1360,430,1976,0.0,98072,47.7362,-122.17200000000001,1910,7500,13352,0.8817857614581958,3204100,229280164,226076064
250000.0,2,1.0,890,6380,1.0,0,0,2,6,890,0,1951,0.0,98115,47.691,-122.303,990,6380,5490,0.8605015673981191,792100,40704400,39912300
781000.0,3,1.5,1290,8175,1.0,0,0,3,7,820,470,1952,0.0,98004,47.6296,-122.205,2130,8577,6885,0.8422018348623853,1664100,66830625,65166525
400000.0,4,2.25,2420,7927,1.0,0,0,3,7,1400,1020,1973,0.0,98133,47.7583,-122.34299999999999,2120,7693,5507,0.6947142676926958,5856400,62837329,56980929
935000.0,4,3.0,3680,7105,2.0,0,2,2,10,2890,790,2008,0.0,98115,47.6956,-122.311,1580,6815,3425,0.48205489092188597,13542400,50481025,36938625
575000.0,4,2.5,3020,17810,1.0,0,0,2,9,1600,1420,1979,0.0,98155,47.7735,-122.281,2500,15815,14790,0.8304323413812464,9120400,317196100,308075700
1660000.0,4,3.25,4240,11189,2.0,0,2,2,10,4240,0,2006,0.0,98033,47.6526,-122.191,3390,12540,6949,0.6210563946733398,17977600,125193721,107216121
302300.0,5,2.75,3130,9450,1.0,0,0,3,8,1580,1550,1973,0.0,98023,47.3099,-122.384,1900,9000,6320,0.6687830687830688,9796900,89302500,79505600
355000.0,2,1.0,900,6656,1.0,0,0,2,7,900,0,1940,0.0,98126,47.5467,-122.37700000000001,1230,6400,5756,0.8647836538461539,810000,44302336,43492336
1540000.0,3,2.25,2880,7599,1.0,0,2,2,9,1710,1170,1958,2002.0,98033,47.6938,-122.215,2920,12401,4719,0.621002763521516,8294400,57744801,49450401
926250.0,4,1.75,2390,17717,1.0,0,0,3,8,2390,0,1964,0.0,98040,47.5755,-122.21799999999999,2390,10730,15327,0.8651013151210701,5712100,313892089,308179989
300000.0,3,1.75,1450,7620,1.0,0,0,3,7,1050,400,1955,0.0,98166,47.4569,-122.354,1380,7620,6170,0.8097112860892388,2102500,58064400,55961900
361500.0,3,1.75,1070,9000,1.0,0,0,3,7,1070,0,1978,0.0,98052,47.6984,-122.132,1700,8400,7930,0.8811111111111111,1144900,81000000,79855100
616000.0,3,1.5,1740,9840,1.0,0,0,3,8,1740,0,1963,0.0,98040,47.5748,-122.23700000000001,1930,9840,8100,0.823170731707317,3027600,96825600,93798000
395000.0,2,1.75,1210,1161,2.0,0,0,2,8,1210,0,2014,0.0,98029,47.5513,-121.99799999999999,1700,2285,-49,-0.04220499569336779,1464100,1347921,-116179
245000.0,3,1.5,2100,10000,1.0,0,0,3,7,2100,0,1954,0.0,98198,47.4222,-122.331,1300,7500,7900,0.79,4410000,100000000,95590000
206000.0,3,1.0,1060,9600,1.0,0,0,3,6,1060,0,1962,0.0,98023,47.2878,-122.35799999999999,1060,9604,8540,0.8895833333333333,1123600,92160000,91036400
706000.0,4,2.5,3280,16575,1.0,0,0,2,9,2190,1090,1972,0.0,98188,47.426,-122.285,1570,13209,13295,0.8021116138763198,10758400,274730625,263972225
578000.0,3,1.5,1660,6000,1.5,0,0,2,7,1660,0,1937,0.0,98199,47.6409,-122.40100000000001,1640,6000,4340,0.7233333333333334,2755600,36000000,33244400
341950.0,5,3.0,3070,5252,2.0,0,0,2,8,3070,0,2005,0.0,98042,47.3666,-122.12799999999999,2760,5203,2182,0.41546077684691546,9424900,27583504,18158604
305000.0,3,1.0,1150,9048,1.0,0,0,1,7,1150,0,1922,0.0,98033,47.6755,-122.177,1550,8207,7898,0.8729000884173298,1322500,81866304,80543804
575000.0,3,2.75,1710,3600,1.0,0,0,2,7,1590,120,1909,0.0,98119,47.641999999999996,-122.36,1710,3600,1890,0.525,2924100,12960000,10035900
330000.0,3,1.0,1180,43124,1.0,0,0,3,6,1180,0,1959,0.0,98027,47.5278,-122.06299999999999,1410,43560,41944,0.9726370466561544,1392400,1859679376,1858286976
445000.0,4,2.25,2130,7200,2.0,0,0,2,7,2130,0,1972,0.0,98034,47.7152,-122.16799999999999,1990,7200,5070,0.7041666666666667,4536900,51840000,47303100
333000.0,3,1.0,1050,7560,1.0,0,0,2,7,1050,0,1951,0.0,98126,47.525,-122.37100000000001,1490,7560,6510,0.8611111111111112,1102500,57153600,56051100
598500.0,4,2.5,2520,3980,2.0,0,0,2,8,2520,0,2005,0.0,98027,47.5401,-122.07,2610,3980,1460,0.36683417085427134,6350400,15840400,9490000
225000.0,2,1.0,700,6000,1.0,0,0,2,6,700,0,1943,0.0,98055,47.4671,-122.212,1320,6000,5300,0.8833333333333333,490000,36000000,35510000
570000.0,4,2.5,2640,4200,2.0,0,0,2,8,2640,0,1998,0.0,98074,47.6038,-122.02,2460,4200,1560,0.37142857142857144,6969600,17640000,10670400
630000.0,5,2.0,2330,6783,1.0,0,0,2,7,1310,1020,1956,0.0,98115,47.6955,-122.295,1930,6783,4453,0.6564941766180157,5428900,46009089,40580189
779000.0,5,2.25,2830,7738,2.0,0,0,3,8,2830,0,1977,0.0,98006,47.5582,-122.13600000000001,2300,9840,4908,0.6342724218144223,8008900,59876644,51867744
760000.0,4,3.5,3720,13591,2.0,0,3,2,10,3720,0,2004,0.0,98065,47.536,-121.85799999999999,4210,14282,9871,0.7262894562578177,13838400,184715281,170876881
322968.0,5,1.75,1890,9600,1.0,0,0,3,7,1890,0,1960,0.0,98028,47.7391,-122.241,2350,5308,7710,0.803125,3572100,92160000,88587900
595000.0,4,2.5,2910,7287,2.0,0,0,2,8,2910,0,1998,0.0,98065,47.5354,-121.869,2420,6180,4377,0.6006587072869494,8468100,53100369,44632269
321000.0,4,1.0,1300,18836,1.0,0,0,3,7,1300,0,1941,0.0,98056,47.5029,-122.18799999999999,1540,8498,17536,0.9309832236143555,1690000,354794896,353104896
653000.0,3,2.25,2770,57745,2.0,0,0,2,8,2770,0,1985,0.0,98072,47.775,-122.124,2720,46765,54975,0.9520304788293359,7672900,3334485025,3326812125
750000.0,4,1.75,2520,21834,1.0,1,4,2,8,1420,1100,1960,0.0,98146,47.4996,-122.37799999999999,1700,8100,19314,0.8845836768342952,6350400,476723556,470373156
530000.0,3,1.0,1340,4284,1.0,0,0,2,7,1080,260,1910,0.0,98105,47.6633,-122.324,1960,4080,2944,0.6872082166199813,1795600,18352656,16557056
352750.0,2,1.75,1060,1241,2.0,0,0,2,7,960,100,2008,0.0,98144,47.5999,-122.3,1170,1400,181,0.14585012087026591,1123600,1540081,416481
424950.0,4,2.5,2480,8563,2.0,0,0,2,8,2480,0,1992,0.0,98038,47.381,-122.03299999999999,2460,8660,6083,0.710381875510919,6150400,73324969,67174569
427000.0,5,2.75,2220,4000,1.0,0,0,2,7,1230,990,1973,0.0,98144,47.5754,-122.305,1580,4000,1780,0.445,4928400,16000000,11071600
558000.0,4,2.5,3220,5120,2.0,0,0,2,9,2420,800,2000,0.0,98118,47.5434,-122.27,1770,7680,1900,0.37109375,10368400,26214400,15846000
438200.0,2,2.0,1600,5643,1.0,0,0,2,7,1600,0,1954,0.0,98115,47.6968,-122.279,1600,5746,4043,0.7164628743576112,2560000,31843449,29283449
340000.0,1,1.0,640,4800,1.0,0,0,2,6,640,0,1918,0.0,98136,47.5551,-122.382,1250,2847,4160,0.8666666666666667,409600,23040000,22630400
830005.0,4,3.75,3610,7904,3.0,0,0,2,11,3290,320,1994,0.0,98117,47.6992,-122.385,2460,7300,4294,0.5432692307692307,13032100,62473216,49441116
548000.0,4,3.25,3420,5012,2.0,0,0,2,10,2330,1090,2008,0.0,98019,47.732,-121.98200000000001,2320,5465,1592,0.31763766959297685,11696400,25120144,13423744
411715.0,3,1.75,1840,5101,1.0,0,0,4,7,1040,800,1952,0.0,98108,47.5585,-122.31700000000001,1340,5000,3261,0.6392864144285434,3385600,26020201,22634601
865000.0,4,4.0,2790,16117,2.0,0,0,3,9,2790,0,1999,0.0,98005,47.6033,-122.155,2740,25369,13327,0.8268908605819941,7784100,259757689,251973589
1750000.0,6,4.25,5860,13928,2.0,0,3,2,10,4150,1710,2013,0.0,98006,47.5382,-122.11399999999999,5790,13928,8068,0.5792647903503734,34339600,193989184,159649584
688000.0,3,3.0,3450,16200,2.0,0,0,2,10,3450,0,1983,0.0,98074,47.6319,-122.041,3130,12150,12750,0.7870370370370371,11902500,262440000,250537500
399950.0,4,2.5,2350,5100,2.0,0,0,2,8,2350,0,2003,0.0,98038,47.3507,-122.007,2190,5100,2750,0.5392156862745098,5522500,26010000,20487500
555000.0,3,1.0,1250,4590,1.5,0,0,2,6,970,280,1903,0.0,98115,47.6757,-122.32700000000001,1830,4080,3340,0.7276688453159041,1562500,21068100,19505600
677000.0,3,2.0,2000,3207,1.0,0,0,3,7,1100,900,1916,0.0,98103,47.6561,-122.34100000000001,1460,3200,1207,0.3763642033052697,4000000,10284849,6284849
539000.0,3,2.0,2260,9568,1.0,0,0,2,8,1780,480,1985,0.0,98074,47.6457,-122.05799999999999,2250,9744,7308,0.7637959866220736,5107600,91546624,86439024
410000.0,3,1.75,1510,6597,1.0,0,0,3,6,950,560,1939,0.0,98144,47.5938,-122.315,1460,5320,5087,0.771108079430044,2280100,43520409,41240309
472000.0,2,2.25,1800,2748,2.0,0,0,3,9,1800,0,1979,0.0,98008,47.6104,-122.113,1800,2755,948,0.34497816593886466,3240000,7551504,4311504
755000.0,3,2.5,2420,8856,1.0,0,3,2,9,1620,800,1957,0.0,98118,47.5405,-122.26299999999999,2650,9750,6436,0.7267389340560072,5856400,78428736,72572336
269900.0,5,1.75,1750,8325,1.0,0,0,4,7,1750,0,1966,0.0,98031,47.4007,-122.198,1430,8325,6575,0.7897897897897898,3062500,69305625,66243125
667400.0,4,2.5,2660,40312,2.0,0,0,3,8,2660,0,1977,0.0,98072,47.7532,-122.139,2650,45302,37652,0.934014685453463,7075600,1625057344,1617981744
1220000.0,3,2.25,2640,7544,1.0,0,0,2,10,2640,0,1995,0.0,98004,47.6224,-122.195,2650,7904,4904,0.6500530222693531,6969600,56911936,49942336
544000.0,3,2.5,1460,1613,2.0,0,0,2,8,1180,280,2007,0.0,98117,47.6781,-122.375,1460,1403,153,0.09485430874147552,2131600,2601769,470169
800000.0,2,1.0,1570,5000,1.5,0,3,3,8,1570,0,1924,0.0,98144,47.5955,-122.294,1760,3000,3430,0.686,2464900,25000000,22535100
315000.0,3,1.0,1010,7500,1.0,0,0,3,7,1010,0,1975,0.0,98074,47.6172,-122.061,1250,10000,6490,0.8653333333333333,1020100,56250000,55229900
227000.0,4,1.0,1200,7200,1.5,0,0,2,6,1200,0,1944,0.0,98178,47.4951,-122.24799999999999,1070,6050,6000,0.8333333333333334,1440000,51840000,50400000
765000.0,4,2.5,4040,25752,2.0,0,0,2,10,4040,0,2000,0.0,98038,47.4579,-122.068,3230,22247,21712,0.8431189810500155,16321600,663165504,646843904
625000.0,3,3.0,1820,1641,3.0,0,0,2,8,1540,280,2006,0.0,98119,47.6482,-122.35799999999999,1720,1501,-179,-0.10907982937233394,3312400,2692881,-619519
1880000.0,4,5.0,5810,7440,2.0,0,0,2,10,3790,2020,2004,0.0,98033,47.6878,-122.212,3010,7200,1630,0.21908602150537634,33756100,55353600,21597500
822600.0,4,2.5,3010,9600,1.0,0,2,2,9,1510,1500,1979,0.0,98006,47.5519,-122.156,2780,10000,6590,0.6864583333333333,9060100,92160000,83099900
515000.0,4,2.5,1910,8947,1.0,0,0,3,8,1160,750,1970,0.0,98011,47.7374,-122.18299999999999,1920,7350,7037,0.7865206214373534,3648100,80048809,76400709
377000.0,4,2.0,1640,5014,1.0,0,0,3,7,930,710,1982,0.0,98106,47.5545,-122.35600000000001,1600,5452,3374,0.6729158356601516,2689600,25140196,22450596
600000.0,3,1.0,1480,17360,1.0,0,1,2,8,1480,0,1954,0.0,98136,47.5179,-122.387,2250,8720,15880,0.9147465437788018,2190400,301369600,299179200
525300.0,4,1.75,2520,7770,1.0,0,0,2,8,1680,840,1965,0.0,98177,47.7721,-122.37200000000001,2340,7770,5250,0.6756756756756757,6350400,60372900,54022500
760000.0,4,3.0,2840,13554,1.0,0,2,3,9,1990,850,1974,0.0,98034,47.7153,-122.257,2840,16940,10714,0.7904677585952486,8065600,183710916,175645316
202000.0,2,1.0,840,7200,1.0,0,0,3,5,840,0,1907,0.0,98032,47.3769,-122.23700000000001,1030,7200,6360,0.8833333333333333,705600,51840000,51134400
470000.0,3,2.0,1730,38884,1.0,0,0,2,8,1730,0,1997,0.0,98038,47.4164,-121.95100000000001,2130,91040,37154,0.9555086925213455,2992900,1511965456,1508972556
810000.0,3,2.5,3140,10983,2.0,0,0,2,10,3140,0,1991,0.0,98075,47.5595,-122.04,3140,10983,7843,0.7141036146772285,9859600,120626289,110766689
175000.0,3,1.0,1480,8415,1.0,0,0,2,7,1080,400,1967,0.0,98188,47.4585,-122.28299999999999,1780,8512,6935,0.8241235888294712,2190400,70812225,68621825
440000.0,4,1.75,1920,7986,1.0,0,0,2,7,960,960,1952,0.0,98125,47.7209,-122.318,1700,7452,6066,0.7595792637114951,3686400,63776196,60089796
197000.0,2,1.0,770,8636,1.0,0,0,1,6,770,0,1951,0.0,98146,47.5075,-122.35799999999999,1110,8636,7866,0.9108383510884669,592900,74580496,73987596
254000.0,3,1.0,1010,7384,1.0,0,2,4,6,1010,0,1943,0.0,98056,47.4905,-122.191,1010,8000,6374,0.8632177681473456,1020100,54523456,53503356
405000.0,3,1.0,1460,10000,1.5,0,0,2,7,1460,0,2002,0.0,98074,47.6214,-122.06299999999999,1910,10000,8540,0.854,2131600,100000000,97868400
416000.0,2,1.0,940,4264,1.0,0,0,4,7,940,0,1949,0.0,98126,47.5314,-122.37799999999999,1630,4472,3324,0.7795497185741088,883600,18181696,17298096
779950.0,4,2.75,2840,4864,3.0,0,0,2,9,2840,0,2014,0.0,98052,47.7103,-122.10799999999999,2990,5314,2024,0.4161184210526316,8065600,23658496,15592896
200000.0,4,2.75,1910,7210,1.0,0,0,3,7,1430,480,1980,0.0,98030,47.3693,-122.169,1750,7446,5300,0.7350901525658807,3648100,51984100,48336000
658100.0,4,2.5,2430,8509,2.0,0,0,2,9,2430,0,1992,0.0,98029,47.5714,-121.991,2760,8509,6079,0.7144200258549771,5904900,72403081,66498181
397000.0,2,1.75,1610,4104,1.0,0,0,2,7,950,660,1996,0.0,98118,47.5565,-122.275,1510,5284,2494,0.6076998050682261,2592100,16842816,14250716
815000.0,3,3.75,2780,5002,2.0,0,0,2,10,2780,0,1999,0.0,98007,47.5939,-122.15,3110,5717,2222,0.44422231107556975,7728400,25020004,17291604
345000.0,2,1.0,1160,8504,1.0,0,0,3,7,1160,0,1949,0.0,98155,47.7364,-122.295,1320,8504,7344,0.863593603010348,1345600,72318016,70972416
305500.0,4,2.5,1850,7199,2.0,0,0,3,7,1850,0,1989,0.0,98031,47.4031,-122.17200000000001,1940,7432,5349,0.743019863869982,3422500,51825601,48403101
340000.0,3,2.25,2120,13090,1.0,0,0,2,8,2120,0,1997,0.0,98002,47.29600000000001,-122.219,1400,12039,10970,0.838044308632544,4494400,171348100,166853700
330000.0,5,2.5,2620,12763,1.0,0,0,2,7,1400,1220,1979,0.0,98034,47.72,-122.213,2390,9156,10143,0.7947191099271331,6864400,162894169,156029769
269000.0,4,2.5,2060,3608,2.0,0,0,2,7,2060,0,2004,0.0,98198,47.361999999999995,-122.309,2060,3608,1548,0.42904656319290463,4243600,13017664,8774064
349950.0,3,1.0,1060,9525,1.0,0,0,2,7,1060,0,1966,0.0,98052,47.6855,-122.111,1630,9525,8465,0.8887139107611548,1123600,90725625,89602025
431000.0,3,1.0,1500,6240,1.0,0,0,3,7,1500,0,1953,0.0,98125,47.7281,-122.311,1230,6240,4740,0.7596153846153846,2250000,38937600,36687600
735000.0,4,1.75,2380,5700,2.0,0,1,3,7,1820,560,1946,0.0,98105,47.6656,-122.271,2190,5700,3320,0.5824561403508772,5664400,32490000,26825600
414000.0,5,3.0,3045,5030,2.0,0,0,2,8,3045,0,1999,0.0,98058,47.4386,-122.12700000000001,3045,5322,1985,0.3946322067594433,9272025,25300900,16028875
619500.0,3,2.5,1700,4105,2.0,0,0,2,8,1700,0,1992,0.0,98122,47.6078,-122.292,1880,3665,2405,0.5858708891595615,2890000,16851025,13961025
675000.0,3,1.75,1240,13869,1.0,0,0,3,7,1240,0,1957,0.0,98033,47.6919,-122.21,1970,7790,12629,0.9105919676977432,1537600,192349161,190811561
380500.0,3,1.0,1410,7854,1.0,0,0,3,7,1410,0,1971,0.0,98034,47.7303,-122.19200000000001,1460,7500,6444,0.8204736440030558,1988100,61685316,59697216
253000.0,3,1.5,880,6600,1.0,0,0,4,6,880,0,1945,0.0,98178,47.5002,-122.24700000000001,1020,6600,5720,0.8666666666666667,774400,43560000,42785600
157500.0,2,1.0,740,9003,1.0,0,0,2,5,740,0,1949,0.0,98031,47.4217,-122.197,1230,8050,8263,0.917805176052427,547600,81054009,80506409
627000.0,4,2.0,2030,9300,1.0,0,0,3,8,2030,0,1976,0.0,98052,47.6658,-122.149,1800,9018,7270,0.7817204301075269,4120900,86490000,82369100
469500.0,4,2.5,2090,7241,1.0,0,0,3,7,1140,950,2001,0.0,98034,47.726000000000006,-122.221,1510,7402,5151,0.7113658334484187,4368100,52432081,48063981
319950.0,2,1.0,920,8341,1.0,0,0,2,7,920,0,1939,0.0,98146,47.5015,-122.38,2330,9792,7421,0.8897014746433282,846400,69572281,68725881
249500.0,3,1.0,1180,7200,1.0,0,0,3,7,1180,0,1968,0.0,98058,47.4249,-122.178,1180,7200,6020,0.8361111111111111,1392400,51840000,50447600
485000.0,3,1.0,1260,3230,1.5,0,0,2,7,1260,0,1907,0.0,98119,47.644,-122.369,1700,3500,1970,0.6099071207430341,1587600,10432900,8845300
1130000.0,5,3.0,3690,10260,1.0,0,4,3,9,2070,1620,1967,0.0,98005,47.5919,-122.176,3160,14000,6570,0.6403508771929824,13616100,105267600,91651500
314500.0,3,1.75,1700,17355,1.0,0,0,2,7,1200,500,1978,0.0,98038,47.3637,-122.057,1900,9528,15655,0.9020455200230482,2890000,301196025,298306025
220000.0,2,1.0,770,8149,1.0,0,0,2,6,770,0,1948,0.0,98155,47.7467,-122.3,880,8149,7379,0.9055098785127009,592900,66406201,65813301
444950.0,3,2.5,2020,7800,1.0,0,0,3,7,1330,690,1958,0.0,98133,47.7368,-122.337,1870,7800,5780,0.7410256410256411,4080400,60840000,56759600
598000.0,4,2.5,2030,9825,1.0,0,0,2,8,1330,700,1985,0.0,98115,47.6892,-122.3,2180,7500,7795,0.7933842239185751,4120900,96530625,92409725
699850.0,4,3.5,2690,6164,2.0,0,0,2,9,2690,0,2002,0.0,98075,47.599,-121.973,2910,5000,3474,0.563595068137573,7236100,37994896,30758796
595000.0,3,2.5,1750,3354,2.0,0,0,3,7,1750,0,1991,0.0,98033,47.6953,-122.199,1750,4286,1604,0.4782349433512224,3062500,11249316,8186816
735000.0,4,2.5,3270,45537,2.0,0,0,2,9,3270,0,1993,0.0,98053,47.6303,-121.984,2670,38827,42267,0.9281902628631662,10692900,2073618369,2062925469
542500.0,4,2.5,2330,14289,2.0,0,0,3,8,2330,0,1978,0.0,98007,47.5916,-122.148,2210,12823,11959,0.836937504373994,5428900,204175521,198746621
450000.0,3,1.75,1720,6960,1.0,0,0,2,7,1140,580,1978,0.0,98052,47.6972,-122.12899999999999,1720,7280,5240,0.7528735632183908,2958400,48441600,45483200
298500.0,3,2.0,2420,8800,1.0,0,0,3,7,1420,1000,1959,0.0,98188,47.4322,-122.291,1546,8666,6380,0.725,5856400,77440000,71583600
403950.0,2,1.0,710,1136,2.0,0,0,3,7,710,0,1943,0.0,98102,47.6414,-122.329,1370,1173,426,0.375,504100,1290496,786396
271000.0,2,1.0,710,4240,1.0,0,0,3,6,710,0,1942,0.0,98106,47.5226,-122.351,850,5200,3530,0.8325471698113207,504100,17977600,17473500
335000.0,2,1.0,1510,3844,1.0,0,0,3,7,1510,0,1923,1970.0,98133,47.7038,-122.348,1170,3844,2334,0.6071800208116546,2280100,14776336,12496236
305000.0,2,2.25,1610,1968,2.0,0,0,4,7,1610,0,1979,0.0,98056,47.5184,-122.196,1950,1968,358,0.18191056910569106,2592100,3873024,1280924
630000.0,3,3.0,1880,2200,2.0,0,0,2,8,1520,360,2007,0.0,98107,47.6666,-122.367,1500,1426,320,0.14545454545454545,3534400,4840000,1305600
253000.0,2,1.75,1220,5000,1.0,0,0,4,7,860,360,1921,0.0,98055,47.4906,-122.204,1120,5000,3780,0.756,1488400,25000000,23511600
395000.0,4,1.75,2060,7900,1.0,0,0,3,7,1070,990,1957,0.0,98008,47.6028,-122.12,1830,8000,5840,0.739240506329114,4243600,62410000,58166400
265000.0,3,2.5,1340,10290,1.0,0,0,3,7,1140,200,1981,0.0,98042,47.3553,-122.149,1760,7903,8950,0.86977648202138,1795600,105884100,104088500
225000.0,2,1.0,1030,9192,1.0,0,0,3,6,1030,0,1959,0.0,98058,47.4565,-122.181,1030,9190,8162,0.8879460400348129,1060900,84492864,83431964
338500.0,4,2.5,2717,4513,2.0,0,0,2,8,2717,0,2005,0.0,98001,47.3373,-122.266,2550,4841,1796,0.397961444715267,7382089,20367169,12985080
300000.0,2,1.75,1360,8100,1.0,0,0,2,7,860,500,1975,0.0,98177,47.7295,-122.359,1830,6766,6740,0.8320987654320988,1849600,65610000,63760400
255000.0,2,1.0,1260,7810,2.0,0,0,2,6,1260,0,1945,0.0,98178,47.5003,-122.24799999999999,1260,7755,6550,0.8386683738796414,1587600,60996100,59408500
337000.0,4,3.0,2240,8504,2.0,0,0,2,7,2240,0,1992,0.0,98155,47.7348,-122.295,1570,8460,6264,0.7365945437441204,5017600,72318016,67300416
324900.0,3,2.25,2080,9740,2.0,0,0,2,8,2080,0,1988,0.0,98092,47.261,-122.219,2080,8705,7660,0.7864476386036962,4326400,94867600,90541200
821000.0,3,2.75,2760,8476,1.0,0,0,3,8,1690,1070,1967,0.0,98040,47.5402,-122.215,2610,9835,5716,0.6743747050495517,7617600,71842576,64224976
500000.0,4,2.75,3000,213008,1.0,0,0,3,8,3000,0,1975,0.0,98038,47.4032,-121.98200000000001,2300,74191,210008,0.9859160219334485,9000000,45372408064,45363408064
885000.0,4,3.5,3310,6000,2.0,0,2,2,8,2200,1110,2010,0.0,98136,47.5511,-122.391,1420,6000,2690,0.4483333333333333,10956100,36000000,25043900
360000.0,4,2.0,1630,10375,1.0,0,0,4,7,1630,0,1968,0.0,98077,47.7566,-122.073,1360,10026,8745,0.8428915662650602,2656900,107640625,104983725
304000.0,3,1.0,900,7500,1.0,0,0,3,7,900,0,1972,0.0,98034,47.7314,-122.23700000000001,1960,7500,6600,0.88,810000,56250000,55440000
376000.0,2,1.0,880,2400,1.0,0,0,2,6,760,120,1918,0.0,98118,47.5643,-122.275,1180,6300,1520,0.6333333333333333,774400,5760000,4985600
425000.0,4,1.5,1620,7875,1.0,0,0,2,7,1620,0,1956,0.0,98008,47.6041,-122.126,1890,8400,6255,0.7942857142857143,2624400,62015625,59391225
1180000.0,3,1.75,1610,7200,1.0,0,0,2,8,1090,520,1973,0.0,98112,47.6279,-122.287,3790,7200,5590,0.7763888888888889,2592100,51840000,49247900
187000.0,3,2.5,1730,1803,2.0,0,0,2,7,1730,0,2005,0.0,98166,47.4648,-122.335,1190,7980,73,0.040488075429839156,2992900,3250809,257909
710000.0,2,1.5,1640,4080,1.5,0,0,4,7,1540,100,1916,0.0,98105,47.6624,-122.325,1880,4080,2440,0.5980392156862745,2689600,16646400,13956800
585000.0,3,1.75,1840,7350,1.0,0,0,2,8,1370,470,1974,0.0,98033,47.6729,-122.166,1920,8518,5510,0.7496598639455783,3385600,54022500,50636900
1400000.0,5,4.0,4700,22326,2.0,0,0,2,11,4700,0,2002,0.0,98006,47.5417,-122.111,4730,27110,17626,0.7894831138582818,22090000,498450276,476360276
1980000.0,4,3.5,4500,44384,1.0,0,0,2,12,3340,1160,1990,0.0,98004,47.6323,-122.19200000000001,2540,26287,39884,0.8986121124729632,20250000,1969939456,1949689456
250000.0,3,1.75,1780,35233,1.0,0,0,3,8,1420,360,1979,0.0,98001,47.2949,-122.26899999999999,1950,17334,33453,0.9494791814492095,3168400,1241364289,1238195889
950000.0,4,2.75,3800,12200,2.0,0,3,3,10,3800,0,1986,0.0,98006,47.5689,-122.156,3710,14796,8400,0.6885245901639344,14440000,148840000,134400000
725000.0,3,2.5,2980,16996,2.0,0,0,2,10,2980,0,1992,0.0,98075,47.595,-122.016,2980,15438,14016,0.824664626971052,8880400,288864016,279983616
505000.0,4,2.5,2780,6369,1.0,0,0,2,8,1590,1190,1978,0.0,98034,47.7284,-122.21600000000001,2170,7490,3589,0.5635107552205998,7728400,40564161,32835761
90000.0,1,1.0,560,4120,1.0,0,0,2,4,560,0,1947,0.0,98106,47.5335,-122.348,980,4120,3560,0.8640776699029126,313600,16974400,16660800
400000.0,4,2.0,2060,3060,2.0,0,0,2,7,2060,0,1968,0.0,98118,47.5631,-122.285,1630,3766,1000,0.32679738562091504,4243600,9363600,5120000
407000.0,3,1.0,1140,7785,1.0,0,0,2,8,1140,0,1954,0.0,98177,47.708999999999996,-122.363,2080,10620,6645,0.8535645472061657,1299600,60606225,59306625
651000.0,3,1.5,1890,4400,1.5,0,0,4,7,1890,0,1919,0.0,98105,47.6662,-122.32600000000001,1620,4080,2510,0.5704545454545454,3572100,19360000,15787900
485000.0,3,2.25,2090,7450,1.0,0,0,2,7,1350,740,1978,0.0,98155,47.7598,-122.303,1740,7644,5360,0.7194630872483222,4368100,55502500,51134400
460000.0,4,2.75,3460,13168,2.0,0,0,3,8,3460,0,1932,1986.0,98022,47.2046,-121.99600000000001,1500,7670,9708,0.7372417982989065,11971600,173396224,161424624
369000.0,2,1.0,1320,6135,1.0,0,0,3,7,880,440,1942,0.0,98126,47.5265,-122.37899999999999,1050,4693,4815,0.784841075794621,1742400,37638225,35895825
355000.0,2,1.0,1240,27042,1.0,0,1,2,6,1000,240,1943,0.0,98070,47.5026,-122.465,2140,20059,25802,0.9541454034464907,1537600,731269764,729732164
155000.0,2,1.0,810,4755,1.0,0,0,2,7,810,0,1980,0.0,98118,47.5313,-122.28,1180,4755,3945,0.8296529968454258,656100,22610025,21953925
1000000.0,3,1.0,1880,5450,1.5,0,0,3,8,1880,0,1924,0.0,98112,47.6453,-122.302,2580,5450,3570,0.655045871559633,3534400,29702500,26168100
419625.0,4,2.5,2680,11590,2.0,0,0,3,9,2680,0,1988,0.0,98058,47.4395,-122.163,2580,8225,8910,0.7687661777394306,7182400,134328100,127145700
435000.0,3,2.0,2040,6880,2.0,0,0,3,7,2040,0,1954,0.0,98133,47.7601,-122.351,1710,7597,4840,0.7034883720930233,4161600,47334400,43172800
379000.0,4,1.75,2180,7876,1.0,0,0,3,7,1290,890,1977,0.0,98056,47.5157,-122.191,1960,7225,5696,0.723209751142712,4752400,62031376,57278976
293000.0,4,2.25,1870,5371,2.0,0,0,2,7,1870,0,2009,0.0,98038,47.3844,-122.036,2380,4502,3501,0.6518339229193819,3496900,28847641,25350741
592100.0,4,2.75,2310,7851,1.0,0,0,3,8,1790,520,1989,0.0,98006,47.5473,-122.18700000000001,2230,7359,5541,0.7057699656094765,5336100,61638201,56302101
362000.0,3,1.75,1120,9730,1.0,0,0,2,7,1120,0,1944,1989.0,98011,47.7372,-122.221,2530,8717,8610,0.8848920863309353,1254400,94672900,93418500
227000.0,3,1.0,1340,10035,1.0,0,0,2,7,1340,0,1959,0.0,98178,47.4916,-122.25399999999999,2090,10035,8695,0.8664673642252118,1795600,100701225,98905625
335500.0,3,1.75,1260,8487,1.0,0,0,2,7,1260,0,1970,0.0,98011,47.7664,-122.20100000000001,1890,13051,7227,0.8515376458112407,1587600,72029169,70441569
213000.0,3,1.75,1200,55321,1.5,0,0,4,7,1200,0,1977,0.0,98010,47.3492,-121.935,1910,54450,54121,0.9783084181413929,1440000,3060413041,3058973041
338000.0,5,2.5,2400,4496,2.0,0,0,2,7,2400,0,2004,0.0,98042,47.3692,-122.126,1880,4319,2096,0.46619217081850534,5760000,20214016,14454016
163500.0,3,1.0,940,7200,1.0,0,0,3,7,940,0,1954,0.0,98002,47.2979,-122.223,1090,7800,6260,0.8694444444444445,883600,51840000,50956400
199988.0,2,1.0,860,5000,1.0,0,0,2,7,860,0,1949,0.0,98178,47.5005,-122.26700000000001,1130,6000,4140,0.828,739600,25000000,24260400
1190000.0,3,2.25,2390,7875,1.0,0,1,2,10,1980,410,1948,0.0,98105,47.6515,-122.27799999999999,3720,9075,5485,0.6965079365079365,5712100,62015625,56303525
320000.0,4,2.5,3130,5200,2.0,0,0,2,7,3130,0,2005,0.0,98042,47.3828,-122.098,3020,5200,2070,0.39807692307692305,9796900,27040000,17243100
450000.0,6,2.25,3550,11780,1.0,0,0,3,8,2960,590,1948,0.0,98125,47.7218,-122.31200000000001,2360,8850,8230,0.698641765704584,12602500,138768400,126165900
249900.0,2,2.0,1470,2541,2.0,0,0,2,6,1470,0,2005,0.0,98038,47.3502,-122.02,1310,2721,1071,0.4214876033057851,2160900,6456681,4295781
223000.0,2,1.0,910,9869,1.0,0,0,2,6,910,0,1957,0.0,98058,47.4572,-122.184,1480,9750,8959,0.9077920761981964,828100,97397161,96569061
631000.0,4,4.0,2630,59586,1.0,0,0,2,7,1470,1160,1963,0.0,98055,47.4496,-122.209,2230,5715,56956,0.9558621152619743,6916900,3550491396,3543574496
350000.0,4,2.25,1780,10416,1.0,0,0,4,7,1060,720,1963,0.0,98055,47.4414,-122.189,1780,9975,8636,0.8291090629800307,3168400,108493056,105324656
279000.0,3,1.75,1430,39160,1.0,0,0,2,7,900,530,1925,1987.0,98065,47.5513,-121.801,1430,40860,37730,0.9634831460674157,2044900,1533505600,1531460700
310000.0,5,2.0,2730,7344,1.0,0,0,4,7,1510,1220,1962,0.0,98058,47.4602,-122.171,1730,7700,4614,0.6282679738562091,7452900,53934336,46481436
185000.0,2,1.0,900,8000,1.0,0,0,3,6,900,0,1954,0.0,98198,47.4217,-122.31700000000001,1240,8000,7100,0.8875,810000,64000000,63190000
445000.0,3,2.5,1740,22089,1.0,0,0,3,8,1130,610,1977,0.0,98070,47.3948,-122.435,2000,24925,20349,0.9212277604237403,3027600,487923921,484896321
365000.0,4,2.5,2905,4874,2.0,0,0,2,9,2905,0,2003,0.0,98031,47.4084,-122.169,2900,5271,1969,0.4039803036520312,8439025,23755876,15316851
333500.0,3,1.5,2230,9120,1.0,0,0,2,7,1390,840,1959,0.0,98146,47.5008,-122.35799999999999,1420,8450,6890,0.7554824561403509,4972900,83174400,78201500
385000.0,3,2.25,1680,8450,1.0,0,0,2,8,1340,340,1960,0.0,98177,47.7575,-122.361,1850,8300,6770,0.8011834319526627,2822400,71402500,68580100
345000.0,3,1.5,1240,11200,1.0,0,0,3,7,1240,0,1954,0.0,98006,47.5716,-122.13799999999999,1240,11008,9960,0.8892857142857142,1537600,125440000,123902400
1260000.0,3,3.0,3230,8625,2.0,0,3,2,10,2220,1010,1998,0.0,98116,47.562,-122.404,2330,6022,5395,0.6255072463768115,10432900,74390625,63957725
440000.0,4,2.5,2560,10400,1.0,0,0,3,7,1280,1280,1965,0.0,98027,47.5225,-122.04,1740,11050,7840,0.7538461538461538,6553600,108160000,101606400
444500.0,3,2.5,2600,4724,2.0,0,0,2,7,2600,0,2002,0.0,98065,47.5359,-121.87799999999999,2400,4724,2124,0.44961896697713805,6760000,22316176,15556176
340000.0,4,1.0,1200,11834,1.0,1,3,2,6,1200,0,1972,0.0,98070,47.4557,-122.443,1670,47462,10634,0.8985972621260774,1440000,140043556,138603556
680000.0,4,1.0,1660,6075,1.5,0,0,4,7,1660,0,1915,0.0,98117,47.6755,-122.40299999999999,1810,5400,4415,0.7267489711934156,2755600,36905625,34150025
420000.0,3,1.75,1140,8558,1.0,0,0,3,7,1140,0,1982,0.0,98033,47.7027,-122.198,1490,10530,7418,0.8667913063799954,1299600,73239364,71939764
438500.0,3,2.25,3050,10689,2.0,0,0,3,9,3050,0,1988,0.0,98092,47.3326,-122.20100000000001,2697,10925,7639,0.7146599307699504,9302500,114254721,104952221
109500.0,2,1.0,800,10625,1.0,0,0,2,6,800,0,1942,0.0,98168,47.496,-122.31700000000001,1130,10625,9825,0.9247058823529412,640000,112890625,112250625
461000.0,4,2.75,1700,7495,1.0,0,0,3,7,1200,500,1964,0.0,98133,47.7589,-122.354,1650,7495,5795,0.7731821214142762,2890000,56175025,53285025
968000.0,4,1.75,2630,9645,1.0,0,0,3,9,2630,0,1963,0.0,98040,47.5459,-122.228,2690,10439,7015,0.7273198548470711,6916900,93026025,86109125
355000.0,3,1.75,1960,7705,1.0,0,0,3,7,980,980,1950,0.0,98106,47.53,-122.34700000000001,1380,4349,5745,0.745619727449708,3841600,59367025,55525425
249000.0,3,1.5,1180,11579,1.0,0,0,3,7,1180,0,1962,0.0,98058,47.4502,-122.089,1780,22486,10399,0.898091372311944,1392400,134073241,132680841
256500.0,5,2.5,1960,7350,1.0,0,0,3,7,1360,600,1969,0.0,98058,47.4368,-122.165,1900,7350,5390,0.7333333333333333,3841600,54022500,50180900
1810000.0,5,2.5,4250,20441,1.0,0,1,3,11,2490,1760,1984,0.0,98004,47.6377,-122.211,3620,16304,16191,0.7920845359816056,18062500,417834481,399771981
269000.0,3,2.25,1950,8661,1.0,0,0,3,8,1950,0,1966,0.0,98023,47.3127,-122.36200000000001,1950,8800,6711,0.7748527883616211,3802500,75012921,71210421
1350000.0,4,3.5,3600,5217,2.0,0,0,2,9,2720,880,1947,2014.0,98112,47.6189,-122.286,2270,5217,1617,0.3099482461184589,12960000,27217089,14257089
885000.0,3,2.25,2060,9552,1.0,0,0,3,9,1610,450,1975,0.0,98040,47.5402,-122.23100000000001,2930,11212,7492,0.7843383584589615,4243600,91240704,86997104
455000.0,3,2.0,1640,9825,1.0,0,0,3,7,1090,550,1971,0.0,98034,47.7244,-122.2,1500,9750,8185,0.8330788804071246,2689600,96530625,93841025
980000.0,4,2.5,2730,4800,1.5,0,0,4,8,2230,500,1909,0.0,98119,47.641999999999996,-122.35799999999999,2190,4200,2070,0.43125,7452900,23040000,15587100
412500.0,3,1.75,1530,6300,1.0,0,0,2,6,1530,0,1942,2004.0,98126,47.51600000000001,-122.375,920,6300,4770,0.7571428571428571,2340900,39690000,37349100
740000.0,4,3.5,3060,4777,2.0,0,0,2,9,3060,0,2007,0.0,98029,47.555,-122.0,3060,4935,1717,0.3594306049822064,9363600,22819729,13456129
1300000.0,4,2.25,2860,5658,2.0,0,3,2,10,2130,730,1933,0.0,98199,47.6395,-122.40899999999999,2700,5221,2798,0.4945210321668434,8179600,32012964,23833364
326000.0,2,1.5,1030,798,3.0,0,0,2,8,1030,0,2008,0.0,98103,47.6975,-122.34,1020,1026,-232,-0.2907268170426065,1060900,636804,-424096
568500.0,4,2.5,2460,4200,2.0,0,0,2,8,2460,0,1998,0.0,98074,47.6041,-122.02,2460,4200,1740,0.4142857142857143,6051600,17640000,11588400
620000.0,4,2.5,2500,8282,2.0,0,0,2,9,2500,0,2013,0.0,98056,47.5127,-122.169,2500,8046,5782,0.6981405457618932,6250000,68591524,62341524
283000.0,3,1.75,1830,7600,2.0,0,0,2,7,1490,340,1947,0.0,98106,47.5317,-122.351,1300,4000,5770,0.7592105263157894,3348900,57760000,54411100
875000.0,6,3.25,2820,4536,2.0,0,0,3,8,1930,890,1917,0.0,98105,47.6688,-122.309,2820,4536,1716,0.3783068783068783,7952400,20575296,12622896
1310000.0,4,2.25,3750,5000,2.0,0,0,4,8,2440,1310,1924,0.0,98115,47.6747,-122.303,2170,4590,1250,0.25,14062500,25000000,10937500
289950.0,3,2.5,2070,6145,2.0,0,0,2,7,2070,0,2003,0.0,98092,47.3357,-122.17200000000001,2070,5297,4075,0.6631407648494712,4284900,37761025,33476125
252500.0,3,2.5,1780,7192,1.0,0,0,3,7,1250,530,1974,0.0,98031,47.4093,-122.17299999999999,1870,8500,5412,0.7525027808676307,3168400,51724864,48556464
376000.0,4,2.25,2200,6750,1.0,0,0,4,8,1480,720,1959,0.0,98056,47.5215,-122.20200000000001,2710,6750,4550,0.674074074074074,4840000,45562500,40722500
635700.0,4,2.5,3240,13978,1.0,0,0,2,9,1860,1380,1977,0.0,98074,47.6298,-122.057,3150,12767,10738,0.7682071827156961,10497600,195384484,184886884
710000.0,4,2.5,2880,12349,2.0,0,0,2,10,2880,0,1996,0.0,98075,47.5879,-121.973,3490,11539,9469,0.7667827354441655,8294400,152497801,144203401
440000.0,3,1.75,1570,5120,1.0,0,2,2,7,980,590,1947,0.0,98177,47.7166,-122.365,2420,7200,3550,0.693359375,2464900,26214400,23749500
439000.0,3,2.5,3180,7904,1.0,0,0,2,8,1810,1370,2006,0.0,98056,47.489,-122.181,1950,7800,4724,0.5976720647773279,10112400,62473216,52360816
455000.0,2,1.5,1310,12196,1.5,0,0,2,6,1310,0,1970,0.0,98052,47.6487,-122.12200000000001,2970,12196,10886,0.8925877336831748,1716100,148742416,147026316
225000.0,2,1.0,910,9612,1.0,0,0,3,7,910,0,1981,0.0,98058,47.4297,-122.152,1410,9611,8702,0.9053266749895963,828100,92390544,91562444
250000.0,3,1.0,1460,10914,1.0,0,0,3,7,1460,0,1959,0.0,98058,47.4511,-122.17299999999999,1490,8314,9454,0.8662268645776068,2131600,119115396,116983796
585000.0,4,3.25,3410,34939,2.0,0,0,3,9,2470,940,1992,0.0,98027,47.458999999999996,-122.00299999999999,2450,39045,31529,0.9024013280288503,11628100,1220733721,1209105621
685000.0,3,1.75,2720,4720,1.5,0,0,3,7,1580,1140,1925,0.0,98105,47.6691,-122.29,1660,4640,2000,0.423728813559322,7398400,22278400,14880000
420000.0,5,2.75,2280,10319,1.0,0,0,2,8,1300,980,1959,0.0,98177,47.7566,-122.363,2370,8056,8039,0.7790483573989728,5198400,106481761,101283361
245000.0,2,1.0,670,1675,1.0,0,0,4,6,670,0,1960,0.0,98144,47.5918,-122.295,1220,1740,1005,0.6,448900,2805625,2356725
275000.0,4,2.0,1480,15000,1.0,0,0,3,7,1480,0,1957,0.0,98055,47.4312,-122.196,1450,8768,13520,0.9013333333333333,2190400,225000000,222809600
270000.0,3,2.0,2330,8000,1.0,0,0,2,7,1390,940,1986,0.0,98023,47.2958,-122.368,1570,7227,5670,0.70875,5428900,64000000,58571100
767250.0,4,3.0,2170,2500,2.0,0,0,2,8,1710,460,1997,0.0,98115,47.6742,-122.303,2170,4080,330,0.132,4708900,6250000,1541100
229000.0,3,2.0,1760,9900,1.0,0,0,3,7,1760,0,1943,0.0,98166,47.4783,-122.338,1190,9900,8140,0.8222222222222222,3097600,98010000,94912400
400000.0,3,1.0,1240,4000,1.5,0,0,2,8,1240,0,1928,0.0,98106,47.5467,-122.359,1200,17707,2760,0.69,1537600,16000000,14462400
2200000.0,5,3.25,5210,35765,2.5,0,4,4,10,4940,270,1911,0.0,98136,47.5463,-122.397,2590,10250,30555,0.8543268558646722,27144100,1279135225,1251991125
665000.0,5,2.0,2800,17788,1.0,0,0,3,8,1400,1400,1963,0.0,98033,47.6719,-122.163,1760,18282,14988,0.8425905104564875,7840000,316412944,308572944
500000.0,4,2.25,2060,44431,2.0,0,0,2,7,2060,0,1988,0.0,98077,47.744,-122.046,2160,45657,42371,0.9536359748824019,4243600,1974113761,1969870161
355500.0,5,2.0,2360,19899,1.0,0,0,3,7,2360,0,1968,0.0,98010,47.3299,-122.046,1860,19998,17539,0.8814010754309262,5569600,395970201,390400601
369000.0,4,2.5,2370,6557,2.0,0,0,2,9,2370,0,1998,0.0,98042,47.423,-122.155,2370,7378,4187,0.6385542168674698,5616900,42994249,37377349
338500.0,2,1.0,720,6050,1.0,0,0,1,5,720,0,1951,0.0,98125,47.7259,-122.29,1480,7280,5330,0.8809917355371901,518400,36602500,36084100
256000.0,3,1.0,950,4000,1.0,0,0,2,7,780,170,1949,0.0,98118,47.5232,-122.28399999999999,1230,4000,3050,0.7625,902500,16000000,15097500
470000.0,3,2.5,1980,9725,2.0,0,0,2,8,1980,0,1994,0.0,98045,47.4856,-121.802,2070,9834,7745,0.7964010282776349,3920400,94575625,90655225
675000.0,3,2.5,2540,7680,2.0,0,1,3,9,2540,0,1940,2001.0,98177,47.7175,-122.36399999999999,2490,7680,5140,0.6692708333333334,6451600,58982400,52530800
369950.0,4,2.75,2760,7533,1.0,0,0,2,8,1400,1360,1997,0.0,98042,47.371,-122.10799999999999,2340,7943,4773,0.6336121067303863,7617600,56746089,49128489
615000.0,5,3.5,2950,7980,2.0,0,3,2,9,2350,600,2005,0.0,98065,47.5339,-121.85799999999999,2950,7980,5030,0.6303258145363408,8702500,63680400,54977900
1200000.0,5,3.0,3640,28531,2.0,0,0,2,10,3640,0,1996,0.0,98006,47.5502,-122.13,3330,17186,24891,0.8724194735550804,13249600,814017961,800768361
950000.0,3,1.75,2150,3503,2.0,0,0,2,8,1870,280,1921,0.0,98112,47.6285,-122.303,3920,6402,1353,0.3862403654010848,4622500,12271009,7648509
799500.0,4,2.5,2760,5750,2.0,0,0,2,8,2760,0,1993,0.0,98112,47.626999999999995,-122.303,2760,5390,2990,0.52,7617600,33062500,25444900
187000.0,2,1.0,840,11600,1.0,0,0,2,6,840,0,1952,0.0,98168,47.492,-122.302,1610,9120,10760,0.9275862068965517,705600,134560000,133854400
598000.0,5,2.25,2890,12478,2.0,0,0,2,9,2890,0,1977,0.0,98074,47.6295,-122.052,2570,11880,9588,0.7683923705722071,8352100,155700484,147348384
429950.0,3,2.25,2060,10160,1.0,0,0,3,8,1340,720,1967,0.0,98155,47.7712,-122.285,2320,11186,8100,0.797244094488189,4243600,103225600,98982000
347950.0,5,2.25,1700,13500,1.5,0,0,3,7,1700,0,1962,0.0,98059,47.4611,-122.06700000000001,1810,14550,11800,0.8740740740740741,2890000,182250000,179360000
851000.0,3,2.5,3560,107290,2.0,0,0,2,10,3560,0,1987,0.0,98053,47.6652,-122.04899999999999,3660,89298,103730,0.9668189020411968,12673600,11511144100,11498470500
205000.0,3,1.0,1210,10185,1.0,0,0,2,6,1210,0,1957,0.0,98146,47.4873,-122.345,1320,10245,8975,0.8811978399607265,1464100,103734225,102270125
225000.0,3,2.25,1590,9200,1.0,0,0,3,7,1110,480,1979,0.0,98092,47.2917,-122.184,1880,9200,7610,0.8271739130434783,2528100,84640000,82111900
705000.0,4,2.25,2620,10536,1.0,0,0,2,8,1520,1100,1979,0.0,98075,47.5847,-122.075,2760,12431,7916,0.7513287775246773,6864400,111007296,104142896
535000.0,5,2.5,3190,6178,2.0,0,0,2,8,3190,0,2003,0.0,98059,47.5104,-122.154,2480,7548,2988,0.4836516672062156,10176100,38167684,27991584
222500.0,3,2.0,1450,9044,2.0,0,0,2,7,1450,0,1990,0.0,98022,47.1955,-121.98700000000001,1450,9044,7594,0.8396727111897391,2102500,81793936,79691436
313500.0,2,1.5,1270,1282,2.0,0,0,2,8,1000,270,2006,0.0,98106,47.5581,-122.363,1270,1325,12,0.0093603744149766,1612900,1643524,30624
632000.0,3,2.25,2730,7521,2.0,0,2,2,9,2730,0,1992,0.0,98011,47.7704,-122.196,2700,8204,4791,0.637016354208217,7452900,56565441,49112541
467000.0,3,2.0,1840,3432,2.0,0,0,2,7,1840,0,2012,0.0,98155,47.7368,-122.295,1280,7573,1592,0.46386946386946387,3385600,11778624,8393024
339000.0,3,2.25,1970,7210,1.0,0,0,3,8,1380,590,1978,0.0,98030,47.3821,-122.171,1970,7350,5240,0.7267683772538142,3880900,51984100,48103200
712000.0,3,2.75,3200,6699,2.0,0,0,2,9,3200,0,2004,0.0,98075,47.5884,-121.991,3020,6699,3499,0.522316763696074,10240000,44876601,34636601
335000.0,3,1.0,1060,10050,1.0,0,0,3,7,1060,0,1967,0.0,98028,47.7355,-122.23100000000001,1570,9938,8990,0.8945273631840795,1123600,101002500,99878900
470000.0,3,3.25,1740,1693,2.0,0,0,2,8,1360,380,2007,0.0,98116,47.558,-122.382,1130,1626,-47,-0.027761370348493797,3027600,2866249,-161351
367000.0,3,1.0,810,7000,1.0,0,0,2,7,810,0,1968,0.0,98052,47.6591,-122.134,1820,7589,6190,0.8842857142857142,656100,49000000,48343900
440500.0,3,2.5,2460,4399,2.0,0,0,2,7,2460,0,2007,0.0,98065,47.5415,-121.884,2060,4399,1939,0.440781995908161,6051600,19351201,13299601
305000.0,4,1.0,2100,9288,1.0,0,0,3,7,1050,1050,1968,0.0,98058,47.4558,-122.171,1600,8550,7188,0.7739018087855297,4410000,86266944,81856944
635000.0,3,1.75,1530,5000,1.0,0,2,2,7,1020,510,1948,0.0,98117,47.6806,-122.36,1530,5000,3470,0.694,2340900,25000000,22659100
1020000.0,3,2.25,1670,4800,1.5,0,3,2,8,1670,0,1903,0.0,98119,47.6356,-122.367,2300,4800,3130,0.6520833333333333,2788900,23040000,20251100
342000.0,2,2.5,1175,1366,2.0,0,0,2,8,740,435,2005,0.0,98103,47.6962,-122.34200000000001,1710,1255,191,0.1398243045387994,1380625,1865956,485331
283000.0,3,2.25,2130,8800,1.0,0,0,2,8,1270,860,1978,0.0,98030,47.383,-122.16799999999999,1960,8075,6670,0.7579545454545454,4536900,77440000,72903100
430000.0,4,2.75,2470,50123,1.0,0,0,2,8,1280,1190,1978,0.0,98022,47.2504,-122.0,2200,54520,47653,0.95072122578457,6100900,2512315129,2506214229
245000.0,4,2.5,1700,4268,2.0,0,0,2,7,1700,0,2000,0.0,98001,47.3303,-122.26799999999999,1700,4488,2568,0.6016869728209935,2890000,18215824,15325824
355500.0,3,2.5,2600,5540,2.0,0,0,2,8,2600,0,2004,0.0,98038,47.3446,-122.041,2600,5540,2940,0.5306859205776173,6760000,30691600,23931600
395000.0,3,1.0,1460,5000,1.0,0,0,3,7,1460,0,1934,1960.0,98115,47.6837,-122.32,1790,4000,3540,0.708,2131600,25000000,22868400
324900.0,4,2.25,2010,7280,2.0,0,0,3,8,2010,0,1988,0.0,98032,47.3585,-122.286,1660,7579,5270,0.7239010989010989,4040100,52998400,48958300
660000.0,3,1.75,1320,5750,1.5,0,0,4,7,1320,0,1918,0.0,98116,47.5848,-122.391,1440,5750,4430,0.7704347826086957,1742400,33062500,31320100
570000.0,3,2.5,3150,20189,2.0,0,0,2,10,3150,0,1990,0.0,98058,47.446999999999996,-122.088,2920,20612,17039,0.8439744415275645,9922500,407595721,397673221
552321.0,3,2.5,1960,8469,2.0,0,0,3,8,1960,0,1984,0.0,98052,47.7236,-122.105,2040,8189,6509,0.7685677175581532,3841600,71723961,67882361
1100000.0,2,1.75,2050,11900,1.0,0,0,3,8,2050,0,1950,0.0,98004,47.6209,-122.219,2980,11900,9850,0.8277310924369747,4202500,141610000,137407500
237000.0,3,1.5,1800,9216,1.0,0,0,3,7,1800,0,1950,0.0,98001,47.2739,-122.249,1400,10022,7416,0.8046875,3240000,84934656,81694656
402000.0,2,1.0,1210,5600,1.5,0,0,2,7,1210,0,1922,0.0,98136,47.5322,-122.39200000000001,1400,5028,4390,0.7839285714285714,1464100,31360000,29895900
470000.0,3,2.25,1830,39165,1.0,0,0,4,8,1830,0,1963,0.0,98027,47.4612,-121.992,2020,36184,37335,0.9532746074301034,3348900,1533897225,1530548325
395900.0,3,1.75,1880,8706,1.0,0,0,2,7,940,940,1927,0.0,98155,47.7362,-122.292,1880,7200,6826,0.7840569722030784,3534400,75794436,72260036
442000.0,2,1.75,860,5535,1.0,0,0,2,7,860,0,1948,0.0,98103,47.6901,-122.331,1420,4960,4675,0.8446251129177959,739600,30636225,29896625
795000.0,4,2.75,2890,16397,2.0,0,0,2,10,2890,0,1997,0.0,98077,47.7102,-122.072,3170,16397,13507,0.8237482466304812,8352100,268861609,260509509
190500.0,3,2.0,1390,10155,1.0,0,0,2,7,1130,260,1980,0.0,98003,47.2575,-122.305,1790,10155,8765,0.8631216149679961,1932100,103124025,101191925
808000.0,4,2.75,3340,7230,2.0,0,0,2,9,3340,0,1996,0.0,98027,47.549,-122.096,3230,7529,3890,0.5380359612724758,11155600,52272900,41117300
500000.0,4,2.5,2040,6685,2.0,0,0,2,8,2040,0,1998,0.0,98133,47.7413,-122.354,1890,8253,4645,0.6948391922213911,4161600,44689225,40527625
775000.0,4,2.75,3010,15992,2.0,0,0,2,11,3010,0,1996,0.0,98075,47.5895,-121.994,3330,12333,12982,0.8117808904452226,9060100,255744064,246683964
300000.0,5,1.75,2110,8500,1.0,0,0,2,7,1100,1010,1962,0.0,98133,47.7737,-122.35,2020,8500,6390,0.7517647058823529,4452100,72250000,67797900
496000.0,5,1.75,2110,8500,1.0,0,0,2,7,1100,1010,1962,0.0,98133,47.7737,-122.35,2020,8500,6390,0.7517647058823529,4452100,72250000,67797900
448000.0,4,2.5,2510,6853,2.0,0,2,2,9,2510,0,2006,0.0,98038,47.3547,-122.00299999999999,3400,6965,4343,0.6337370494673865,6300100,46963609,40663509
645000.0,2,2.25,2770,11884,1.0,0,3,3,8,1570,1200,1969,0.0,98070,47.5098,-122.47399999999999,2310,17097,9114,0.7669134971390105,7672900,141229456,133556556
464600.0,3,1.75,1120,5500,1.5,0,0,3,7,1120,0,1925,0.0,98136,47.5445,-122.391,1490,5500,4380,0.7963636363636364,1254400,30250000,28995600
590000.0,3,1.0,1530,2370,2.0,0,0,2,8,1530,0,1901,0.0,98122,47.6108,-122.303,1310,2370,840,0.35443037974683544,2340900,5616900,3276000
399000.0,3,2.5,1800,3300,2.0,0,0,2,7,1690,110,2004,0.0,98118,47.5491,-122.27600000000001,1570,3902,1500,0.45454545454545453,3240000,10890000,7650000
305000.0,2,1.0,1030,6000,1.0,0,0,2,7,1030,0,1925,0.0,98118,47.5669,-122.28299999999999,1510,5000,4970,0.8283333333333334,1060900,36000000,34939100
478000.0,3,1.75,1210,6175,1.0,0,0,2,7,1210,0,1976,0.0,98034,47.7291,-122.20200000000001,1520,7475,4965,0.8040485829959514,1464100,38130625,36666525
598800.0,1,1.0,1090,32010,1.0,0,0,3,6,1090,0,1958,0.0,98014,47.6928,-121.87,1870,25346,30920,0.9659481412058731,1188100,1024640100,1023452000
430000.0,4,2.25,1790,7203,1.0,0,0,3,7,1110,680,1973,0.0,98155,47.7709,-122.294,2270,9000,5413,0.7514924337081772,3204100,51883209,48679109
433000.0,4,1.5,1550,5053,1.0,0,0,3,7,1180,370,1963,0.0,98118,47.5499,-122.274,1450,5639,3503,0.6932515337423313,2402500,25532809,23130309
420000.0,4,2.75,2400,20000,1.0,0,0,2,8,1170,1230,1961,2015.0,98058,47.4556,-122.087,1690,20000,17600,0.88,5760000,400000000,394240000
585000.0,4,1.75,2470,131790,2.0,0,2,2,8,2470,0,1937,0.0,98070,47.4421,-122.444,1470,92747,129320,0.9812580620684422,6100900,17368604100,17362503200
255000.0,3,1.0,1170,7395,1.0,0,0,3,7,1170,0,1969,0.0,98055,47.4627,-122.19,1430,7920,6225,0.8417849898580122,1368900,54686025,53317125
305000.0,3,1.0,1120,10125,1.0,0,0,2,6,1120,0,1961,0.0,98059,47.4794,-122.07799999999999,1120,8820,9005,0.8893827160493827,1254400,102515625,101261225
396000.0,4,1.0,1040,4420,1.5,0,0,2,6,1040,0,1944,0.0,98117,47.6945,-122.368,1310,4920,3380,0.7647058823529411,1081600,19536400,18454800
347500.0,4,2.5,2460,7350,2.0,0,0,2,9,2460,0,1989,0.0,98023,47.3061,-122.34899999999999,2390,8568,4890,0.6653061224489796,6051600,54022500,47970900
900000.0,4,2.5,3690,11468,2.0,0,0,2,11,3690,0,1987,0.0,98027,47.5699,-122.09200000000001,3370,10751,7778,0.6782350889431461,13616100,131515024,117898924
425000.0,3,1.75,1960,43332,1.0,0,0,3,7,1400,560,1982,0.0,98077,47.739,-122.04799999999999,2010,44431,41372,0.954767839010431,3841600,1877662224,1873820624
429000.0,3,2.5,1920,15124,2.0,0,0,2,8,1920,0,1995,0.0,98045,47.5015,-121.773,1920,16477,13204,0.8730494578153928,3686400,228735376,225048976
540000.0,3,2.25,1670,3135,2.0,0,0,2,8,1220,450,2002,0.0,98199,47.6478,-122.396,1630,1596,1465,0.46730462519936206,2788900,9828225,7039325
324950.0,3,2.0,1340,9750,1.0,0,0,3,7,890,450,1974,0.0,98024,47.5644,-121.898,1460,12900,8410,0.8625641025641025,1795600,95062500,93266900
1050000.0,3,2.25,2610,3357,2.0,0,0,3,7,1980,630,1926,0.0,98112,47.63800000000001,-122.306,1940,3357,747,0.2225201072386059,6812100,11269449,4457349
221000.0,4,1.75,1540,7200,1.0,0,0,2,7,1260,280,1966,0.0,98003,47.3424,-122.30799999999999,1540,8416,5660,0.7861111111111111,2371600,51840000,49468400
405000.0,3,2.0,1640,7201,1.0,0,0,2,8,1640,0,1948,0.0,98125,47.7216,-122.289,1750,7201,5561,0.7722538536314401,2689600,51854401,49164801
1150000.0,3,2.5,2100,15120,1.0,0,0,3,8,2100,0,1953,0.0,98004,47.6201,-122.22200000000001,3070,16078,13020,0.8611111111111112,4410000,228614400,224204400
588000.0,4,1.75,1930,7245,1.0,0,0,3,8,1510,420,1972,0.0,98008,47.6396,-122.11200000000001,1880,7245,5315,0.7336093857832988,3724900,52490025,48765125
234950.0,3,2.0,1430,10850,1.0,0,0,2,7,1430,0,1994,0.0,98001,47.2671,-122.23299999999999,1610,8015,9420,0.8682027649769585,2044900,117722500,115677600
580000.0,4,1.5,2430,4995,1.5,0,0,3,7,1730,700,1928,0.0,98144,47.5782,-122.292,2240,5000,2565,0.5135135135135135,5904900,24950025,19045125
637000.0,5,3.0,2460,7240,1.0,0,0,2,9,1840,620,1991,0.0,98006,47.5486,-122.189,2530,7885,4780,0.6602209944751382,6051600,52417600,46366000
704000.0,4,2.25,2490,6973,1.0,0,0,3,8,1490,0,1953,0.0,98199,47.6516,-122.40899999999999,1780,5612,4483,0.6429083608203069,6200100,48622729,42422629
210000.0,2,1.0,880,9750,1.0,0,0,4,6,880,0,1938,0.0,98168,47.4885,-122.29799999999999,1220,9406,8870,0.9097435897435897,774400,95062500,94288100
772000.0,4,2.5,2110,3750,2.0,0,0,2,8,2110,0,2000,0.0,98117,47.6789,-122.363,1700,5000,1640,0.43733333333333335,4452100,14062500,9610400
763000.0,4,1.75,1850,4388,2.0,0,0,4,8,1850,0,1941,0.0,98117,47.6885,-122.381,1410,4107,2538,0.5783956244302644,3422500,19254544,15832044
213500.0,2,1.5,2060,7713,1.5,0,0,3,7,2060,0,1930,0.0,98030,47.3722,-122.185,1780,7713,5653,0.7329184493711915,4243600,59490369,55246769
255000.0,2,1.0,1360,9367,1.0,0,0,3,6,680,680,1924,0.0,98155,47.7689,-122.315,1360,7543,8007,0.8548094373865699,1849600,87740689,85891089
423500.0,3,2.0,2000,10490,1.0,0,0,2,8,1430,570,1978,0.0,98033,47.6976,-122.166,1530,7659,8490,0.8093422306959008,4000000,110040100,106040100
520000.0,3,1.5,1810,18483,1.0,0,0,2,8,1810,0,1954,0.0,98177,47.7617,-122.37799999999999,2920,20279,16673,0.9020721744305578,3276100,341621289,338345189
550000.0,3,2.75,2230,14400,1.0,0,0,3,8,1460,770,1977,0.0,98075,47.5791,-122.04799999999999,2200,13280,12170,0.8451388888888889,4972900,207360000,202387100
795000.0,3,2.75,1820,7517,1.0,0,0,2,9,1820,0,1997,0.0,98116,47.5705,-122.406,2540,8035,5697,0.7578821338299854,3312400,56505289,53192889
495000.0,4,3.0,2740,2811,2.0,0,0,2,8,2240,500,2003,0.0,98072,47.7738,-122.15799999999999,2740,3596,71,0.025257915332621842,7507600,7901721,394121
455000.0,4,2.5,2710,6558,2.0,0,0,2,9,2710,0,1997,0.0,98058,47.434,-122.109,2710,7635,3848,0.5867642573955474,7344100,43007364,35663264
85000.0,2,1.0,910,9753,1.0,0,0,2,5,910,0,1947,0.0,98032,47.3897,-122.236,1160,7405,8843,0.9066953757818107,828100,95121009,94292909
239000.0,4,2.0,1980,10585,1.5,0,0,1,6,1980,0,1924,0.0,98055,47.4836,-122.214,1360,7810,8605,0.8129428436466698,3920400,112042225,108121825
184900.0,3,1.0,1040,10080,1.0,0,0,2,6,1040,0,1959,0.0,98023,47.32899999999999,-122.34299999999999,1000,8736,9040,0.8968253968253969,1081600,101606400,100524800
386000.0,4,2.25,2810,8560,1.0,0,0,2,8,1610,1200,1979,0.0,98058,47.4437,-122.124,2400,7600,5750,0.6717289719626168,7896100,73273600,65377500
415000.0,4,2.5,2000,5962,2.0,0,0,2,8,2000,0,1999,0.0,98133,47.7695,-122.35,1790,10500,3962,0.6645420999664542,4000000,35545444,31545444
387000.0,3,1.0,1530,6372,1.0,0,0,2,7,1210,320,1962,0.0,98118,47.535,-122.289,1960,6426,4842,0.7598870056497176,2340900,40602384,38261484
2140000.0,6,4.0,5110,7128,2.5,0,0,3,11,5110,0,1906,0.0,98112,47.6285,-122.304,4110,6480,2018,0.2831088664421998,26112100,50808384,24696284
685000.0,4,2.25,3133,16197,2.0,0,0,2,9,2533,600,1965,2010.0,98166,47.4255,-122.338,3090,15588,13064,0.8065691177378527,9815689,262342809,252527120
340000.0,4,2.5,2020,32710,1.0,0,0,2,7,1070,950,1941,0.0,98168,47.4969,-122.33,1340,17700,30690,0.9382451849587282,4080400,1069944100,1065863700
422000.0,2,1.0,750,4000,1.0,0,0,3,6,750,0,1926,0.0,98118,47.5547,-122.272,1120,5038,3250,0.8125,562500,16000000,15437500
442000.0,3,2.5,1980,39932,2.0,0,0,2,8,1980,0,1994,0.0,98011,47.7433,-122.196,2610,12769,37952,0.9504157067013924,3920400,1594564624,1590644224
280000.0,3,1.0,1200,6250,1.0,0,0,2,6,920,280,1943,0.0,98168,47.5095,-122.331,1280,9375,5050,0.808,1440000,39062500,37622500
1150000.0,5,2.5,3580,8921,2.0,0,0,2,9,3580,0,2000,0.0,98033,47.69300000000001,-122.20200000000001,2710,9308,5341,0.5986996973433472,12816400,79584241,66767841
279000.0,3,2.5,2010,11618,2.0,0,0,2,7,2010,0,1990,0.0,98022,47.1956,-121.985,1550,9354,9608,0.8269925976932346,4040100,134977924,130937824
569000.0,4,2.0,1730,3884,1.0,0,0,4,7,1060,670,1924,0.0,98103,47.6624,-122.34899999999999,1360,3563,2154,0.554582904222451,2992900,15085456,12092556
1360000.0,5,3.5,5960,13703,2.0,0,2,2,10,4770,1190,1984,0.0,98008,47.6151,-122.10700000000001,2810,17320,7743,0.5650587462599431,35521600,187772209,152250609
209950.0,2,1.0,860,5080,1.0,0,0,2,7,860,0,1960,0.0,98032,47.39,-122.236,1250,6477,4220,0.8307086614173228,739600,25806400,25066800
468000.0,3,1.5,1370,7697,1.0,0,0,2,7,1370,0,1939,0.0,98177,47.7153,-122.361,1370,7697,6327,0.8220085747693907,1876900,59243809,57366909
237100.0,3,1.75,1360,9603,1.0,0,0,2,7,1360,0,1963,0.0,98198,47.3959,-122.309,2240,10605,8243,0.8583775903363532,1849600,92217609,90368009
336000.0,4,2.5,2530,8169,2.0,0,0,2,8,2530,0,1993,0.0,98003,47.2634,-122.31200000000001,2220,8013,5639,0.6902925694699473,6400900,66732561,60331661
500000.0,4,2.0,1680,3813,2.0,0,0,3,7,1680,0,1900,0.0,98144,47.593,-122.29299999999999,2540,3996,2133,0.5594020456333596,2822400,14538969,11716569
290000.0,3,2.5,1580,6860,2.0,0,0,2,7,1580,0,1995,0.0,98055,47.4447,-122.18799999999999,1580,7050,5280,0.7696793002915452,2496400,47059600,44563200
1190000.0,7,3.5,3890,8342,2.0,0,4,2,9,2840,1050,1968,0.0,98117,47.7011,-122.39200000000001,2870,8342,4452,0.533684967633661,15132100,69588964,54456864
365000.0,5,2.0,1600,4168,1.5,0,0,2,7,1600,0,1927,0.0,98126,47.5297,-122.381,1190,4168,2568,0.6161228406909789,2560000,17372224,14812224
146300.0,3,1.0,1200,9668,1.0,0,0,4,6,1200,0,1975,0.0,98092,47.3156,-122.12799999999999,1200,9800,8468,0.8758791890773686,1440000,93470224,92030224
554000.0,3,1.75,1760,10780,1.0,0,0,2,8,1760,0,1977,0.0,98005,47.5938,-122.154,2090,10780,9020,0.8367346938775511,3097600,116208400,113110800
424000.0,3,2.0,1670,7700,1.0,0,0,2,7,1170,500,1972,0.0,98034,47.725,-122.2,1500,7875,6030,0.7831168831168831,2788900,59290000,56501100
1350000.0,4,3.5,4640,9827,2.0,0,2,2,10,3210,1430,2007,0.0,98027,47.5524,-122.07799999999999,3810,8207,5187,0.5278314846850514,21529600,96569929,75040329
508500.0,4,1.5,1800,6750,1.5,0,0,3,7,1800,0,1950,0.0,98115,47.6868,-122.285,1420,5900,4950,0.7333333333333333,3240000,45562500,42322500
244500.0,3,1.75,1210,8864,1.0,0,0,2,7,1210,0,1985,0.0,98042,47.3639,-122.08,1510,8062,7654,0.8634927797833934,1464100,78570496,77106396
206000.0,2,2.5,1280,1566,2.0,0,0,2,7,1280,0,2005,0.0,98055,47.4336,-122.195,1460,1845,286,0.1826309067688378,1638400,2452356,813956
643500.0,3,2.0,1650,7104,2.0,0,0,2,8,1650,0,1945,0.0,98177,47.7053,-122.374,1730,7104,5454,0.7677364864864865,2722500,50466816,47744316
372500.0,4,1.75,1590,10523,2.0,0,0,3,7,1590,0,1922,0.0,98133,47.7358,-122.34200000000001,1610,8568,8933,0.8489024042573411,2528100,110733529,108205429
630000.0,5,2.0,1900,5000,1.0,0,2,2,8,1720,180,1957,0.0,98107,47.6735,-122.36200000000001,1770,5000,3100,0.62,3610000,25000000,21390000
418000.0,2,2.5,1500,3608,2.0,0,0,2,8,1500,0,2005,0.0,98029,47.5472,-121.994,2080,2686,2108,0.5842572062084257,2250000,13017664,10767664
425000.0,4,2.5,2689,6688,2.0,0,0,2,9,2689,0,2006,0.0,98030,47.3803,-122.184,2665,5700,3999,0.5979366028708134,7230721,44729344,37498623
800000.0,4,2.75,3250,5500,2.0,0,0,2,9,3250,0,2007,0.0,98027,47.5398,-121.99700000000001,3920,6000,2250,0.4090909090909091,10562500,30250000,19687500
208000.0,2,1.0,960,13438,1.0,0,0,2,7,960,0,1951,0.0,98168,47.4745,-122.295,1630,11656,12478,0.9285607977377586,921600,180579844,179658244
476000.0,3,1.75,1650,9600,1.0,0,0,3,7,1650,0,1977,0.0,98075,47.5779,-122.044,2040,12220,7950,0.828125,2722500,92160000,89437500
277500.0,3,2.5,1690,5171,2.0,0,0,2,8,1690,0,2003,0.0,98023,47.2779,-122.34700000000001,2550,5025,3481,0.6731773351382712,2856100,26739241,23883141
478000.0,3,1.75,2790,36585,1.0,0,0,3,8,1410,1380,1970,0.0,98027,47.4734,-121.999,1900,45302,33795,0.923739237392374,7784100,1338462225,1330678125
890000.0,4,2.75,2310,4020,3.0,0,0,4,8,2310,0,1979,0.0,98122,47.6154,-122.291,2270,3750,1710,0.4253731343283582,5336100,16160400,10824300
450000.0,3,3.5,1790,1288,3.0,0,0,2,8,1390,400,2000,0.0,98199,47.651,-122.384,1560,1426,-502,-0.38975155279503104,3204100,1658944,-1545156
205000.0,3,1.0,1230,8750,1.0,0,0,2,6,1230,0,1965,0.0,98003,47.3266,-122.334,1230,8750,7520,0.8594285714285714,1512900,76562500,75049600
665000.0,3,2.0,1620,2640,1.5,0,0,4,8,1620,0,1929,0.0,98115,47.6884,-122.322,1470,4080,1020,0.38636363636363635,2624400,6969600,4345200
518000.0,4,2.75,2440,12051,1.0,0,0,4,8,1440,1000,1966,0.0,98133,47.7456,-122.351,2030,8006,9611,0.7975271761679529,5953600,145226601,139273001
465000.0,4,2.25,2100,7350,2.0,0,0,2,8,2100,0,1979,0.0,98033,47.7019,-122.171,1780,7350,5250,0.7142857142857143,4410000,54022500,49612500
330000.0,3,2.5,3040,7232,2.0,0,0,2,7,3040,0,2003,0.0,98092,47.3355,-122.16799999999999,2760,6926,4192,0.5796460176991151,9241600,52301824,43060224
449400.0,4,3.0,2490,5064,2.0,0,0,2,7,2490,0,2007,0.0,98056,47.5139,-122.189,2470,5064,2574,0.5082938388625592,6200100,25644096,19443996
829000.0,3,2.75,2690,10443,1.0,0,0,2,9,2690,0,2007,0.0,98053,47.7185,-122.024,1440,4185,7753,0.7424111845255195,7236100,109056249,101820149
450000.0,4,1.75,2190,9752,1.0,0,0,2,8,2190,0,1964,0.0,98034,47.7108,-122.23899999999999,2040,9964,7562,0.7754306808859721,4796100,95101504,90305404
310000.0,3,1.75,1490,9120,1.0,0,0,4,7,1490,0,1959,0.0,98059,47.4806,-122.163,1340,8040,7630,0.8366228070175439,2220100,83174400,80954300
615000.0,3,2.25,2530,45234,2.0,0,0,3,9,2530,0,1985,0.0,98072,47.7221,-122.12,3110,35617,42704,0.9440686209488438,6400900,2046114756,2039713856
605000.0,3,2.0,2060,4040,1.0,0,0,3,8,1120,940,1947,0.0,98103,47.6798,-122.352,1500,4000,1980,0.4900990099009901,4243600,16321600,12078000
437500.0,3,2.25,1970,35100,2.0,0,0,3,9,1970,0,1977,0.0,98027,47.4635,-121.991,2340,35100,33130,0.9438746438746439,3880900,1232010000,1228129100
545000.0,3,1.75,1400,4000,1.5,0,0,3,7,1400,0,1925,0.0,98117,47.6902,-122.38799999999999,1050,4330,2600,0.65,1960000,16000000,14040000
770000.0,3,2.5,3680,35617,1.0,0,0,2,10,2390,1290,1985,0.0,98052,47.7213,-122.12,3570,35633,31937,0.896678552376674,13542400,1268570689,1255028289
600000.0,5,2.25,3000,13899,2.0,0,0,3,8,3000,0,1975,0.0,98052,47.6373,-122.105,2270,10763,10899,0.7841571336067343,9000000,193182201,184182201
560000.0,3,1.0,1440,5000,2.0,0,0,2,7,1440,0,1910,0.0,98103,47.6741,-122.354,1850,4500,3560,0.712,2073600,25000000,22926400
1920000.0,5,5.75,7730,230868,2.0,0,0,2,12,6660,1070,2004,0.0,98077,47.7615,-122.084,2660,39292,223138,0.9665176637732383,59752900,53300033424,53240280524
457000.0,3,1.0,1170,3348,1.5,0,0,3,7,1170,0,1924,0.0,98117,47.687,-122.37799999999999,1590,4219,2178,0.6505376344086021,1368900,11209104,9840204
585000.0,2,1.0,1770,8640,1.5,0,0,2,6,1520,250,1949,0.0,98117,47.6926,-122.363,1060,4804,6870,0.7951388888888888,3132900,74649600,71516700
560000.0,3,2.0,1860,13374,1.0,0,0,2,8,1860,0,1985,0.0,98027,47.5397,-122.054,1960,9797,11514,0.860924181247196,3459600,178863876,175404276
345000.0,2,1.0,770,3008,1.0,0,0,3,5,770,0,1917,0.0,98116,47.5686,-122.389,1550,4563,2238,0.7440159574468085,592900,9048064,8455164
550000.0,4,3.5,3820,17745,2.0,0,2,2,8,2440,1380,1955,0.0,98108,47.556999999999995,-122.295,2520,9640,13925,0.7847280924204001,14592400,314885025,300292625
589950.0,4,2.5,3190,8195,2.0,0,0,2,10,3190,0,2006,0.0,98038,47.3555,-122.00299999999999,3400,7607,5005,0.610738255033557,10176100,67158025,56981925
327000.0,3,1.5,1320,13200,1.0,0,0,2,7,1320,0,1970,0.0,98059,47.5009,-122.14299999999999,1730,13200,11880,0.9,1742400,174240000,172497600
800000.0,2,2.25,1730,31491,2.0,1,2,3,7,1730,0,1947,1988.0,98070,47.37300000000001,-122.464,1400,12410,29761,0.9450636689847893,2992900,991683081,988690181
150000.0,3,1.0,1010,25000,1.0,0,0,2,6,1010,0,1966,0.0,98014,47.6927,-121.90100000000001,2020,101494,23990,0.9596,1020100,625000000,623979900
425000.0,2,2.5,1140,1182,3.0,0,0,2,8,1140,0,2007,0.0,98107,47.6713,-122.383,1290,1189,42,0.03553299492385787,1299600,1397124,97524
350000.0,3,1.0,860,7030,1.0,0,0,2,7,860,0,1973,0.0,98034,47.7151,-122.211,1360,7500,6170,0.8776671408250356,739600,49420900,48681300
273000.0,3,1.75,1540,10545,2.0,0,0,3,6,1540,0,1978,0.0,98045,47.4451,-121.76299999999999,1540,10000,9005,0.853959222380275,2371600,111197025,108825425
750000.0,4,2.25,2160,9525,1.0,0,0,2,8,1080,1080,1961,0.0,98040,47.5651,-122.221,2780,9525,7365,0.7732283464566929,4665600,90725625,86060025
240000.0,3,1.5,1450,9477,1.0,0,0,3,7,1450,0,1963,0.0,98031,47.4215,-122.20299999999999,1460,9477,8027,0.8469979951461433,2102500,89813529,87711029
400000.0,3,1.75,1830,9620,1.0,0,0,3,8,1830,0,1978,0.0,98023,47.3123,-122.389,1990,8280,7790,0.8097713097713097,3348900,92544400,89195500
230000.0,3,1.5,1630,6625,1.0,0,0,4,7,980,650,1980,0.0,98023,47.29,-122.368,1440,7145,4995,0.7539622641509434,2656900,43890625,41233725
372000.0,4,2.5,2500,8215,2.0,0,0,2,8,2500,0,1990,0.0,98031,47.4124,-122.204,2360,7801,5715,0.6956786366402922,6250000,67486225,61236225
459500.0,3,1.75,1470,4950,1.0,0,0,2,7,1030,440,1984,0.0,98133,47.7325,-122.337,1100,5250,3480,0.703030303030303,2160900,24502500,22341600
582000.0,3,2.5,2380,19860,2.0,0,0,3,8,2380,0,1995,0.0,98056,47.5255,-122.17299999999999,2450,10220,17480,0.8801611278952669,5664400,394419600,388755200
465000.0,4,2.5,2170,7700,1.0,0,0,2,7,1420,750,1969,0.0,98034,47.7216,-122.219,1710,7770,5530,0.7181818181818181,4708900,59290000,54581100
386000.0,3,2.0,2120,7560,1.0,0,0,2,9,2120,0,1991,0.0,98058,47.435,-122.16,2660,7700,5440,0.7195767195767195,4494400,57153600,52659200
546000.0,3,2.5,1530,3464,2.0,0,0,2,8,1530,0,1998,0.0,98007,47.6179,-122.141,1530,3446,1934,0.5583140877598153,2340900,11999296,9658396
278000.0,3,1.75,2710,9088,1.0,0,0,3,7,2060,650,1965,0.0,98001,47.3073,-122.272,1690,10454,6378,0.7018045774647887,7344100,82591744,75247644
540000.0,3,2.5,2860,8935,2.0,0,0,2,8,2860,0,2004,0.0,98065,47.5336,-121.855,2650,6167,6075,0.6799104644655848,8179600,79834225,71654625
529000.0,4,1.75,2800,90169,2.0,0,0,2,7,2800,0,1934,0.0,98065,47.5204,-121.829,1600,27194,87369,0.968947199148266,7840000,8130448561,8122608561
554000.0,4,1.0,1120,7104,1.5,0,0,2,7,1120,0,1946,0.0,98177,47.7055,-122.37200000000001,1370,7104,5984,0.8423423423423423,1254400,50466816,49212416
210000.0,3,1.0,1730,7210,1.0,0,0,2,7,1430,300,1963,0.0,98001,47.3404,-122.28,1820,7210,5480,0.7600554785020804,2992900,51984100,48991200
225000.0,2,1.0,1010,5408,1.0,0,0,3,6,1010,0,1926,0.0,98032,47.3759,-122.238,980,7800,4398,0.8132396449704142,1020100,29246464,28226364
561600.0,4,2.5,2350,6624,2.0,0,0,2,9,2350,0,1990,0.0,98074,47.6262,-122.045,2590,11240,4274,0.6452294685990339,5522500,43877376,38354876
300000.0,6,5.25,2860,5682,2.0,0,0,2,7,2860,0,1978,0.0,98002,47.303000000000004,-122.221,1390,5956,2822,0.49665610700457585,8179600,32285124,24105524
1650000.0,4,3.5,4285,9567,2.0,0,1,4,10,3485,800,1946,0.0,98199,47.6434,-122.40899999999999,2960,6902,5282,0.5521061983903,18361225,91527489,73166264
1020000.0,4,3.75,4060,19290,2.0,0,0,2,10,4060,0,2002,0.0,98074,47.6051,-122.053,4020,13250,15230,0.7895282529808191,16483600,372104100,355620500
150000.0,3,1.0,1310,9612,1.0,0,0,2,7,960,350,1962,0.0,98001,47.2958,-122.285,1310,9812,8302,0.863712026633375,1716100,92390544,90674444
400950.0,2,1.75,2320,6250,1.0,0,0,2,7,1400,920,1948,0.0,98136,47.5468,-122.38600000000001,1420,6250,3930,0.6288,5382400,39062500,33680100
620000.0,4,2.25,2210,8101,2.0,0,0,2,9,2210,0,1985,0.0,98074,47.6475,-122.07,2330,8842,5891,0.7271941735588199,4884100,65626201,60742101
449000.0,4,2.75,2090,14141,1.5,0,0,3,8,1680,410,1941,0.0,98166,47.4333,-122.34700000000001,1990,12920,12051,0.8522028145109964,4368100,199967881,195599781
630000.0,4,2.5,2240,4025,1.0,0,2,2,7,1250,990,1926,0.0,98115,47.6818,-122.311,1380,3500,1785,0.4434782608695652,5017600,16200625,11183025
336000.0,2,1.0,1180,7200,1.0,0,0,3,6,1180,0,1949,0.0,98133,47.7475,-122.34200000000001,1180,7200,6020,0.8361111111111111,1392400,51840000,50447600
299950.0,4,1.75,1560,31299,1.0,0,0,3,7,1560,0,1965,0.0,98092,47.3384,-122.164,2460,44907,29739,0.9501581520176363,2433600,979627401,977193801
352500.0,4,2.0,1970,7451,1.0,0,0,2,8,1350,620,1962,0.0,98133,47.765,-122.335,1980,7510,5481,0.735605958931687,3880900,55517401,51636501
150000.0,2,1.0,840,12750,1.0,0,0,2,6,840,0,1925,0.0,98055,47.483999999999995,-122.211,1480,6969,11910,0.9341176470588235,705600,162562500,161856900
175000.0,2,1.0,840,12750,1.0,0,0,2,6,840,0,1925,0.0,98055,47.483999999999995,-122.211,1480,6969,11910,0.9341176470588235,705600,162562500,161856900
305000.0,3,2.0,1830,10873,1.0,0,0,2,8,1830,0,1989,0.0,98023,47.3066,-122.39399999999999,2490,8976,9043,0.8316931849535547,3348900,118222129,114873229
2570000.0,4,3.75,4475,20424,2.0,0,4,2,12,2659,1816,1999,0.0,98033,47.6646,-122.208,4340,5250,15949,0.7808950254602428,20025625,417139776,397114151
607500.0,3,1.5,1800,4700,1.0,0,0,2,7,1200,600,1941,0.0,98117,47.6858,-122.385,1580,4700,2900,0.6170212765957447,3240000,22090000,18850000
505000.0,2,1.0,1250,5040,1.0,0,0,2,7,950,300,1920,0.0,98117,47.6959,-122.365,1290,5040,3790,0.751984126984127,1562500,25401600,23839100
280500.0,3,1.75,2440,10179,1.0,0,0,3,7,1220,1220,1962,0.0,98198,47.4118,-122.314,1650,9711,7739,0.7602907947735534,5953600,103612041,97658441
610000.0,3,2.5,2910,12283,2.0,0,2,2,10,2910,0,1993,0.0,98058,47.4602,-122.152,2680,22499,9373,0.7630871936823251,8468100,150872089,142403989
381000.0,5,2.75,3060,6895,2.0,0,0,2,8,3060,0,2003,0.0,98042,47.3809,-122.098,2590,6895,3835,0.5562001450326324,9363600,47541025,38177425
482000.0,5,2.25,2230,9600,1.0,0,0,2,8,1320,910,1978,0.0,98077,47.7466,-122.07600000000001,2080,9760,7370,0.7677083333333333,4972900,92160000,87187100
379950.0,3,1.0,1270,6900,1.0,0,0,2,7,1270,0,1977,0.0,98034,47.7279,-122.19200000000001,1480,7280,5630,0.8159420289855073,1612900,47610000,45997100
2500000.0,4,4.5,4300,19844,2.0,0,0,2,11,4300,0,1985,1999.0,98039,47.6218,-122.23700000000001,3070,19845,15544,0.78330981656924,18490000,393784336,375294336
425000.0,3,2.25,1580,39189,1.0,0,0,2,7,1180,400,1992,0.0,98053,47.6365,-121.97200000000001,1580,29649,37609,0.9596825639847917,2496400,1535777721,1533281321
580000.0,4,2.25,2570,36465,2.0,0,0,3,8,2570,0,1980,0.0,98053,47.6555,-122.042,2390,41454,33895,0.9295214589332237,6604900,1329696225,1323091325
605000.0,2,1.0,860,6510,1.0,0,0,2,7,860,0,1952,0.0,98004,47.6021,-122.20200000000001,1740,10800,5650,0.8678955453149002,739600,42380100,41640500
194000.0,1,1.0,820,1060,1.0,0,0,2,8,760,60,2007,0.0,98126,47.5472,-122.37200000000001,1770,1853,240,0.22641509433962265,672400,1123600,451200
546200.0,4,2.25,2090,8579,2.0,0,0,2,8,2090,0,1987,0.0,98074,47.6364,-122.03,1850,8843,6489,0.7563818626879589,4368100,73599241,69231141
1400000.0,4,3.5,3560,16782,2.0,0,0,2,10,2560,1000,2014,0.0,98040,47.5569,-122.225,3100,18047,13222,0.787867953759981,12673600,281635524,268961924
315000.0,3,1.75,1860,9629,1.0,0,0,3,7,1240,620,1961,0.0,98059,47.4913,-122.14299999999999,1940,9629,7769,0.8068335237303977,3459600,92717641,89258041
465000.0,3,1.5,900,8690,1.5,0,0,4,6,900,0,1941,0.0,98116,47.5751,-122.39299999999999,1000,6150,7790,0.8964326812428078,810000,75516100,74706100
330000.0,2,1.0,1160,32251,1.0,0,0,2,6,580,580,1963,0.0,98010,47.3537,-121.939,1160,33656,31091,0.9640321230349447,1345600,1040127001,1038781401
795000.0,4,2.75,3100,7501,2.0,0,0,2,10,3100,0,1998,0.0,98052,47.6859,-122.109,3140,8672,4401,0.5867217704306092,9610000,56265001,46655001
265000.0,4,2.25,2300,9100,1.0,0,0,2,7,1280,1020,1977,0.0,98058,47.4576,-122.16,1640,9100,6800,0.7472527472527473,5290000,82810000,77520000
1300000.0,4,2.5,3110,11857,2.0,0,4,2,11,2040,1070,1990,0.0,98117,47.6952,-122.402,3110,11570,8747,0.737707683225099,9672100,140588449,130916349
126500.0,3,1.0,1130,12212,1.0,0,0,2,6,1130,0,1942,0.0,98146,47.4952,-122.34,1190,9240,11082,0.9074680641991484,1276900,149132944,147856044
760000.0,4,2.5,2920,7901,2.0,0,0,2,9,2920,0,2004,0.0,98052,47.7036,-122.125,3020,7900,4981,0.6304265282875585,8526400,62425801,53899401
540000.0,2,1.25,1230,1569,2.0,0,0,2,9,1050,180,2009,0.0,98112,47.6193,-122.304,1100,1230,339,0.21606118546845124,1512900,2461761,948861
446000.0,5,2.75,2190,12687,1.0,0,0,4,7,1370,820,1978,0.0,98028,47.7762,-122.257,2280,10784,10497,0.8273823598959565,4796100,160959969,156163869
170000.0,1,0.75,850,5600,1.0,0,2,2,6,850,0,1903,0.0,98019,47.7654,-121.48,900,12250,4750,0.8482142857142857,722500,31360000,30637500
379000.0,3,2.5,1500,7420,1.0,0,0,2,7,1000,500,1972,0.0,98034,47.7236,-122.17399999999999,1840,7272,5920,0.7978436657681941,2250000,55056400,52806400
1400000.0,9,4.0,4620,5508,2.5,0,0,2,11,3870,750,1915,0.0,98105,47.6684,-122.309,2710,4320,888,0.16122004357298475,21344400,30338064,8993664
800000.0,4,2.75,3150,7035,2.0,0,0,2,9,3150,0,2004,0.0,98075,47.5979,-121.97399999999999,3200,7035,3885,0.5522388059701493,9922500,49491225,39568725
260000.0,3,1.0,1300,10139,1.0,0,0,2,7,1300,0,1962,2007.0,98042,47.3427,-122.087,1260,10139,8839,0.8717822270440871,1690000,102799321,101109321
820000.0,5,2.5,3160,8000,1.0,0,0,3,7,1580,1580,1960,0.0,98040,47.5735,-122.208,2440,8079,4840,0.605,9985600,64000000,54014400
449950.0,3,1.75,2070,96703,1.0,0,3,3,7,2070,0,1999,0.0,98092,47.2853,-122.008,1820,117612,94633,0.9785942525050929,4284900,9351470209,9347185309
392000.0,3,2.25,1790,7125,1.0,0,0,2,7,1220,570,1974,0.0,98034,47.7184,-122.226,2040,7950,5335,0.7487719298245614,3204100,50765625,47561525
465000.0,3,2.5,1650,4636,2.0,0,0,2,8,1650,0,1999,0.0,98075,47.5997,-122.016,1650,4504,2986,0.6440897325280415,2722500,21492496,18769996
449950.0,4,2.5,2070,7312,1.0,0,0,3,7,1230,840,1977,0.0,98052,47.6958,-122.12,1770,7668,5242,0.7169037199124726,4284900,53465344,49180444
520000.0,3,1.5,1580,8841,1.5,0,0,4,7,1180,400,1923,0.0,98103,47.6931,-122.352,1580,7512,7261,0.8212871847076123,2496400,78163281,75666881
546800.0,4,2.25,2170,10000,1.0,0,0,2,8,1420,750,1975,0.0,98008,47.6219,-122.109,2390,11000,7830,0.783,4708900,100000000,95291100
825000.0,4,2.75,2220,11925,1.0,0,0,2,7,1560,660,1953,1985.0,98004,47.6381,-122.205,2500,11377,9705,0.8138364779874214,4928400,142205625,137277225
337000.0,3,1.75,1440,11364,1.0,0,0,2,7,1440,0,1985,0.0,98155,47.743,-122.32799999999999,1950,9390,9924,0.8732840549102429,2073600,129140496,127066896
333000.0,2,1.0,720,6686,1.0,0,0,2,6,720,0,1942,0.0,98117,47.7003,-122.36200000000001,1200,6686,5966,0.8923122943463955,518400,44702596,44184196
380000.0,2,2.0,1120,780,2.0,0,0,2,8,760,360,2004,0.0,98116,47.5788,-122.41,1120,1322,-340,-0.4358974358974359,1254400,608400,-646000
280000.0,3,2.5,1970,8426,2.0,0,0,2,8,1970,0,1992,0.0,98003,47.2674,-122.306,1970,9197,6456,0.7661998575836696,3880900,70997476,67116576
202000.0,3,1.5,1420,9081,1.0,0,0,3,6,1420,0,1990,0.0,98022,47.1948,-121.999,1090,8410,7661,0.8436295562162758,2016400,82464561,80448161
585000.0,4,2.5,2250,4119,2.0,0,0,2,8,2250,0,2001,0.0,98075,47.5973,-122.03399999999999,2290,3115,1869,0.4537509104151493,5062500,16966161,11903661
435000.0,4,2.0,2630,9663,1.0,0,1,3,8,1330,1300,1956,0.0,98056,47.4841,-122.19,1900,8894,7033,0.7278277967504916,6916900,93373569,86456669
1200000.0,4,3.5,4740,172497,2.0,0,0,2,11,4740,0,2003,0.0,98053,47.6779,-122.075,2120,49658,167757,0.9725212612393259,22467600,29755215009,29732747409
364000.0,2,2.25,1280,2574,2.0,0,0,2,7,1280,0,1992,0.0,98144,47.5939,-122.302,1250,3960,1294,0.5027195027195027,1638400,6625476,4987076
300000.0,3,1.0,1260,8280,1.0,0,0,2,6,1260,0,1946,0.0,98115,47.7,-122.29899999999999,2100,8280,7020,0.8478260869565217,1587600,68558400,66970800
558000.0,2,1.75,1930,4601,1.0,0,0,2,8,1930,0,2006,0.0,98053,47.7196,-122.022,1670,4500,2671,0.580525972614649,3724900,21169201,17444301
199950.0,1,1.5,1048,4800,1.0,0,0,2,7,1048,0,1942,0.0,98055,47.4759,-122.212,950,4800,3752,0.7816666666666666,1098304,23040000,21941696
515000.0,3,2.25,1640,8400,1.0,0,0,3,8,1640,0,1962,0.0,98006,47.5484,-122.17200000000001,2110,8400,6760,0.8047619047619048,2689600,70560000,67870400
590000.0,4,2.5,2380,4950,2.0,0,0,2,8,2380,0,2004,0.0,98136,47.5382,-122.391,1370,5120,2570,0.5191919191919192,5664400,24502500,18838100
813500.0,4,2.0,2530,15520,1.0,0,0,4,8,2220,310,1964,0.0,98005,47.613,-122.167,2500,13300,12990,0.8369845360824743,6400900,240870400,234469500
725000.0,4,2.5,2700,25870,2.0,0,0,3,8,2700,0,1992,0.0,98033,47.6934,-122.161,1540,20720,23170,0.89563200618477,7290000,669256900,661966900
490000.0,3,2.25,2330,3600,1.5,0,0,2,8,2330,0,1971,0.0,98074,47.631,-122.061,2050,4275,1270,0.3527777777777778,5428900,12960000,7531100
277000.0,3,2.25,2160,9612,2.0,0,0,2,7,2160,0,1994,0.0,98022,47.1927,-122.01100000000001,1970,9247,7452,0.7752808988764045,4665600,92390544,87724944
325000.0,4,1.5,1470,70800,1.0,0,0,2,7,1470,0,1976,0.0,98010,47.3458,-121.948,1810,72337,69330,0.9792372881355932,2160900,5012640000,5010479100
649800.0,4,2.5,2280,9827,2.0,0,0,2,8,2280,0,1995,0.0,98033,47.6883,-122.16799999999999,1660,9827,7547,0.7679861605779994,5198400,96569929,91371529
425000.0,3,1.0,1280,3200,1.5,0,0,2,7,1280,0,1903,0.0,98122,47.6029,-122.307,1320,1676,1920,0.6,1638400,10240000,8601600
460000.0,2,1.0,850,4650,1.0,0,0,2,7,850,0,1975,0.0,98117,47.6926,-122.365,980,4700,3800,0.8172043010752689,722500,21622500,20900000
750000.0,3,3.25,4610,81935,2.0,0,0,3,9,4610,0,1984,0.0,98074,47.6217,-122.021,2900,43500,77325,0.9437358882040642,21252100,6713344225,6692092125
469000.0,5,2.5,2690,11745,1.0,0,0,2,8,1790,900,1960,0.0,98177,47.7708,-122.36200000000001,2670,7905,9055,0.7709663686675181,7236100,137945025,130708925
566000.0,4,1.75,2440,5000,1.0,0,0,2,8,1340,1100,1954,0.0,98117,47.6823,-122.37100000000001,2170,5000,2560,0.512,5953600,25000000,19046400
407500.0,3,2.5,1930,10460,2.0,0,0,2,8,1930,0,1996,0.0,98059,47.4938,-122.161,2290,8228,8530,0.8154875717017208,3724900,109411600,105686700
353500.0,2,1.0,800,8775,1.0,0,0,2,6,800,0,1942,0.0,98125,47.7171,-122.307,1470,8976,7975,0.9088319088319088,640000,77000625,76360625
524000.0,3,2.25,2430,73151,1.0,0,0,2,8,2430,0,1974,0.0,98059,47.4749,-122.09200000000001,2800,39250,70721,0.9667810419543137,5904900,5351068801,5345163901
264950.0,4,2.5,1990,9656,2.0,0,0,2,7,1990,0,1994,0.0,98010,47.3125,-121.99799999999999,1500,9656,7666,0.793910521955261,3960100,93238336,89278236
547500.0,3,2.5,2550,10355,2.0,0,0,2,9,2550,0,1990,0.0,98011,47.739,-122.20299999999999,2550,10084,7805,0.7537421535490101,6502500,107226025,100723525
264500.0,3,2.25,1370,7087,2.0,0,0,2,7,1370,0,1993,0.0,98038,47.3504,-122.035,1400,6600,5717,0.8066883025257514,1876900,50225569,48348669
507500.0,3,2.0,2020,8118,1.0,0,0,2,7,1020,1000,1963,0.0,98008,47.5866,-122.118,1670,8118,6098,0.751170238975117,4080400,65901924,61821524
560000.0,3,3.5,1560,2198,2.0,0,0,2,8,1180,380,2006,0.0,98116,47.5812,-122.40299999999999,1550,1467,638,0.2902638762511374,2433600,4831204,2397604
995000.0,5,4.0,5610,22529,2.0,0,0,2,11,4090,1520,1996,0.0,98072,47.7239,-122.09200000000001,3860,24751,16919,0.7509876159616494,31472100,507555841,476083741
835000.0,6,2.0,3560,5120,2.5,0,2,2,9,3560,0,1900,0.0,98122,47.6056,-122.311,2130,5120,1560,0.3046875,12673600,26214400,13540800
440000.0,3,1.5,2120,6290,1.0,0,0,3,8,1220,900,1949,0.0,98108,47.5658,-122.318,1620,5400,4170,0.6629570747217806,4494400,39564100,35069700
1020000.0,3,2.5,2920,5629,1.0,0,2,4,8,1460,1460,1955,0.0,98199,47.641999999999996,-122.405,2380,5000,2709,0.4812577722508438,8526400,31685641,23159241
300000.0,2,1.0,1340,7788,1.0,0,2,2,7,1340,0,1947,0.0,98178,47.5094,-122.244,2550,7788,6448,0.8279404211607602,1795600,60652944,58857344
125000.0,3,1.0,1230,4800,1.5,0,0,0,6,1230,0,1916,0.0,98117,47.6941,-122.365,1230,4800,3570,0.74375,1512900,23040000,21527100
986000.0,4,3.5,2840,5900,2.0,0,0,2,10,1920,920,1910,2008.0,98118,47.5543,-122.26799999999999,1300,4900,3060,0.5186440677966102,8065600,34810000,26744400
315000.0,4,2.5,2080,5650,1.0,0,0,2,7,1680,400,1950,0.0,98178,47.5107,-122.257,1270,5650,3570,0.631858407079646,4326400,31922500,27596100
320000.0,4,2.5,2070,7007,2.0,0,0,2,7,2070,0,1996,0.0,98031,47.3968,-122.171,2130,8100,4937,0.7045811331525618,4284900,49098049,44813149
972000.0,4,3.25,4010,13797,2.0,0,0,2,11,4010,0,2003,0.0,98059,47.5229,-122.152,3980,12120,9787,0.7093571066173806,16080100,190357209,174277109
760000.0,3,2.5,2190,10000,1.0,0,0,3,7,1540,650,1957,0.0,98040,47.5419,-122.214,2880,11782,7810,0.781,4796100,100000000,95203900
265000.0,4,3.0,1730,7264,2.0,0,0,2,6,1730,0,1920,0.0,98168,47.4738,-122.264,1500,12104,5534,0.7618392070484582,2992900,52765696,49772796
355000.0,2,1.0,1250,4558,1.0,0,0,2,7,1250,0,1948,0.0,98126,47.5318,-122.37899999999999,1180,4494,3308,0.7257569109258447,1562500,20775364,19212864
300000.0,3,1.0,1300,20812,1.0,0,0,2,6,1300,0,1927,0.0,98106,47.5435,-122.359,1210,17340,19512,0.9375360369017874,1690000,433139344,431449344
474950.0,5,2.5,2080,8347,1.0,0,0,3,7,1460,620,1975,0.0,98034,47.7334,-122.16799999999999,1840,7713,6267,0.750808673775009,4326400,69672409,65346009
470000.0,4,2.0,2180,17180,2.0,0,0,3,7,2180,0,1977,0.0,98014,47.698,-121.92,1880,14043,15000,0.8731082654249127,4752400,295152400,290400000
437500.0,3,1.0,1630,16393,1.0,0,0,2,7,1630,0,1969,0.0,98033,47.6576,-122.186,1880,23497,14763,0.9005673153175136,2656900,268730449,266073549
520000.0,2,1.5,1840,3825,1.0,0,0,2,8,1040,800,1928,0.0,98117,47.6808,-122.38,1290,5100,1985,0.5189542483660131,3385600,14630625,11245025
237600.0,2,1.0,1370,11584,1.0,0,0,3,6,1370,0,1950,0.0,98198,47.4224,-122.29299999999999,1330,8012,10214,0.8817334254143646,1876900,134189056,132312156
162950.0,2,1.0,950,2784,1.0,0,0,3,8,950,0,1972,0.0,98198,47.3793,-122.321,1080,3899,1834,0.6587643678160919,902500,7750656,6848156
457000.0,3,1.75,1690,6375,1.0,0,0,2,8,1690,0,1903,2002.0,98024,47.5247,-121.926,1270,7774,4685,0.7349019607843137,2856100,40640625,37784525
635000.0,3,2.5,1780,11000,1.0,0,0,3,8,1210,570,1980,0.0,98006,47.5574,-122.149,2310,9700,9220,0.8381818181818181,3168400,121000000,117831600
735000.0,4,3.0,2840,4120,1.5,0,0,3,8,2060,780,1931,0.0,98118,47.5683,-122.28299999999999,1840,5871,1280,0.3106796116504854,8065600,16974400,8908800
910000.0,2,2.5,2000,5150,2.0,0,4,2,9,2000,0,1992,0.0,98034,47.7056,-122.223,2510,6800,3150,0.6116504854368932,4000000,26522500,22522500
346500.0,3,3.25,1570,2048,2.0,0,0,2,8,1290,280,2006,0.0,98126,47.548,-122.375,1570,2006,478,0.2333984375,2464900,4194304,1729404
655000.0,4,2.5,2370,9517,1.0,0,0,2,9,1630,740,1984,0.0,98074,47.6222,-122.03399999999999,2440,9035,7147,0.7509719449406326,5616900,90573289,84956389
425000.0,3,1.75,1610,144619,1.0,0,0,2,7,1610,0,1977,0.0,98024,47.5659,-121.863,2220,144619,143009,0.9888672995941059,2592100,20914655161,20912063061
137000.0,3,1.0,1300,10125,1.0,0,0,3,6,1300,0,1959,0.0,98002,47.2921,-122.215,1300,10125,8825,0.8716049382716049,1690000,102515625,100825625
557500.0,3,2.5,2620,11056,2.0,0,0,2,9,2620,0,1988,0.0,98011,47.7378,-122.21799999999999,2560,8688,8436,0.7630246020260492,6864400,122235136,115370736
415000.0,4,2.25,3060,48787,2.0,0,0,2,8,3060,0,1992,0.0,98010,47.3397,-121.91799999999999,2090,48787,45727,0.9372783733371595,9363600,2380171369,2370807769
830000.0,5,2.25,2780,10192,2.0,0,0,3,9,2780,0,1978,0.0,98007,47.6134,-122.152,2740,9900,7412,0.7272370486656201,7728400,103876864,96148464
949000.0,4,3.0,4270,85643,2.0,0,0,2,11,4270,0,1991,0.0,98077,47.7711,-122.04799999999999,3760,51170,81373,0.9501418679868757,18232900,7334723449,7316490549
420000.0,3,1.0,1310,3963,1.0,0,0,4,7,1310,0,1986,0.0,98052,47.6826,-122.096,1010,3363,2653,0.6694423416603583,1716100,15705369,13989269
353000.0,2,1.0,1100,7500,1.0,0,0,2,7,1100,0,1951,0.0,98125,47.7235,-122.32600000000001,1920,7149,6400,0.8533333333333334,1210000,56250000,55040000
560000.0,3,1.75,1480,383328,1.5,0,0,2,8,1480,0,1980,0.0,98019,47.7192,-121.932,1480,67082,381848,0.9961390767175892,2190400,146940355584,146938165184
445700.0,3,2.5,1270,1180,3.0,0,0,2,8,1270,0,2001,0.0,98107,47.6697,-122.39200000000001,1320,1180,-90,-0.07627118644067797,1612900,1392400,-220500
226000.0,4,1.0,1270,6459,1.5,0,0,2,7,1270,0,1918,0.0,98118,47.5441,-122.273,1300,4100,5189,0.8033751354698869,1612900,41718681,40105781
358000.0,3,1.0,890,9870,1.0,0,0,3,7,890,0,1960,0.0,98056,47.5398,-122.178,1270,9861,8980,0.9098277608915907,792100,97416900,96624800
501000.0,3,1.75,1480,8667,1.0,0,0,4,7,740,740,1954,0.0,98006,47.5718,-122.13600000000001,1600,10644,7187,0.8292373370254991,2190400,75116889,72926489
609000.0,4,2.5,3240,23870,1.0,0,0,2,9,1840,1400,1972,0.0,98155,47.7731,-122.28200000000001,2290,13340,20630,0.8642647674905739,10497600,569776900,559279300
734950.0,4,3.25,4280,47179,2.0,0,0,2,10,3050,1230,2002,0.0,98092,47.3017,-122.12700000000001,2820,43401,42899,0.909281671930308,18318400,2225858041,2207539641
725000.0,5,2.5,3210,12000,1.0,0,0,3,8,1830,1380,1968,0.0,98007,47.6205,-122.148,2450,12000,8790,0.7325,10304100,144000000,133695900
350500.0,3,2.25,1870,7200,1.0,0,0,2,7,1390,480,1975,0.0,98072,47.733999999999995,-122.17399999999999,1830,7876,5330,0.7402777777777778,3496900,51840000,48343100
610000.0,5,2.5,3990,3839,1.0,0,0,3,8,1990,2000,1962,0.0,98112,47.6236,-122.29899999999999,2090,5000,-151,-0.03933315967699922,15920100,14737921,-1182179
605125.0,2,1.0,1160,5029,1.0,0,0,2,7,910,250,1940,0.0,98115,47.6723,-122.266,1220,5029,3869,0.7693378405249552,1345600,25290841,23945241
1390000.0,4,2.25,2940,20384,2.0,0,0,3,9,2940,0,1970,0.0,98004,47.6214,-122.227,3410,19910,17444,0.8557692307692307,8643600,415507456,406863856
550000.0,3,2.25,1850,37264,2.0,0,0,2,8,1850,0,1981,0.0,98053,47.6486,-122.035,2390,36036,35414,0.9503542292829541,3422500,1388605696,1385183196
335000.0,2,1.75,1060,1202,2.0,0,0,2,7,760,300,2003,0.0,98136,47.5426,-122.38799999999999,1060,1493,142,0.11813643926788686,1123600,1444804,321204
397000.0,3,2.0,1100,9165,1.0,0,0,3,7,1100,0,1969,0.0,98034,47.7304,-122.23100000000001,1510,8500,8065,0.8799781778505182,1210000,83997225,82787225
240000.0,3,2.0,1190,10299,1.0,0,0,2,7,1190,0,1994,0.0,98010,47.31399999999999,-122.0,1700,9849,9109,0.8844548014370327,1416100,106069401,104653301
240000.0,3,2.0,1030,11118,1.0,0,0,4,7,1030,0,1970,0.0,98003,47.3463,-122.30799999999999,1300,7920,10088,0.9073574383881993,1060900,123609924,122549024
262500.0,2,1.5,1140,14373,1.0,0,0,2,7,1140,0,1949,1996.0,98011,47.7354,-122.219,2140,9860,13233,0.9206846169901899,1299600,206583129,205283529
440000.0,3,1.5,2260,5300,1.0,0,0,2,7,1200,1060,1940,0.0,98103,47.6756,-122.348,1950,5000,3040,0.5735849056603773,5107600,28090000,22982400
160000.0,3,1.0,1140,3240,1.5,0,0,3,6,1140,0,1910,0.0,98014,47.7093,-121.36399999999999,1140,4700,2100,0.6481481481481481,1299600,10497600,9198000
427000.0,4,1.0,1860,4736,1.5,0,0,0,7,1860,0,1901,0.0,98112,47.6251,-122.3,1800,4000,2876,0.6072635135135135,3459600,22429696,18970096
920000.0,4,3.5,4080,10666,2.0,0,0,2,9,4080,0,2005,0.0,98053,47.6818,-122.023,3920,8154,6586,0.6174760922557659,16646400,113763556,97117156
2300000.0,4,2.5,3280,7100,2.0,0,4,2,10,2180,1100,1911,1987.0,98119,47.6285,-122.36200000000001,3240,6674,3820,0.5380281690140845,10758400,50410000,39651600
480000.0,4,2.5,2870,35757,2.0,0,0,3,9,2870,0,1977,0.0,98077,47.7568,-122.05,2700,41221,32887,0.919735995749084,8236900,1278563049,1270326149
615000.0,4,1.75,2300,11700,1.0,0,0,3,9,1960,340,1977,0.0,98052,47.6331,-122.094,2840,12000,9400,0.8034188034188035,5290000,136890000,131600000
736500.0,3,2.0,2230,4800,1.5,0,0,3,7,1290,940,1915,0.0,98199,47.645,-122.38600000000001,1650,5040,2570,0.5354166666666667,4972900,23040000,18067100
542500.0,3,2.5,1920,1649,2.5,0,0,2,8,1600,320,2004,0.0,98116,47.5901,-122.38799999999999,1650,3053,-271,-0.1643420254699818,3686400,2719201,-967199
191000.0,2,1.0,700,5000,1.0,0,0,4,6,700,0,1952,0.0,98056,47.4927,-122.17200000000001,1040,5200,4300,0.86,490000,25000000,24510000
730000.0,4,2.5,2740,11975,2.0,0,0,3,8,2740,0,1991,0.0,98074,47.6315,-122.02799999999999,2310,9068,9235,0.7711899791231733,7507600,143400625,135893025
1230000.0,5,2.25,3440,5000,2.0,0,2,4,9,3440,0,1901,0.0,98122,47.6127,-122.286,2822,5000,1560,0.312,11833600,25000000,13166400
129000.0,1,1.0,650,15364,1.0,0,0,3,5,650,0,1967,0.0,98042,47.3721,-122.15899999999999,1630,7952,14714,0.9576933090341057,422500,236052496,235629996
284000.0,3,1.5,1500,10018,1.0,0,0,3,7,1500,0,1957,0.0,98058,47.468,-122.163,1500,10937,8518,0.8502695148732282,2250000,100360324,98110324
645000.0,3,2.5,2490,5978,2.0,0,0,2,9,2490,0,2003,0.0,98074,47.6298,-122.022,2710,6629,3488,0.5834727333556373,6200100,35736484,29536384
218000.0,3,1.5,1330,7600,1.0,0,0,3,7,1330,0,1968,0.0,98023,47.3103,-122.366,1500,7776,6270,0.825,1768900,57760000,55991100
675000.0,4,3.5,3190,6875,2.0,0,2,2,8,2120,1070,1999,0.0,98034,47.7082,-122.221,2550,6875,3685,0.536,10176100,47265625,37089525
575000.0,3,2.5,1590,2910,2.0,0,0,2,7,1110,480,1984,0.0,98115,47.6855,-122.321,1590,3880,1320,0.4536082474226804,2528100,8468100,5940000
225000.0,2,1.0,830,5720,1.0,0,0,3,6,830,0,1950,0.0,98133,47.7339,-122.339,1150,5250,4890,0.8548951048951049,688900,32718400,32029500
626000.0,3,2.25,1810,5107,2.0,0,0,2,8,1810,0,1989,0.0,98033,47.6882,-122.171,1760,5454,3297,0.6455844918738985,3276100,26081449,22805349
499950.0,4,2.5,2910,20067,2.0,0,0,2,9,2910,0,2001,0.0,98168,47.4714,-122.273,1730,21420,17157,0.8549857975781133,8468100,402684489,394216389
405000.0,4,1.75,2180,13529,1.0,0,0,2,7,1090,1090,1956,0.0,98155,47.7516,-122.294,2000,13529,11349,0.8388646610983812,4752400,183033841,178281441
152500.0,3,1.0,1090,3523,1.0,0,0,3,6,1090,0,1969,0.0,98092,47.3161,-122.182,1030,3200,2433,0.6906045983536758,1188100,12411529,11223429
325000.0,4,2.5,2160,6825,2.0,0,0,2,8,2160,0,1994,0.0,98031,47.4111,-122.2,2020,7035,4665,0.6835164835164835,4665600,46580625,41915025
475300.0,3,1.0,2110,10005,1.0,0,0,4,7,1110,1000,1924,0.0,98033,47.688,-122.16799999999999,1360,9827,7895,0.7891054472763618,4452100,100100025,95647925
485000.0,3,1.75,2180,7318,1.0,0,0,3,7,1210,970,1967,0.0,98126,47.5251,-122.37,2140,7560,5138,0.7021044001093195,4752400,53553124,48800724
720000.0,3,2.5,2100,2200,2.0,0,0,3,7,1500,600,1919,0.0,98122,47.614,-122.294,1750,4400,100,0.045454545454545456,4410000,4840000,430000
465000.0,3,1.75,1410,6886,1.0,0,0,2,7,1410,0,1924,2013.0,98133,47.7183,-122.353,1410,6561,5476,0.7952367121696196,1988100,47416996,45428896
489000.0,3,1.5,1020,9072,1.0,0,0,2,7,920,100,1930,0.0,98115,47.695,-122.301,1620,7930,8052,0.8875661375661376,1040400,82301184,81260784
3100000.0,5,5.25,5090,23669,2.0,0,0,2,12,5090,0,2006,0.0,98004,47.6297,-122.21600000000001,3830,22605,18579,0.7849507795006126,25908100,560221561,534313461
288000.0,3,2.25,2090,7500,1.0,0,0,3,7,1280,810,1977,0.0,98031,47.3951,-122.17200000000001,1800,7350,5410,0.7213333333333334,4368100,56250000,51881900
225000.0,3,1.75,1350,9793,1.0,0,0,3,7,1350,0,1968,0.0,98022,47.1981,-122.00299999999999,1690,8080,8443,0.8621464311242725,1822500,95902849,94080349
499000.0,3,1.75,2650,11774,1.0,0,1,2,8,2240,410,1952,0.0,98146,47.4909,-122.363,2650,10120,9124,0.7749278070324443,7022500,138627076,131604576
632000.0,5,3.0,3520,36558,2.0,0,0,3,8,2100,1420,1985,0.0,98027,47.4658,-122.007,3000,36558,33038,0.9037146452212922,12390400,1336487364,1324096964
580000.0,3,2.5,2040,4627,2.0,0,0,2,8,2040,0,1992,0.0,98052,47.6365,-122.10799999999999,2230,4500,2587,0.5591095742381673,4161600,21409129,17247529
730000.0,4,1.5,2340,5000,2.0,0,0,2,8,2100,240,1912,0.0,98122,47.6065,-122.291,2320,5500,2660,0.532,5475600,25000000,19524400
325000.0,4,2.25,1770,7799,2.0,0,0,2,7,1770,0,1998,0.0,98031,47.4192,-122.20200000000001,1770,7778,6029,0.7730478266444416,3132900,60824401,57691501
421000.0,3,1.75,1100,8662,1.0,0,0,4,7,1100,0,1964,0.0,98056,47.5368,-122.17299999999999,1100,9240,7562,0.8730085430616485,1210000,75030244,73820244
316000.0,3,2.5,1490,4078,2.0,0,0,2,8,1490,0,1998,0.0,98059,47.4915,-122.155,1310,2767,2588,0.6346248160863168,2220100,16630084,14409984
415000.0,2,1.0,1460,4200,1.0,0,0,3,6,880,580,1914,0.0,98117,47.6774,-122.361,1540,4200,2740,0.6523809523809524,2131600,17640000,15508400
401000.0,3,2.25,1350,2839,2.0,0,0,2,7,1350,0,2003,0.0,98053,47.6824,-122.036,1650,3093,1489,0.5244804508629799,1822500,8059921,6237421
229950.0,3,0.75,1030,12700,1.0,0,0,3,5,1030,0,1944,0.0,98032,47.3877,-122.236,1140,6955,11670,0.9188976377952756,1060900,161290000,160229100
539950.0,3,1.75,1820,9875,1.0,0,0,3,8,1820,0,1966,0.0,98008,47.6243,-122.094,2670,10000,8055,0.8156962025316455,3312400,97515625,94203225
335000.0,3,2.0,1170,5360,1.0,0,0,2,6,1170,0,1919,0.0,98106,47.5181,-122.36399999999999,1180,7200,4190,0.7817164179104478,1368900,28729600,27360700
339000.0,3,2.5,1450,3748,2.0,0,0,2,7,1450,0,2004,0.0,98065,47.532,-121.85,1970,3748,2298,0.6131270010672358,2102500,14047504,11945004
414950.0,4,1.75,2200,8545,1.0,0,0,3,7,1100,1100,1918,1982.0,98133,47.7481,-122.353,1940,9315,6345,0.7425394967817437,4840000,73017025,68177025
650000.0,4,2.0,1610,8976,1.0,0,0,3,8,1610,0,1966,0.0,98004,47.6011,-122.19200000000001,1930,8976,7366,0.8206327985739751,2592100,80568576,77976476
445000.0,3,2.5,2690,21883,2.0,0,0,2,8,2690,0,1994,0.0,98014,47.6462,-121.904,2370,21781,19193,0.8770735273956953,7236100,478865689,471629589
295000.0,3,2.25,1850,7800,2.0,0,0,2,9,1850,0,1974,0.0,98023,47.3146,-122.37899999999999,2360,8000,5950,0.7628205128205128,3422500,60840000,57417500
975000.0,4,2.25,2250,3600,2.0,0,0,3,9,2010,240,1912,0.0,98119,47.643,-122.37,1910,3990,1350,0.375,5062500,12960000,7897500
296500.0,3,1.5,1580,10100,1.0,0,0,3,7,1580,0,1961,0.0,98055,47.4423,-122.193,1650,10032,8520,0.8435643564356435,2496400,102010000,99513600
440000.0,4,2.75,2030,56192,1.0,0,0,2,8,1550,480,1979,0.0,98077,47.751999999999995,-122.073,2510,44866,54162,0.963873861047836,4120900,3157540864,3153419964
420000.0,5,1.5,1890,10880,1.0,0,0,2,7,1890,0,1962,0.0,98034,47.7196,-122.197,1670,9750,8990,0.8262867647058824,3572100,118374400,114802300
302000.0,3,2.5,2140,9492,2.0,0,0,2,8,2140,0,1994,0.0,98092,47.3289,-122.204,2180,9184,7352,0.7745469869363675,4579600,90098064,85518464
350000.0,4,1.75,1770,7336,1.0,0,0,3,8,1770,0,1986,0.0,98058,47.4265,-122.163,2030,8183,5566,0.7587241003271538,3132900,53816896,50683996
667000.0,3,1.75,3320,478288,1.5,0,3,3,8,2260,1060,1933,1982.0,98022,47.2407,-121.95299999999999,2960,217800,474968,0.9930585755862577,11022400,228759410944,228748388544
645000.0,3,2.0,1640,4218,1.0,0,0,3,7,910,730,1941,0.0,98103,47.6546,-122.344,1670,4000,2578,0.611190137505927,2689600,17791524,15101924
430000.0,4,2.75,1820,5400,1.0,0,0,3,7,1220,600,1988,0.0,98056,47.5204,-122.205,1630,5400,3580,0.662962962962963,3312400,29160000,25847600
413000.0,4,1.0,1410,6000,1.0,0,0,2,7,810,600,1925,0.0,98126,47.566,-122.37299999999999,1500,4800,4590,0.765,1988100,36000000,34011900
420000.0,3,1.0,1240,7300,1.0,0,0,2,7,1240,0,1968,0.0,98033,47.6775,-122.16799999999999,1240,8260,6060,0.8301369863013699,1537600,53290000,51752400
495000.0,3,2.25,1780,8050,1.0,0,0,3,7,1230,550,1979,0.0,98052,47.6977,-122.126,1780,7200,6270,0.7788819875776397,3168400,64802500,61634100
2190000.0,4,4.5,4240,13162,2.0,0,0,2,10,4240,0,2004,0.0,98039,47.6193,-122.229,3010,12163,8922,0.6778605075216533,17977600,173238244,155260644
965000.0,4,2.5,3570,17411,2.0,0,0,2,10,3570,0,1990,0.0,98075,47.5617,-122.03,3510,16153,13841,0.7949572109585894,12744900,303142921,290398021
500000.0,4,2.5,1900,5001,1.0,0,0,2,8,1200,700,2008,0.0,98133,47.7289,-122.335,1950,4680,3101,0.6200759848030394,3610000,25010001,21400001
636100.0,3,1.0,1010,6000,1.5,0,0,2,7,1010,0,1919,1977.0,98119,47.6438,-122.35700000000001,1960,4000,4990,0.8316666666666667,1020100,36000000,34979900
720000.0,4,2.5,2870,12648,2.0,0,0,3,9,2870,0,1986,0.0,98029,47.5632,-122.01700000000001,2560,12648,9778,0.7730866540164453,8236900,159971904,151735004
298000.0,3,1.75,1620,12825,1.0,0,0,2,8,1340,280,1962,0.0,98003,47.3321,-122.323,2076,11200,11205,0.8736842105263158,2624400,164480625,161856225
409000.0,2,1.75,1480,4000,1.0,0,0,3,6,740,0,1925,0.0,98117,47.6916,-122.38,1060,4000,2520,0.63,2190400,16000000,13809600
370000.0,4,2.5,2650,5706,2.0,0,0,2,9,2650,0,2005,0.0,98042,47.3515,-122.164,2760,5749,3056,0.5355765860497722,7022500,32558436,25535936
230000.0,5,1.0,1410,9000,1.0,0,0,4,7,1410,0,1967,0.0,98023,47.3054,-122.369,1200,8346,7590,0.8433333333333334,1988100,81000000,79011900
290000.0,3,2.0,1360,6685,1.0,0,0,2,7,1360,0,1952,0.0,98155,47.7365,-122.324,1300,8138,5325,0.7965594614809275,1849600,44689225,42839625
420000.0,4,2.25,2930,9840,1.0,0,0,3,8,1560,1370,1977,0.0,98023,47.3103,-122.382,2800,8374,6910,0.7022357723577236,8584900,96825600,88240700
917000.0,4,2.5,3500,10891,2.0,0,2,2,10,3500,0,1995,0.0,98027,47.5533,-122.09299999999999,3820,13521,7391,0.6786337342760077,12250000,118613881,106363881
957000.0,5,3.25,3160,5000,2.0,0,2,2,10,2180,980,2005,0.0,98199,47.6464,-122.405,3160,5746,1840,0.368,9985600,25000000,15014400
482000.0,3,2.25,1710,21485,2.0,0,0,2,7,1710,0,1989,0.0,98074,47.6198,-122.053,1680,21485,19775,0.9204095880847103,2924100,461605225,458681125
488000.0,3,1.75,2180,14734,2.0,0,0,2,9,2180,0,1990,0.0,98045,47.4831,-121.76700000000001,2300,21618,12554,0.8520428939866974,4752400,217090756,212338356
760369.0,5,2.5,2870,4712,2.0,0,0,2,9,2870,0,2014,0.0,98006,47.5463,-122.182,2870,6768,1842,0.39091680814940577,8236900,22202944,13966044
170000.0,2,1.0,1500,18540,1.0,0,0,2,8,1500,0,1950,0.0,98168,47.4727,-122.281,1700,9355,17040,0.919093851132686,2250000,343731600,341481600
625000.0,3,2.5,2120,10021,1.0,0,0,3,8,1230,890,1976,0.0,98006,47.5621,-122.135,2690,10183,7901,0.7884442670392177,4494400,100420441,95926041
357000.0,3,1.5,1590,6750,1.0,0,0,2,7,1080,510,1976,0.0,98034,47.73,-122.191,1590,7400,5160,0.7644444444444445,2528100,45562500,43034400
583000.0,3,2.25,1830,8276,1.0,0,0,2,8,1350,480,1989,0.0,98074,47.6336,-122.025,1920,8276,6446,0.7788786853552441,3348900,68492176,65143276
173250.0,3,2.0,1210,9097,1.0,0,0,3,7,1210,0,1954,0.0,98168,47.4849,-122.303,1360,10125,7887,0.8669891172914147,1464100,82755409,81291309
414050.0,4,2.0,1590,10331,1.5,0,0,3,7,1590,0,1956,0.0,98133,47.7273,-122.33200000000001,1400,9434,8741,0.8460942793534024,2528100,106729561,104201461
400000.0,3,1.75,1050,6150,1.5,0,0,3,6,950,100,1928,0.0,98116,47.5715,-122.39399999999999,1360,6150,5100,0.8292682926829268,1102500,37822500,36720000
537000.0,3,2.0,1550,27003,1.5,0,0,2,8,1550,0,1982,0.0,98074,47.606,-122.056,2400,27003,25453,0.9425989704847609,2402500,729162009,726759509
465000.0,4,2.25,2070,7500,2.0,0,0,3,7,2070,0,1977,0.0,98034,47.727,-122.21700000000001,2080,7700,5430,0.724,4284900,56250000,51965100
425000.0,3,2.25,1740,9682,1.0,0,0,4,8,1740,0,1969,0.0,98056,47.5138,-122.17299999999999,2100,9536,7942,0.8202850650692006,3027600,93741124,90713524
445000.0,4,2.0,1700,21780,1.0,0,0,3,6,1080,620,1940,0.0,98052,47.6289,-122.10799999999999,2070,12054,20080,0.9219467401285583,2890000,474368400,471478400
179950.0,2,1.0,1200,9000,1.0,0,0,2,6,1200,0,1958,0.0,98023,47.3277,-122.34899999999999,1040,9600,7800,0.8666666666666667,1440000,81000000,79560000
275000.0,3,2.5,1710,7230,2.0,0,0,2,7,1710,0,1996,0.0,98003,47.2778,-122.29799999999999,1720,6537,5520,0.7634854771784232,2924100,52272900,49348800
190000.0,4,2.5,1840,13493,2.0,0,0,2,7,1840,0,1994,0.0,98001,47.2649,-122.242,1430,11463,11653,0.8636329948862373,3385600,182061049,178675449
385000.0,3,1.75,1900,5520,1.0,0,0,2,7,1280,620,1982,0.0,98118,47.5549,-122.292,1330,5196,3620,0.6557971014492754,3610000,30470400,26860400
303000.0,4,1.0,2300,9583,1.0,0,0,2,6,1220,1080,1928,0.0,98024,47.5671,-121.89,1200,11325,7283,0.7599916518835438,5290000,91833889,86543889
165000.0,3,1.0,970,7503,1.0,0,0,3,6,970,0,1967,0.0,98058,47.4688,-122.163,1230,9504,6533,0.8707183793149407,940900,56295009,55354109
600000.0,2,2.0,1270,5000,1.0,0,0,2,6,1270,0,1944,0.0,98107,47.6729,-122.363,2190,5000,3730,0.746,1612900,25000000,23387100
710000.0,3,2.25,3130,65775,2.0,0,0,3,8,3130,0,1978,0.0,98027,47.5462,-122.085,3130,72309,62645,0.9524135309768149,9796900,4326350625,4316553725
875000.0,5,3.25,4230,21455,2.0,0,0,2,10,2720,1510,1990,0.0,98074,47.6375,-122.015,3280,22393,17225,0.8028431601025402,17892900,460317025,442424125
269950.0,3,2.5,1480,9743,2.0,0,0,3,7,1480,0,1996,0.0,98010,47.3293,-122.001,1810,9601,8263,0.8480960689725957,2190400,94926049,92735649
838000.0,4,2.5,3310,42998,2.0,0,0,2,9,3310,0,2001,0.0,98052,47.7232,-122.131,3350,42847,39688,0.9230196753337364,10956100,1848828004,1837871904
670500.0,4,2.0,1590,6750,1.0,0,0,2,7,1590,0,1951,0.0,98102,47.6406,-122.31700000000001,2370,4500,5160,0.7644444444444445,2528100,45562500,43034400
420000.0,4,1.5,1690,9391,1.0,0,0,2,7,1290,400,1960,0.0,98155,47.7438,-122.329,1780,9390,7701,0.8200404642743052,2856100,88190881,85334781
370000.0,3,1.5,1690,161913,1.0,0,0,1,7,1430,260,1952,0.0,98030,47.356,-122.189,1930,12548,160223,0.9895622958008313,2856100,26215819569,26212963469
360000.0,3,1.75,1500,7200,1.0,0,0,2,7,1500,0,1957,0.0,98133,47.7748,-122.337,1650,7392,5700,0.7916666666666666,2250000,51840000,49590000
562500.0,4,2.5,2320,8721,2.0,0,0,2,8,2320,0,1991,0.0,98034,47.7326,-122.226,2260,8268,6401,0.7339754615296411,5382400,76055841,70673441
360500.0,3,2.5,3300,11525,1.0,0,0,4,8,1650,1650,1961,0.0,98198,47.4113,-122.315,1950,9680,8225,0.7136659436008677,10890000,132825625,121935625
389999.0,3,2.25,1445,1471,2.0,0,0,2,7,1300,145,2003,0.0,98027,47.5342,-122.072,1410,1399,26,0.017675050985723997,2088025,2163841,75816
450000.0,4,3.0,1890,13140,1.0,0,0,3,7,1270,620,1967,0.0,98027,47.5221,-122.044,1900,11160,11250,0.8561643835616438,3572100,172659600,169087500
247500.0,4,2.0,1760,8400,1.0,0,0,2,7,1060,700,1962,0.0,98003,47.3258,-122.323,1280,8415,6640,0.7904761904761904,3097600,70560000,67462400
208000.0,3,1.0,1050,6240,1.0,0,0,4,5,1050,0,1948,0.0,98146,47.4933,-122.338,1410,6240,5190,0.8317307692307693,1102500,38937600,37835100
455000.0,3,2.5,1980,7309,2.0,0,0,2,7,1980,0,1993,0.0,98034,47.7257,-122.17200000000001,2060,9681,5329,0.7291011082227391,3920400,53421481,49501081
379400.0,4,1.75,2120,7680,1.0,0,0,3,7,1060,1060,1950,0.0,98177,47.7172,-122.361,1530,7680,5560,0.7239583333333334,4494400,58982400,54488000
190000.0,3,1.5,760,40039,1.0,0,0,2,6,760,0,1906,0.0,98065,47.5295,-121.829,980,6000,39279,0.9810185069557181,577600,1603121521,1602543921
326188.0,3,1.0,1300,8800,1.0,0,0,2,7,1300,0,1977,0.0,98053,47.64,-121.96600000000001,1600,12210,7500,0.8522727272727273,1690000,77440000,75750000
168000.0,2,2.5,1160,2174,2.0,0,0,2,7,1160,0,1998,0.0,98106,47.5264,-122.366,1380,1919,1014,0.46642134314627415,1345600,4726276,3380676
314000.0,4,2.5,2340,8990,2.0,0,0,2,8,2340,0,2003,0.0,98038,47.3781,-122.03,2980,6718,6650,0.7397107897664071,5475600,80820100,75344500
630000.0,4,2.75,2710,37277,2.0,0,0,2,9,2710,0,2000,0.0,98027,47.4634,-121.98700000000001,2390,39299,34567,0.9273010167127183,7344100,1389574729,1382230629
550000.0,3,1.75,1440,8957,1.0,0,0,3,7,1440,0,1957,0.0,98008,47.6008,-122.118,1340,8780,7517,0.8392318856760076,2073600,80227849,78154249
530000.0,4,2.25,1980,15086,2.0,0,0,2,8,1980,0,1981,0.0,98074,47.647,-122.064,2100,10927,13106,0.8687524857483759,3920400,227587396,223666996
637500.0,3,1.75,1680,10685,1.0,0,0,3,7,1680,0,1966,0.0,98033,47.6556,-122.193,3340,10390,9005,0.8427702386523164,2822400,114169225,111346825
400000.0,3,2.5,1390,2815,2.0,0,0,2,8,1390,0,1999,0.0,98126,47.566,-122.366,1390,3700,1425,0.5062166962699822,1932100,7924225,5992125
700000.0,5,2.75,3100,9825,2.0,0,2,3,8,3100,0,1950,1982.0,98125,47.7188,-122.281,2120,8400,6725,0.6844783715012722,9610000,96530625,86920625
272000.0,3,2.5,1680,8512,2.0,0,0,2,7,1680,0,1991,0.0,98022,47.1952,-121.986,1580,8512,6832,0.8026315789473685,2822400,72454144,69631744
600000.0,4,2.5,2710,6474,2.0,0,0,2,8,2710,0,2004,0.0,98065,47.5383,-121.87799999999999,2870,6968,3764,0.5814025332097621,7344100,41912676,34568576
450600.0,2,1.0,840,7020,1.5,0,0,3,7,840,0,1943,0.0,98136,47.5513,-122.39399999999999,1310,7072,6180,0.8803418803418803,705600,49280400,48574800
550000.0,3,2.25,2090,8095,2.0,0,2,2,10,2090,0,1988,0.0,98136,47.5287,-122.385,1940,5635,6005,0.7418159357628166,4368100,65529025,61160925
225000.0,3,1.0,1120,8407,1.0,0,0,4,6,1120,0,1987,0.0,98022,47.2051,-122.006,1250,8658,7287,0.8667776852622814,1254400,70677649,69423249
132825.0,3,1.5,1210,5200,1.0,0,0,4,6,1210,0,1969,0.0,98042,47.3615,-122.087,1120,5200,3990,0.7673076923076924,1464100,27040000,25575900
219950.0,3,1.5,1210,5200,1.0,0,0,4,6,1210,0,1969,0.0,98042,47.3615,-122.087,1120,5200,3990,0.7673076923076924,1464100,27040000,25575900
580000.0,5,2.0,1940,6000,1.0,0,0,4,7,970,970,1945,0.0,98115,47.6875,-122.287,1700,6000,4060,0.6766666666666666,3763600,36000000,32236400
568000.0,3,1.75,1930,213008,1.0,0,2,2,7,1300,630,1980,0.0,98053,47.6751,-121.993,2860,208652,211078,0.9909393074438518,3724900,45372408064,45368683164
406000.0,3,1.75,1270,6017,1.0,0,0,3,7,1030,240,1990,0.0,98028,47.736999999999995,-122.225,1630,7381,4747,0.788931361143427,1612900,36204289,34591389
469000.0,3,1.75,1680,2400,1.5,0,0,2,7,1170,510,1929,0.0,98117,47.6849,-122.367,1080,4560,720,0.3,2822400,5760000,2937600
415000.0,3,2.5,2090,6045,2.0,0,0,2,8,2090,0,2000,0.0,98056,47.4947,-122.17399999999999,2040,6392,3955,0.6542597187758478,4368100,36542025,32173925
390000.0,3,1.5,1000,13991,1.0,0,0,3,7,1000,0,1956,0.0,98006,47.5643,-122.13799999999999,1520,11465,12991,0.9285254806661425,1000000,195748081,194748081
251000.0,3,1.75,1350,10125,1.0,0,0,2,8,1350,0,1967,0.0,98003,47.3334,-122.29799999999999,1520,9720,8775,0.8666666666666667,1822500,102515625,100693125
750000.0,3,2.5,3280,6750,2.0,0,1,2,9,2440,840,2001,0.0,98126,47.5219,-122.38,1770,6387,3470,0.5140740740740741,10758400,45562500,34804100
845000.0,4,2.5,2390,5071,2.0,0,0,2,9,1760,630,1988,0.0,98122,47.6144,-122.28299999999999,1940,5071,2681,0.5286925655689213,5712100,25715041,20002941
350000.0,3,1.5,1860,17640,1.0,0,0,3,7,1860,0,1966,0.0,98059,47.483999999999995,-122.111,1860,17820,15780,0.8945578231292517,3459600,311169600,307710000
322000.0,3,1.0,1380,5864,1.0,0,0,2,7,790,590,1944,0.0,98133,47.7049,-122.339,1509,5864,4484,0.7646657571623465,1904400,34386496,32482096
664500.0,4,2.25,3070,9210,2.0,0,0,2,8,2740,330,2010,0.0,98011,47.7638,-122.196,2580,9660,6140,0.6666666666666666,9424900,84824100,75399200
988000.0,3,1.75,2190,3800,1.5,0,2,3,8,2190,0,1923,0.0,98109,47.643,-122.355,2190,3880,1610,0.4236842105263158,4796100,14440000,9643900
625000.0,2,1.75,1990,4000,1.0,0,0,4,7,1090,900,1952,0.0,98103,47.6889,-122.34200000000001,1270,5700,2010,0.5025,3960100,16000000,12039900
675000.0,2,1.0,930,36478,1.0,0,2,2,6,930,0,1951,0.0,98006,47.5699,-122.164,2800,11141,35548,0.97450518120511,864900,1330644484,1329779584
503000.0,3,1.75,2070,9827,1.0,0,0,3,7,1420,650,1967,0.0,98027,47.522,-122.05,2150,9827,7757,0.7893558563142363,4284900,96569929,92285029
431000.0,4,2.25,2170,10500,1.0,0,2,3,8,1270,900,1960,0.0,98166,47.4394,-122.338,2080,11019,8330,0.7933333333333333,4708900,110250000,105541100
250000.0,3,1.75,1910,10230,1.0,0,0,3,7,1290,620,1964,0.0,98031,47.4185,-122.20700000000001,1590,10800,8320,0.8132942326490714,3648100,104652900,101004800
268500.0,4,2.5,2100,4237,2.0,0,0,2,8,2100,0,2006,0.0,98031,47.3901,-122.17399999999999,2100,4575,2137,0.5043662969081898,4410000,17952169,13542169
1070000.0,6,3.25,3560,21400,2.0,0,4,3,9,3560,0,1952,0.0,98177,47.7602,-122.37200000000001,3560,24338,17840,0.8336448598130841,12673600,457960000,445286400
295000.0,4,2.5,2290,4539,2.0,0,0,2,7,2290,0,2001,0.0,98058,47.4753,-122.17200000000001,1710,7200,2249,0.4954835866931042,5244100,20602521,15358421
780000.0,3,2.25,2130,11782,1.0,0,0,3,8,1590,540,1977,0.0,98040,47.5423,-122.215,2700,11782,9652,0.8192157528433203,4536900,138815524,134278624
354000.0,3,2.5,2160,15817,2.0,0,0,2,8,2160,0,1999,0.0,98031,47.4166,-122.18299999999999,1990,15817,13657,0.863438072959474,4665600,250177489,245511889
305000.0,2,1.0,860,7250,1.0,0,0,2,6,860,0,1949,0.0,98133,47.7206,-122.35,1270,7250,6390,0.8813793103448276,739600,52562500,51822900
733000.0,5,2.75,2880,4425,2.0,0,0,2,8,2880,0,2005,0.0,98052,47.7048,-122.109,2940,6581,1545,0.34915254237288135,8294400,19580625,11286225
640000.0,4,2.75,2100,11894,1.0,0,0,3,8,1720,380,1968,0.0,98004,47.6006,-122.194,2390,9450,9794,0.8234403901126618,4410000,141467236,137057236
840000.0,4,2.5,2360,9600,1.0,0,2,2,8,1630,730,1973,0.0,98040,47.5889,-122.249,2140,6300,7240,0.7541666666666667,5569600,92160000,86590400
1480000.0,5,3.25,3680,10300,1.5,0,0,3,10,3680,0,1927,0.0,98105,47.6548,-122.28,2690,7200,6620,0.6427184466019418,13542400,106090000,92547600
525000.0,3,1.0,1560,8100,1.0,0,0,3,8,1140,420,1952,0.0,98177,47.7261,-122.36399999999999,2130,8100,6540,0.8074074074074075,2433600,65610000,63176400
625000.0,4,2.75,1680,11180,1.0,0,0,3,7,1680,0,1966,0.0,98052,47.6557,-122.12700000000001,2400,9627,9500,0.8497316636851521,2822400,124992400,122170000
350000.0,3,2.0,1380,3600,3.0,0,0,2,8,1380,0,2015,0.0,98122,47.6074,-122.305,1480,3600,2220,0.6166666666666667,1904400,12960000,11055600
650000.0,4,2.75,2610,4160,3.0,0,0,4,8,1910,700,1910,0.0,98103,47.6901,-122.35700000000001,1470,4140,1550,0.37259615384615385,6812100,17305600,10493500
435000.0,2,1.0,870,4000,1.0,0,2,2,7,870,0,1950,0.0,98126,47.5682,-122.374,1690,4000,3130,0.7825,756900,16000000,15243100
660000.0,3,1.0,1210,9622,1.0,0,1,2,8,1210,0,1955,2009.0,98006,47.5728,-122.179,1580,9714,8412,0.874246518395344,1464100,92582884,91118784
350000.0,3,1.0,1150,12877,1.0,0,0,3,6,1150,0,1970,0.0,98053,47.6614,-122.056,1490,12150,11727,0.910693484507261,1322500,165817129,164494629
435000.0,3,2.5,3110,6000,1.0,0,2,2,8,1560,1550,1967,0.0,98106,47.5331,-122.353,2060,6000,2890,0.4816666666666667,9672100,36000000,26327900
375900.0,6,1.5,2550,33740,1.0,0,0,3,8,1750,800,1958,0.0,98023,47.3222,-122.36200000000001,2010,28200,31190,0.9244220509780676,6502500,1138387600,1131885100
272000.0,3,3.0,2430,10500,1.0,0,0,3,8,2150,280,1983,0.0,98003,47.2579,-122.31200000000001,1670,9800,8070,0.7685714285714286,5904900,110250000,104345100
233000.0,3,1.75,1460,7800,1.0,0,0,1,7,1040,420,1979,0.0,98023,47.3035,-122.382,1310,7865,6340,0.8128205128205128,2131600,60840000,58708400
500000.0,4,1.5,1330,5750,1.5,0,2,2,7,1330,0,1915,0.0,98116,47.5681,-122.384,1360,5750,4420,0.768695652173913,1768900,33062500,31293600
540000.0,4,1.75,2040,9322,1.0,0,0,2,8,1440,600,1977,0.0,98155,47.7611,-122.29799999999999,1910,10026,7282,0.7811628405921476,4161600,86899684,82738084
712000.0,3,2.5,2375,4094,2.0,0,0,2,9,2375,0,2002,0.0,98052,47.6627,-122.086,2095,4442,1719,0.4198827552515877,5640625,16760836,11120211
425000.0,4,2.5,2480,4504,2.0,0,0,2,7,2480,0,2005,0.0,98059,47.4998,-122.15,2950,4504,2024,0.4493783303730018,6150400,20286016,14135616
242000.0,3,1.75,1580,6099,1.0,0,0,4,7,790,0,1944,0.0,98168,47.4807,-122.29,1330,6099,4519,0.7409411378914577,2496400,37197801,34701401
515000.0,5,3.25,2740,9629,1.0,0,0,4,7,1390,1350,1977,0.0,98011,47.7645,-122.197,2150,10500,6889,0.7154429328071451,7507600,92717641,85210041
415000.0,4,1.75,1920,7700,2.0,0,0,3,7,1920,0,1970,0.0,98056,47.5381,-122.177,1310,7700,5780,0.7506493506493507,3686400,59290000,55603600
375000.0,3,2.75,2200,9600,1.0,0,3,3,8,1570,630,1977,0.0,98003,47.3438,-122.323,2680,9896,7400,0.7708333333333334,4840000,92160000,87320000
182500.0,3,1.0,910,7194,1.0,0,0,3,7,910,0,1971,0.0,98001,47.3337,-122.275,1530,7200,6284,0.8735056991937726,828100,51753636,50925536
310000.0,3,1.5,1860,10379,1.0,0,0,2,7,1240,620,1963,0.0,98198,47.3962,-122.309,2240,11328,8519,0.8207919838134695,3459600,107723641,104264041
360000.0,3,1.75,1510,6000,1.0,0,0,2,7,1060,450,1947,0.0,98136,47.5535,-122.39,1610,6000,4490,0.7483333333333333,2280100,36000000,33719900
889000.0,4,3.5,3920,9555,2.0,0,0,2,9,3920,0,2004,0.0,98053,47.6797,-122.025,3920,8598,5635,0.5897435897435898,15366400,91298025,75931625
450500.0,2,1.0,1330,3698,1.0,0,0,2,7,1330,0,1952,0.0,98117,47.6866,-122.37200000000001,1900,5000,2368,0.6403461330448891,1768900,13675204,11906304
342000.0,4,2.25,1964,3541,2.0,0,0,2,9,1964,0,2013,0.0,98030,47.3594,-122.20100000000001,1757,3547,1577,0.4453544196554646,3857296,12538681,8681385
413000.0,3,2.0,1520,3451,1.0,0,0,2,8,1520,0,1996,0.0,98177,47.7753,-122.375,1800,3451,1931,0.5595479571138801,2310400,11909401,9599001
960000.0,5,4.0,3720,15200,2.0,0,0,2,10,3720,0,2005,0.0,98075,47.5956,-122.02600000000001,4100,19036,11480,0.7552631578947369,13838400,231040000,217201600
180000.0,2,1.0,770,9370,1.0,0,0,2,7,770,0,1947,0.0,98155,47.762,-122.321,1060,9352,8600,0.9178228388473852,592900,87796900,87204000
770000.0,4,2.5,3210,14910,2.0,0,0,2,10,3210,0,1995,0.0,98074,47.6073,-122.06200000000001,3280,14910,11700,0.7847082494969819,10304100,222308100,212004000
224400.0,3,1.75,1070,7200,1.0,0,0,2,7,1070,0,1994,0.0,98010,47.3129,-122.023,1280,7200,6130,0.8513888888888889,1144900,51840000,50695100
280000.0,3,1.5,1430,8861,1.0,0,0,2,7,1430,0,1956,0.0,98188,47.4454,-122.289,1080,9425,7431,0.8386186660647782,2044900,78517321,76472421
500000.0,3,2.5,1670,2575,2.0,0,0,2,8,1670,0,2000,0.0,98027,47.53100000000001,-122.04700000000001,1670,2897,905,0.35145631067961164,2788900,6630625,3841725
153000.0,2,1.0,710,9000,1.0,0,0,4,6,710,0,1943,0.0,98166,47.4811,-122.339,1230,9000,8290,0.9211111111111111,504100,81000000,80495900
385000.0,3,2.25,1920,4833,1.0,0,0,3,7,1060,860,1921,0.0,98133,47.7067,-122.352,1580,5134,2913,0.6027312228429547,3686400,23357889,19671489
325000.0,2,1.0,750,5534,1.0,0,0,2,7,750,0,1947,0.0,98177,47.7017,-122.36,1050,5534,4784,0.8644741597397904,562500,30625156,30062656
315000.0,4,3.0,2210,4191,2.0,0,0,2,7,2210,0,2004,0.0,98002,47.2959,-122.225,890,4288,1981,0.4726795514197089,4884100,17564481,12680381
294999.0,4,2.5,1660,9760,2.0,0,0,2,7,1660,0,1994,0.0,98030,47.3635,-122.18799999999999,1580,9614,8100,0.8299180327868853,2755600,95257600,92502000
175000.0,3,1.75,1910,17003,1.5,0,0,3,8,1910,0,1963,0.0,98001,47.3095,-122.28299999999999,1820,14806,15093,0.8876668823148857,3648100,289102009,285453909
299000.0,3,1.75,1910,17003,1.5,0,0,3,8,1910,0,1963,0.0,98001,47.3095,-122.28299999999999,1820,14806,15093,0.8876668823148857,3648100,289102009,285453909
146000.0,2,1.0,780,9750,1.0,0,0,2,6,780,0,1937,0.0,98168,47.4816,-122.322,1670,9750,8970,0.92,608400,95062500,94454100
290000.0,3,2.25,1650,10336,1.0,0,0,2,7,1500,150,1962,0.0,98133,47.7757,-122.35,1420,10260,8686,0.8403637770897833,2722500,106832896,104110396
1780000.0,3,3.25,3230,7800,2.0,0,3,2,10,3230,0,2005,0.0,98199,47.6348,-122.40299999999999,3030,6600,4570,0.5858974358974359,10432900,60840000,50407100
367500.0,2,1.0,810,4800,1.0,0,0,2,6,810,0,1919,0.0,98118,47.5614,-122.27,1040,4800,3990,0.83125,656100,23040000,22383900
535000.0,4,2.5,2750,15099,2.0,0,0,2,8,2750,0,1994,0.0,98019,47.7298,-121.97200000000001,2500,14564,12349,0.8178687330286774,7562500,227979801,220417301
334999.0,3,2.5,1650,13816,2.0,0,0,2,7,1650,0,1998,0.0,98014,47.6553,-121.913,1630,18750,12166,0.8805732484076433,2722500,190881856,188159356
655000.0,3,1.75,1960,5520,1.0,0,0,3,7,1080,880,1952,0.0,98199,47.6535,-122.397,1720,5760,3560,0.644927536231884,3841600,30470400,26628800
1300000.0,4,3.5,2790,10125,1.5,0,0,4,8,2790,0,1985,0.0,98040,47.5651,-122.22,2570,10125,7335,0.7244444444444444,7784100,102515625,94731525
480000.0,4,2.25,2230,11200,1.0,0,0,3,7,1300,930,1977,0.0,98011,47.7691,-122.167,2090,10563,8970,0.8008928571428572,4972900,125440000,120467100
465000.0,3,1.5,1280,4720,1.0,0,0,3,7,850,430,1941,0.0,98126,47.5509,-122.37700000000001,1280,4720,3440,0.7288135593220338,1638400,22278400,20640000
297950.0,3,2.0,1240,10800,1.0,0,0,2,7,1240,0,1967,2010.0,98058,47.449,-122.155,1480,8840,9560,0.8851851851851852,1537600,116640000,115102400
590000.0,3,2.0,1860,3600,1.5,0,0,2,7,1110,750,1915,0.0,98122,47.6102,-122.296,1680,3695,1740,0.48333333333333334,3459600,12960000,9500400
805000.0,4,2.75,2410,6000,1.0,0,0,4,8,1410,1000,1950,0.0,98107,47.6707,-122.399,1760,6000,3590,0.5983333333333334,5808100,36000000,30191900
204250.0,3,2.25,1960,7708,1.0,0,0,3,7,1490,470,1984,0.0,98023,47.2981,-122.374,1580,8063,5748,0.7457187337830825,3841600,59413264,55571664
500000.0,3,2.25,1710,4561,2.0,0,0,3,8,1710,0,1994,0.0,98029,47.5691,-122.00399999999999,1810,4770,2851,0.6250822188116641,2924100,20802721,17878621
490000.0,4,2.5,3480,12696,1.0,0,0,3,9,1980,1500,1977,0.0,98042,47.3816,-122.15299999999999,3480,14175,9216,0.725897920604915,12110400,161188416,149078016
2500000.0,4,3.75,3480,14850,1.0,0,4,2,9,1870,1610,1951,2013.0,98004,47.6227,-122.21600000000001,4780,18480,11370,0.7656565656565657,12110400,220522500,208412100
750000.0,3,2.5,2960,69351,2.0,1,3,3,9,2960,0,1990,0.0,98070,47.4,-122.42,2350,41433,66391,0.9573185678649191,8761600,4809561201,4800799601
405000.0,4,2.5,2670,20894,2.0,0,0,2,9,2330,340,2002,0.0,98155,47.7735,-122.281,2440,15815,18224,0.8722121183114769,7128900,436559236,429430336
209995.0,2,1.0,700,7303,1.0,0,0,4,5,700,0,1953,0.0,98056,47.4934,-122.166,960,6060,6603,0.9041489798712857,490000,53333809,52843809
680000.0,4,2.5,2830,8399,2.0,0,0,2,9,2830,0,1998,0.0,98075,47.5851,-122.03399999999999,2520,6890,5569,0.6630551256101916,8008900,70543201,62534301
355000.0,3,1.75,1120,7740,1.0,0,0,3,6,860,260,1948,0.0,98125,47.7107,-122.291,1240,7740,6620,0.8552971576227391,1254400,59907600,58653200
280000.0,2,1.0,1310,6600,1.0,0,0,2,6,1310,0,1942,0.0,98168,47.4834,-122.33200000000001,1240,6600,5290,0.8015151515151515,1716100,43560000,41843900
385000.0,3,2.25,1710,11500,1.0,0,0,2,7,1210,500,1978,0.0,98028,47.7675,-122.26700000000001,1800,11500,9790,0.851304347826087,2924100,132250000,129325900
505000.0,4,2.75,2200,9778,1.0,0,0,3,8,1100,1100,1962,0.0,98006,47.5472,-122.176,2140,11321,7578,0.7750051135201472,4840000,95609284,90769284
429900.0,4,3.25,3310,8897,2.0,0,0,2,9,2380,930,1991,0.0,98003,47.2655,-122.31,2490,8638,5587,0.6279644824098011,10956100,79156609,68200509
560000.0,4,2.5,2280,9874,2.0,0,0,2,9,2280,0,1989,0.0,98034,47.7099,-122.229,2670,9782,7594,0.7690905408142596,5198400,97495876,92297476
231000.0,3,2.0,1640,4875,1.0,0,0,3,7,1040,600,1977,0.0,98042,47.3661,-122.094,1640,5200,3235,0.6635897435897435,2689600,23765625,21076025
135000.0,2,1.0,750,5217,1.0,0,0,3,6,750,0,1943,0.0,98106,47.5188,-122.353,760,4440,4467,0.8562392179413456,562500,27217089,26654589
800000.0,4,3.0,3520,4895,1.0,0,0,2,8,1980,1540,1954,0.0,98107,47.6678,-122.361,1570,2153,1375,0.2808988764044944,12390400,23961025,11570625
420000.0,3,2.5,2720,8622,2.0,0,0,2,8,2720,0,2002,0.0,98059,47.4954,-122.163,1950,8603,5902,0.6845279517513339,7398400,74338884,66940484
360000.0,3,1.0,1660,9600,1.0,0,0,2,7,1660,0,1963,0.0,98034,47.708,-122.21600000000001,2020,9600,7940,0.8270833333333333,2755600,92160000,89404400
642000.0,4,2.5,2560,8780,2.0,0,0,2,9,2560,0,1992,0.0,98029,47.5717,-121.991,2780,8357,6220,0.7084282460136674,6553600,77088400,70534800
379950.0,3,2.0,1080,5077,1.0,0,0,2,7,1080,0,1985,0.0,98052,47.6836,-122.095,1070,3471,3997,0.7872759503643885,1166400,25775929,24609529
745000.0,3,1.75,2050,11041,1.5,0,0,4,9,2050,0,1959,0.0,98005,47.5968,-122.17399999999999,2530,11041,8991,0.8143284122814962,4202500,121903681,117701181
630000.0,4,2.0,2670,3240,1.5,0,0,3,9,1780,890,1930,0.0,98144,47.5841,-122.294,1820,4000,570,0.17592592592592593,7128900,10497600,3368700
250000.0,3,2.5,1730,7200,2.0,0,0,3,7,1730,0,1985,0.0,98031,47.4029,-122.196,1770,7396,5470,0.7597222222222222,2992900,51840000,48847100
275000.0,3,1.0,990,9798,1.0,0,0,2,7,990,0,1968,0.0,98072,47.766999999999996,-122.164,1210,9870,8808,0.898958971218616,980100,96000804,95020704
435000.0,6,3.0,3560,4290,1.0,0,0,3,7,1780,1780,1957,0.0,98118,47.5282,-122.26899999999999,3040,6000,730,0.17016317016317017,12673600,18404100,5730500
175000.0,2,1.0,700,8174,1.0,0,0,2,5,700,0,1941,0.0,98146,47.5136,-122.34899999999999,1250,8046,7474,0.9143626131636897,490000,66814276,66324276
560000.0,4,1.75,1880,3880,1.5,0,0,3,7,1090,790,1944,0.0,98107,47.6635,-122.36200000000001,1390,3880,2000,0.5154639175257731,3534400,15054400,11520000
325000.0,4,2.25,1870,9680,1.0,0,0,3,7,1170,700,1959,0.0,98034,47.7157,-122.234,2000,9790,7810,0.8068181818181818,3496900,93702400,90205500
1190000.0,3,2.75,2500,5568,2.0,0,0,4,9,2500,0,1905,0.0,98112,47.6258,-122.31200000000001,2810,5568,3068,0.5510057471264368,6250000,31002624,24752624
399950.0,3,2.5,2570,10431,2.0,0,0,2,9,2570,0,1989,0.0,98031,47.4188,-122.213,2590,10078,7861,0.7536190202281661,6604900,108805761,102200861
752000.0,4,2.5,2940,10382,2.0,0,0,3,9,2940,0,1991,0.0,98059,47.5333,-122.15100000000001,2980,10547,7442,0.7168175688691967,8643600,107785924,99142324
1200000.0,4,3.5,3930,43560,2.0,0,0,2,10,3930,0,2003,0.0,98072,47.7497,-122.12100000000001,2860,36460,39630,0.9097796143250688,15444900,1897473600,1882028700
400000.0,4,1.5,2150,11026,1.0,0,0,3,7,2150,0,1952,0.0,98028,47.7635,-122.26299999999999,1760,10283,8876,0.8050063486305097,4622500,121572676,116950176
240000.0,3,2.0,1330,6000,1.0,0,0,3,7,630,700,1900,0.0,98108,47.5255,-122.32700000000001,1140,6000,4670,0.7783333333333333,1768900,36000000,34231100
640000.0,5,2.5,3220,4759,2.0,0,0,2,8,3220,0,2003,0.0,98075,47.5957,-122.03200000000001,2550,4759,1539,0.32338726623240177,10368400,22648081,12279681
564450.0,3,2.5,2710,6174,2.0,0,0,2,9,2710,0,1998,0.0,98056,47.512,-122.17399999999999,2730,7266,3464,0.5610625202461937,7344100,38118276,30774176
300000.0,3,1.5,1630,82764,1.0,0,0,3,6,1630,0,1948,0.0,98027,47.4743,-122.02600000000001,1680,199069,81134,0.9803054468126239,2656900,6849879696,6847222796
286000.0,3,2.5,1680,4226,2.0,0,0,2,8,1680,0,2003,0.0,98042,47.3684,-122.12299999999999,1800,5559,2546,0.6024609559867486,2822400,17859076,15036676
531800.0,3,2.5,1930,5344,2.0,0,0,2,7,1930,0,2004,0.0,98053,47.6783,-122.03200000000001,2410,5080,3414,0.6388473053892215,3724900,28558336,24833436
502000.0,4,2.25,2140,10943,1.0,0,0,2,7,1550,590,1977,0.0,98034,47.7271,-122.215,2350,9000,8803,0.8044411952846569,4579600,119749249,115169649
993500.0,4,2.25,4070,23321,2.0,0,0,3,10,4070,0,1968,0.0,98040,47.5563,-122.219,2820,10871,19251,0.8254791818532653,16564900,543869041,527304141
450000.0,3,1.0,1350,10000,1.0,0,0,3,7,1350,0,1954,0.0,98006,47.5741,-122.133,1450,10000,8650,0.865,1822500,100000000,98177500
997950.0,4,3.5,4270,117176,2.0,0,0,2,9,4270,0,2008,0.0,98024,47.5352,-121.883,2610,5251,112906,0.9635590905987574,18232900,13730214976,13711982076
526000.0,3,1.0,1320,5250,1.5,0,0,4,7,1320,0,1913,0.0,98126,47.5566,-122.37799999999999,1490,5250,3930,0.7485714285714286,1742400,27562500,25820100
335000.0,3,1.75,2100,8298,1.0,0,0,3,7,1230,870,1952,0.0,98166,47.4601,-122.36,1700,10830,6198,0.7469269703543022,4410000,68856804,64446804
187250.0,2,1.0,710,14700,1.0,0,0,4,6,710,0,1926,0.0,98168,47.4939,-122.318,1320,14700,13990,0.9517006802721089,504100,216090000,215585900
735000.0,3,2.25,2350,6000,1.0,0,0,4,7,1020,1330,1948,0.0,98115,47.6809,-122.305,1570,5000,3650,0.6083333333333333,5522500,36000000,30477500
425000.0,3,1.0,1180,8400,1.0,0,0,2,7,1180,0,1951,0.0,98125,47.7028,-122.295,1740,7020,7220,0.8595238095238096,1392400,70560000,69167600
110000.0,3,1.0,1250,53143,1.0,0,0,4,6,1250,0,1945,0.0,98038,47.4235,-122.051,1820,217800,51893,0.9764785578533391,1562500,2824178449,2822615949
305000.0,3,2.0,1490,7697,1.0,0,0,2,7,1490,0,1994,0.0,98059,47.4852,-122.164,1540,7529,6207,0.8064180849681695,2220100,59243809,57023709
212000.0,3,1.0,1000,9450,1.0,0,0,2,6,1000,0,1962,0.0,98055,47.4562,-122.193,1300,13500,8450,0.8941798941798942,1000000,89302500,88302500
1380000.0,5,4.25,4050,18827,1.0,0,2,3,10,2150,1900,1979,0.0,98040,47.5323,-122.23700000000001,3600,25120,14777,0.7848834121208902,16402500,354455929,338053429
298950.0,5,2.25,2300,11505,1.0,0,0,2,8,1300,1000,1963,0.0,98030,47.3812,-122.223,2350,11505,9205,0.8000869187309865,5290000,132365025,127075025
525000.0,3,1.75,1330,8136,1.0,0,0,3,7,1330,0,1977,0.0,98033,47.7001,-122.17299999999999,1330,8136,6806,0.8365290068829891,1768900,66194496,64425596
707000.0,4,3.25,3200,7081,2.0,0,0,2,9,3200,0,2004,0.0,98075,47.5886,-121.98899999999999,3120,6094,3881,0.548086428470555,10240000,50140561,39900561
695000.0,3,2.75,2590,12063,2.0,0,0,2,10,2590,0,1993,0.0,98006,47.5527,-122.12,2850,8469,9473,0.7852938738290641,6708100,145515969,138807869
796500.0,3,2.75,2590,12063,2.0,0,0,2,10,2590,0,1993,0.0,98006,47.5527,-122.12,2850,8469,9473,0.7852938738290641,6708100,145515969,138807869
420000.0,4,2.5,2030,8100,1.0,0,0,2,7,1150,880,1973,0.0,98034,47.7404,-122.186,1770,8071,6070,0.7493827160493827,4120900,65610000,61489100
625000.0,5,2.5,2700,21208,1.0,0,0,3,8,1950,750,1955,0.0,98005,47.6078,-122.154,2550,20409,18508,0.8726895511127877,7290000,449779264,442489264
620000.0,3,1.75,1670,9900,1.0,0,0,3,8,1670,0,1957,0.0,98005,47.595,-122.17200000000001,2410,8800,8230,0.8313131313131313,2788900,98010000,95221100
1450000.0,5,2.75,3090,19865,1.0,0,0,3,9,3090,0,1953,0.0,98039,47.6232,-122.235,2970,19862,16775,0.8444500377548452,9548100,394618225,385070125
549950.0,5,2.5,2650,54380,2.0,0,0,2,9,2650,0,1984,0.0,98077,47.7726,-122.081,2560,49044,51730,0.9512688488414859,7022500,2957184400,2950161900
275000.0,4,2.0,1440,10920,1.0,0,0,2,5,1440,0,1943,0.0,98056,47.5049,-122.18,1500,11902,9480,0.8681318681318682,2073600,119246400,117172800
705000.0,3,2.5,2820,7200,1.0,0,3,2,9,1780,1040,1979,0.0,98177,47.7691,-122.38799999999999,2300,7200,4380,0.6083333333333333,7952400,51840000,43887600
197000.0,3,1.75,1690,7735,1.0,0,0,3,7,1060,630,1976,0.0,98001,47.3324,-122.28,1580,7503,6045,0.7815126050420168,2856100,59830225,56974125
265000.0,3,1.75,1420,8126,1.0,0,0,2,8,1420,0,1991,0.0,98031,47.3871,-122.189,1730,7954,6706,0.8252522766428747,2016400,66031876,64015476
297000.0,4,1.75,1790,5341,1.0,0,0,3,7,1050,740,1951,0.0,98166,47.4663,-122.363,1540,6916,3551,0.6648567683954316,3204100,28526281,25322181
207500.0,3,1.75,1320,12528,1.0,0,0,3,7,1320,0,1970,0.0,98042,47.3234,-122.14200000000001,1340,11039,11208,0.8946360153256705,1742400,156950784,155208384
410000.0,3,2.5,1509,1418,3.0,0,0,2,8,1509,0,2014,0.0,98133,47.7047,-122.34,1509,1991,-91,-0.06417489421720733,2277081,2010724,-266357
268000.0,3,2.0,1610,8416,1.0,0,0,2,7,1610,0,1994,0.0,98031,47.397,-122.18700000000001,1600,8308,6806,0.8086977186311787,2592100,70829056,68236956
330000.0,4,1.75,1550,50094,1.0,0,3,3,6,1550,0,1967,0.0,98022,47.2194,-122.059,1720,50094,48544,0.9690581706391983,2402500,2509408836,2507006336
417500.0,3,1.0,1160,7491,1.0,0,0,3,6,1160,0,1917,0.0,98177,47.7024,-122.359,1800,2267,6331,0.8451475103457482,1345600,56115081,54769481
760000.0,4,2.25,2500,8500,2.0,0,0,3,8,2500,0,1979,0.0,98006,47.5569,-122.15100000000001,2470,9100,6000,0.7058823529411765,6250000,72250000,66000000
499000.0,3,2.5,1540,1326,3.0,0,0,2,8,1390,150,1995,0.0,98119,47.6457,-122.374,1680,1592,-214,-0.16138763197586728,2371600,1758276,-613324
620000.0,4,2.5,1910,7683,2.0,0,0,2,8,1910,0,1987,0.0,98027,47.5644,-122.09200000000001,1980,8485,5773,0.7513991930235585,3648100,59028489,55380389
315000.0,3,2.5,2340,6837,2.0,0,0,2,7,2340,0,1992,0.0,98030,47.3608,-122.194,1850,6209,4497,0.6577446248354542,5475600,46744569,41268969
624950.0,3,2.5,2060,4730,2.0,0,0,3,8,2060,0,1994,0.0,98033,47.6874,-122.178,1980,5010,2670,0.5644820295983086,4243600,22372900,18129300
525000.0,3,2.25,1960,12350,1.0,0,0,3,7,1960,0,1961,0.0,98027,47.5247,-122.052,1920,13608,10390,0.8412955465587044,3841600,152522500,148680900
300000.0,2,1.5,1150,3927,2.0,0,0,2,7,1150,0,1982,0.0,98034,47.7248,-122.162,1400,3425,2777,0.7071555895085306,1322500,15421329,14098829
299900.0,4,2.75,2330,7200,1.0,0,0,3,8,1560,770,1977,0.0,98023,47.3203,-122.385,2350,7600,4870,0.6763888888888889,5428900,51840000,46411100
299000.0,3,2.5,2210,10119,1.0,0,0,3,7,1450,760,1966,0.0,98030,47.3783,-122.22,2110,10119,7909,0.7815989722304576,4884100,102394161,97510061
1880000.0,4,2.75,3260,19542,1.0,0,0,3,10,2170,1090,1968,0.0,98039,47.6245,-122.236,3480,19863,16282,0.8331798178282673,10627600,381889764,371262164
265000.0,4,1.75,1900,10588,1.0,0,0,4,6,1900,0,1958,0.0,98002,47.288999999999994,-122.212,1530,10587,8688,0.8205515678126181,3610000,112105744,108495744
280000.0,2,1.75,1610,158558,1.5,0,0,1,6,1610,0,1948,0.0,98065,47.5319,-121.84,1800,3572,156948,0.9898459869574541,2592100,25140639364,25138047264
124740.0,3,1.0,1340,15600,1.0,0,0,3,6,1340,0,1978,0.0,98042,47.3224,-122.14299999999999,1320,9800,14260,0.9141025641025641,1795600,243360000,241564400
1090000.0,3,2.75,3170,34850,1.0,0,0,4,9,3170,0,1957,0.0,98033,47.6611,-122.169,3920,36740,31680,0.909038737446198,10048900,1214522500,1204473600
1970000.0,8,3.5,4440,6480,2.0,0,3,4,10,3140,1300,1959,0.0,98112,47.631,-122.303,4440,8640,2040,0.3148148148148148,19713600,41990400,22276800
219000.0,4,1.0,1370,5339,1.5,0,0,3,6,1370,0,1948,0.0,98168,47.5046,-122.3,1280,7048,3969,0.7433976400074921,1876900,28504921,26628021
569950.0,5,1.0,1420,6250,1.5,0,0,3,8,1420,0,1926,0.0,98116,47.5807,-122.389,1420,6250,4830,0.7728,2016400,39062500,37046100
212500.0,2,2.0,1030,21712,1.0,0,0,3,6,1030,0,1938,0.0,98168,47.4905,-122.331,1790,9199,20682,0.9525607958732498,1060900,471410944,470350044
680000.0,3,2.25,1820,8316,1.0,0,0,4,7,1320,500,1960,0.0,98005,47.5849,-122.169,1780,8400,6496,0.7811447811447811,3312400,69155856,65843456
1460000.0,4,1.5,2650,6900,2.0,0,0,3,9,2400,250,1909,0.0,98112,47.6275,-122.305,2420,6900,4250,0.6159420289855072,7022500,47610000,40587500
300000.0,3,1.0,910,7700,1.0,0,0,3,7,910,0,1971,0.0,98034,47.7303,-122.238,1250,7700,6790,0.8818181818181818,828100,59290000,58461900
629950.0,3,2.5,1680,1683,2.0,0,0,2,9,1120,560,2014,0.0,98119,47.6424,-122.374,1610,1249,3,0.0017825311942959,2822400,2832489,10089
349900.0,2,1.75,1550,9230,1.0,0,0,2,6,970,580,1969,0.0,98045,47.4701,-121.744,1550,10856,7680,0.8320693391115926,2402500,85192900,82790400
690000.0,4,2.5,2780,6235,2.0,0,0,2,8,2780,0,2001,0.0,98075,47.5976,-122.039,2670,4410,3455,0.5541299117882919,7728400,38875225,31146825
1450000.0,5,4.0,4070,11334,2.0,0,0,2,10,4070,0,2014,0.0,98033,47.6771,-122.18700000000001,2640,9401,7264,0.640903476266102,16564900,128459556,111894656
1290000.0,3,2.5,3240,12625,2.0,0,0,2,11,3240,0,1987,0.0,98040,47.5327,-122.23200000000001,3470,12331,9385,0.7433663366336634,10497600,159390625,148893025
696000.0,4,3.5,3650,38546,2.0,0,0,2,9,2550,1100,1996,0.0,98045,47.4776,-121.73,2860,34284,34896,0.9053079437555129,13322500,1485794116,1472471616
650000.0,3,2.25,2180,60112,2.0,0,0,2,8,2180,0,1976,0.0,98053,47.6723,-122.08200000000001,2060,120225,57932,0.9637343625232898,4752400,3613452544,3608700144
640000.0,3,3.5,2480,10800,2.0,0,0,2,8,2480,0,1998,0.0,98074,47.6083,-122.06,2380,11310,8320,0.7703703703703704,6150400,116640000,110489600
499950.0,5,2.5,3180,23809,1.0,0,0,2,9,3180,0,1978,0.0,98038,47.3727,-122.054,2500,15778,20629,0.8664370616153555,10112400,566868481,556756081
490000.0,4,2.5,3630,8387,2.0,0,0,2,10,3630,0,1997,0.0,98042,47.3623,-122.12700000000001,3370,8869,4757,0.5671873136997735,13176900,70341769,57164869
685000.0,5,2.5,3160,5635,2.0,0,0,2,9,3160,0,2003,0.0,98027,47.5362,-122.06700000000001,3670,6087,2475,0.4392191659272405,9985600,31753225,21767625
387500.0,4,1.0,1370,7140,2.0,0,0,2,6,1370,0,1942,0.0,98146,47.512,-122.376,1090,6300,5770,0.8081232492997199,1876900,50979600,49102700
401750.0,2,1.5,1070,1236,2.0,0,0,2,8,1000,70,2005,0.0,98116,47.5619,-122.382,1170,1888,166,0.1343042071197411,1144900,1527696,382796
254950.0,4,2.0,2180,8800,1.0,0,0,4,7,1170,0,1977,0.0,98038,47.3676,-122.046,1630,8800,6620,0.7522727272727273,4752400,77440000,72687600
500000.0,4,2.25,2420,36680,2.0,0,0,3,8,2420,0,1977,0.0,98027,47.4663,-122.006,2410,36680,34260,0.9340239912758996,5856400,1345422400,1339566000
856500.0,4,2.5,3290,8147,2.0,0,0,2,10,3290,0,2003,0.0,98052,47.7048,-122.10700000000001,3290,7467,4857,0.5961703694611513,10824100,66373609,55549509
552000.0,3,1.0,1430,5000,1.0,0,0,3,6,1080,350,1919,0.0,98115,47.6724,-122.296,1630,4600,3570,0.714,2044900,25000000,22955100
506500.0,4,2.5,1890,7200,1.0,0,0,3,7,1500,390,1978,0.0,98034,47.7278,-122.21799999999999,2070,7200,5310,0.7375,3572100,51840000,48267900
500000.0,3,2.25,1760,4539,2.0,0,0,2,8,1760,0,1988,0.0,98029,47.5754,-122.01299999999999,1960,4808,2779,0.6122493941396784,3097600,20602521,17504921
280000.0,4,2.75,2230,10160,1.0,0,0,2,7,1400,830,1968,0.0,98168,47.5123,-122.32,1740,10080,7930,0.780511811023622,4972900,103225600,98252700
308000.0,3,1.75,1630,11475,1.0,0,0,3,7,1330,300,1979,0.0,98045,47.4635,-121.74600000000001,1630,11475,9845,0.8579520697167756,2656900,131675625,129018725
613500.0,3,2.5,2350,7035,2.0,0,0,2,8,2350,0,1989,0.0,98029,47.5713,-122.02,2270,7192,4685,0.665955934612651,5522500,49491225,43968725
255000.0,3,1.75,1550,9720,1.0,0,0,2,7,1050,500,1976,0.0,98010,47.3433,-122.037,1550,9750,8170,0.8405349794238683,2402500,94478400,92075900
545000.0,3,2.5,3550,136343,2.0,0,0,2,10,3550,0,1977,0.0,98014,47.6223,-121.869,3080,215186,132793,0.9739627263592557,12602500,18589413649,18576811149
620000.0,4,2.5,2720,34498,1.0,0,0,4,7,1360,1360,1966,0.0,98075,47.5832,-122.02,1920,22474,31778,0.9211548495564961,7398400,1190112004,1182713604
450000.0,3,1.75,1740,6800,1.5,0,0,3,7,1740,0,1949,0.0,98126,47.5314,-122.37299999999999,990,6800,5060,0.7441176470588236,3027600,46240000,43212400
279000.0,4,1.75,1840,7275,1.0,0,0,2,7,1090,750,1976,0.0,98031,47.4002,-122.189,1840,7275,5435,0.7470790378006873,3385600,52925625,49540025
625000.0,3,2.5,2010,3200,2.0,0,0,2,9,2010,0,2009,0.0,98027,47.5463,-122.015,2250,3200,1190,0.371875,4040100,10240000,6199900
274950.0,3,1.75,1670,7415,1.0,0,0,2,7,1320,350,1987,0.0,98042,47.3776,-122.116,1650,8585,5745,0.7747808496291302,2788900,54982225,52193325
423000.0,3,1.75,1820,6038,1.0,0,0,3,7,1040,780,1952,0.0,98126,47.5233,-122.37799999999999,1700,6040,4218,0.69857568731368,3312400,36457444,33145044
350000.0,2,1.0,720,5820,1.0,0,1,4,6,720,0,1950,0.0,98028,47.7598,-122.255,952,5820,5100,0.8762886597938144,518400,33872400,33354000
305000.0,4,1.75,2370,10140,1.0,0,0,2,7,1460,910,1968,0.0,98001,47.3352,-122.27799999999999,1450,7800,7770,0.7662721893491125,5616900,102819600,97202700
368000.0,3,1.75,2120,11340,1.0,0,3,3,7,1060,1060,1966,0.0,98198,47.4109,-122.329,1830,8650,9220,0.8130511463844797,4494400,128595600,124101200
232000.0,3,1.75,1290,6604,1.0,0,0,2,7,1290,0,1984,0.0,98023,47.323,-122.34899999999999,1440,6682,5314,0.8046638400969109,1664100,43612816,41948716
250000.0,4,3.0,1800,2500,2.0,0,0,2,7,1800,0,2000,0.0,98108,47.5333,-122.294,1830,6900,700,0.28,3240000,6250000,3010000
220000.0,3,1.75,1230,8917,1.0,0,0,3,7,1230,0,1966,0.0,98058,47.4528,-122.17200000000001,1420,7938,7687,0.8620612313558371,1512900,79512889,77999989
435000.0,3,2.0,1380,2500,1.0,0,0,2,7,750,630,1986,0.0,98107,47.6753,-122.363,1630,3800,1120,0.448,1904400,6250000,4345600
350000.0,2,1.0,740,7680,1.0,0,0,3,6,740,0,1922,0.0,98126,47.5245,-122.37100000000001,1080,7680,6940,0.9036458333333334,547600,58982400,58434800
206325.0,5,2.5,1720,10202,1.5,0,0,2,7,1720,0,1970,0.0,98058,47.4572,-122.167,1720,8478,8482,0.8314056067437757,2958400,104080804,101122404
339000.0,5,2.5,1720,10202,1.5,0,0,2,7,1720,0,1970,0.0,98058,47.4572,-122.167,1720,8478,8482,0.8314056067437757,2958400,104080804,101122404
399000.0,4,2.5,2100,7355,1.0,0,0,4,7,2100,0,1969,0.0,98059,47.5078,-122.161,1750,7200,5255,0.7144799456152278,4410000,54096025,49686025
529000.0,2,1.0,1210,7667,1.0,0,0,2,6,900,310,1950,0.0,98199,47.6571,-122.396,1330,6462,6457,0.8421807747489239,1464100,58782889,57318789
640000.0,4,2.5,2210,7722,2.0,0,0,2,9,2210,0,1999,0.0,98075,47.5992,-122.01899999999999,2970,8683,5512,0.7138047138047138,4884100,59629284,54745184
735000.0,4,2.5,2470,2550,3.0,0,0,2,8,2470,0,2004,0.0,98117,47.6765,-122.389,1270,3060,80,0.03137254901960784,6100900,6502500,401600
378000.0,5,2.5,2760,8015,1.0,0,0,3,8,1600,1160,1960,0.0,98125,47.7255,-122.29700000000001,460,18000,5255,0.6556456643792888,7617600,64240225,56622625
775000.0,3,2.0,2540,7200,1.5,0,3,3,8,1600,940,1905,0.0,98144,47.5972,-122.292,2040,5900,4660,0.6472222222222223,6451600,51840000,45388400
2250000.0,3,4.25,5150,7800,2.5,0,2,2,11,4170,980,1954,0.0,98112,47.6288,-122.28200000000001,4270,7800,2650,0.33974358974358976,26522500,60840000,34317500
1350000.0,4,4.5,3420,7440,3.0,0,0,2,9,3420,0,2014,0.0,98103,47.6875,-122.33,1360,5580,4020,0.5403225806451613,11696400,55353600,43657200
380000.0,4,2.5,2270,11500,1.0,0,0,2,8,1540,730,1967,0.0,98034,47.7089,-122.241,2020,10918,9230,0.802608695652174,5152900,132250000,127097100
624900.0,4,2.5,2270,11500,1.0,0,0,2,8,1540,730,1967,0.0,98034,47.7089,-122.241,2020,10918,9230,0.802608695652174,5152900,132250000,127097100
379770.0,3,2.5,1470,1779,2.0,0,0,2,8,1160,310,2005,0.0,98029,47.5472,-121.99799999999999,1470,1576,309,0.1736930860033727,2160900,3164841,1003941
340000.0,3,1.75,1280,16200,1.0,0,0,2,8,1030,250,1976,0.0,98077,47.7427,-122.071,1160,10565,14920,0.9209876543209876,1638400,262440000,260801600
515500.0,4,2.75,2830,8126,2.0,0,0,2,8,2830,0,2005,0.0,98059,47.4863,-122.14,2830,7916,5296,0.6517351710558701,8008900,66031876,58022976
600000.0,4,2.25,1970,7125,1.5,0,0,2,7,1500,470,1908,0.0,98115,47.6725,-122.29299999999999,1980,4750,5155,0.7235087719298245,3880900,50765625,46884725
400000.0,1,1.0,1390,60984,1.0,0,0,2,6,1390,0,1960,0.0,98019,47.7652,-121.90299999999999,1620,24225,59594,0.9772071362980453,1932100,3719048256,3717116156
364000.0,4,1.0,1020,11383,1.5,0,0,4,6,1020,0,1947,0.0,98155,47.7429,-122.321,1290,11213,10363,0.9103926908547835,1040400,129572689,128532289
440000.0,4,2.5,2250,7526,2.0,0,0,2,8,2250,0,1989,0.0,98059,47.5123,-122.15,1980,7526,5276,0.7010364071219771,5062500,56640676,51578176
285000.0,2,1.0,800,6240,1.0,0,0,2,6,800,0,1954,0.0,98125,47.7257,-122.296,1530,8000,5440,0.8717948717948718,640000,38937600,38297600
669000.0,3,1.0,1560,4500,1.5,0,0,4,7,1560,0,1915,0.0,98112,47.6204,-122.292,1530,4500,2940,0.6533333333333333,2433600,20250000,17816400
475000.0,4,2.0,2100,13468,1.0,0,0,4,7,1050,1050,1962,0.0,98125,47.7139,-122.292,1470,8675,11368,0.8440748440748441,4410000,181387024,176977024
747000.0,2,1.0,990,4000,1.0,0,0,3,7,990,0,1911,0.0,98103,47.6589,-122.34100000000001,1560,4000,3010,0.7525,980100,16000000,15019900
317000.0,3,1.5,1060,5750,1.0,0,0,1,7,1060,0,1981,0.0,98126,47.5532,-122.37200000000001,1060,5750,4690,0.8156521739130435,1123600,33062500,31938900
390000.0,2,1.0,1270,8164,1.0,0,0,3,6,1270,0,1941,0.0,98125,47.7116,-122.311,1580,9095,6894,0.8444390004899559,1612900,66650896,65037996
1070000.0,4,2.5,2740,5000,2.0,0,0,2,9,2740,0,2012,0.0,98107,47.674,-122.37100000000001,1660,5000,2260,0.452,7507600,25000000,17492400
1210000.0,4,2.75,2470,5500,1.0,0,3,2,9,1570,900,1960,2005.0,98107,47.6586,-122.35799999999999,1620,5500,3030,0.5509090909090909,6100900,30250000,24149100
580000.0,3,1.75,1970,5100,1.0,0,0,2,7,1130,840,1908,1965.0,98117,47.6831,-122.37899999999999,1250,4080,3130,0.6137254901960785,3880900,26010000,22129100
518000.0,4,2.5,2070,10244,1.0,0,0,2,8,1370,700,1969,0.0,98006,47.5592,-122.178,2070,9683,8174,0.7979304959000391,4284900,104939536,100654636
147500.0,3,1.75,1010,6552,1.0,0,0,2,7,1010,0,1969,0.0,98042,47.375,-122.117,1010,6552,5542,0.8458485958485958,1020100,42928704,41908604
555000.0,4,2.25,2220,8125,1.0,0,0,3,8,1450,770,1965,0.0,98006,47.5429,-122.177,1980,8700,5905,0.7267692307692307,4928400,66015625,61087225
427500.0,2,2.0,1090,934,3.0,0,0,2,8,1090,0,2008,0.0,98109,47.6341,-122.34200000000001,1090,1376,-156,-0.1670235546038544,1188100,872356,-315744
1740000.0,3,2.5,4310,32093,1.5,0,4,4,10,2510,1800,1982,0.0,98177,47.7624,-122.38,3810,26400,27783,0.865702801233914,18576100,1029960649,1011384549
265950.0,3,2.5,1490,3840,2.0,0,0,2,7,1490,0,2002,0.0,98042,47.373999999999995,-122.133,2060,4384,2350,0.6119791666666666,2220100,14745600,12525500
247500.0,2,1.0,700,6046,1.0,0,0,2,6,700,0,1950,0.0,98133,47.7172,-122.34,990,6790,5346,0.8842209725438306,490000,36554116,36064116
244000.0,4,1.0,1450,8960,1.0,0,0,2,6,1450,0,1943,0.0,98146,47.4972,-122.348,1160,7680,7510,0.8381696428571429,2102500,80281600,78179100
578550.0,3,2.5,2120,6602,2.0,0,0,3,8,2120,0,1989,0.0,98029,47.5669,-122.012,2330,7795,4482,0.6788851863071796,4494400,43586404,39092004
451000.0,4,2.5,1670,3315,2.0,0,0,2,7,1670,0,2005,0.0,98029,47.5532,-121.99799999999999,1650,2051,1645,0.4962292609351433,2788900,10989225,8200325
489000.0,2,1.75,1810,4220,2.0,0,0,2,8,1810,0,2004,0.0,98053,47.7177,-122.03399999999999,1350,4479,2410,0.5710900473933649,3276100,17808400,14532300
190000.0,2,1.0,710,1164794,1.0,0,0,1,5,710,0,1915,0.0,98014,47.6888,-121.90899999999999,1680,16730,1164084,0.9993904501568518,504100,1356745062436,1356744558336
475000.0,3,3.0,2540,18900,1.0,0,0,2,7,1580,960,1978,0.0,98072,47.754,-122.14399999999999,2270,16000,16360,0.8656084656084656,6451600,357210000,350758400
485000.0,3,2.0,1420,4080,1.5,0,0,2,7,1420,0,1905,2013.0,98103,47.6872,-122.34899999999999,1420,4590,2660,0.6519607843137255,2016400,16646400,14630000
530000.0,3,2.75,2440,45738,2.0,0,0,2,8,1840,600,1987,0.0,98027,47.5453,-121.95700000000001,2440,189100,43298,0.9466526739254012,5953600,2091964644,2086011044
379000.0,4,2.5,2570,10155,2.0,0,0,2,9,2570,0,1994,0.0,98030,47.3842,-122.17,2770,10155,7585,0.7469226981782373,6604900,103124025,96519125
1630000.0,5,2.5,3090,16583,2.0,0,0,3,9,3090,0,1964,0.0,98004,47.6458,-122.21799999999999,3740,17853,13493,0.8136645962732919,9548100,274995889,265447789
739000.0,3,1.75,2050,5160,1.5,0,0,3,8,1300,750,1926,0.0,98112,47.6374,-122.304,2220,5960,3110,0.6027131782945736,4202500,26625600,22423100
189950.0,3,1.0,920,6460,1.0,0,0,4,6,920,0,1969,0.0,98042,47.3665,-122.08200000000001,920,4770,5540,0.8575851393188855,846400,41731600,40885200
637500.0,4,3.0,2320,4468,2.0,0,0,2,8,2160,160,1999,0.0,98029,47.54600000000001,-122.009,2330,3541,2148,0.4807520143240824,5382400,19963024,14580624
2230000.0,3,3.0,3450,16740,1.0,0,4,3,9,1960,1490,1949,0.0,98177,47.7067,-122.38,3220,12528,13290,0.7939068100358423,11902500,280227600,268325100
209950.0,3,1.0,1660,8800,1.0,0,0,3,7,960,700,1963,0.0,98023,47.3212,-122.352,1370,10112,7140,0.8113636363636364,2755600,77440000,74684400
460000.0,3,1.0,1130,7000,1.0,0,0,2,6,830,300,1944,0.0,98125,47.7132,-122.28299999999999,1050,7000,5870,0.8385714285714285,1276900,49000000,47723100
543500.0,4,2.5,2550,5835,2.0,0,0,2,8,2550,0,1998,0.0,98065,47.5373,-121.87,2420,5817,3285,0.5629820051413882,6502500,34047225,27544725
376000.0,4,2.75,2420,5773,2.0,0,0,2,8,2420,0,2005,0.0,98038,47.3772,-122.029,2420,6200,3353,0.5808072059587736,5856400,33327529,27471129
430000.0,3,2.25,1470,1703,2.0,0,0,2,8,1470,0,2005,0.0,98029,47.5478,-121.999,1380,1107,233,0.13681738109219024,2160900,2900209,739309
515000.0,4,2.5,2030,39049,1.0,0,0,3,7,1530,500,1953,0.0,98166,47.4413,-122.345,2400,14605,37019,0.9480140336500295,4120900,1524824401,1520703501
580000.0,7,2.75,2310,2400,1.5,0,0,2,6,2310,0,1915,0.0,98117,47.6775,-122.39,1340,3825,90,0.0375,5336100,5760000,423900
600000.0,5,3.5,3370,16846,2.0,0,1,2,9,2650,720,1998,0.0,98027,47.5584,-122.089,3330,13000,13476,0.7999525109818354,11356900,283787716,272430816
476800.0,3,1.75,1900,43700,1.5,0,0,3,6,1900,0,1919,0.0,98052,47.7265,-122.13600000000001,2070,43995,41800,0.9565217391304348,3610000,1909690000,1906080000
815000.0,3,1.5,1940,3570,2.0,0,0,3,8,1740,200,1916,0.0,98105,47.6618,-122.325,1580,3570,1630,0.4565826330532213,3763600,12744900,8981300
455600.0,3,2.5,2420,8252,2.0,0,0,2,7,2420,0,1998,0.0,98065,47.5382,-121.87100000000001,2420,5818,5832,0.7067377605428987,5856400,68095504,62239104
270000.0,3,1.0,1010,9514,1.0,0,0,2,7,1010,0,1969,0.0,98059,47.4936,-122.105,1010,9514,8504,0.8938406558755518,1020100,90516196,89496096
1200000.0,5,4.0,2710,2800,3.0,0,0,2,10,2380,330,1974,2008.0,98119,47.6346,-122.36399999999999,1530,3600,90,0.03214285714285714,7344100,7840000,495900
525000.0,2,1.5,1340,3600,1.5,0,0,2,7,1340,0,1903,0.0,98119,47.6358,-122.36399999999999,1340,3600,2260,0.6277777777777778,1795600,12960000,11164400
242000.0,3,1.75,1310,9645,1.0,0,0,2,7,1310,0,1979,0.0,98198,47.4051,-122.29,1440,9893,8335,0.8641783307413168,1716100,93026025,91309925
715000.0,4,2.5,2650,30500,1.0,0,0,3,8,1680,970,1960,0.0,98029,47.5535,-122.02799999999999,2650,30500,27850,0.9131147540983606,7022500,930250000,923227500
475000.0,3,2.75,1890,3938,2.0,0,0,2,8,1890,0,1999,0.0,98065,47.5336,-121.867,1890,4142,2048,0.5200609446419502,3572100,15507844,11935744
370000.0,4,3.0,2580,5511,2.0,0,0,2,8,2580,0,1999,0.0,98058,47.4286,-122.185,2010,5600,2931,0.5318454001088732,6656400,30371121,23714721
788600.0,4,2.75,3500,7200,2.0,0,0,2,9,3500,0,2005,0.0,98053,47.6818,-122.025,3920,7666,3700,0.5138888888888888,12250000,51840000,39590000
160000.0,2,1.0,1040,13100,1.0,0,0,4,6,1040,0,1912,0.0,98032,47.3877,-122.234,910,5080,12060,0.9206106870229007,1081600,171610000,170528400
800000.0,5,1.75,1930,501376,2.0,0,0,2,7,1930,0,1930,0.0,98014,47.6294,-121.911,1710,87120,499446,0.9961505935665049,3724900,251377893376,251374168476
520000.0,4,3.0,2190,5085,2.0,0,0,3,8,2190,0,1992,0.0,98029,47.5693,-122.00200000000001,2130,5142,2895,0.5693215339233039,4796100,25857225,21061125
725000.0,3,1.75,1530,4000,2.0,0,0,2,8,1530,0,1985,0.0,98136,47.5239,-122.38799999999999,2140,5000,2470,0.6175,2340900,16000000,13659100
335000.0,4,1.0,1480,6500,1.5,0,0,3,7,1480,0,1914,0.0,98118,47.5282,-122.26700000000001,2380,6000,5020,0.7723076923076924,2190400,42250000,40059600
919000.0,4,2.5,3620,17133,1.0,0,4,2,10,2220,1400,1993,0.0,98075,47.5604,-122.027,3530,17026,13513,0.788711842642853,13104400,293539689,280435289
425000.0,3,2.75,3370,13929,2.0,0,0,2,9,2650,720,1986,0.0,98092,47.3411,-122.197,2150,14048,10559,0.7580587263981621,11356900,194017041,182660141
420000.0,5,2.5,2100,14395,1.0,0,0,2,7,1140,960,1983,0.0,98155,47.7723,-122.31700000000001,1830,8700,12295,0.8541160125043418,4410000,207216025,202806025
905000.0,4,3.0,3370,47959,2.0,0,0,3,10,3370,0,1981,0.0,98072,47.733000000000004,-122.12899999999999,3370,38896,44589,0.929731645780771,11356900,2300065681,2288708781
435000.0,2,1.0,2240,7200,1.0,0,0,3,7,1120,1120,1940,0.0,98118,47.5631,-122.271,1390,6000,4960,0.6888888888888889,5017600,51840000,46822400
438000.0,3,2.5,1650,3031,2.0,0,0,2,7,1650,0,2003,0.0,98053,47.681999999999995,-122.03399999999999,1560,3070,1381,0.4556252062025734,2722500,9186961,6464461
725000.0,4,2.75,2630,7505,2.0,0,0,2,8,2630,0,1994,0.0,98052,47.6846,-122.163,2670,7506,4875,0.6495669553630913,6916900,56325025,49408125
840000.0,4,1.75,2330,4000,2.0,0,0,4,8,1300,1030,1924,0.0,98105,47.666000000000004,-122.289,2040,4000,1670,0.4175,5428900,16000000,10571100
425500.0,3,2.5,1970,2752,2.0,0,0,2,8,1970,0,1978,0.0,98052,47.6345,-122.10799999999999,1850,2778,782,0.28415697674418605,3880900,7573504,3692604
853505.0,3,2.5,2820,14890,1.0,0,4,2,9,1770,1050,1985,0.0,98034,47.7019,-122.228,3740,14890,12070,0.8106111484217595,7952400,221712100,213759700
398000.0,2,1.0,590,10945,1.5,0,0,2,5,590,0,1983,0.0,98010,47.3364,-122.03299999999999,2020,15180,10355,0.946094106898127,348100,119793025,119444925
418500.0,3,2.5,2060,4399,2.0,0,0,2,7,2060,0,2007,0.0,98065,47.5415,-121.884,2060,4399,2339,0.5317117526710616,4243600,19351201,15107601
826000.0,3,1.5,1890,5000,1.5,0,0,2,9,1890,0,1929,0.0,98109,47.6312,-122.353,2560,5000,3110,0.622,3572100,25000000,21427900
742000.0,4,2.5,2810,10986,2.0,0,0,2,10,2810,0,1997,0.0,98075,47.5943,-121.98100000000001,3540,10986,8176,0.7442199162570544,7896100,120692196,112796096
180000.0,4,1.0,1470,18581,1.5,0,0,2,6,1470,0,1924,0.0,98055,47.4336,-122.197,1770,18581,17111,0.9208869275065927,2160900,345253561,343092661
286000.0,4,1.75,2190,8400,2.0,0,0,1,8,2190,0,1978,0.0,98023,47.3003,-122.37299999999999,2410,7700,6210,0.7392857142857143,4796100,70560000,65763900
421200.0,3,2.5,1440,3060,2.0,0,0,2,7,1440,0,2003,0.0,98053,47.6821,-122.035,1650,3060,1620,0.5294117647058824,2073600,9363600,7290000
390000.0,3,3.0,2480,14141,1.0,0,0,2,8,1500,980,1994,0.0,98038,47.3778,-122.03299999999999,2480,10667,11661,0.8246234354006081,6150400,199967881,193817481
739000.0,4,2.5,2780,6737,2.0,0,0,2,9,2780,0,2002,0.0,98006,47.5656,-122.12200000000001,2750,7950,3957,0.5873534214041859,7728400,45387169,37658769
499900.0,4,3.0,2180,12196,2.0,0,0,3,7,2180,0,1968,0.0,98027,47.5338,-122.03299999999999,1500,6534,10016,0.8212528697933749,4752400,148742416,143990016
670000.0,3,2.25,3340,13805,1.0,0,0,2,8,3340,0,1950,0.0,98155,47.744,-122.292,2060,12304,10465,0.7580586743933357,11155600,190578025,179422425
842500.0,3,2.25,2560,3996,1.5,0,0,2,8,2150,410,1910,0.0,98112,47.6321,-122.306,2970,4320,1436,0.35935935935935936,6553600,15968016,9414416
492500.0,2,2.25,1600,80400,2.0,0,0,3,7,1600,0,1978,0.0,98070,47.4422,-122.505,1600,198414,78800,0.9800995024875622,2560000,6464160000,6461600000
836500.0,3,2.5,2230,7200,3.0,0,3,2,9,2230,0,1996,0.0,98118,47.558,-122.265,2230,7200,4970,0.6902777777777778,4972900,51840000,46867100
334000.0,2,1.0,900,1818,2.0,0,0,3,7,900,0,1945,0.0,98199,47.6485,-122.397,1570,1830,918,0.504950495049505,810000,3305124,2495124
179900.0,3,1.0,1010,9920,1.0,0,0,2,6,1010,0,1977,0.0,98042,47.3238,-122.14,1270,9680,8910,0.8981854838709677,1020100,98406400,97386300
563000.0,3,2.0,1580,5289,1.0,0,0,2,7,870,710,1940,0.0,98103,47.6881,-122.34200000000001,1310,5535,3709,0.7012667801096616,2496400,27973521,25477121
310000.0,3,2.5,1890,6300,2.0,0,0,2,7,1890,0,2003,0.0,98038,47.3673,-122.031,2100,6525,4410,0.7,3572100,39690000,36117900
335000.0,4,2.25,2160,8817,1.0,0,0,2,7,1460,700,1965,0.0,98133,47.7595,-122.35600000000001,1880,8817,6657,0.7550187138482477,4665600,77739489,73073889
499950.0,4,2.25,2160,8817,1.0,0,0,2,7,1460,700,1965,0.0,98133,47.7595,-122.35600000000001,1880,8817,6657,0.7550187138482477,4665600,77739489,73073889
658500.0,2,1.0,1410,5101,1.5,0,0,2,8,1410,0,1927,0.0,98103,47.6872,-122.333,1410,4224,3691,0.7235836110566556,1988100,26020201,24032101
297000.0,2,1.5,1430,1650,3.0,0,0,2,7,1430,0,1999,0.0,98125,47.7222,-122.29,1430,1650,220,0.13333333333333333,2044900,2722500,677600
725000.0,6,1.75,2380,4080,2.0,0,0,2,8,2380,0,1917,0.0,98105,47.6629,-122.325,2030,4080,1700,0.4166666666666667,5664400,16646400,10982000
780000.0,3,2.25,2206,82031,1.0,0,2,2,6,866,1340,1983,0.0,98074,47.6302,-122.069,2590,53024,79825,0.9731077275664078,4866436,6729084961,6724218525
252500.0,3,1.0,1030,6127,1.0,0,0,2,7,880,150,1947,0.0,98125,47.7192,-122.32,1610,6127,5097,0.8318916272237636,1060900,37540129,36479229
330000.0,3,2.5,1070,1155,2.0,0,0,2,7,720,350,2005,0.0,98102,47.5617,-122.385,1120,2594,85,0.0735930735930736,1144900,1334025,189125
525000.0,3,2.5,2320,9610,1.0,0,0,2,9,1730,590,1990,0.0,98011,47.7394,-122.204,2450,9608,7290,0.7585848074921956,5382400,92352100,86969700
365000.0,2,1.75,1270,7500,1.0,0,0,3,7,1270,0,1982,0.0,98074,47.6186,-122.06299999999999,1280,7500,6230,0.8306666666666667,1612900,56250000,54637100
500000.0,4,3.0,2570,9104,2.0,0,2,2,7,2570,0,1930,0.0,98116,47.5821,-122.40100000000001,1630,4950,6534,0.7177065026362038,6604900,82882816,76277916
179950.0,3,1.0,920,4875,1.0,0,0,4,6,920,0,1969,0.0,98042,47.3648,-122.081,960,5200,3955,0.8112820512820513,846400,23765625,22919225
440000.0,3,2.0,1790,32379,1.0,0,0,2,7,1790,0,2007,0.0,98045,47.4826,-121.698,2290,43560,30589,0.9447172550109639,3204100,1048399641,1045195541
145000.0,1,0.75,480,9750,1.0,0,0,1,4,480,0,1948,0.0,98146,47.4982,-122.36200000000001,1550,9924,9270,0.9507692307692308,230400,95062500,94832100
331000.0,4,3.0,2483,5701,2.0,0,0,2,8,2483,0,2005,0.0,98030,47.3623,-122.199,2075,5720,3218,0.564462375021926,6165289,32501401,26336112
780000.0,3,2.25,2140,3000,2.0,0,0,2,9,2140,0,1905,0.0,98103,47.6767,-122.351,1430,4712,860,0.2866666666666667,4579600,9000000,4420400
855000.0,3,1.75,1900,4000,1.0,0,0,2,7,1300,600,1965,0.0,98103,47.6854,-122.331,1880,4000,2100,0.525,3610000,16000000,12390000
225000.0,3,2.25,1650,7739,1.0,0,0,2,8,1290,360,1986,0.0,98003,47.3532,-122.304,1650,6033,6089,0.7867941594521256,2722500,59892121,57169621
199000.0,3,1.0,1510,9100,1.0,0,0,2,7,1510,0,1966,0.0,98003,47.3331,-122.319,1180,7220,7590,0.8340659340659341,2280100,82810000,80529900
550000.0,3,1.75,2910,35200,1.5,0,0,2,8,2910,0,1979,0.0,98075,47.5747,-122.035,2590,37500,32290,0.9173295454545455,8468100,1239040000,1230571900
1430000.0,4,4.25,4960,6000,2.5,0,0,2,11,3680,1280,1909,2003.0,98109,47.6437,-122.35600000000001,2160,4080,1040,0.17333333333333334,24601600,36000000,11398400
805000.0,3,2.0,2710,4500,1.5,0,0,3,8,1880,830,1929,0.0,98115,47.6747,-122.295,2060,4500,1790,0.3977777777777778,7344100,20250000,12905900
261000.0,3,1.5,1810,29308,1.0,0,0,2,7,950,860,1983,0.0,98042,47.3585,-122.06700000000001,1790,37531,27498,0.9382421181929849,3276100,858958864,855682764
347000.0,3,1.0,940,9198,1.0,0,0,2,7,940,0,1968,0.0,98052,47.6889,-122.117,1430,8370,8258,0.8978038704066101,883600,84603204,83719604
390000.0,3,2.25,1600,10240,1.0,0,0,2,7,1090,510,1979,0.0,98034,47.7281,-122.23200000000001,1520,9394,8640,0.84375,2560000,104857600,102297600
436000.0,4,2.5,2640,3899,2.0,0,0,2,7,2640,0,2000,0.0,98011,47.754,-122.21700000000001,2460,4057,1259,0.32290330854065147,6969600,15202201,8232601
1800000.0,5,3.25,3890,20005,1.0,0,0,2,10,2260,1630,1977,0.0,98004,47.6312,-122.22399999999999,3450,20176,16115,0.8055486128467882,15132100,400200025,385067925
557000.0,3,2.5,1630,1587,3.0,0,0,2,8,1630,0,2004,0.0,98107,47.6693,-122.39299999999999,1500,1527,-43,-0.027095148078134845,2656900,2518569,-138331
135000.0,3,1.0,830,9600,1.0,0,0,2,7,830,0,1959,0.0,98032,47.3698,-122.29700000000001,1240,9198,8770,0.9135416666666667,688900,92160000,91471100
425000.0,3,2.5,1800,14036,2.0,0,0,2,8,1800,0,1993,0.0,98019,47.7334,-121.97,2450,14025,12236,0.871758335708179,3240000,197009296,193769296
648752.0,3,2.25,2060,9953,1.0,0,0,4,8,1070,990,1964,0.0,98040,47.5767,-122.23299999999999,2340,9600,7893,0.7930272279714659,4243600,99062209,94818609
1390000.0,4,3.0,4040,20001,1.0,0,0,2,9,2020,2020,1972,2001.0,98004,47.6408,-122.212,2990,20098,15961,0.7980100994950252,16321600,400040001,383718401
630100.0,4,2.75,1910,11356,1.0,0,0,4,7,1160,750,1977,0.0,98033,47.6999,-122.2,1770,11357,9446,0.8318069742867207,3648100,128958736,125310636
739000.0,4,2.5,2800,246114,2.0,0,0,2,9,2800,0,1999,0.0,98014,47.6586,-121.962,2750,60351,243314,0.9886231583737618,7840000,60572100996,60564260996
269000.0,3,1.5,1320,2625,2.0,0,0,2,7,1320,0,1986,0.0,98133,47.7316,-122.338,1230,5250,1305,0.49714285714285716,1742400,6890625,5148225
250000.0,3,1.0,1220,5038,1.0,0,0,4,6,1220,0,1942,0.0,98056,47.496,-122.189,1140,5038,3818,0.7578404128622469,1488400,25381444,23893044
475000.0,5,2.75,3100,5298,2.0,0,0,2,7,3100,0,2007,0.0,98065,47.5369,-121.887,2440,5250,2198,0.41487353718384296,9610000,28068804,18458804
290000.0,1,1.0,550,5700,1.0,0,0,1,6,550,0,1916,0.0,98117,47.6846,-122.366,1100,4560,5150,0.9035087719298246,302500,32490000,32187500
219000.0,3,1.0,1080,10639,1.5,0,0,2,7,1080,0,1953,0.0,98002,47.3171,-122.219,1470,10600,9559,0.898486699877808,1166400,113188321,112021921
416000.0,2,1.0,880,6650,1.0,0,0,4,6,880,0,1918,0.0,98117,47.6914,-122.37200000000001,1250,6650,5770,0.8676691729323308,774400,44222500,43448100
179000.0,2,1.0,720,8914,1.0,0,0,2,6,720,0,1949,0.0,98188,47.4488,-122.274,1100,8916,8194,0.9192281803903971,518400,79459396,78940996
302000.0,4,2.75,2030,9120,1.0,0,0,3,7,2030,0,1988,0.0,98003,47.282,-122.303,1790,7627,7090,0.7774122807017544,4120900,83174400,79053500
565000.0,4,2.0,2040,8281,2.0,0,1,2,7,2040,0,1961,0.0,98033,47.6689,-122.195,2560,8281,6241,0.7536529404661273,4161600,68574961,64413361
281700.0,3,1.0,1570,8316,1.0,0,0,2,7,1070,500,1962,0.0,98031,47.3943,-122.198,2030,8295,6746,0.8112073112073112,2464900,69155856,66690956
480000.0,2,1.0,1500,3420,1.0,0,0,2,7,1500,0,1902,0.0,98103,47.661,-122.338,2050,3420,1920,0.5614035087719298,2250000,11696400,9446400
775000.0,4,2.5,3180,15358,2.0,0,0,2,9,3180,0,1988,0.0,98027,47.5172,-122.053,3020,15522,12178,0.7929417892954812,10112400,235868164,225755764
375000.0,3,1.75,1260,11224,1.0,0,0,4,7,1260,0,1947,0.0,98155,47.7444,-122.321,1570,11052,9964,0.8877405559515325,1587600,125978176,124390576
345000.0,3,1.5,1390,13860,2.0,0,0,2,7,1390,0,1979,0.0,98045,47.4704,-121.74700000000001,1390,11860,12470,0.8997113997113997,1932100,192099600,190167500
300000.0,3,3.0,2850,9375,1.0,0,0,2,8,2240,610,1977,0.0,98055,47.4655,-122.209,1800,9375,6525,0.696,8122500,87890625,79768125
364950.0,4,2.5,2070,2992,2.0,0,0,2,8,2070,0,2002,0.0,98058,47.4496,-122.12,1900,2957,922,0.30815508021390375,4284900,8952064,4667164
410000.0,3,3.25,2650,7819,1.0,0,2,3,8,1760,890,1956,0.0,98056,47.4821,-122.19200000000001,2400,7727,5169,0.6610819797928124,7022500,61136761,54114261
231000.0,3,1.75,1220,8817,1.0,0,0,2,7,1220,0,1978,0.0,98023,47.3111,-122.396,2000,8028,7597,0.8616309402291029,1488400,77739489,76251089
445000.0,3,2.0,1630,8702,1.0,0,0,2,9,1630,0,1987,0.0,98056,47.5168,-122.193,2250,9890,7072,0.812686738680763,2656900,75724804,73067904
530000.0,2,2.5,1785,779,2.0,0,0,2,7,1595,190,1975,0.0,98004,47.5959,-122.198,1780,794,-1006,-1.2913992297817716,3186225,606841,-2579384
353500.0,3,2.5,1260,972,2.0,0,0,2,8,840,420,2008,0.0,98144,47.5872,-122.316,1270,925,-288,-0.2962962962962963,1587600,944784,-642816
209950.0,3,1.5,1380,11130,1.0,0,0,2,7,1380,0,1960,0.0,98003,47.3146,-122.323,1380,9200,9750,0.876010781671159,1904400,123876900,121972500
650000.0,3,1.75,2330,7200,1.0,0,0,3,8,1320,1010,1950,0.0,98118,47.565,-122.274,1820,7200,4870,0.6763888888888889,5428900,51840000,46411100
325000.0,2,1.0,840,4239,1.0,0,0,2,7,840,0,1948,0.0,98126,47.5319,-122.382,1120,4494,3399,0.8018400566171267,705600,17969121,17263521
257000.0,3,2.25,1730,9516,1.0,0,0,2,8,1180,550,1978,0.0,98030,47.3823,-122.166,1870,8165,7786,0.8182009247583019,2992900,90554256,87561356
337000.0,4,2.5,2230,5970,2.0,0,0,3,7,2230,0,2002,0.0,98042,47.3745,-122.131,1970,4919,3740,0.626465661641541,4972900,35640900,30668000
541000.0,3,2.5,1790,4038,2.0,0,0,2,8,1790,0,2005,0.0,98029,47.5499,-121.99799999999999,1700,3365,2248,0.5567112431896979,3204100,16305444,13101344
577500.0,3,2.5,2280,10879,2.0,0,0,2,9,2280,0,1984,0.0,98074,47.6217,-122.03399999999999,2400,9536,8599,0.79042191377884,5198400,118352641,113154241
560000.0,3,2.5,2430,5128,1.0,0,1,2,8,1270,1160,1978,0.0,98136,47.5198,-122.389,2510,5330,2698,0.5261310452418096,5904900,26296384,20391484
979700.0,5,3.0,3730,5500,1.5,0,0,2,7,2160,1570,1927,0.0,98102,47.6507,-122.32,1890,5500,1770,0.32181818181818184,13912900,30250000,16337100
750000.0,5,3.0,2230,8560,1.0,0,0,2,8,1150,1080,1960,2014.0,98008,47.6154,-122.115,2040,8560,6330,0.7394859813084113,4972900,73273600,68300700
407500.0,2,1.0,770,2971,1.0,0,2,2,7,770,0,1923,0.0,98102,47.6358,-122.322,1440,4000,2201,0.7408280040390441,592900,8826841,8233941
530000.0,4,1.75,1814,5000,1.0,0,0,3,7,944,870,1951,0.0,98115,47.684,-122.281,1290,5000,3186,0.6372,3290596,25000000,21709404
235000.0,4,1.75,1920,9350,1.0,0,0,3,7,1000,920,1977,0.0,98002,47.292,-122.195,1910,8400,7430,0.7946524064171123,3686400,87422500,83736100
715000.0,4,2.5,1860,3840,1.5,0,0,2,7,1170,690,1928,2014.0,98117,47.6886,-122.359,1400,3840,1980,0.515625,3459600,14745600,11286000
795000.0,5,3.0,2750,10000,1.0,0,0,3,7,1730,1020,1957,0.0,98008,47.5878,-122.13,2520,10000,7250,0.725,7562500,100000000,92437500
465000.0,4,2.5,1930,9653,1.0,0,0,3,9,1930,0,1968,0.0,98023,47.3367,-122.335,2100,10454,7723,0.8000621568424324,3724900,93180409,89455509
287600.0,3,2.5,1950,8251,2.0,0,0,2,7,1950,0,1990,0.0,98001,47.343,-122.28,1540,8588,6301,0.7636650103017816,3802500,68079001,64276501
630000.0,6,3.0,2470,9328,2.0,0,0,2,8,2470,0,1982,0.0,98007,47.6025,-122.15299999999999,2470,9454,6858,0.7352058319039451,6100900,87011584,80910684
445000.0,3,2.25,1630,6449,1.0,0,0,2,7,1310,320,1986,0.0,98011,47.7275,-122.23200000000001,1620,7429,4819,0.7472476352922934,2656900,41589601,38932701
490000.0,4,2.25,2110,16200,1.0,0,0,2,8,1630,480,1978,0.0,98072,47.751999999999995,-122.14399999999999,2370,16000,14090,0.8697530864197531,4452100,262440000,257987900
565000.0,3,1.75,1490,5000,1.0,0,1,2,8,1250,240,1954,0.0,98136,47.5257,-122.39200000000001,1980,5000,3510,0.702,2220100,25000000,22779900
330000.0,3,2.5,1740,1844,2.0,0,0,2,8,1320,420,2008,0.0,98106,47.5248,-122.365,1740,1789,104,0.05639913232104121,3027600,3400336,372736
463000.0,4,2.75,1900,6000,1.0,0,2,2,7,1300,600,1961,0.0,98178,47.495,-122.229,2230,6000,4100,0.6833333333333333,3610000,36000000,32390000
1870000.0,5,4.0,4510,15175,2.0,0,0,2,10,4510,0,1969,2002.0,98040,47.5309,-122.228,3510,13500,10665,0.7028006589785832,20340100,230280625,209940525
219500.0,3,1.0,1090,6710,1.5,0,0,4,5,1090,0,1912,0.0,98002,47.3066,-122.21700000000001,1170,6708,5620,0.8375558867362146,1188100,45024100,43836000
622200.0,3,1.75,1720,7200,1.0,0,0,2,7,1420,300,1959,0.0,98125,47.7062,-122.304,1380,8000,5480,0.7611111111111111,2958400,51840000,48881600
474800.0,2,3.25,1400,1243,3.0,0,0,2,8,1400,0,2000,0.0,98103,47.6534,-122.353,1400,1335,-157,-0.1263073209975865,1960000,1545049,-414951
465000.0,4,2.5,2090,9702,1.0,0,0,4,7,1320,770,1965,0.0,98133,47.7467,-122.339,1850,7200,7612,0.7845804988662132,4368100,94128804,89760704
389950.0,3,1.75,1580,9049,1.0,0,0,2,8,1580,0,1966,0.0,98177,47.7776,-122.375,2100,8446,7469,0.8253950712785943,2496400,81884401,79388001
650000.0,4,2.5,2620,19864,2.0,0,0,3,8,2620,0,1984,0.0,98052,47.7014,-122.12200000000001,2500,13285,17244,0.8681031010873943,6864400,394578496,387714096
395000.0,3,2.0,1500,2506,1.0,0,0,2,7,870,630,2003,0.0,98144,47.5962,-122.301,1500,4662,1006,0.4014365522745411,2250000,6280036,4030036
304500.0,4,2.5,2030,5202,2.0,0,0,2,8,2030,0,2001,0.0,98031,47.38800000000001,-122.176,2260,5232,3172,0.609765474817378,4120900,27060804,22939904
307000.0,3,1.0,1020,8484,1.0,0,0,2,6,1020,0,1949,0.0,98155,47.7719,-122.31,1180,9660,7464,0.8797736916548797,1040400,71978256,70937856
485000.0,3,2.5,1540,7120,1.0,0,0,2,7,770,770,1938,2013.0,98038,47.3729,-122.037,1000,6638,5580,0.7837078651685393,2371600,50694400,48322800
1560000.0,5,3.0,3910,16200,1.0,0,0,3,9,2890,1020,1960,0.0,98004,47.6326,-122.21700000000001,3620,16200,12290,0.758641975308642,15288100,262440000,247151900
650500.0,5,4.25,3920,11412,2.0,0,0,2,7,3920,0,1955,2005.0,98006,47.5766,-122.15100000000001,1400,9750,7492,0.6565019277953031,15366400,130233744,114867344
960000.0,4,2.5,3180,10105,2.0,0,0,3,9,3180,0,1986,0.0,98040,47.5328,-122.226,2670,10355,6925,0.6853043047996041,10112400,102111025,91998625
710000.0,3,2.5,2330,9160,2.0,0,0,2,9,2330,0,1997,0.0,98006,47.5467,-122.181,2460,9160,6830,0.7456331877729258,5428900,83905600,78476700
540000.0,3,2.5,2600,23361,1.5,1,4,2,8,2150,450,1912,0.0,98146,47.4997,-122.37899999999999,1700,14700,20761,0.8887033945464663,6760000,545736321,538976321
601000.0,4,1.75,1950,4200,1.0,0,0,4,7,1040,910,1951,0.0,98115,47.6755,-122.285,1450,5000,2250,0.5357142857142857,3802500,17640000,13837500
463828.0,5,1.75,3250,13702,1.0,0,2,2,8,1650,1600,1965,0.0,98055,47.4883,-122.225,2620,11328,10452,0.7628083491461101,10562500,187744804,177182304
293000.0,4,1.0,1130,8308,1.5,0,0,3,6,1130,0,1944,0.0,98166,47.4669,-122.355,1130,8652,7178,0.8639865190178142,1276900,69022864,67745964
597500.0,3,2.5,2620,4800,2.0,0,0,2,7,2620,0,2002,0.0,98053,47.6849,-122.037,2400,4756,2180,0.45416666666666666,6864400,23040000,16175600
240000.0,2,1.0,1120,45302,1.0,0,2,3,5,1120,0,1932,0.0,98045,47.5105,-121.77,2150,101930,44182,0.9752770297117125,1254400,2052271204,2051016804
284000.0,3,1.75,1800,23103,1.0,0,0,2,7,1800,0,1968,0.0,98014,47.6517,-121.906,1410,18163,21303,0.9220880405142189,3240000,533748609,530508609
440000.0,4,1.75,2180,10200,1.0,0,2,2,8,2000,180,1966,0.0,98028,47.7638,-122.27,2590,10445,8020,0.7862745098039216,4752400,104040000,99287600
340000.0,3,1.75,1960,8136,1.0,0,0,2,7,980,980,1948,0.0,98106,47.5208,-122.36399999999999,1070,7480,6176,0.7590953785644051,3841600,66194496,62352896
363000.0,3,1.75,1960,8136,1.0,0,0,2,7,980,980,1948,0.0,98106,47.5208,-122.36399999999999,1070,7480,6176,0.7590953785644051,3841600,66194496,62352896
270000.0,2,1.0,1150,3600,1.0,0,0,2,6,1150,0,1910,0.0,98144,47.5729,-122.31,1160,4000,2450,0.6805555555555556,1322500,12960000,11637500
365000.0,4,2.5,2800,6820,2.0,0,0,3,7,2800,0,1997,0.0,98042,47.3695,-122.10799999999999,2060,6820,4020,0.5894428152492669,7840000,46512400,38672400
428000.0,3,2.0,1310,2550,1.0,0,0,2,7,780,530,1986,0.0,98103,47.6911,-122.35,1460,5100,1240,0.48627450980392156,1716100,6502500,4786400
600000.0,3,1.75,2340,57499,1.0,0,0,2,8,2340,0,1988,0.0,98053,47.6989,-122.044,3260,137649,55159,0.9593036400633055,5475600,3306135001,3300659401
405000.0,3,2.5,1430,10200,1.0,0,0,2,7,1430,0,1960,0.0,98033,47.7012,-122.166,1470,10350,8770,0.8598039215686275,2044900,104040000,101995100
339900.0,4,2.5,2340,9748,1.0,0,1,2,8,1610,730,1981,0.0,98003,47.3363,-122.331,2070,8241,7408,0.7599507591300779,5475600,95023504,89547904
275000.0,3,1.0,1290,11250,1.0,0,0,2,7,1290,0,1956,0.0,98166,47.4743,-122.34100000000001,1410,11196,9960,0.8853333333333333,1664100,126562500,124898400
361600.0,2,1.0,760,6380,1.0,0,0,2,6,760,0,1941,0.0,98115,47.6914,-122.31,1590,6380,5620,0.8808777429467085,577600,40704400,40126800
325000.0,6,2.0,2780,13950,2.5,0,0,3,7,2780,0,1955,1964.0,98030,47.3738,-122.226,2120,13950,11170,0.8007168458781362,7728400,194602500,186874100
1050000.0,3,2.0,2090,4077,1.5,0,0,3,8,1530,560,1931,0.0,98112,47.6433,-122.3,2010,4132,1987,0.48736816286485163,4368100,16621929,12253829
959750.0,4,3.0,3060,50002,1.0,0,2,3,8,2460,600,1957,0.0,98008,47.6205,-122.096,2740,16181,46942,0.9388024479020839,9363600,2500200004,2490836404
210000.0,3,1.0,1110,7962,1.0,0,0,2,7,1110,0,1962,0.0,98146,47.5035,-122.36,1200,8094,6852,0.8605877920120573,1232100,63393444,62161344
258000.0,3,2.0,1790,7879,1.5,0,0,2,7,1790,0,1998,0.0,98001,47.2634,-122.289,1790,7879,6089,0.7728138088589923,3204100,62078641,58874541
468000.0,3,1.5,1830,9848,1.0,0,0,4,7,1830,0,1962,0.0,98056,47.538999999999994,-122.18,1830,8168,8018,0.8141754670999187,3348900,96983104,93634204
710000.0,4,3.5,2850,2910,2.0,0,2,2,8,1970,880,1905,0.0,98115,47.6855,-122.321,1460,3880,60,0.020618556701030927,8122500,8468100,345600
268000.0,3,1.0,1420,6000,1.0,0,0,2,6,1420,0,1941,0.0,98146,47.4913,-122.336,1480,6000,4580,0.7633333333333333,2016400,36000000,33983600
115000.0,2,1.0,790,7252,1.0,0,0,2,5,790,0,1930,0.0,98146,47.5048,-122.365,1260,11470,6462,0.8910645339216767,624100,52591504,51967404
500000.0,3,2.5,2300,4307,2.0,0,0,2,8,2300,0,1998,0.0,98034,47.7326,-122.197,2010,4307,2007,0.4659856048293476,5290000,18550249,13260249
431000.0,3,2.5,2440,71002,1.0,0,0,3,9,2440,0,1996,0.0,98022,47.2689,-122.01,3170,84000,68562,0.9656347708515253,5953600,5041284004,5035330404
241500.0,3,2.0,1310,7349,1.0,0,0,2,7,870,440,1995,0.0,98030,47.3639,-122.186,1690,6580,6039,0.821744455027895,1716100,54007801,52291701
300000.0,3,1.0,1380,12000,1.0,0,0,2,7,1380,0,1963,0.0,98031,47.3997,-122.215,1890,22001,10620,0.885,1904400,144000000,142095600
982000.0,4,2.5,2790,10289,2.0,0,0,2,9,2790,0,1987,0.0,98006,47.5483,-122.15799999999999,2650,10126,7499,0.7288366216347556,7784100,105863521,98079421
248500.0,3,2.5,1360,7293,2.0,0,0,2,8,1360,0,1988,0.0,98003,47.3304,-122.302,1540,7353,5933,0.8135198135198135,1849600,53187849,51338249
665000.0,4,2.5,2510,5936,2.0,0,0,2,9,2510,0,1998,0.0,98075,47.5847,-122.03200000000001,2760,6060,3426,0.5771563342318059,6300100,35236096,28935996
1220000.0,3,3.0,4560,16339,2.0,0,2,2,10,4040,520,2001,0.0,98034,47.7024,-122.243,2620,11561,11779,0.7209131525797172,20793600,266962921,246169321
380000.0,2,1.0,780,3910,1.0,0,0,2,6,780,0,1918,0.0,98126,47.566,-122.38,1500,5060,3130,0.8005115089514067,608400,15288100,14679700
220000.0,3,2.0,1410,7998,1.0,0,0,3,7,1410,0,1940,0.0,98178,47.4968,-122.277,1780,8278,6588,0.8237059264816204,1988100,63968004,61979904
631500.0,4,2.0,2530,5650,1.5,0,0,3,8,1910,620,1910,0.0,98116,47.5778,-122.382,1310,5750,3120,0.552212389380531,6400900,31922500,25521600
386100.0,3,2.0,1270,6760,1.0,0,0,4,7,1270,0,1972,0.0,98034,47.7381,-122.179,1550,5734,5490,0.8121301775147929,1612900,45697600,44084700
1050000.0,4,4.5,3180,4606,2.0,0,3,3,9,1990,1190,1929,0.0,98199,47.6402,-122.405,2110,5323,1426,0.30959617889709073,10112400,21215236,11102836
650000.0,2,1.75,1450,4000,1.5,0,0,3,7,1350,100,1903,0.0,98105,47.6571,-122.32600000000001,1310,4000,2550,0.6375,2102500,16000000,13897500
545000.0,4,1.75,2040,53578,1.0,0,0,4,7,1160,880,1959,0.0,98038,47.3844,-122.0,2040,53578,51538,0.961924670573743,4161600,2870602084,2866440484
870000.0,4,2.5,2650,12001,2.0,0,0,3,9,2650,0,1984,0.0,98006,47.5496,-122.14,2880,14054,9351,0.7791850679110074,7022500,144024001,137001501
380000.0,3,1.75,1240,8611,1.0,0,0,3,7,1240,0,1973,0.0,98133,47.7175,-122.331,1700,8037,7371,0.8559981419115086,1537600,74149321,72611721
265000.0,2,1.0,820,8423,1.0,0,2,2,6,820,0,1957,0.0,98055,47.4741,-122.2,1960,9140,7603,0.9026475127626736,672400,70946929,70274529
645500.0,2,1.0,1890,5202,1.5,0,0,3,7,1890,0,1909,0.0,98117,47.6786,-122.37899999999999,1670,5100,3312,0.6366782006920415,3572100,27060804,23488704
570000.0,3,2.0,1270,3090,2.0,0,0,4,7,1270,0,1911,0.0,98117,47.685,-122.359,1440,3090,1820,0.5889967637540453,1612900,9548100,7935200
1200000.0,4,2.5,3350,11688,1.0,0,2,2,10,1760,1590,1995,0.0,98006,47.5507,-122.133,4240,10804,8338,0.7133812457221081,11222500,136609344,125386844
605000.0,2,1.0,1550,3200,1.5,0,0,2,8,1550,0,1927,0.0,98112,47.6368,-122.306,1800,3937,1650,0.515625,2402500,10240000,7837500
199500.0,3,1.0,920,9812,1.0,0,0,3,7,920,0,1962,0.0,98001,47.2958,-122.28399999999999,1188,9812,8892,0.9062372604973502,846400,96275344,95428944
445000.0,2,1.0,950,4800,1.0,0,0,2,6,950,0,1941,0.0,98144,47.5864,-122.301,1420,5400,3850,0.8020833333333334,902500,23040000,22137500
495000.0,4,1.75,2040,3570,1.0,0,0,3,7,1020,1020,1917,0.0,98144,47.5754,-122.288,1790,4206,1530,0.42857142857142855,4161600,12744900,8583300
594000.0,4,1.75,1870,5200,2.0,0,0,3,7,1200,670,1937,0.0,98115,47.6843,-122.28299999999999,1790,5000,3330,0.6403846153846153,3496900,27040000,23543100
465000.0,3,1.75,1720,5280,1.0,0,0,3,8,900,820,1943,0.0,98199,47.6493,-122.40100000000001,1600,6000,3560,0.6742424242424242,2958400,27878400,24920000
160000.0,2,1.0,1020,13647,1.0,0,0,4,6,1020,0,1915,1974.0,98022,47.2848,-121.927,980,8250,12627,0.9252582985271488,1040400,186240609,185200209
340000.0,4,2.5,2690,6099,2.0,0,0,2,9,2690,0,1998,0.0,98092,47.3314,-122.171,2520,6168,3409,0.55894408919495,7236100,37197801,29961701
870000.0,4,2.0,3090,41147,1.0,0,0,2,7,3090,0,1990,0.0,98052,47.6748,-122.04899999999999,3300,34280,38057,0.9249033951442389,9548100,1693075609,1683527509
249000.0,3,1.5,1070,5150,1.0,0,0,3,6,1070,0,1940,0.0,98106,47.5335,-122.34899999999999,1020,4800,4080,0.7922330097087379,1144900,26522500,25377600
500000.0,4,2.25,2050,7201,2.0,0,0,2,8,2050,0,1994,0.0,98033,47.7003,-122.165,1970,7350,5151,0.7153173170393001,4202500,51854401,47651901
220000.0,3,1.5,1660,15600,2.0,0,0,2,7,1660,0,1981,0.0,98001,47.2589,-122.279,1660,14400,13940,0.8935897435897436,2755600,243360000,240604400
368500.0,5,1.75,2810,9360,1.0,0,0,3,7,1520,1290,1965,0.0,98055,47.4361,-122.193,1770,9360,6550,0.6997863247863247,7896100,87609600,79713500
439950.0,4,2.25,2460,14600,1.0,0,0,3,8,1720,740,1977,0.0,98042,47.3762,-122.16,2460,14600,12140,0.8315068493150685,6051600,213160000,207108400
179900.0,3,1.75,1230,12000,1.0,0,0,2,6,1230,0,1970,0.0,98001,47.2878,-122.251,1550,12000,10770,0.8975,1512900,144000000,142487100
490000.0,4,2.5,2360,4367,2.0,0,0,2,8,2360,0,2003,0.0,98011,47.7731,-122.167,2360,4868,2007,0.4595832379207694,5569600,19070689,13501089
425000.0,4,1.75,1730,11890,1.0,0,0,1,7,980,750,1955,0.0,98004,47.5979,-122.194,2100,12325,10160,0.8544995794785534,2992900,141372100,138379200
533300.0,4,2.5,2770,21806,2.0,0,0,2,9,2770,0,1991,0.0,98045,47.4815,-121.76799999999999,2500,21656,19036,0.8729707419976154,7672900,475501636,467828736
447500.0,4,2.0,1770,3332,2.0,0,0,2,7,1630,140,1924,1975.0,98118,47.5563,-122.281,1640,4000,1562,0.4687875150060024,3132900,11102224,7969324
768000.0,5,2.75,3030,13640,2.0,0,0,3,8,3030,0,1980,0.0,98007,47.6186,-122.146,2500,13225,10610,0.7778592375366569,9180900,186049600,176868700
285000.0,3,1.75,2380,6000,1.5,0,0,2,7,1320,0,1935,0.0,98178,47.49800000000001,-122.22200000000001,1290,6000,3620,0.6033333333333334,5664400,36000000,30335600
336900.0,3,1.75,1780,120661,1.0,0,0,3,6,1780,0,1979,0.0,98019,47.7731,-121.897,1440,25000,118881,0.9852479260075749,3168400,14559076921,14555908521
415000.0,4,1.5,1540,7886,2.0,0,0,2,7,1540,0,1967,0.0,98034,47.733999999999995,-122.193,1550,7396,6346,0.8047172203905656,2371600,62188996,59817396
500000.0,3,2.25,1580,4379,2.0,0,0,3,8,1580,0,1994,0.0,98029,47.5694,-122.005,1770,4187,2799,0.6391870290020553,2496400,19175641,16679241
337000.0,4,2.5,3200,5772,2.0,0,0,2,8,3200,0,2003,0.0,98042,47.3486,-122.15299999999999,3010,5772,2572,0.4455994455994456,10240000,33315984,23075984
419950.0,4,2.5,2220,6800,2.0,0,0,2,7,2220,0,2002,0.0,98059,47.49,-122.15,2220,5303,4580,0.6735294117647059,4928400,46240000,41311600
290000.0,4,2.75,2240,8162,2.0,0,0,4,7,1380,860,1946,0.0,98133,47.7427,-122.34,1550,8163,5922,0.725557461406518,5017600,66618244,61600644
349950.0,2,1.75,1640,4176,1.0,0,0,3,7,1040,600,1948,0.0,98118,47.5162,-122.26,1460,5200,2536,0.60727969348659,2689600,17438976,14749376
330000.0,3,1.5,1170,4950,1.0,0,0,3,7,1170,0,1960,0.0,98007,47.6057,-122.135,1570,7700,3780,0.7636363636363637,1368900,24502500,23133600
965000.0,4,2.25,3160,34560,1.0,0,0,3,10,3160,0,1981,0.0,98072,47.7337,-122.132,3530,38045,31400,0.9085648148148148,9985600,1194393600,1184408000
515000.0,3,2.5,2100,7851,2.0,0,0,2,8,2100,0,1986,0.0,98052,47.7242,-122.105,2100,8187,5751,0.7325181505540695,4410000,61638201,57228201
665000.0,4,2.5,2600,17388,2.0,0,0,2,9,2600,0,1996,0.0,98059,47.5283,-122.146,2950,11553,14788,0.8504715896020244,6760000,302342544,295582544
265000.0,3,1.75,1630,5999,1.5,0,0,3,7,1630,0,1985,0.0,98198,47.3816,-122.31299999999999,1540,7500,4369,0.7282880480080013,2656900,35988001,33331101
545400.0,3,2.0,2850,19200,1.0,0,3,2,8,2340,510,2004,0.0,98023,47.3378,-122.348,2860,18240,16350,0.8515625,8122500,368640000,360517500
350000.0,4,3.0,2560,5606,2.0,0,0,2,9,2560,0,2004,0.0,98092,47.3274,-122.178,2667,7334,3046,0.543346414555833,6553600,31427236,24873636
260000.0,2,1.5,980,1296,2.0,0,0,2,7,840,140,2001,0.0,98133,47.7075,-122.336,1100,1228,316,0.24382716049382716,960400,1679616,719216
2510000.0,3,3.25,5480,57990,2.0,1,4,2,11,5480,0,1991,0.0,98166,47.4558,-122.37100000000001,2500,22954,52510,0.9055009484393861,30030400,3362840100,3332809700
355000.0,3,2.0,2160,8091,1.5,0,0,2,8,2160,0,2000,0.0,98003,47.3474,-122.303,2190,8297,5931,0.7330367074527252,4665600,65464281,60798681
879000.0,3,3.0,3030,5156,1.5,0,0,3,9,2080,950,1929,0.0,98119,47.647,-122.369,1910,5720,2126,0.41233514352211015,9180900,26584336,17403436
833000.0,4,3.5,3560,7178,2.0,0,3,2,10,2590,0,2006,0.0,98052,47.7054,-122.10700000000001,3290,6978,3618,0.5040401225968236,12673600,51523684,38850084
261590.0,2,1.0,760,6407,1.0,0,0,2,6,760,0,1943,0.0,98178,47.4977,-122.259,1050,8580,5647,0.8813797409083814,577600,41049649,40472049
512500.0,3,3.0,2260,2400,2.0,0,0,2,7,2260,0,1909,1972.0,98122,47.6094,-122.31,1320,2790,140,0.058333333333333334,5107600,5760000,652400
600000.0,2,1.75,1560,3200,1.0,0,0,4,7,880,680,1946,0.0,98199,47.6419,-122.39399999999999,2060,4940,1640,0.5125,2433600,10240000,7806400
417500.0,5,3.0,2270,6664,1.0,0,0,2,7,1340,930,1995,0.0,98125,47.7191,-122.315,1870,6187,4394,0.6593637454981993,5152900,44408896,39255996
970000.0,5,3.0,3480,15185,2.0,0,0,3,8,3480,0,1964,0.0,98040,47.5757,-122.21600000000001,3030,14257,11705,0.7708264734935792,12110400,230584225,218473825
316000.0,3,2.25,1900,7479,2.0,0,0,3,7,1900,0,1992,0.0,98038,47.3495,-122.037,1520,6559,5579,0.7459553416232116,3610000,55935441,52325441
397500.0,4,3.0,2350,9952,1.0,0,0,2,9,1650,700,1989,0.0,98031,47.4194,-122.211,2440,9100,7602,0.7638665594855305,5522500,99042304,93519804
1350000.0,3,2.5,2390,5500,1.0,0,3,2,9,1700,690,1952,0.0,98199,47.6389,-122.40899999999999,2700,5500,3110,0.5654545454545454,5712100,30250000,24537900
840000.0,4,2.5,3730,9847,2.0,0,0,2,10,3730,0,1997,0.0,98075,47.586999999999996,-121.976,3490,10219,6117,0.6212044277444907,13912900,96963409,83050509
270000.0,2,1.0,1780,81021,1.0,0,3,3,9,1780,0,1954,0.0,98001,47.2712,-122.265,1780,26723,79241,0.9780303871835697,3168400,6564402441,6561234041
312900.0,4,2.5,1630,4473,2.0,0,0,2,7,1630,0,2003,0.0,98038,47.3546,-122.015,1830,5082,2843,0.6355913257321708,2656900,20007729,17350829
325000.0,2,1.0,1130,6908,1.5,0,0,2,6,1130,0,1945,0.0,98155,47.745,-122.31299999999999,1150,6908,5778,0.8364215402431963,1276900,47720464,46443564
680000.0,3,1.75,2140,3584,1.0,0,0,2,7,1070,1070,1952,0.0,98199,47.636,-122.391,1620,4000,1444,0.4029017857142857,4579600,12845056,8265456
763000.0,4,2.5,3220,7873,2.0,0,0,2,10,3220,0,1994,0.0,98075,47.5849,-122.03,2610,8023,4653,0.5910072399339514,10368400,61984129,51615729
375000.0,1,1.0,800,533610,1.5,0,0,4,5,800,0,1950,0.0,98038,47.4134,-121.986,1790,216057,532810,0.998500777721557,640000,284739632100,284738992100
475000.0,3,2.5,1800,3300,2.0,0,0,2,7,1690,110,2004,0.0,98118,47.5491,-122.27600000000001,1570,4097,1500,0.45454545454545453,3240000,10890000,7650000
219000.0,2,2.5,809,940,2.0,0,0,2,7,809,0,2003,0.0,98136,47.5499,-122.384,1260,4240,131,0.13936170212765958,654481,883600,229119
415000.0,3,2.25,1820,9694,1.0,0,0,2,7,1240,580,1977,0.0,98074,47.6157,-122.05,1820,9694,7874,0.8122550030946978,3312400,93973636,90661236
90000.0,2,1.0,580,7500,1.0,0,0,2,5,580,0,1943,0.0,98178,47.4852,-122.251,1700,11250,6920,0.9226666666666666,336400,56250000,55913600
220000.0,2,1.0,580,7500,1.0,0,0,2,5,580,0,1943,0.0,98178,47.4852,-122.251,1700,11250,6920,0.9226666666666666,336400,56250000,55913600
616000.0,3,2.0,2900,5650,1.0,0,2,2,8,1520,1380,1959,0.0,98116,47.5789,-122.396,1810,6250,2750,0.48672566371681414,8410000,31922500,23512500
269500.0,2,1.0,1140,74052,1.0,0,0,3,6,1140,0,1968,0.0,98022,47.2093,-121.962,1730,43560,72912,0.984605412412899,1299600,5483698704,5482399104
395350.0,2,1.0,1060,5754,1.0,0,0,3,6,1060,0,1917,0.0,98117,47.6931,-122.37200000000001,1460,7200,4694,0.8157803267292318,1123600,33108516,31984916
770000.0,4,3.0,2320,7200,1.0,0,0,2,7,1260,1060,1943,2000.0,98040,47.5893,-122.23200000000001,1760,7200,4880,0.6777777777777778,5382400,51840000,46457600
840000.0,4,2.5,3450,43216,2.0,0,0,2,9,3450,0,2000,0.0,98072,47.7625,-122.025,3030,50481,39766,0.9201684561273602,11902500,1867622656,1855720156
428950.0,2,1.0,1760,4441,1.0,0,0,2,8,1310,450,1950,0.0,98126,47.5311,-122.381,1350,5748,2681,0.6036928619680252,3097600,19722481,16624881
800000.0,4,3.75,3370,6766,2.0,0,0,2,9,3370,0,2005,0.0,98052,47.7063,-122.10600000000001,3530,6766,3396,0.5019213715637009,11356900,45778756,34421856
401000.0,4,1.0,1940,5753,1.5,0,0,2,7,1940,0,1947,0.0,98177,47.7188,-122.35799999999999,2170,6075,3813,0.6627846341039457,3763600,33097009,29333409
303697.0,4,2.0,2520,7334,1.0,0,0,2,7,1600,920,1955,0.0,98125,47.7263,-122.291,2040,7937,4814,0.6563948731933461,6350400,53787556,47437156
355000.0,3,1.0,1360,8968,1.0,0,0,2,7,1360,0,1956,0.0,98125,47.7105,-122.289,1490,7355,7608,0.848349687778769,1849600,80425024,78575424
350000.0,2,1.0,800,5040,1.0,0,0,2,6,800,0,1960,0.0,98117,47.6953,-122.36200000000001,1020,5040,4240,0.8412698412698413,640000,25401600,24761600
754999.0,4,2.5,3010,9323,2.0,0,0,2,10,3010,0,1992,0.0,98075,47.578,-122.053,2840,8413,6313,0.6771425506811112,9060100,86918329,77858229
982218.0,3,1.75,2340,5500,2.0,0,2,2,9,2340,0,1988,0.0,98102,47.6451,-122.319,2830,5500,3160,0.5745454545454546,5475600,30250000,24774400
406500.0,3,2.0,1780,8621,1.0,0,0,2,8,1780,0,1992,0.0,98059,47.5062,-122.149,2470,8542,6841,0.7935274330124116,3168400,74321641,71153241
1650000.0,4,3.25,4200,210394,2.0,0,0,3,10,4200,0,1993,0.0,98024,47.5607,-121.961,2370,184694,206194,0.9800374535395496,17640000,44265635236,44247995236
565000.0,2,1.75,1720,3000,1.0,0,0,4,7,860,860,1925,0.0,98103,47.68600000000001,-122.351,1360,4500,1280,0.4266666666666667,2958400,9000000,6041600
160000.0,2,1.0,830,4500,1.0,0,0,2,6,830,0,1920,0.0,98118,47.5248,-122.265,1092,5350,3670,0.8155555555555556,688900,20250000,19561100
220000.0,3,1.0,1090,6320,1.0,0,0,2,6,890,200,1954,0.0,98146,47.4976,-122.35,1460,7080,5230,0.8275316455696202,1188100,39942400,38754300
1280000.0,5,4.25,5040,9466,2.0,0,0,2,11,5040,0,2004,0.0,98059,47.5282,-122.133,4300,9417,4426,0.46756813860130997,25401600,89605156,64203556
970000.0,5,2.75,3500,5040,2.0,0,2,2,9,2950,550,1927,2007.0,98126,47.5527,-122.37899999999999,1450,5040,1540,0.3055555555555556,12250000,25401600,13151600
115000.0,3,1.0,1080,6250,1.0,0,0,1,5,1080,0,1950,0.0,98168,47.5045,-122.33,1070,6250,5170,0.8272,1166400,39062500,37896100
124000.0,3,1.0,1080,6250,1.0,0,0,1,5,1080,0,1950,0.0,98168,47.5045,-122.33,1070,6250,5170,0.8272,1166400,39062500,37896100
157000.0,3,1.0,1080,6250,1.0,0,0,1,5,1080,0,1950,0.0,98168,47.5045,-122.33,1070,6250,5170,0.8272,1166400,39062500,37896100
183000.0,3,1.0,870,5200,1.0,0,0,4,6,870,0,1969,0.0,98042,47.3702,-122.07799999999999,870,5200,4330,0.8326923076923077,756900,27040000,26283100
527000.0,4,2.5,2830,6163,2.0,0,0,2,9,2830,0,2000,0.0,98056,47.5227,-122.19,2730,6202,3333,0.5408080480285575,8008900,37982569,29973669
407193.0,4,2.0,1880,14653,2.0,0,0,2,8,1880,0,1978,0.0,98014,47.6959,-121.921,1750,14858,12773,0.871698628267249,3534400,214710409,211176009
970000.0,4,2.75,3600,5040,2.0,0,0,2,9,2610,990,2004,0.0,98199,47.6487,-122.38799999999999,1590,5040,1440,0.2857142857142857,12960000,25401600,12441600
535000.0,4,2.5,2340,5600,2.0,0,0,2,7,2340,0,1921,2013.0,98146,47.5117,-122.37899999999999,1310,5600,3260,0.5821428571428572,5475600,31360000,25884400
245000.0,3,2.0,2040,13125,1.0,0,0,2,6,810,1230,1910,0.0,98168,47.478,-122.27799999999999,1460,10582,11085,0.8445714285714285,4161600,172265625,168104025
337000.0,3,1.75,1310,12750,1.0,0,0,2,7,1310,0,1993,0.0,98059,47.4695,-122.07,1790,13500,11440,0.8972549019607843,1716100,162562500,160846400
630000.0,3,2.0,1470,6000,1.0,0,0,2,8,1090,380,1950,1996.0,98033,47.6829,-122.20200000000001,1880,7799,4530,0.755,2160900,36000000,33839100
320000.0,3,1.75,1370,9900,1.0,0,0,3,7,1370,0,1983,0.0,98003,47.2575,-122.31200000000001,1490,9600,8530,0.8616161616161616,1876900,98010000,96133100
228500.0,3,1.0,1080,7486,1.5,0,0,2,6,990,90,1942,0.0,98146,47.4838,-122.335,1170,7800,6406,0.8557306973016298,1166400,56040196,54873796
293000.0,3,2.5,1990,7577,2.0,0,0,2,7,1990,0,1990,0.0,98023,47.2908,-122.351,1900,7152,5587,0.7373630724561172,3960100,57410929,53450829
447000.0,3,1.0,1310,7000,1.0,0,0,3,7,1310,0,1958,0.0,98008,47.6019,-122.12299999999999,1280,7300,5690,0.8128571428571428,1716100,49000000,47283900
226500.0,3,1.75,1640,10762,1.0,0,0,2,7,1130,510,1988,0.0,98042,47.3586,-122.074,1680,10259,9122,0.8476119680356811,2689600,115820644,113131044
436000.0,3,2.25,1770,8000,1.0,0,0,3,7,1350,420,1976,0.0,98072,47.7358,-122.17,1850,7875,6230,0.77875,3132900,64000000,60867100
451000.0,3,2.5,2050,4876,2.0,0,0,2,8,2050,0,2005,0.0,98072,47.7746,-122.15799999999999,2320,4065,2826,0.5795734208367515,4202500,23775376,19572876
315000.0,3,1.0,1170,62290,2.0,0,0,2,5,1170,0,1986,0.0,98045,47.5104,-121.787,1810,42173,61120,0.9812168887461872,1368900,3880044100,3878675200
450000.0,2,1.0,1340,7250,1.0,0,0,3,7,1340,0,1951,0.0,98125,47.7015,-122.32,1450,7026,5910,0.8151724137931035,1795600,52562500,50766900
635000.0,3,1.5,2240,5300,1.0,0,0,4,7,1120,1120,1955,0.0,98117,47.6927,-122.395,1740,7110,3060,0.5773584905660377,5017600,28090000,23072400
292500.0,2,1.0,880,17743,1.0,0,0,3,5,880,0,1951,0.0,98031,47.4115,-122.197,1217,13000,16863,0.9504029758214507,774400,314814049,314039649
329900.0,3,2.5,2170,4905,2.0,0,0,2,8,2170,0,2004,0.0,98038,47.3503,-122.039,2300,4935,2735,0.5575942915392457,4708900,24059025,19350125
531000.0,2,1.5,1260,6660,1.5,0,0,3,7,1260,0,1926,0.0,98115,47.6792,-122.287,2140,4770,5400,0.8108108108108109,1587600,44355600,42768000
725000.0,3,1.75,1880,13300,1.0,0,0,2,7,1380,500,1967,0.0,98004,47.63399999999999,-122.204,3550,10883,11420,0.8586466165413534,3534400,176890000,173355600
355300.0,3,2.5,1620,7410,1.0,0,0,4,7,1620,0,1955,0.0,98133,47.7708,-122.335,1450,8121,5790,0.7813765182186235,2624400,54908100,52283700
280000.0,3,2.5,1610,10022,2.0,0,0,2,7,1610,0,1996,0.0,98003,47.2583,-122.3,1820,10017,8412,0.8393534224705648,2592100,100440484,97848384
1100000.0,4,2.75,3330,9143,2.0,0,0,3,10,3330,0,1995,0.0,98033,47.6821,-122.19,2390,9143,5813,0.6357869408290495,11088900,83594449,72505549
605004.0,4,2.0,1370,4000,2.0,0,0,2,9,1370,0,1951,1994.0,98199,47.6593,-122.39399999999999,2010,5720,2630,0.6575,1876900,16000000,14123100
260000.0,2,1.0,690,6000,1.0,0,0,2,6,690,0,1949,0.0,98118,47.5621,-122.28299999999999,840,3030,5310,0.885,476100,36000000,35523900
748000.0,4,2.5,3170,4979,2.0,0,0,3,7,2570,600,1925,0.0,98103,47.6655,-122.34,2060,5000,1809,0.3633259690700944,10048900,24790441,14741541
776000.0,2,2.0,1990,6180,1.0,0,0,3,7,1010,980,1941,0.0,98115,47.6792,-122.303,1470,5150,4190,0.6779935275080906,3960100,38192400,34232300
425000.0,4,1.0,1080,6095,1.5,0,0,3,6,1080,0,1924,0.0,98103,47.6962,-122.346,1200,5060,5015,0.822805578342904,1166400,37149025,35982625
230000.0,4,1.0,1870,14703,1.5,0,0,2,6,1090,780,1928,0.0,98118,47.5274,-122.281,1650,6045,12833,0.8728150717540638,3496900,216178209,212681309
418000.0,3,1.75,1670,12075,1.0,0,0,2,7,1370,300,1958,0.0,98155,47.7681,-122.307,1800,12123,10405,0.8616977225672878,2788900,145805625,143016725
440000.0,4,2.5,2800,28254,2.0,0,0,2,9,2800,0,2001,0.0,98038,47.3552,-122.06299999999999,2530,4694,25454,0.9008989877539464,7840000,798288516,790448516
858450.0,5,2.75,3460,7977,2.0,0,0,2,9,3460,0,2011,0.0,98074,47.5908,-122.06200000000001,3390,6630,4517,0.5662529773097655,11971600,63632529,51660929
390000.0,3,2.0,1930,12443,1.0,0,0,2,7,1930,0,1969,0.0,98045,47.4906,-121.775,1400,12183,10513,0.8448927107610705,3724900,154828249,151103349
957000.0,4,3.0,2370,3836,2.0,0,0,2,9,1750,620,1969,2008.0,98107,47.6718,-122.39399999999999,1690,4698,1466,0.3821689259645464,5616900,14714896,9097996
507000.0,3,1.0,1180,6000,1.0,0,0,2,7,1180,0,1950,0.0,98115,47.6853,-122.286,1680,6000,4820,0.8033333333333333,1392400,36000000,34607600
575000.0,2,1.0,1320,4750,1.5,0,0,3,7,1320,0,1928,0.0,98107,47.6729,-122.38,1360,2873,3430,0.7221052631578947,1742400,22562500,20820100
700000.0,3,1.75,1350,4000,1.5,0,0,3,7,1350,0,1925,0.0,98103,47.6581,-122.354,1880,4000,2650,0.6625,1822500,16000000,14177500
239950.0,2,1.5,1068,1452,2.0,0,0,2,7,1068,0,1990,0.0,98028,47.753,-122.244,1078,1357,384,0.2644628099173554,1140624,2108304,967680
253000.0,3,1.0,1580,8240,1.0,0,0,3,7,1040,540,1978,0.0,98030,47.3542,-122.181,1480,9200,6660,0.808252427184466,2496400,67897600,65401200
540000.0,4,1.0,1690,3417,1.5,0,0,2,7,1690,0,1907,0.0,98199,47.663000000000004,-122.402,1970,4800,1727,0.5054141059408838,2856100,11675889,8819789
1550000.0,3,4.0,5120,4600,3.0,0,2,2,11,4490,630,2008,0.0,98034,47.7052,-122.223,2510,5918,-520,-0.11304347826086956,26214400,21160000,-5054400
805000.0,4,2.5,3960,38615,2.0,0,0,2,10,3960,0,2000,0.0,98077,47.7249,-122.024,3290,43560,34655,0.8974491777806551,15681600,1491118225,1475436625
920000.0,4,3.25,2420,4000,1.5,0,0,4,9,1870,550,1911,0.0,98105,47.6567,-122.325,1810,4000,1580,0.395,5856400,16000000,10143600
496600.0,3,2.5,1910,5562,2.0,0,0,2,8,1910,0,1988,0.0,98029,47.5738,-122.01700000000001,1940,4647,3652,0.6565983459187342,3648100,30935844,27287744
246000.0,3,2.25,1440,10500,1.0,0,0,2,8,1130,310,1983,0.0,98023,47.31800000000001,-122.391,1510,8125,9060,0.8628571428571429,2073600,110250000,108176400
350000.0,5,3.0,2320,8400,1.0,0,0,2,7,1510,810,1963,0.0,98106,47.556999999999995,-122.365,1200,4800,6080,0.7238095238095238,5382400,70560000,65177600
585000.0,3,2.0,1670,4572,1.5,0,0,2,8,1670,0,1931,0.0,98117,47.6854,-122.37299999999999,1480,4890,2902,0.6347331583552056,2788900,20903184,18114284
450000.0,3,1.75,1390,11700,1.0,0,0,3,7,1390,0,1966,0.0,98033,47.7002,-122.19200000000001,1060,8686,10310,0.8811965811965812,1932100,136890000,134957900
746000.0,3,2.5,2620,8950,2.0,0,0,2,9,2620,0,1992,0.0,98006,47.5523,-122.119,2850,8809,6330,0.7072625698324022,6864400,80102500,73238100
598555.0,3,2.5,3040,7880,2.0,0,0,2,9,3040,0,2004,0.0,98056,47.5277,-122.184,3040,7880,4840,0.6142131979695431,9241600,62094400,52852800
820000.0,3,2.5,2990,10711,1.0,1,4,2,9,1560,1430,1976,1991.0,98198,47.3573,-122.324,2870,11476,7721,0.7208477266361685,8940100,114725521,105785421
266500.0,3,2.25,1740,5460,1.0,0,0,2,7,1210,530,1998,0.0,98038,47.3648,-122.046,1740,7500,3720,0.6813186813186813,3027600,29811600,26784000
370000.0,2,1.0,2360,105850,1.0,0,2,1,6,1180,1180,1947,0.0,98022,47.2495,-121.97,2640,386812,103490,0.9777042985356637,5569600,11204222500,11198652900
625000.0,3,2.75,2240,3600,2.5,0,0,2,7,1650,590,1901,0.0,98102,47.6244,-122.32600000000001,1716,3120,1360,0.37777777777777777,5017600,12960000,7942400
243500.0,4,2.0,1610,6200,1.0,0,0,3,7,1610,0,1979,0.0,98198,47.3833,-122.306,1610,7500,4590,0.7403225806451613,2592100,38440000,35847900
340000.0,2,1.0,700,5829,1.0,0,0,2,6,700,0,1945,0.0,98103,47.6958,-122.35700000000001,1160,6700,5129,0.8799107908732201,490000,33977241,33487241
559950.0,5,3.0,2730,9519,1.0,0,0,2,8,1670,1060,2014,0.0,98155,47.7504,-122.307,1150,9519,6789,0.7132051686101482,7452900,90611361,83158461
315000.0,3,2.75,1780,15114,1.0,0,0,2,7,1080,700,1980,0.0,98003,47.258,-122.305,1792,10155,13334,0.8822283975122404,3168400,228432996,225264596
753000.0,3,2.5,3070,223463,2.0,0,0,2,9,3070,0,2003,0.0,98053,47.663999999999994,-121.993,3640,223463,220393,0.9862617077547513,9424900,49935712369,49926287469
800000.0,3,3.0,2060,3200,2.0,0,0,2,8,2060,0,1907,0.0,98102,47.637,-122.324,1760,2669,1140,0.35625,4243600,10240000,5996400
550000.0,3,2.25,1360,5111,1.5,0,0,4,7,1360,0,1934,0.0,98115,47.6988,-122.31299999999999,1900,5111,3751,0.7339072588534533,1849600,26122321,24272721
465000.0,3,2.0,1430,14250,1.0,0,0,2,7,1430,0,1953,0.0,98033,47.701,-122.199,1530,11475,12820,0.8996491228070176,2044900,203062500,201017600
465000.0,3,2.25,1840,5752,2.0,0,0,2,7,1840,0,2003,0.0,98034,47.7042,-122.18700000000001,1670,2462,3912,0.6801112656467315,3385600,33085504,29699904
710000.0,4,2.25,2000,8068,2.0,0,0,4,8,2000,0,1976,0.0,98006,47.5584,-122.137,2080,7837,6068,0.7521070897372335,4000000,65092624,61092624
505000.0,3,2.5,1820,11012,2.0,0,0,2,8,1820,0,1988,0.0,98074,47.6358,-122.02600000000001,1860,7767,9192,0.834725753723211,3312400,121264144,117951744
690000.0,3,1.75,2330,16300,2.0,0,0,2,9,2330,0,1964,0.0,98034,47.7037,-122.24,2330,16300,13970,0.8570552147239264,5428900,265690000,260261100
217500.0,2,2.0,1070,8400,1.0,0,0,3,7,1070,0,1980,0.0,98031,47.4014,-122.186,1430,8190,7330,0.8726190476190476,1144900,70560000,69415100
500000.0,2,1.0,930,3750,1.0,0,0,3,7,930,0,1909,0.0,98115,47.6733,-122.296,1740,4300,2820,0.752,864900,14062500,13197600
325000.0,2,2.0,1040,5796,1.0,0,2,3,6,1040,0,1921,0.0,98155,47.7362,-122.29,2300,5796,4756,0.8205659075224293,1081600,33593616,32512016
500000.0,4,2.25,1960,12436,2.0,0,0,2,8,1960,0,1984,0.0,98074,47.6276,-122.037,1960,12436,10476,0.8423930524284335,3841600,154654096,150812496
721500.0,3,3.25,2970,234788,2.0,0,3,2,9,2040,930,1991,0.0,98024,47.5353,-121.897,2970,220413,231818,0.9873502904748113,8820900,55125404944,55116584044
924000.0,3,1.5,2200,5000,1.5,0,0,2,9,2200,0,1932,0.0,98199,47.6404,-122.40799999999999,2860,5000,2800,0.56,4840000,25000000,20160000
2010000.0,6,4.5,3810,28176,1.0,0,4,4,10,3810,0,1969,0.0,98177,47.7612,-122.381,3810,26400,24366,0.864778534923339,14516100,793886976,779370876
345000.0,2,1.5,830,1034,2.0,0,0,2,8,830,0,2009,0.0,98144,47.5926,-122.3,1130,2534,204,0.19729206963249515,688900,1069156,380256
825000.0,4,3.5,3920,11086,2.0,0,0,2,10,3920,0,1999,0.0,98065,47.5416,-121.869,3740,10880,7166,0.6464008659570629,15366400,122899396,107532996
560000.0,3,2.0,2870,95396,1.0,0,0,3,9,1350,1520,1980,0.0,98027,47.4834,-122.001,2870,102366,92526,0.9699148811270912,8236900,9100396816,9092159916
599000.0,3,2.0,2560,14680,1.0,0,0,2,8,1330,1230,1987,0.0,98052,47.648,-122.118,2390,13848,12120,0.8256130790190735,6553600,215502400,208948800
211000.0,3,1.5,1350,7620,1.0,0,0,4,6,1350,0,1941,0.0,98166,47.4565,-122.35,1350,7620,6270,0.8228346456692913,1822500,58064400,56241900
425000.0,4,2.25,1240,21190,1.0,0,0,2,8,910,330,1974,0.0,98056,47.5123,-122.197,1760,8200,19950,0.9414818310523831,1537600,449016100,447478500
750000.0,4,2.75,3210,8520,1.0,0,2,3,7,1810,1400,1976,0.0,98177,47.7743,-122.38799999999999,2450,7360,5310,0.6232394366197183,10304100,72590400,62286300
479000.0,3,2.5,1690,3322,2.0,0,0,2,7,1690,0,2003,0.0,98053,47.6824,-122.036,1650,3446,1632,0.4912703190848886,2856100,11035684,8179584
612500.0,4,2.5,2550,10623,2.0,0,0,2,9,2550,0,1992,0.0,98029,47.5695,-121.992,2750,8100,8073,0.7599548150240045,6502500,112848129,106345629
605000.0,5,1.75,3240,34510,2.0,0,0,3,7,2690,550,1963,0.0,98029,47.5529,-122.027,2650,28250,31270,0.9061141698058534,10497600,1190940100,1180442500
1360000.0,4,2.5,3560,8960,2.0,0,0,2,10,3560,0,2001,0.0,98033,47.6903,-122.213,1660,7680,5400,0.6026785714285714,12673600,80281600,67608000
389900.0,3,2.5,2160,59241,1.0,0,0,2,7,2160,0,2007,0.0,98042,47.3304,-122.13,2290,125017,57081,0.9635387653820834,4665600,3509496081,3504830481
710000.0,4,2.5,3060,5000,2.0,0,0,2,9,3060,0,2006,0.0,98059,47.5395,-122.18799999999999,2870,5548,1940,0.388,9363600,25000000,15636400
295000.0,3,2.5,1690,8564,2.0,0,0,3,7,1690,0,1992,0.0,98038,47.3518,-122.057,1690,7532,6874,0.8026623073330219,2856100,73342096,70485996
275250.0,3,2.25,1520,7199,2.0,0,0,3,7,1520,0,1992,0.0,98038,47.3492,-122.03399999999999,1410,6751,5679,0.7888595638283095,2310400,51825601,49515201
250000.0,4,2.5,2040,5770,2.0,0,0,2,7,2040,0,1994,0.0,98038,47.3522,-122.059,1570,6753,3730,0.6464471403812825,4161600,33292900,29131300
709000.0,3,2.0,2360,18000,1.0,0,0,3,8,2180,180,1951,0.0,98177,47.7133,-122.367,2600,17300,15640,0.8688888888888889,5569600,324000000,318430400
399500.0,4,1.75,1360,4840,1.5,0,0,3,7,1360,0,1928,0.0,98126,47.556000000000004,-122.376,1320,4840,3480,0.71900826446281,1849600,23425600,21576000
225000.0,3,2.5,2000,9202,2.0,0,0,3,7,2000,0,1992,0.0,98038,47.3516,-122.057,1750,7827,7202,0.7826559443599218,4000000,84676804,80676804
500000.0,3,2.5,1650,4648,2.0,0,0,2,8,1650,0,2001,0.0,98075,47.5968,-122.015,1800,5637,2998,0.6450086058519794,2722500,21603904,18881404
364900.0,3,3.0,2500,8304,2.0,0,0,2,8,2500,0,1997,0.0,98031,47.4022,-122.166,2290,7855,5804,0.6989402697495183,6250000,68956416,62706416
356000.0,3,1.5,1140,7500,1.0,0,0,2,7,1140,0,1976,0.0,98074,47.619,-122.064,1380,7500,6360,0.848,1299600,56250000,54950400
616750.0,3,1.5,2140,47743,1.5,0,0,2,9,2140,0,1978,0.0,98106,47.5402,-122.365,1060,6016,45603,0.9551766751146765,4579600,2279394049,2274814449
755000.0,3,2.75,2870,6600,2.0,0,2,2,8,2870,0,1984,0.0,98008,47.5745,-122.113,2570,7925,3730,0.5651515151515152,8236900,43560000,35323100
327500.0,2,1.0,830,8183,1.0,0,0,4,6,830,0,1950,0.0,98155,47.7366,-122.302,1180,8184,7353,0.8985702065257241,688900,66961489,66272589
605000.0,3,2.25,1960,10139,2.0,0,0,2,8,1960,0,1984,0.0,98074,47.6481,-122.061,2080,9753,8179,0.8066870500049315,3841600,102799321,98957721
179950.0,4,1.5,1130,5200,1.0,0,0,2,6,1130,0,1968,0.0,98042,47.3616,-122.089,1140,5200,4070,0.7826923076923077,1276900,27040000,25763100
633000.0,5,2.75,3630,30570,2.0,0,0,2,11,3630,0,2000,0.0,98058,47.4243,-122.09700000000001,3620,41965,26940,0.8812561334641805,13176900,934524900,921348000
349950.0,4,2.0,1764,15600,1.0,0,0,4,7,1764,0,1942,0.0,98058,47.4318,-122.181,1490,22387,13836,0.8869230769230769,3111696,243360000,240248304
1080000.0,3,2.75,2770,5800,1.0,0,0,3,8,1650,1120,1959,0.0,98199,47.6496,-122.413,2340,5800,3030,0.5224137931034483,7672900,33640000,25967100
425000.0,3,2.5,2650,12247,2.0,0,0,2,9,2650,0,2002,0.0,98001,47.3185,-122.259,2920,8965,9597,0.7836204784845269,7022500,149989009,142966509
990000.0,3,2.75,2500,6350,2.0,0,0,4,9,2370,130,1979,0.0,98122,47.6035,-122.285,2090,5454,3850,0.6062992125984252,6250000,40322500,34072500
410000.0,3,1.0,2710,19000,2.0,0,3,3,7,2710,0,1950,0.0,98166,47.4462,-122.359,2150,19000,16290,0.8573684210526316,7344100,361000000,353655900
590000.0,3,2.25,2490,8800,2.0,0,0,3,8,2490,0,1975,0.0,98006,47.5666,-122.132,2690,10000,6310,0.7170454545454545,6200100,77440000,71239900
242000.0,3,1.75,1500,7560,1.0,0,0,2,7,1500,0,1979,0.0,98003,47.3467,-122.296,1500,7560,6060,0.8015873015873016,2250000,57153600,54903600
775000.0,3,2.0,1160,13747,1.0,0,0,4,5,580,580,1931,0.0,98075,47.585,-122.051,2961,16320,12587,0.915617953007929,1345600,188980009,187634409
680000.0,4,1.5,1880,6200,1.0,0,2,4,8,1440,440,1954,0.0,98146,47.5035,-122.384,2070,6500,4320,0.6967741935483871,3534400,38440000,34905600
217000.0,3,2.5,1340,4200,2.0,0,0,2,7,1340,0,2002,0.0,98002,47.2942,-122.226,990,4520,2860,0.680952380952381,1795600,17640000,15844400
395000.0,3,2.5,1960,3953,2.0,0,0,2,8,1960,0,1999,0.0,98059,47.4904,-122.15799999999999,1690,3593,1993,0.5041740450290918,3841600,15626209,11784609
572500.0,3,2.25,2030,9791,1.0,0,0,3,8,1500,530,1984,0.0,98059,47.534,-122.161,2030,11031,7761,0.7926667347564089,4120900,95863681,91742781
559900.0,5,3.0,2200,6380,1.0,0,0,2,7,1440,760,1987,0.0,98125,47.7033,-122.322,1960,5800,4180,0.6551724137931034,4840000,40704400,35864400
845000.0,3,2.0,2540,4750,1.5,0,0,4,9,1840,700,1930,0.0,98117,47.6838,-122.4,2190,4750,2210,0.4652631578947368,6451600,22562500,16110900
241000.0,3,2.0,1520,7131,1.0,0,0,2,8,1520,0,1993,0.0,98023,47.3061,-122.361,1890,7379,5611,0.7868461646332913,2310400,50851161,48540761
1330000.0,3,2.25,2360,5504,2.0,0,0,3,8,2080,280,1913,0.0,98122,47.617,-122.288,2840,5470,3144,0.5712209302325582,5569600,30294016,24724416
475000.0,3,1.75,1340,2805,1.5,0,0,2,7,1340,0,1919,0.0,98144,47.5922,-122.29700000000001,1650,2805,1465,0.5222816399286988,1795600,7868025,6072425
575000.0,2,1.5,1400,5810,2.0,0,0,2,7,1400,0,1940,0.0,98103,47.6843,-122.34100000000001,1470,3920,4410,0.7590361445783133,1960000,33756100,31796100
455000.0,4,2.75,3030,117378,1.0,0,0,3,8,1680,1350,1959,0.0,98042,47.401,-122.135,2060,110957,114348,0.9741859632980626,9180900,13777594884,13768413984
839000.0,3,2.5,3200,203425,1.0,0,0,2,10,3200,0,2000,0.0,98077,47.7614,-122.015,3200,203425,200225,0.9842693867518741,10240000,41381730625,41371490625
475000.0,4,1.5,1580,10260,1.0,0,0,3,7,1030,550,1955,0.0,98007,47.5984,-122.147,1520,7000,8680,0.8460038986354775,2496400,105267600,102771200
600000.0,2,1.0,2120,6897,1.0,0,0,3,7,1060,1060,1923,0.0,98118,47.5566,-122.27799999999999,1900,4462,4777,0.6926199797013194,4494400,47568609,43074209
515000.0,2,1.0,1640,5200,1.0,0,0,3,7,1040,600,1937,0.0,98199,47.6426,-122.40299999999999,1780,5040,3560,0.6846153846153846,2689600,27040000,24350400
425000.0,3,2.25,1890,8400,1.0,0,0,2,8,1520,0,1977,0.0,98034,47.7103,-122.23200000000001,1830,7980,6510,0.775,3572100,70560000,66987900
565000.0,4,2.0,1710,3875,1.5,0,0,3,7,1710,0,1907,0.0,98122,47.6086,-122.294,1710,3812,2165,0.5587096774193548,2924100,15015625,12091525
498000.0,2,2.0,1140,8282,1.0,0,0,2,6,1140,0,1924,2009.0,98033,47.6949,-122.21,1650,9000,7142,0.8623520888674233,1299600,68591524,67291924
739000.0,4,3.0,2720,3800,2.0,0,0,4,8,1800,920,1919,0.0,98115,47.6756,-122.306,1940,4001,1080,0.28421052631578947,7398400,14440000,7041600
355000.0,2,1.75,1650,4000,1.0,0,0,3,7,950,700,1947,0.0,98108,47.5622,-122.319,1060,4110,2350,0.5875,2722500,16000000,13277500
263000.0,3,1.75,1790,7485,1.0,0,0,3,8,1330,460,1979,0.0,98023,47.3118,-122.34,1970,8097,5695,0.7608550434201736,3204100,56025225,52821125
375000.0,4,1.75,1680,6834,1.5,0,0,2,7,1680,0,1948,0.0,98125,47.716,-122.307,950,7425,5154,0.7541703248463565,2822400,46703556,43881156
322000.0,3,1.75,2200,12231,1.0,0,0,3,7,1250,950,1964,0.0,98056,47.5076,-122.17299999999999,2200,9825,10031,0.8201291799525795,4840000,149597361,144757361
325000.0,2,1.0,830,5100,1.0,0,0,2,6,830,0,1941,0.0,98103,47.6932,-122.346,1050,5100,4270,0.8372549019607843,688900,26010000,25321100
290000.0,2,1.0,770,4800,1.0,0,0,2,7,770,0,1943,0.0,98136,47.527,-122.383,1390,4800,4030,0.8395833333333333,592900,23040000,22447100
809950.0,4,2.5,3280,6181,2.0,0,0,2,10,3280,0,2001,0.0,98074,47.6484,-122.081,3110,7570,2901,0.46934153049668337,10758400,38204761,27446361
969500.0,3,3.25,2080,3025,2.0,0,2,3,8,1220,860,1984,0.0,98122,47.6051,-122.289,2680,6518,945,0.31239669421487604,4326400,9150625,4824225
665000.0,4,2.5,2790,43091,2.0,0,0,3,9,2790,0,1989,0.0,98077,47.7759,-122.08,2750,35290,40301,0.9352533011533731,7784100,1856834281,1849050181
635000.0,5,3.5,4150,13232,2.0,0,0,2,11,4150,0,2006,0.0,98003,47.3417,-122.182,3840,15121,9082,0.68636638452237,17222500,175085824,157863324
272450.0,3,2.25,1780,7332,2.0,0,0,2,7,1780,0,1987,0.0,98038,47.3593,-122.051,1510,7625,5552,0.7572285870158211,3168400,53758224,50589824
427000.0,4,1.75,1460,9750,1.0,0,0,3,7,1460,0,1967,0.0,98008,47.6205,-122.102,1820,9840,8290,0.8502564102564103,2131600,95062500,92930900
261500.0,3,1.0,1410,8174,1.0,0,0,2,8,1410,0,1958,0.0,98056,47.4969,-122.178,1500,8058,6764,0.8275018350868608,1988100,66814276,64826176
488800.0,4,2.25,2170,9665,1.0,0,0,3,8,1300,870,1976,0.0,98006,47.5444,-122.165,2170,12054,7495,0.7754785307811691,4708900,93412225,88703325
340000.0,2,1.0,690,5200,1.0,0,0,2,6,690,0,1918,0.0,98136,47.556000000000004,-122.395,1380,5700,4510,0.8673076923076923,476100,27040000,26563900
398950.0,4,3.0,3000,10297,2.0,0,0,2,8,3000,0,2003,0.0,98042,47.3684,-122.073,2520,8366,7297,0.7086530057298243,9000000,106028209,97028209
217000.0,3,1.0,870,5200,1.0,0,0,4,6,870,0,1969,0.0,98042,47.3701,-122.07799999999999,1020,5200,4330,0.8326923076923077,756900,27040000,26283100
799000.0,4,2.5,3170,94855,1.0,0,0,3,9,1910,1260,1978,0.0,98072,47.7648,-122.11200000000001,2590,65340,91685,0.9665805703442096,10048900,8997471025,8987422125
160000.0,4,1.0,1540,7350,1.0,0,0,3,6,770,770,1969,0.0,98023,47.3318,-122.34,910,8000,5810,0.7904761904761904,2371600,54022500,51650900
447000.0,3,1.0,1270,8800,1.0,0,0,2,7,1270,0,1968,0.0,98052,47.6703,-122.15,1560,8250,7530,0.8556818181818182,1612900,77440000,75827100
765000.0,3,1.75,2190,6450,1.0,0,0,2,8,1480,710,1957,0.0,98136,47.5284,-122.391,2190,6450,4260,0.6604651162790698,4796100,41602500,36806400
1320000.0,4,3.5,4410,36200,2.0,0,0,2,11,4410,0,1989,0.0,98006,47.5487,-122.126,4760,35860,31790,0.8781767955801105,19448100,1310440000,1290991900
445000.0,4,2.5,2790,8111,2.0,0,0,2,9,2480,310,2004,0.0,98058,47.4492,-122.116,2550,7634,5321,0.6560226852422636,7784100,65788321,58004221
310000.0,3,1.0,1510,6000,1.0,0,0,2,8,1170,340,1953,0.0,98118,47.5168,-122.285,1125,6000,4490,0.7483333333333333,2280100,36000000,33719900
380000.0,2,1.75,1800,7191,1.0,0,3,3,7,990,810,1952,0.0,98056,47.4828,-122.191,1940,7400,5391,0.7496871088861077,3240000,51710481,48470481
325000.0,4,1.0,2410,6975,1.0,0,0,2,7,1510,900,1957,0.0,98108,47.5692,-122.295,1880,6255,4565,0.6544802867383512,5808100,48650625,42842525
345000.0,4,2.75,2250,7412,1.0,0,0,3,8,1480,770,1975,0.0,98058,47.4449,-122.12899999999999,2070,7632,5162,0.6964382083108472,5062500,54937744,49875244
300000.0,3,1.0,950,4760,1.5,0,0,2,6,950,0,1929,0.0,98106,47.5236,-122.348,1080,4760,3810,0.8004201680672269,902500,22657600,21755100
530000.0,4,1.75,2860,48351,1.0,0,0,2,8,1710,1150,1978,0.0,98077,47.7605,-122.085,2460,43560,45491,0.9408492068416372,8179600,2337819201,2329639601
583500.0,4,1.75,2860,48351,1.0,0,0,2,8,1710,1150,1978,0.0,98077,47.7605,-122.085,2460,43560,45491,0.9408492068416372,8179600,2337819201,2329639601
410000.0,2,1.0,1560,10125,1.0,0,0,3,7,1130,430,1954,0.0,98155,47.7488,-122.304,1680,10125,8565,0.845925925925926,2433600,102515625,100082025
535000.0,2,1.5,1940,5700,1.0,0,0,2,7,970,970,1937,0.0,98117,47.6881,-122.367,1250,5700,3760,0.6596491228070176,3763600,32490000,28726400
2050000.0,4,3.25,3580,19989,1.5,1,4,3,7,3480,100,1915,1965.0,98125,47.7087,-122.27600000000001,2410,6389,16409,0.8209014958227024,12816400,399560121,386743721
345000.0,4,2.5,2040,5523,2.0,0,0,2,7,2040,0,1999,0.0,98148,47.431999999999995,-122.32799999999999,1720,6646,3483,0.6306355241716458,4161600,30503529,26341929
539000.0,5,1.0,1700,11727,1.5,0,0,3,7,1700,0,1954,0.0,98033,47.68600000000001,-122.17200000000001,1740,8212,10027,0.8550353884198857,2890000,137522529,134632529
590000.0,4,2.5,3700,12500,1.0,0,0,4,8,1920,1780,1973,0.0,98006,47.5403,-122.16799999999999,2020,8350,8800,0.704,13690000,156250000,142560000
187000.0,2,1.75,1050,2926,1.0,0,0,3,8,1050,0,1974,0.0,98198,47.3811,-122.31700000000001,1150,3802,1876,0.6411483253588517,1102500,8561476,7458976
270000.0,3,2.0,1690,9583,1.0,0,0,3,7,1690,0,1969,0.0,98059,47.4825,-122.164,1690,9583,7893,0.823646039862256,2856100,91833889,88977789
546000.0,2,1.0,1120,6180,1.0,0,0,3,7,1120,0,1939,0.0,98115,47.6824,-122.301,1420,5356,5060,0.8187702265372169,1254400,38192400,36938000
520000.0,3,1.75,1490,1036,2.0,0,0,2,10,1090,400,2008,0.0,98199,47.6588,-122.40299999999999,1460,1206,-454,-0.43822393822393824,2220100,1073296,-1146804
515000.0,5,2.0,2220,6000,1.5,0,0,3,7,1390,830,1925,0.0,98144,47.5822,-122.295,1600,6000,3780,0.63,4928400,36000000,31071600
990000.0,3,2.5,2160,6000,1.5,0,0,3,8,1880,280,1939,0.0,98105,47.6582,-122.28,2300,6000,3840,0.64,4665600,36000000,31334400
382000.0,2,1.0,870,10492,1.0,0,0,2,7,870,0,1937,0.0,98106,47.5467,-122.365,1300,7987,9622,0.9170796797560046,756900,110082064,109325164
1210000.0,3,1.75,1900,13600,1.0,0,0,3,8,1900,0,1956,0.0,98004,47.6163,-122.219,2510,16600,11700,0.8602941176470589,3610000,184960000,181350000
900000.0,4,3.5,3370,5000,2.0,0,2,2,8,2470,900,2008,0.0,98126,47.5714,-122.38,1820,5000,1630,0.326,11356900,25000000,13643100
675000.0,3,2.75,3370,5350,1.5,0,1,3,7,2310,1060,1910,0.0,98136,47.5373,-122.39,1720,5618,1980,0.37009345794392523,11356900,28622500,17265600
460000.0,2,1.0,880,3300,1.0,0,0,3,7,880,0,1909,0.0,98107,47.6566,-122.36,1960,5500,2420,0.7333333333333333,774400,10890000,10115600
234000.0,2,1.0,940,5375,1.0,0,0,3,5,940,0,1952,0.0,98198,47.4206,-122.324,1200,7500,4435,0.8251162790697675,883600,28890625,28007025
399000.0,3,1.0,1340,7191,1.0,0,0,2,7,1340,0,1974,0.0,98034,47.7148,-122.212,1340,7215,5851,0.8136559588374357,1795600,51710481,49914881
253500.0,3,1.5,1440,12040,1.0,0,0,3,7,1440,0,1959,0.0,98042,47.3715,-122.16,1720,12040,10600,0.8803986710963455,2073600,144961600,142888000
475000.0,3,1.5,1750,12632,1.0,0,0,3,7,1750,0,1952,0.0,98033,47.6736,-122.176,1740,12196,10882,0.8614629512349589,3062500,159567424,156504924
740000.0,5,3.5,3990,5000,2.0,0,0,2,8,2910,1080,2004,0.0,98118,47.54,-122.27,1310,5000,1010,0.202,15920100,25000000,9079900
799000.0,3,2.5,2860,4442,2.0,0,0,2,8,2860,0,2000,0.0,98199,47.661,-122.396,1440,4400,1582,0.3561458802341288,8179600,19731364,11551764
390000.0,4,2.5,1940,3864,2.0,0,0,2,8,1940,0,2003,0.0,98058,47.4507,-122.12,1900,3864,1924,0.4979296066252588,3763600,14930496,11166896
421000.0,2,1.5,1400,11245,1.0,0,0,4,7,1400,0,1947,0.0,98155,47.7469,-122.321,1220,11241,9845,0.8755002223210315,1960000,126450025,124490025
296500.0,3,2.5,1770,6033,2.0,0,0,3,7,1770,0,1987,0.0,98042,47.3764,-122.119,1590,6510,4263,0.7066136250621581,3132900,36397089,33264189
895000.0,4,2.0,1710,4178,1.5,0,0,3,8,1710,0,1926,0.0,98112,47.6373,-122.3,1760,4178,2468,0.5907132599329823,2924100,17455684,14531584
386000.0,4,2.5,2810,11897,2.0,0,0,2,8,2810,0,2003,0.0,98092,47.3251,-122.186,1770,4240,9087,0.7638060015129865,7896100,141538609,133642509
424000.0,3,1.0,1580,13912,1.0,0,0,3,8,1580,0,1955,0.0,98155,47.7552,-122.27600000000001,2130,16420,12332,0.8864289821736631,2496400,193543744,191047344
749000.0,3,1.0,1580,5000,1.5,0,0,2,7,1580,0,1926,0.0,98117,47.684,-122.38600000000001,1280,4000,3420,0.684,2496400,25000000,22503600
523000.0,3,1.0,1440,8681,1.5,0,0,2,7,1440,0,1937,0.0,98115,47.6976,-122.28299999999999,1700,7770,7241,0.8341204930307569,2073600,75359761,73286161
389000.0,4,2.5,2420,9147,2.0,0,0,2,10,2420,0,1998,0.0,98003,47.3221,-122.322,1400,7200,6727,0.7354323822018148,5856400,83667609,77811209
270000.0,4,1.5,1930,15000,1.0,0,0,4,7,1930,0,1946,0.0,98198,47.3864,-122.31200000000001,1620,7500,13070,0.8713333333333333,3724900,225000000,221275100
275000.0,3,1.0,1190,27215,1.0,0,0,4,7,1190,0,1943,1989.0,98059,47.4978,-122.115,1450,56628,26025,0.956274113540327,1416100,740656225,739240125
287500.0,4,2.5,2240,6944,1.0,0,2,2,7,1310,930,1979,0.0,98001,47.338,-122.258,1780,7477,4704,0.6774193548387096,5017600,48219136,43201536
345000.0,2,2.5,2550,216344,2.5,0,0,2,7,2550,0,1993,0.0,98092,47.2584,-122.124,1750,289978,213794,0.9882132159893503,6502500,46804726336,46798223836
427000.0,2,1.0,920,3780,1.0,0,0,2,6,920,0,1910,0.0,98103,47.6576,-122.348,1570,2640,2860,0.7566137566137566,846400,14288400,13442000
508450.0,4,1.75,1520,9600,1.0,0,0,3,7,1000,520,1955,0.0,98006,47.5763,-122.154,1510,9000,8080,0.8416666666666667,2310400,92160000,89849600
705000.0,3,2.0,1460,6250,1.5,0,0,3,7,1460,0,1912,0.0,98103,47.6693,-122.333,1690,4750,4790,0.7664,2131600,39062500,36930900
550000.0,1,1.5,1900,40600,1.5,0,0,4,9,1450,450,1977,0.0,98027,47.4718,-122.009,2920,40427,38700,0.9532019704433498,3610000,1648360000,1644750000
380000.0,3,1.5,1430,11173,1.0,0,0,0,7,1430,0,1955,0.0,98006,47.5734,-122.15299999999999,1520,11659,9743,0.8720128882126555,2044900,124835929,122791029
539900.0,3,2.5,2500,4203,2.0,0,0,2,8,2500,0,2001,0.0,98065,47.5346,-121.875,2460,4798,1703,0.4051867713537949,6250000,17665209,11415209
330000.0,2,1.0,720,7250,1.0,0,0,2,5,720,0,1943,0.0,98027,47.5267,-122.03200000000001,1760,7250,6530,0.9006896551724138,518400,52562500,52044100
455000.0,2,1.0,1140,5720,1.0,0,0,2,7,850,290,1947,0.0,98115,47.6827,-122.29799999999999,1410,5832,4580,0.8006993006993007,1299600,32718400,31418800
510000.0,4,4.0,3530,10935,2.0,0,0,2,10,3530,0,1992,0.0,98023,47.3016,-122.34200000000001,3360,11250,7405,0.6771833561957019,12460900,119574225,107113325
315000.0,3,2.0,1220,14645,1.0,0,0,2,6,1220,0,1970,0.0,98059,47.4842,-122.117,1980,24960,13425,0.9166951177876408,1488400,214476025,212987625
206000.0,3,1.0,1320,7000,1.0,0,0,3,7,1320,0,1967,0.0,98002,47.2787,-122.205,1260,7455,5680,0.8114285714285714,1742400,49000000,47257600
592500.0,4,3.0,2170,8240,1.0,0,0,3,8,1370,800,1968,0.0,98052,47.6291,-122.09299999999999,2020,7944,6070,0.7366504854368932,4708900,67897600,63188700
744000.0,3,2.5,2020,7512,2.0,0,0,3,8,2020,0,1981,0.0,98033,47.6927,-122.206,2410,8500,5492,0.7310969116080938,4080400,56430144,52349744
334500.0,3,2.5,1990,3694,2.0,0,0,2,8,1990,0,1989,0.0,98042,47.3872,-122.154,2110,3842,1704,0.46128857606930157,3960100,13645636,9685536
886000.0,4,2.0,2660,3900,1.5,0,0,3,7,1480,1180,1923,0.0,98112,47.6398,-122.306,2350,3900,1240,0.31794871794871793,7075600,15210000,8134400
600000.0,4,2.5,2360,13500,1.0,0,0,3,8,1780,580,1973,0.0,98052,47.6315,-122.103,2780,12400,11140,0.8251851851851851,5569600,182250000,176680400
850000.0,3,2.0,2740,101930,1.0,0,2,2,9,2740,0,1999,0.0,98045,47.5056,-121.77,2140,83635,99190,0.9731188070244285,7507600,10389724900,10382217300
550000.0,3,1.75,1360,5850,1.0,0,0,3,7,1000,360,1938,0.0,98116,47.5711,-122.391,1540,5850,4490,0.7675213675213676,1849600,34222500,32372900
184900.0,2,1.0,1230,5000,1.0,0,0,4,6,1230,0,1911,0.0,98022,47.2064,-121.988,1230,5413,3770,0.754,1512900,25000000,23487100
245000.0,3,1.5,1260,7964,1.0,0,0,3,7,1260,0,1955,0.0,98148,47.4307,-122.334,1510,8776,6704,0.8417880462079357,1587600,63425296,61837696
370000.0,2,1.0,1040,4172,1.0,0,0,2,7,1040,0,1946,0.0,98112,47.6308,-122.302,3120,4800,3132,0.75071907957814,1081600,17405584,16323984
480000.0,4,2.5,2700,9700,1.0,0,0,2,8,1670,1030,1978,0.0,98011,47.7752,-122.198,2470,9228,7000,0.7216494845360825,7290000,94090000,86800000
579000.0,3,1.75,1800,4429,2.0,0,0,3,7,1800,0,1906,0.0,98103,47.6842,-122.35700000000001,1310,4429,2629,0.5935877173176789,3240000,19616041,16376041
339275.0,3,1.5,1590,7260,1.0,0,0,2,7,1080,510,1964,0.0,98133,47.7753,-122.353,1590,7594,5670,0.78099173553719,2528100,52707600,50179500
425000.0,3,2.75,1360,542322,1.0,0,2,3,7,1140,220,1955,0.0,98022,47.2069,-122.024,1700,60548,540962,0.9974922647430862,1849600,294113151684,294111302084
170000.0,3,1.75,1370,10780,1.0,0,0,2,7,1370,0,1959,0.0,98168,47.4727,-122.29799999999999,1370,10317,9410,0.87291280148423,1876900,116208400,114331500
950000.0,4,2.5,3320,7644,2.0,0,0,2,10,3320,0,1995,0.0,98006,47.5541,-122.10600000000001,3320,9472,4324,0.56567242281528,11022400,58430736,47408336
623000.0,4,2.5,2980,9235,1.0,0,0,3,8,1690,1290,1977,0.0,98006,47.5513,-122.162,2690,10046,6255,0.6773145641580942,8880400,85285225,76404825
477000.0,3,2.5,1350,2053,3.0,0,0,2,8,1350,0,2005,0.0,98117,47.6758,-122.38600000000001,1350,4150,703,0.34242571846078906,1822500,4214809,2392309
330000.0,3,1.0,1160,9600,1.0,0,0,3,7,1160,0,1967,0.0,98077,47.7419,-122.073,1160,9730,8440,0.8791666666666667,1345600,92160000,90814400
600000.0,3,2.25,1480,5400,2.0,0,0,3,8,1480,0,1914,0.0,98122,47.6095,-122.296,1280,3600,3920,0.725925925925926,2190400,29160000,26969600
570000.0,3,2.0,1640,2808,1.0,0,3,3,7,820,820,1924,0.0,98144,47.5945,-122.291,2270,5328,1168,0.41595441595441596,2689600,7884864,5195264
515000.0,4,2.5,2680,7178,2.0,0,0,2,8,2680,0,2004,0.0,98065,47.5325,-121.85600000000001,2540,7133,4498,0.6266369462245751,7182400,51523684,44341284
805000.0,4,2.25,2440,9889,1.0,0,0,2,7,1540,900,1952,0.0,98115,47.6932,-122.3,1710,6284,7449,0.7532611993123672,5953600,97792321,91838721
555000.0,4,2.5,2920,24074,2.0,0,0,2,9,2920,0,1997,0.0,98038,47.381,-122.056,2760,26023,21154,0.8787073190994433,8526400,579557476,571031076
245000.0,3,2.25,1780,9598,2.0,0,0,3,7,1780,0,1985,0.0,98030,47.3718,-122.182,1820,7533,7818,0.8145446968118358,3168400,92121604,88953204
638150.0,4,2.5,2170,7275,1.0,0,0,2,8,1820,350,1978,0.0,98027,47.5672,-122.09,2390,7275,5105,0.7017182130584192,4708900,52925625,48216725
1650000.0,4,4.5,5550,16065,2.0,0,0,2,9,3880,1670,2003,0.0,98040,47.5455,-122.214,3470,16488,10515,0.6545284780578898,30802500,258084225,227281725
269950.0,4,2.5,2060,13500,1.0,0,0,2,7,1260,800,1968,0.0,98042,47.4229,-122.15299999999999,1610,10714,11440,0.8474074074074074,4243600,182250000,178006400
195000.0,3,1.5,1050,5525,1.0,0,0,4,6,1050,0,1969,0.0,98042,47.3608,-122.083,1100,5200,4475,0.8099547511312217,1102500,30525625,29423125
159100.0,2,1.0,790,7095,1.0,0,0,2,6,790,0,1944,0.0,98178,47.4928,-122.23899999999999,1150,7200,6305,0.8886539816772375,624100,50339025,49714925
550000.0,3,1.0,1010,6120,1.0,0,0,2,6,1010,0,1942,0.0,98033,47.6648,-122.204,1260,5977,5110,0.8349673202614379,1020100,37454400,36434300
299000.0,2,1.0,1040,4600,1.0,0,0,3,6,1040,0,1950,0.0,98118,47.5387,-122.277,1390,5897,3560,0.7739130434782608,1081600,21160000,20078400
1380000.0,4,3.5,3130,4500,2.0,0,0,2,9,2060,1070,2014,0.0,98103,47.677,-122.33,1500,4500,1370,0.30444444444444446,9796900,20250000,10453100
249500.0,2,1.0,900,4500,1.0,0,0,2,6,900,0,1951,0.0,98055,47.4881,-122.204,860,4500,3600,0.8,810000,20250000,19440000
700000.0,4,1.0,1470,5450,1.5,0,0,2,7,1470,0,1918,0.0,98112,47.6458,-122.306,2160,5450,3980,0.7302752293577982,2160900,29702500,27541600
275000.0,4,1.0,1080,26114,1.5,0,0,4,5,1080,0,1900,0.0,98030,47.3834,-122.215,1720,20360,25034,0.9586428735544152,1166400,681940996,680774596
565000.0,3,2.25,2440,8378,1.0,0,0,2,7,1480,960,1962,0.0,98028,47.7705,-122.26,2510,9602,5938,0.7087610408211984,5953600,70190884,64237284
425000.0,4,1.75,2520,11017,1.0,0,0,3,7,1320,1200,1956,0.0,98133,47.7604,-122.35600000000001,1660,8775,8497,0.7712625941726423,6350400,121374289,115023889
620047.0,4,1.75,1760,6000,1.0,0,0,2,7,880,880,1946,0.0,98119,47.6508,-122.37299999999999,2040,6000,4240,0.7066666666666667,3097600,36000000,32902400
480000.0,3,2.25,1820,13362,1.0,0,0,2,8,1220,600,1977,0.0,98075,47.5898,-122.052,2050,15000,11542,0.8637928453824277,3312400,178543044,175230644
515000.0,3,2.25,1820,13362,1.0,0,0,2,8,1220,600,1977,0.0,98075,47.5898,-122.052,2050,15000,11542,0.8637928453824277,3312400,178543044,175230644
420000.0,4,2.5,3040,24123,2.0,0,0,2,8,3040,0,1999,0.0,98092,47.2667,-122.21600000000001,2420,10026,21083,0.873979189984662,9241600,581919129,572677529
610000.0,5,3.25,3490,23400,1.0,0,0,3,8,1890,1600,1957,0.0,98006,47.5701,-122.124,2660,12400,19910,0.8508547008547008,12180100,547560000,535379900
849000.0,4,1.5,2440,8040,1.0,0,0,3,8,1440,1000,1950,0.0,98177,47.7081,-122.374,2140,7920,5600,0.6965174129353234,5953600,64641600,58688000
718000.0,3,1.75,2280,3446,2.0,0,0,2,8,2280,0,1949,1991.0,98125,47.715,-122.28200000000001,1610,6670,1166,0.3383633197910621,5198400,11874916,6676516
295000.0,3,2.25,1980,8000,1.0,0,0,3,9,1560,420,1974,0.0,98023,47.3149,-122.37799999999999,2360,8000,6020,0.7525,3920400,64000000,60079600
871000.0,5,1.75,2360,6150,1.0,0,0,4,7,1180,1180,1940,0.0,98107,47.6732,-122.4,2100,5500,3790,0.616260162601626,5569600,37822500,32252900
430000.0,3,3.75,3890,7140,1.0,0,2,2,8,2390,1500,1943,2007.0,98178,47.5073,-122.23899999999999,1820,7320,3250,0.45518207282913165,15132100,50979600,35847500
440000.0,4,2.5,2300,10880,1.0,0,0,3,7,1190,1110,1961,0.0,98028,47.7341,-122.242,1960,10400,8580,0.7886029411764706,5290000,118374400,113084400
405000.0,2,1.0,910,6490,1.0,0,0,2,7,910,0,1942,0.0,98115,47.6892,-122.306,1040,6490,5580,0.8597842835130971,828100,42120100,41292000
340000.0,3,2.0,1140,11620,1.0,0,0,2,7,1140,0,1994,0.0,98045,47.4991,-121.78299999999999,1140,8400,10480,0.9018932874354562,1299600,135024400,133724800
675000.0,4,2.5,2390,5249,2.0,0,0,2,9,2390,0,2006,0.0,98074,47.6194,-122.02600000000001,2600,5342,2859,0.5446751762240427,5712100,27552001,21839901
480000.0,3,1.0,1150,4945,1.0,0,2,2,7,1150,0,1943,0.0,98126,47.5663,-122.37899999999999,1390,4945,3795,0.7674418604651163,1322500,24453025,23130525
362500.0,5,2.0,2330,8586,1.0,0,0,3,7,1270,1060,1961,0.0,98133,47.7671,-122.334,1550,8287,6256,0.7286279990682506,5428900,73719396,68290496
752888.0,3,2.5,2420,9000,2.0,0,0,3,9,2420,0,1987,0.0,98007,47.6599,-122.146,2630,9000,6580,0.7311111111111112,5856400,81000000,75143600
255000.0,4,1.75,960,8863,1.0,0,0,4,6,580,380,1949,0.0,98118,47.5372,-122.289,1720,8249,7903,0.8916845311971116,921600,78552769,77631169
283700.0,1,1.75,1010,10900,1.0,0,0,3,6,1010,0,1968,0.0,98019,47.7391,-121.98200000000001,1410,8359,9890,0.9073394495412844,1020100,118810000,117789900
335000.0,4,2.5,2370,6000,2.0,0,0,2,8,2370,0,2001,0.0,98030,47.3732,-122.179,2190,6070,3630,0.605,5616900,36000000,30383100
285000.0,3,1.75,2880,18296,1.0,0,0,2,8,1580,1300,1958,0.0,98168,47.4881,-122.281,1380,9592,15416,0.8425885439440315,8294400,334743616,326449216
278000.0,4,2.25,2400,7738,1.5,0,0,2,8,2400,0,1964,0.0,98148,47.4562,-122.33,2170,8452,5338,0.6898423365210649,5760000,59876644,54116644
731000.0,5,2.5,3670,8960,1.5,0,0,2,8,3670,0,1973,0.0,98052,47.6654,-122.14200000000001,2340,9425,5290,0.5904017857142857,13468900,80281600,66812700
335000.0,3,1.5,1140,15890,1.0,0,0,2,7,840,300,1985,0.0,98045,47.4752,-121.757,1200,15247,14750,0.9282567652611705,1299600,252492100,251192500
334200.0,3,1.75,1410,45302,1.0,0,0,2,7,1410,0,1980,0.0,98019,47.7077,-121.914,2240,49222,43892,0.9688755463334953,1988100,2052271204,2050283104
642000.0,6,1.0,1530,4305,1.5,0,0,3,7,1530,0,1921,0.0,98115,47.6862,-122.31,1530,3800,2775,0.6445993031358885,2340900,18533025,16192125
540000.0,4,1.75,1720,4240,1.5,0,0,3,7,1460,260,1925,0.0,98144,47.57899999999999,-122.294,1930,4280,2520,0.5943396226415094,2958400,17977600,15019200
299000.0,3,2.5,1620,79993,1.0,0,2,3,6,1620,0,1960,0.0,98022,47.2138,-121.98200000000001,1620,15680,78373,0.9797482279699473,2624400,6398880049,6396255649
560000.0,3,1.75,1570,4375,1.0,0,0,2,7,970,600,1940,0.0,98116,47.5889,-122.389,1790,5750,2805,0.6411428571428571,2464900,19140625,16675725
852000.0,5,2.75,1990,3750,1.5,0,0,3,7,1990,0,1913,0.0,98107,47.6733,-122.35799999999999,1820,5000,1760,0.4693333333333333,3960100,14062500,10102400
306000.0,2,1.0,930,5650,1.0,0,2,2,7,930,0,1941,0.0,98126,47.5478,-122.37700000000001,1340,6400,4720,0.8353982300884956,864900,31922500,31057600
440000.0,3,1.75,1550,7820,1.0,0,0,3,7,1210,340,1981,0.0,98034,47.717,-122.163,1550,6900,6270,0.8017902813299232,2402500,61152400,58749900
517000.0,4,1.0,1650,8250,1.0,0,0,2,7,1650,0,1966,0.0,98008,47.6366,-122.118,2240,9776,6600,0.8,2722500,68062500,65340000
379000.0,2,1.0,800,6380,1.0,0,2,2,7,800,0,1940,0.0,98115,47.691,-122.309,920,5940,5580,0.8746081504702194,640000,40704400,40064400
360000.0,2,1.0,930,6098,1.0,0,0,3,6,930,0,1919,0.0,98027,47.5289,-122.03,1730,9000,5168,0.8474909806493932,864900,37185604,36320704
645000.0,4,1.5,2550,4000,1.5,0,0,3,7,1760,790,1926,0.0,98115,47.6811,-122.318,1840,4000,1450,0.3625,6502500,16000000,9497500
217000.0,2,1.0,720,4760,1.0,0,0,4,5,720,0,1942,0.0,98056,47.496,-122.186,840,4760,4040,0.8487394957983193,518400,22657600,22139200
255000.0,2,1.0,620,4760,1.0,0,0,2,6,620,0,1941,0.0,98126,47.5292,-122.376,620,4760,4140,0.8697478991596639,384400,22657600,22273200
625000.0,3,2.5,2360,12164,2.0,0,0,2,10,2360,0,1987,0.0,98029,47.5596,-122.022,2400,11260,9804,0.8059848733969089,5569600,147962896,142393296
680000.0,3,1.75,1760,8400,1.0,0,0,3,8,1460,300,1960,0.0,98136,47.5355,-122.39,1980,8400,6640,0.7904761904761904,3097600,70560000,67462400
440000.0,3,1.75,2100,29735,1.0,0,0,3,7,1080,1020,1957,0.0,98155,47.7622,-122.302,2100,11250,27635,0.9293761560450647,4410000,884170225,879760225
615000.0,5,2.25,2480,12070,2.0,0,0,2,9,2480,0,1978,0.0,98074,47.631,-122.052,2570,12000,9590,0.7945318972659486,6150400,145684900,139534500
239000.0,3,1.0,1040,6860,2.0,0,0,2,6,1040,0,1942,0.0,98146,47.5121,-122.375,1030,6512,5820,0.8483965014577259,1081600,47059600,45978000
462500.0,3,2.5,1656,108900,1.0,0,0,3,7,1656,0,1985,0.0,98070,47.3758,-122.425,2030,29859,107244,0.9847933884297521,2742336,11859210000,11856467664
619400.0,4,2.0,2090,3610,1.5,0,0,4,7,1790,300,1927,0.0,98115,47.6881,-122.31299999999999,1660,3767,1520,0.42105263157894735,4368100,13032100,8664000
975000.0,6,2.75,2520,54160,2.0,1,4,2,7,2520,0,1954,0.0,98146,47.4969,-122.376,2790,26809,51640,0.9534711964549483,6350400,2933305600,2926955200
330000.0,2,1.0,700,4000,1.0,0,0,2,6,700,0,1943,0.0,98136,47.5487,-122.391,1060,6000,3300,0.825,490000,16000000,15510000
985000.0,4,3.25,4030,36762,2.0,0,0,2,11,4030,0,1988,0.0,98077,47.7235,-122.039,4090,40371,32732,0.8903759316685708,16240900,1351444644,1335203744
430000.0,2,1.0,760,7114,1.0,0,0,2,6,760,0,1946,0.0,98103,47.7005,-122.352,780,7102,6354,0.893168400337363,577600,50608996,50031396
2460000.0,4,5.25,6500,14986,2.0,0,0,2,11,5180,1320,2001,0.0,98039,47.6304,-122.236,2270,8119,8486,0.5662618443880956,42250000,224580196,182330196
778000.0,3,2.0,1840,6000,2.0,0,0,4,7,1720,120,1946,0.0,98033,47.6828,-122.20700000000001,1390,6000,4160,0.6933333333333334,3385600,36000000,32614400
219000.0,3,2.0,1090,7350,1.0,0,0,3,7,1090,0,1990,0.0,98042,47.3687,-122.085,1490,7741,6260,0.8517006802721089,1188100,54022500,52834400
1600000.0,4,2.5,2980,13341,1.5,1,4,4,8,1800,1180,1928,0.0,98034,47.70399999999999,-122.245,2340,19810,10361,0.7766284386477775,8880400,177982281,169101881
715000.0,4,2.25,1900,8272,1.0,0,0,3,9,1460,440,1966,0.0,98040,47.5803,-122.227,2040,8479,6372,0.7703094777562862,3610000,68425984,64815984
950000.0,4,2.5,2790,15653,2.0,0,0,3,10,2790,0,1964,0.0,98040,47.5477,-122.215,3520,15653,12863,0.8217594071424008,7784100,245016409,237232309
425000.0,2,1.0,1280,5026,1.0,0,2,3,8,1020,260,1951,0.0,98115,47.6938,-122.31200000000001,1540,6380,3746,0.745324313569439,1638400,25260676,23622276
239000.0,3,1.0,1510,15022,1.0,0,0,2,7,1510,0,1962,0.0,98003,47.3304,-122.304,1510,12970,13512,0.8994807615497271,2280100,225660484,223380384
310000.0,1,1.0,920,8282,1.5,0,0,2,6,920,0,1944,0.0,98011,47.761,-122.214,2260,14025,7362,0.8889157208403767,846400,68591524,67745124
400000.0,2,1.0,700,8120,1.0,0,0,2,7,700,0,1927,0.0,98115,47.6962,-122.321,1130,5599,7420,0.9137931034482759,490000,65934400,65444400
428000.0,2,1.75,1980,44550,2.0,0,1,4,7,1280,700,1977,0.0,98070,47.4193,-122.444,1680,25343,42570,0.9555555555555556,3920400,1984702500,1980782100
600000.0,3,1.0,1440,4300,1.5,0,0,2,8,1440,0,1929,0.0,98117,47.6847,-122.37200000000001,1640,4500,2860,0.6651162790697674,2073600,18490000,16416400
415000.0,4,4.0,2740,8250,2.0,0,0,3,9,2740,0,1990,0.0,98042,47.3735,-122.156,2290,8250,5510,0.6678787878787878,7507600,68062500,60554900
401000.0,2,1.0,1400,8220,1.0,0,0,2,7,1400,0,1949,0.0,98133,47.7228,-122.35700000000001,1760,8220,6820,0.829683698296837,1960000,67568400,65608400
292000.0,3,1.75,2270,7156,1.0,0,0,2,7,1370,900,1948,0.0,98168,47.4864,-122.316,1210,7156,4886,0.6827836780324203,5152900,51208336,46055436
291750.0,3,2.25,1310,12825,1.0,0,0,2,7,1310,0,1950,2013.0,98166,47.4515,-122.368,1600,11250,11515,0.8978557504873295,1716100,164480625,162764525
227000.0,3,1.75,1680,7455,1.0,0,0,3,8,1680,0,1968,0.0,98023,47.3112,-122.37799999999999,2040,8214,5775,0.7746478873239436,2822400,55577025,52754625
675000.0,3,2.25,2260,13209,1.0,0,0,2,9,2260,0,1977,0.0,98005,47.6385,-122.167,2820,12534,10949,0.8289045347868877,5107600,174477681,169370081
397500.0,3,2.25,1350,980,2.0,0,0,2,8,1050,300,2007,0.0,98144,47.5998,-122.31200000000001,1350,1245,-370,-0.37755102040816324,1822500,960400,-862100
206000.0,2,1.5,1820,8867,2.0,0,0,2,7,1820,0,1921,0.0,98168,47.4764,-122.26899999999999,1430,9288,7047,0.7947445584752453,3312400,78623689,75311289
1190000.0,3,3.5,3380,3333,3.0,0,0,2,10,2800,580,2008,0.0,98122,47.6162,-122.288,2790,5000,-47,-0.014101410141014101,11424400,11108889,-315511
360000.0,4,1.75,2140,49658,1.0,0,0,4,7,2140,0,1959,0.0,98010,47.3583,-121.92200000000001,1720,99316,47518,0.9569052317854122,4579600,2465916964,2461337364
427500.0,4,2.5,2430,3249,2.0,0,0,2,8,2430,0,2010,0.0,98059,47.5048,-122.155,2650,3844,819,0.2520775623268698,5904900,10556001,4651101
115000.0,2,1.0,940,6000,1.0,0,0,2,6,940,0,1943,0.0,98146,47.4907,-122.336,1310,6000,5060,0.8433333333333334,883600,36000000,35116400
559000.0,3,1.5,2070,5386,1.0,0,0,3,7,1140,930,1948,0.0,98117,47.6896,-122.374,1770,5386,3316,0.6156702562198292,4284900,29008996,24724096
420000.0,4,1.0,1510,1501,1.5,0,0,2,7,1510,0,1906,0.0,98103,47.6526,-122.34200000000001,1560,1602,-9,-0.005996002664890073,2280100,2253001,-27099
550000.0,4,1.75,2550,39460,1.0,0,0,2,8,1890,660,1982,0.0,98072,47.7707,-122.12299999999999,2560,38638,36910,0.9353775975671567,6502500,1557091600,1550589100
282150.0,2,1.0,700,5940,1.0,0,0,2,7,700,0,1948,0.0,98133,47.7289,-122.337,1070,5995,5240,0.8821548821548821,490000,35283600,34793600
260000.0,3,1.0,1150,3090,1.0,0,0,2,6,1150,0,1910,0.0,98118,47.5506,-122.27600000000001,1150,5664,1940,0.627831715210356,1322500,9548100,8225600
428000.0,3,2.5,2340,3466,2.0,0,0,2,7,2340,0,2004,0.0,98065,47.5322,-121.851,1970,3739,1126,0.32487016733987306,5475600,12013156,6537556
319950.0,3,3.25,1510,1245,3.0,0,0,2,7,1510,0,2007,0.0,98133,47.7293,-122.34299999999999,1510,1245,-265,-0.21285140562248997,2280100,1550025,-730075
1350000.0,3,2.0,2070,9600,1.0,0,1,2,7,1590,480,1946,0.0,98039,47.61600000000001,-122.23899999999999,3000,16215,7530,0.784375,4284900,92160000,87875100
552000.0,2,1.0,1150,5000,1.0,0,0,3,7,1050,100,1924,0.0,98115,47.6846,-122.31700000000001,1463,4320,3850,0.77,1322500,25000000,23677500
637000.0,4,2.75,2190,2867,1.5,0,0,4,7,1470,720,1929,0.0,98115,47.6868,-122.30799999999999,1600,3800,677,0.23613533310080223,4796100,8219689,3423589
213000.0,4,1.75,1980,9000,1.0,0,0,1,7,1480,500,1978,0.0,98023,47.3071,-122.381,1980,9360,7020,0.78,3920400,81000000,77079600
215000.0,3,1.0,960,7200,1.0,0,0,3,6,960,0,1958,0.0,98166,47.4583,-122.353,1060,7620,6240,0.8666666666666667,921600,51840000,50918400
590000.0,3,1.75,2180,6120,1.0,0,2,2,8,1380,800,1949,0.0,98199,47.6501,-122.405,2020,6122,3940,0.6437908496732027,4752400,37454400,32702000
390000.0,4,2.5,2560,43560,2.0,0,0,2,8,2560,0,1989,0.0,98038,47.3692,-122.04700000000001,2130,10150,41000,0.9412304866850322,6553600,1897473600,1890920000
287000.0,4,2.25,2270,11997,1.0,0,2,3,7,1540,730,1959,0.0,98198,47.4095,-122.296,1920,9634,9727,0.8107860298407935,5152900,143928009,138775109
580000.0,5,2.75,3550,9600,2.0,0,0,2,7,3550,0,1960,0.0,98033,47.6766,-122.186,3370,9600,6050,0.6302083333333334,12602500,92160000,79557500
424000.0,3,2.0,1330,5632,1.0,0,0,2,8,1330,0,1988,0.0,98029,47.5745,-122.01700000000001,1900,4842,4302,0.7638494318181818,1768900,31719424,29950524
610000.0,4,2.5,2110,6360,2.0,0,0,2,8,2110,0,1988,0.0,98029,47.5641,-122.012,2050,7000,4250,0.6682389937106918,4452100,40449600,35997500
1320000.0,4,3.25,3470,11843,1.0,0,3,2,11,2270,1200,1989,0.0,98006,47.5513,-122.135,3910,13247,8373,0.7069999155619353,12040900,140256649,128215749
623500.0,4,3.0,1550,3350,1.0,0,0,2,7,860,690,1918,2014.0,98107,47.6583,-122.36200000000001,1310,5000,1800,0.5373134328358209,2402500,11222500,8820000
260000.0,2,1.0,570,81893,1.0,0,1,2,6,570,0,1936,0.0,98070,47.4433,-122.444,2040,115434,81323,0.9930396981426984,324900,6706463449,6706138549
906000.0,3,2.5,2030,1800,3.0,0,0,2,9,2030,0,2013,0.0,98112,47.6199,-122.3,1450,1441,-230,-0.12777777777777777,4120900,3240000,-880900
330000.0,3,2.0,1500,11233,1.0,0,0,2,7,1500,0,1987,0.0,98019,47.7279,-121.96700000000001,1580,14013,9733,0.8664648802635093,2250000,126180289,123930289
275000.0,2,1.0,920,7688,1.0,0,0,2,6,920,0,1955,0.0,98106,47.5281,-122.36200000000001,1040,7440,6768,0.8803329864724245,846400,59105344,58258944
290000.0,3,1.0,1470,8200,1.0,0,0,2,7,1040,430,1953,0.0,98155,47.7347,-122.302,1420,8200,6730,0.8207317073170731,2160900,67240000,65079100
599950.0,2,1.0,1150,3775,1.0,0,0,2,7,1150,0,1917,0.0,98103,47.6539,-122.329,2240,3753,2625,0.695364238410596,1322500,14250625,12928125
550000.0,4,3.0,4180,35169,2.0,0,0,2,11,4180,0,1986,1998.0,98038,47.4,-122.027,3010,35190,30989,0.8811453268503512,17472400,1236858561,1219386161
289000.0,3,1.75,1690,3449,1.0,0,0,2,7,1690,0,1987,0.0,98055,47.4719,-122.191,1530,4093,1759,0.5100028993911279,2856100,11895601,9039501
411000.0,4,2.75,2150,9915,1.0,0,0,4,8,1240,910,1976,0.0,98056,47.5378,-122.17,1980,9325,7765,0.7831568330811901,4622500,98307225,93684725
826000.0,3,3.25,2330,4000,1.0,0,2,2,10,1730,600,1964,2000.0,98144,47.5882,-122.295,2080,4000,1670,0.4175,5428900,16000000,10571100
400000.0,4,2.0,2680,13680,2.0,0,2,3,7,2350,330,1943,0.0,98056,47.4887,-122.19200000000001,1430,11000,11000,0.804093567251462,7182400,187142400,179960000
342000.0,3,2.5,1740,2226,2.0,0,0,2,8,1320,420,2008,0.0,98106,47.525,-122.366,1740,1789,486,0.2183288409703504,3027600,4955076,1927476
475000.0,2,1.75,1320,3420,1.0,0,1,2,7,1080,240,1955,0.0,98199,47.6639,-122.399,2070,6000,2100,0.6140350877192983,1742400,11696400,9954000
1210000.0,4,3.5,3150,5500,2.0,0,0,2,9,3150,0,2014,0.0,98105,47.6644,-122.29299999999999,1550,4200,2350,0.42727272727272725,9922500,30250000,20327500
455000.0,4,3.0,2480,9238,1.0,0,0,4,7,2050,430,1913,0.0,98166,47.4701,-122.36399999999999,1820,12214,6758,0.7315436241610739,6150400,85340644,79190244
850000.0,4,3.0,3330,4000,1.0,0,0,2,8,1790,1540,1958,0.0,98103,47.6559,-122.344,1610,4000,670,0.1675,11088900,16000000,4911100
185000.0,3,1.0,1010,6400,1.0,0,0,2,7,1010,0,1971,0.0,98023,47.3027,-122.376,1820,6500,5390,0.8421875,1020100,40960000,39939900
850000.0,6,3.25,4920,20590,1.0,0,3,3,9,2730,2190,1960,0.0,98118,47.5468,-122.26700000000001,3700,14994,15670,0.7610490529383196,24206400,423948100,399741700
239900.0,4,1.75,1570,18730,1.0,0,0,2,7,1200,370,1960,0.0,98198,47.3999,-122.301,1920,18295,17160,0.9161772557394554,2464900,350812900,348348000
765000.0,5,3.75,3580,14275,2.0,0,0,2,10,3190,390,1999,0.0,98027,47.5322,-122.056,2740,14300,10695,0.7492119089316988,12816400,203775625,190959225
437000.0,3,1.75,2220,17568,1.0,0,0,3,8,2220,0,1967,0.0,98072,47.748999999999995,-122.083,2070,11745,15348,0.8736338797814208,4928400,308634624,303706224
240000.0,3,1.5,1010,10350,1.0,0,0,2,7,1010,0,1969,0.0,98032,47.379,-122.29,1640,7700,9340,0.9024154589371981,1020100,107122500,106102400
395000.0,2,1.0,1440,7808,1.0,0,0,3,7,860,580,1949,0.0,98133,47.7431,-122.336,1550,7682,6368,0.8155737704918032,2073600,60964864,58891264
320000.0,3,1.0,1230,7492,1.0,0,0,2,7,1230,0,1955,0.0,98155,47.7633,-122.315,1710,7238,6262,0.8358248798718633,1512900,56130064,54617164
525000.0,3,1.75,1710,7350,1.0,0,0,2,8,1280,430,1981,0.0,98033,47.699,-122.167,2100,7560,5640,0.7673469387755102,2924100,54022500,51098400
260000.0,3,3.0,2390,8993,2.0,0,0,2,8,1680,710,1988,0.0,98003,47.3532,-122.306,1820,10362,6603,0.7342377404648059,5712100,80874049,75161949
450000.0,3,2.75,2840,39324,1.0,0,0,2,9,2200,640,1988,0.0,98092,47.3076,-122.101,2840,39413,36484,0.9277794730953107,8065600,1546376976,1538311376
560000.0,4,2.5,2300,7989,2.0,0,0,2,9,2300,0,1990,0.0,98074,47.6273,-122.03399999999999,2280,8835,5689,0.7121041431968957,5290000,63824121,58534121
310000.0,5,3.0,2270,5001,1.0,0,0,2,7,1360,910,1989,0.0,98108,47.5539,-122.3,1950,5500,2731,0.5460907818436312,5152900,25010001,19857101
440000.0,3,2.5,2290,6302,2.0,0,0,2,9,2290,0,1997,0.0,98058,47.435,-122.10700000000001,2700,7500,4012,0.6366232941923199,5244100,39715204,34471104
458450.0,4,1.0,1330,9715,1.0,0,0,3,7,970,360,1957,0.0,98008,47.6038,-122.12200000000001,1590,8400,8385,0.863098301595471,1768900,94381225,92612325
200000.0,3,1.0,1200,10703,1.5,0,0,1,7,1200,0,1918,0.0,98118,47.5209,-122.28,1380,8068,9503,0.8878819022703914,1440000,114554209,113114209
430000.0,3,2.25,2160,6527,2.0,0,0,3,7,1580,580,1987,0.0,98034,47.7292,-122.212,1950,9675,4367,0.669066952658189,4665600,42601729,37936129
360000.0,3,1.0,1120,10500,1.0,0,0,3,7,1120,0,1966,0.0,98034,47.7267,-122.226,1320,10500,9380,0.8933333333333333,1254400,110250000,108995600
311000.0,4,2.5,2090,11645,1.0,0,0,2,7,1200,890,1962,0.0,98168,47.4759,-122.29899999999999,1450,9481,9555,0.8205238299699442,4368100,135606025,131237925
615000.0,3,3.25,1470,1152,3.0,0,0,2,8,1470,0,2003,0.0,98103,47.6516,-122.337,1470,1506,-318,-0.2760416666666667,2160900,1327104,-833796
575000.0,3,1.75,2270,10136,2.0,0,0,2,8,2270,0,1979,0.0,98027,47.535,-122.056,2260,9600,7866,0.7760457774269929,5152900,102738496,97585596
2030000.0,4,3.75,4100,22798,1.5,0,3,4,11,2540,1560,1934,1979.0,98040,47.5648,-122.21,3880,18730,18698,0.8201596631283445,16810000,519748804,502938804
430000.0,3,1.75,1440,4025,1.0,0,0,3,6,720,720,1917,0.0,98126,47.567,-122.38,1500,5750,2585,0.6422360248447205,2073600,16200625,14127025
400000.0,3,1.5,1200,4800,1.0,0,0,3,7,1200,0,1962,0.0,98007,47.6084,-122.13600000000001,1510,7668,3600,0.75,1440000,23040000,21600000
340000.0,3,1.75,1720,10710,1.0,0,0,2,7,860,860,1957,0.0,98146,47.5092,-122.36200000000001,1480,10359,8990,0.8394024276377218,2958400,114704100,111745700
351000.0,1,0.75,930,6600,1.0,0,0,2,6,930,0,1924,0.0,98125,47.7127,-122.296,1590,6600,5670,0.8590909090909091,864900,43560000,42695100
440000.0,4,2.5,2400,8038,2.0,0,0,2,8,2400,0,2002,0.0,98059,47.4881,-122.14299999999999,2040,7756,5638,0.7014182632495646,5760000,64609444,58849444
298000.0,4,2.5,1960,11798,2.0,0,0,2,8,1960,0,1999,0.0,98092,47.3293,-122.205,2360,11785,9838,0.8338701474826242,3841600,139192804,135351204
300000.0,4,1.75,1890,9205,1.0,0,0,2,8,1260,630,1964,0.0,98133,47.773999999999994,-122.348,1430,6775,7315,0.7946768060836502,3572100,84732025,81159925
310000.0,3,2.25,1590,3056,2.0,0,0,2,7,1590,0,2001,0.0,98108,47.5432,-122.29299999999999,1540,2890,1466,0.47971204188481675,2528100,9339136,6811036
500000.0,4,2.5,2590,9354,2.0,0,0,3,9,2590,0,1993,0.0,98011,47.7703,-122.193,2730,9264,6764,0.7231131066923241,6708100,87497316,80789216
399900.0,3,1.0,860,1664,1.5,0,0,2,7,860,0,1927,0.0,98117,47.6761,-122.384,1540,4080,804,0.4831730769230769,739600,2768896,2029296
343000.0,3,2.5,1270,2509,2.0,0,0,2,8,1270,0,2004,0.0,98106,47.5357,-122.365,1420,2206,1239,0.4938222399362296,1612900,6295081,4682181
415000.0,2,2.25,1130,2191,2.0,0,0,2,8,1130,0,2010,0.0,98052,47.6861,-122.103,1140,1710,1061,0.4842537654039252,1276900,4800481,3523581
410000.0,3,2.5,1860,15457,2.0,0,0,2,8,1860,0,1997,0.0,98019,47.7383,-121.955,2040,14055,13597,0.8796661706670117,3459600,238918849,235459249
320000.0,2,1.0,1802,11225,1.0,0,0,2,7,1802,0,1961,0.0,98125,47.7205,-122.323,1810,7332,9423,0.8394654788418708,3247204,126000625,122753421
1990000.0,5,3.0,4480,5000,2.5,0,0,4,12,3420,1060,1902,0.0,98112,47.6275,-122.315,3220,5600,520,0.104,20070400,25000000,4929600
253000.0,2,1.0,1310,7128,1.0,0,0,3,7,940,370,1980,0.0,98031,47.3958,-122.189,1400,7161,5818,0.8162177328843996,1716100,50808384,49092284
630000.0,3,2.5,2320,32772,2.0,0,0,2,9,2320,0,1992,0.0,98053,47.6304,-121.988,2610,33305,30452,0.9292078603686074,5382400,1074003984,1068621584
216000.0,2,1.0,1130,12500,1.0,0,0,3,7,1130,0,1953,0.0,98055,47.4514,-122.18700000000001,1270,10798,11370,0.9096,1276900,156250000,154973100
540000.0,3,2.5,2180,11100,1.0,0,0,2,8,1230,950,1983,0.0,98052,47.717,-122.101,1930,12000,8920,0.8036036036036036,4752400,123210000,118457600
212000.0,3,1.5,1830,12233,1.5,0,0,3,5,1830,0,1930,0.0,98022,47.2057,-122.00299999999999,1520,12233,10403,0.8504046431782882,3348900,149646289,146297389
300000.0,3,2.75,2340,12282,1.0,0,2,2,8,1470,870,1978,0.0,98155,47.7379,-122.289,2640,8887,9942,0.8094772838299951,5475600,150847524,145371924
969950.0,3,2.5,2830,3750,3.0,0,0,2,10,2830,0,2014,0.0,98117,47.6798,-122.385,1780,5100,920,0.24533333333333332,8008900,14062500,6053600
715000.0,3,1.0,1610,7680,1.0,0,0,2,6,900,710,1956,0.0,98122,47.6038,-122.303,1940,2880,6070,0.7903645833333334,2592100,58982400,56390300
1320000.0,5,2.75,2410,19447,2.0,0,2,2,10,2290,120,1968,0.0,98040,47.5549,-122.211,2980,19447,17037,0.8760734303491541,5808100,378185809,372377709
1440000.0,4,2.75,2660,9547,1.0,0,1,2,8,1930,730,1968,2006.0,98004,47.61600000000001,-122.21799999999999,2410,10001,6887,0.7213784434901016,7075600,91145209,84069609
305000.0,3,1.0,1030,5350,1.0,0,0,2,7,1030,0,1924,2009.0,98055,47.4905,-122.206,1030,5250,4320,0.8074766355140187,1060900,28622500,27561600
458000.0,3,4.0,1390,1569,2.0,0,0,2,9,1150,240,2006,0.0,98105,47.67100000000001,-122.26899999999999,1620,1855,179,0.11408540471637986,1932100,2461761,529661
275000.0,3,1.75,1580,8775,1.0,0,0,2,6,1220,360,1942,0.0,98146,47.4845,-122.335,1180,8775,7195,0.81994301994302,2496400,77000625,74504225
550000.0,3,2.75,2330,4780,2.0,0,3,2,8,1730,600,1930,1988.0,98198,47.3459,-122.32600000000001,1100,5336,2450,0.5125523012552301,5428900,22848400,17419500
742000.0,3,3.25,1540,704,3.0,0,0,2,9,1540,0,2011,0.0,98122,47.6177,-122.30799999999999,1540,1456,-836,-1.1875,2371600,495616,-1875984
700000.0,3,1.0,1570,4000,2.0,0,0,4,8,1570,0,1908,0.0,98103,47.6575,-122.346,1640,4000,2430,0.6075,2464900,16000000,13535100
640000.0,4,3.0,2940,5763,1.0,0,0,4,8,1640,1300,1955,0.0,98108,47.5589,-122.295,2020,7320,2823,0.4898490369599167,8643600,33212169,24568569
352000.0,3,0.75,1240,7200,1.0,0,0,2,7,1240,0,1947,0.0,98133,47.7298,-122.34200000000001,1210,7200,5960,0.8277777777777777,1537600,51840000,50302400
301500.0,3,1.0,1410,7419,1.0,0,0,2,7,1050,360,1969,0.0,98056,47.534,-122.17299999999999,1800,8000,6009,0.8099474322684997,1988100,55041561,53053461
630000.0,4,2.5,2190,9880,1.0,0,0,3,8,1410,780,1979,0.0,98033,47.6926,-122.186,2190,9198,7690,0.77834008097166,4796100,97614400,92818300
340000.0,3,2.5,3040,6255,2.0,0,0,2,7,3040,0,1999,0.0,98030,47.3817,-122.206,2670,6259,3215,0.5139888089528377,9241600,39125025,29883425
477500.0,4,1.75,1860,9364,1.0,0,0,2,7,1080,780,1953,0.0,98125,47.731,-122.301,1800,9364,7504,0.8013669372063221,3459600,87684496,84224896
285000.0,3,2.5,1690,7460,1.0,0,0,2,7,870,820,1997,0.0,98146,47.4964,-122.353,1900,7302,5770,0.7734584450402144,2856100,55651600,52795500
255000.0,3,2.75,1900,16117,1.0,0,0,3,7,1900,0,1958,0.0,98001,47.3144,-122.27799999999999,1640,19166,14217,0.8821120555934727,3610000,259757689,256147689
315000.0,3,2.5,1600,7982,2.0,0,0,2,8,1600,0,1993,0.0,98001,47.3397,-122.266,1890,9830,6382,0.7995489852167377,2560000,63712324,61152324
830000.0,6,3.0,2530,9000,1.0,0,0,2,6,2530,0,1978,0.0,98033,47.6716,-122.199,1886,6000,6470,0.7188888888888889,6400900,81000000,74599100
539950.0,3,2.25,1860,1558,3.0,0,0,2,8,1860,0,2014,0.0,98103,47.7006,-122.339,1760,2456,-302,-0.19383825417201542,3459600,2427364,-1032236
980000.0,3,2.25,2390,4590,2.0,0,0,2,8,2090,300,1941,1998.0,98105,47.6615,-122.27600000000001,2280,5179,2200,0.4793028322440087,5712100,21068100,15356000
735000.0,4,2.5,3100,8529,2.0,0,0,2,9,3100,0,1990,0.0,98074,47.6252,-122.029,2710,8344,5429,0.6365341775120178,9610000,72743841,63133841
536000.0,5,2.25,2650,9140,1.0,0,1,2,8,1350,1300,1965,0.0,98177,47.7772,-122.387,2700,7800,6490,0.7100656455142232,7022500,83539600,76517100
575000.0,3,2.0,1520,5000,1.5,0,0,2,7,1140,380,1945,0.0,98107,47.6733,-122.389,1530,4650,3480,0.696,2310400,25000000,22689600
500000.0,2,1.0,1510,4000,1.0,0,0,2,6,930,580,1924,0.0,98117,47.6917,-122.38,1300,4000,2490,0.6225,2280100,16000000,13719900
285500.0,4,1.75,1960,7950,1.0,0,0,3,8,1960,0,1967,0.0,98023,47.3109,-122.37700000000001,1960,8400,5990,0.7534591194968554,3841600,63202500,59360900
498000.0,4,2.75,2270,7375,1.0,0,0,3,7,1290,980,1973,0.0,98034,47.7222,-122.16799999999999,1750,7760,5105,0.6922033898305084,5152900,54390625,49237725
412000.0,2,1.0,910,6282,1.0,0,0,3,7,910,0,1939,0.0,98103,47.6967,-122.354,970,6281,5372,0.8551416746259153,828100,39463524,38635424
607000.0,4,2.5,2100,8220,1.0,0,0,3,8,1300,800,1975,0.0,98052,47.6733,-122.145,2160,8348,6120,0.7445255474452555,4410000,67568400,63158400
199000.0,3,1.0,1000,8512,1.0,0,0,2,6,1000,0,1991,0.0,98022,47.2151,-121.993,1490,10395,7512,0.8825187969924813,1000000,72454144,71454144
492500.0,4,2.75,2760,18306,1.0,0,0,2,7,1630,1130,1978,0.0,98034,47.7302,-122.215,2470,9856,15546,0.8492297607341855,7617600,335109636,327492036
585000.0,4,2.5,2840,11044,2.0,0,0,2,8,2840,0,2001,0.0,98034,47.7134,-122.23700000000001,1934,9605,8204,0.7428467946396233,8065600,121969936,113904336
326995.0,3,2.5,1860,5321,2.0,0,0,2,7,1860,0,2000,0.0,98038,47.3848,-122.03299999999999,1940,5205,3461,0.6504416463070851,3459600,28313041,24853441
372500.0,4,2.25,1920,9660,1.0,0,0,3,8,1920,0,1968,0.0,98058,47.4544,-122.14299999999999,1890,7800,7740,0.8012422360248447,3686400,93315600,89629200
528000.0,2,0.75,840,40642,1.0,1,4,3,6,840,0,1937,0.0,98070,47.403999999999996,-122.447,1850,64069,39802,0.9793317258008957,705600,1651772164,1651066564
400000.0,3,1.5,2390,32109,1.0,0,0,2,7,2390,0,1975,0.0,98092,47.3028,-122.102,1370,32109,29719,0.9255660406739543,5712100,1030987881,1025275781
344000.0,4,2.5,2100,8501,2.0,0,0,4,7,2100,0,1993,0.0,98022,47.1951,-122.01,2130,8560,6401,0.7529702387954358,4410000,72267001,67857001
409950.0,4,3.0,2430,7163,2.0,0,0,2,8,2430,0,2003,0.0,98038,47.3558,-122.01299999999999,2430,6028,4733,0.6607566662013123,5904900,51308569,45403669
625000.0,3,2.0,1880,4000,1.0,0,2,2,8,1280,600,1950,0.0,98199,47.6375,-122.391,1920,4000,2120,0.53,3534400,16000000,12465600
304950.0,3,1.75,1350,9000,1.0,0,0,2,7,1350,0,1987,0.0,98045,47.4487,-121.773,1370,9500,7650,0.85,1822500,81000000,79177500
381500.0,2,2.0,2160,35183,1.0,0,0,2,9,2160,0,1985,0.0,98092,47.312,-122.115,2450,34992,33023,0.9386067134695734,4665600,1237843489,1233177889
215000.0,3,1.75,1430,13399,1.0,0,0,3,7,900,530,1946,0.0,98168,47.4787,-122.275,1720,6415,11969,0.8932756175834018,2044900,179533201,177488301
345000.0,5,1.75,2840,12870,2.0,0,2,3,7,2840,0,1925,0.0,98178,47.4961,-122.235,2170,9612,10030,0.7793317793317793,8065600,165636900,157571300
363000.0,3,0.75,2510,20000,2.0,0,0,3,7,2510,0,1961,0.0,98001,47.2871,-122.287,2130,20000,17490,0.8745,6300100,400000000,393699900
240000.0,3,1.0,1690,20063,1.5,0,0,3,7,1690,0,1913,0.0,98001,47.3556,-122.294,1700,15899,18373,0.915765339181578,2856100,402523969,399667869
548050.0,2,2.0,1930,5479,1.0,0,0,2,8,1930,0,2005,0.0,98053,47.7054,-122.01100000000001,1900,5479,3549,0.6477459390399708,3724900,30019441,26294541
314000.0,2,1.0,720,4920,1.0,0,0,2,6,720,0,1941,0.0,98126,47.5352,-122.37100000000001,670,4920,4200,0.8536585365853658,518400,24206400,23688000
800000.0,4,2.5,2990,16809,2.0,0,0,2,11,2990,0,1990,0.0,98077,47.7123,-122.073,3340,18752,13819,0.8221191028615623,8940100,282542481,273602381
400000.0,5,1.75,2300,6720,2.0,0,0,2,7,2300,0,1905,0.0,98108,47.528,-122.32,1200,6000,4420,0.6577380952380952,5290000,45158400,39868400
247000.0,1,1.0,460,4120,1.0,0,0,2,4,460,0,1937,0.0,98055,47.4868,-122.199,990,4120,3660,0.8883495145631068,211600,16974400,16762800
540000.0,2,1.75,1240,4120,1.0,0,0,3,7,890,350,1906,0.0,98105,47.6689,-122.314,1640,3740,2880,0.6990291262135923,1537600,16974400,15436800
410000.0,4,2.5,1900,15123,2.0,0,0,2,8,1900,0,1995,0.0,98045,47.5015,-121.772,1900,16477,13223,0.8743635522052503,3610000,228705129,225095129
525000.0,3,1.75,2120,9146,1.0,0,0,2,8,1260,860,1981,0.0,98074,47.6475,-122.064,2040,10485,7026,0.7682046796413733,4494400,83649316,79154916
820000.0,4,2.5,2440,5737,2.0,0,0,3,8,1700,740,1929,0.0,98119,47.6472,-122.367,2020,5543,3297,0.5746906048457382,5953600,32913169,26959569
1250000.0,4,2.25,3300,15375,1.5,0,3,2,8,2820,480,1933,1984.0,98040,47.526,-122.225,3250,15375,12075,0.7853658536585366,10890000,236390625,225500625
244000.0,2,1.0,1180,10200,1.0,0,0,3,7,1180,0,1955,0.0,98148,47.4358,-122.336,1330,10200,9020,0.884313725490196,1392400,104040000,102647600
275000.0,1,1.0,520,4800,1.0,0,0,2,5,520,0,1930,0.0,98106,47.5533,-122.363,800,4960,4280,0.8916666666666667,270400,23040000,22769600
577000.0,2,1.75,2070,23160,1.0,0,0,2,7,1260,810,1946,0.0,98199,47.6551,-122.39399999999999,1690,5458,21090,0.9106217616580311,4284900,536385600,532100700
446950.0,5,2.5,2250,7945,1.0,0,0,3,7,1360,890,1977,0.0,98034,47.7316,-122.221,1820,7866,5695,0.7168030207677785,5062500,63123025,58060525
457000.0,3,2.5,2050,5694,2.0,0,2,2,8,2050,0,2004,0.0,98065,47.5331,-121.855,2680,7187,3644,0.6399719002458728,4202500,32421636,28219136
320000.0,4,1.5,1310,137214,1.5,0,0,3,7,1310,0,1926,0.0,98198,47.361999999999995,-122.316,1310,9450,135904,0.990452869240748,1716100,18827681796,18825965696
210000.0,3,1.5,1250,9484,1.0,0,0,3,7,1250,0,1969,0.0,98042,47.3675,-122.147,1320,9600,8234,0.8681990721214677,1562500,89946256,88383756
220000.0,4,2.5,2130,9100,1.0,0,0,2,8,1290,840,1978,0.0,98030,47.3815,-122.169,1770,7700,6970,0.765934065934066,4536900,82810000,78273100
589000.0,3,2.0,2250,8800,1.0,0,0,3,7,1250,1000,1925,0.0,98116,47.5737,-122.40899999999999,2250,4800,6550,0.7443181818181818,5062500,77440000,72377500
435000.0,4,2.0,1880,3840,1.0,0,0,2,7,970,910,1904,0.0,98144,47.5929,-122.303,1670,1820,1960,0.5104166666666666,3534400,14745600,11211200
375000.0,3,1.0,1520,10798,1.0,0,0,2,7,1520,0,1953,0.0,98028,47.7635,-122.262,1670,9876,9278,0.8592331913317282,2310400,116596804,114286404
1740000.0,4,3.5,4010,9654,2.0,0,0,2,10,4010,0,2007,0.0,98004,47.5891,-122.2,1870,9873,5644,0.5846281334162006,16080100,93199716,77119616
545000.0,2,1.75,1660,5581,1.0,0,0,2,8,1660,0,2005,0.0,98053,47.713,-122.03299999999999,1670,4871,3921,0.7025622648270919,2755600,31147561,28391961
970000.0,3,2.25,3400,10000,2.0,0,0,2,10,3400,0,1983,0.0,98115,47.6846,-122.28399999999999,1860,5100,6600,0.66,11560000,100000000,88440000
705000.0,2,1.75,2320,6755,1.0,0,0,4,8,1380,940,1946,0.0,98199,47.6398,-122.40299999999999,1990,5000,4435,0.6565507031828275,5382400,45630025,40247625
915557.0,5,3.25,3740,11536,2.0,0,0,3,9,2540,1200,1984,0.0,98006,47.5599,-122.10799999999999,2920,11258,7796,0.6757975034674064,13987600,133079296,119091696
259000.0,4,1.5,1810,9000,1.5,0,0,2,7,1810,0,1960,0.0,98168,47.4911,-122.322,1520,9780,7190,0.7988888888888889,3276100,81000000,77723900
1700000.0,2,2.25,3170,3000,2.0,0,2,4,10,1990,1180,1900,0.0,98109,47.6291,-122.351,2980,5061,-170,-0.056666666666666664,10048900,9000000,-1048900
427000.0,3,1.75,1680,8610,1.0,0,0,3,7,1290,390,1969,0.0,98034,47.7246,-122.17299999999999,1640,8809,6930,0.8048780487804879,2822400,74132100,71309700
390000.0,2,1.0,930,3100,1.0,0,0,2,6,930,0,1911,0.0,98144,47.5943,-122.302,1670,3800,2170,0.7,864900,9610000,8745100
363000.0,3,2.5,2390,8000,2.0,0,0,2,8,2390,0,1995,0.0,98042,47.3895,-122.154,2070,7585,5610,0.70125,5712100,64000000,58287900
612000.0,4,2.5,2680,3626,1.5,0,3,3,7,1680,1000,1928,0.0,98107,47.6727,-122.361,1950,4500,946,0.2608935466078323,7182400,13147876,5965476
380000.0,4,1.75,1790,10186,1.0,0,0,3,8,1790,0,1965,0.0,98177,47.7769,-122.376,1790,9142,8396,0.8242686039662281,3204100,103754596,100550496
230000.0,4,3.0,1680,6003,1.0,0,0,2,7,1150,530,1997,0.0,98002,47.2885,-122.21799999999999,1820,6207,4323,0.7201399300349826,2822400,36036009,33213609
580000.0,3,1.75,1570,2600,1.5,0,0,3,8,1570,0,1931,0.0,98117,47.6867,-122.37,1490,4000,1030,0.39615384615384613,2464900,6760000,4295100
770000.0,3,1.0,2230,3200,2.0,0,2,2,8,1630,600,1918,0.0,98109,47.6334,-122.35600000000001,2280,5400,970,0.303125,4972900,10240000,5267100
207200.0,4,2.0,1260,8400,1.0,0,0,2,6,1260,0,1991,0.0,98022,47.1946,-122.0,1120,8400,7140,0.85,1587600,70560000,68972400
525000.0,3,2.0,1790,11430,1.0,0,0,2,7,1190,600,1985,0.0,98074,47.6319,-122.035,1700,12114,9640,0.8433945756780402,3204100,130644900,127440800
925000.0,3,2.5,2440,7419,1.0,0,0,2,7,1520,920,1961,0.0,98103,47.6857,-122.334,2440,4880,4979,0.6711147054859146,5953600,55041561,49087961
883000.0,4,2.25,2410,4000,2.0,0,0,4,8,1650,760,1910,0.0,98115,47.6727,-122.316,1820,4000,1590,0.3975,5808100,16000000,10191900
455000.0,4,2.5,1780,2992,2.0,0,0,2,7,1780,0,2003,0.0,98072,47.7633,-122.149,1610,2961,1212,0.4050802139037433,3168400,8952064,5783664
343500.0,3,2.5,1900,5194,2.0,0,0,2,7,1900,0,2004,0.0,98058,47.4391,-122.117,2230,5194,3294,0.634193299961494,3610000,26977636,23367636
244000.0,2,1.0,960,8450,1.0,0,0,4,6,960,0,1950,0.0,98155,47.755,-122.316,1090,8450,7490,0.8863905325443787,921600,71402500,70480900
397000.0,3,1.75,1640,11730,1.0,0,0,4,7,1640,0,1967,0.0,98034,47.7351,-122.189,1640,7770,10090,0.8601875532821824,2689600,137592900,134903300
180500.0,2,1.0,850,5000,1.0,0,0,2,6,850,0,1976,0.0,98198,47.3817,-122.314,1160,5000,4150,0.83,722500,25000000,24277500
310000.0,3,2.75,2150,6576,1.0,0,0,3,7,1900,250,1926,0.0,98155,47.7539,-122.30799999999999,2150,9071,4426,0.6730535279805353,4622500,43243776,38621276
315000.0,4,2.5,2780,3969,2.0,0,0,2,7,2780,0,2005,0.0,98042,47.3992,-122.164,2260,4160,1189,0.29957168052406147,7728400,15752961,8024561
718000.0,3,1.0,1030,4958,1.0,0,0,4,7,1030,0,1952,0.0,98105,47.6647,-122.277,2230,6987,3928,0.7922549415086728,1060900,24581764,23520864
279950.0,3,1.75,1930,7267,1.0,0,0,3,7,1330,600,1977,0.0,98002,47.3217,-122.205,1600,7698,5337,0.734415852483831,3724900,52809289,49084389
689000.0,3,2.5,2080,9612,1.0,0,3,3,8,1700,380,1940,0.0,98125,47.7293,-122.28299999999999,2560,10202,7532,0.7836038285476488,4326400,92390544,88064144
828000.0,4,2.5,3520,9901,2.0,0,0,2,10,3520,0,1998,0.0,98074,47.6084,-122.01100000000001,3490,9667,6381,0.6444803555196444,12390400,98029801,85639401
150000.0,2,1.0,890,8100,1.0,0,0,2,6,890,0,1942,0.0,98146,47.4839,-122.34,1260,8100,7210,0.8901234567901235,792100,65610000,64817900
505400.0,3,1.75,1640,3400,1.0,0,0,3,7,930,710,1926,0.0,98105,47.6694,-122.3,1380,3750,1760,0.5176470588235295,2689600,11560000,8870400
1680000.0,5,3.25,4860,23723,2.0,0,2,3,11,3820,1040,1989,0.0,98040,47.5767,-122.215,4040,13860,18863,0.795135522488724,23619600,562780729,539161129
217450.0,3,1.0,1040,5000,1.0,0,0,2,7,1040,0,1959,0.0,98146,47.5122,-122.35799999999999,1440,5000,3960,0.792,1081600,25000000,23918400
677000.0,4,2.5,2820,4174,2.0,0,0,2,9,2820,0,2004,0.0,98034,47.7112,-122.226,2560,4853,1354,0.3243890752275994,7952400,17422276,9469876
361000.0,2,2.5,1320,48787,1.0,0,0,2,8,1320,0,2004,0.0,98027,47.5157,-121.92399999999999,1830,155073,47467,0.9729436120277943,1742400,2380171369,2378428969
620000.0,3,2.5,2590,7237,2.0,0,0,2,8,2590,0,2004,0.0,98125,47.7113,-122.309,1670,7648,4647,0.6421168992676524,6708100,52374169,45666069
176000.0,3,2.25,1540,5449,1.0,0,0,1,7,1180,360,1989,0.0,98023,47.29,-122.35799999999999,1460,6740,3909,0.7173793356579189,2371600,29691601,27320001
330000.0,3,1.0,960,7218,1.0,0,0,3,7,960,0,1969,0.0,98034,47.7278,-122.226,1580,9104,6258,0.8669991687448046,921600,52099524,51177924
290000.0,3,2.5,1190,8175,1.0,0,0,2,7,1190,0,1986,0.0,98055,47.4556,-122.20299999999999,2230,9520,6985,0.854434250764526,1416100,66830625,65414525
711000.0,4,2.5,2770,9532,2.0,0,0,3,9,2770,0,1988,0.0,98029,47.5688,-122.012,2770,9219,6762,0.7093999160721779,7672900,90859024,83186124
295000.0,3,1.75,1060,8100,2.0,0,0,3,7,1060,0,1983,0.0,98038,47.3617,-122.04700000000001,1410,8100,7040,0.8691358024691358,1123600,65610000,64486400
1100000.0,5,3.25,4010,12110,2.0,0,0,2,11,4010,0,2003,0.0,98059,47.5228,-122.15100000000001,4010,12334,8100,0.6688687035507844,16080100,146652100,130572000
257500.0,3,2.0,1140,7078,1.0,0,0,3,7,1140,0,1991,0.0,98031,47.4057,-122.185,1460,7078,5938,0.8389375529810681,1299600,50098084,48798484
240000.0,4,1.0,1910,16320,1.5,0,0,2,6,1910,0,1934,0.0,98106,47.5151,-122.366,1380,9000,14410,0.8829656862745098,3648100,266342400,262694300
645000.0,4,2.5,2340,8955,2.0,0,0,2,9,2340,0,1990,0.0,98074,47.6283,-122.02600000000001,2340,8955,6615,0.7386934673366834,5475600,80192025,74716425
499000.0,2,1.75,1170,2400,1.0,0,0,3,7,740,430,1903,0.0,98103,47.6653,-122.333,1570,3919,1230,0.5125,1368900,5760000,4391100
321000.0,3,1.0,1290,9526,1.5,0,0,2,7,1290,0,1961,0.0,98034,47.7111,-122.213,1290,9508,8236,0.8645811463363426,1664100,90744676,89080576
449000.0,3,2.5,1810,1658,3.0,0,0,2,8,1810,0,1998,0.0,98117,47.6955,-122.376,1470,1585,-152,-0.09167671893848009,3276100,2748964,-527136
515000.0,3,2.5,1820,5280,1.0,0,0,3,7,910,910,1949,0.0,98117,47.6892,-122.375,1600,4820,3460,0.6553030303030303,3312400,27878400,24566000
456000.0,4,1.5,2220,12385,1.0,0,0,2,8,1270,950,1978,0.0,98033,47.6734,-122.185,2030,8831,10165,0.8207509083568834,4928400,153388225,148459825
865000.0,3,3.75,3830,219106,2.0,0,0,2,9,3830,0,1977,1999.0,98027,47.5432,-121.95200000000001,2440,219106,215276,0.9825198762242933,14668900,48007439236,47992770336
515500.0,4,2.5,2920,7700,2.0,0,0,2,9,2920,0,2003,0.0,98019,47.7351,-121.975,2920,8943,4780,0.6207792207792208,8526400,59290000,50763600
576925.0,4,2.5,2630,6100,2.0,0,0,2,8,2630,0,2004,0.0,98072,47.7735,-122.167,2360,5765,3470,0.5688524590163935,6916900,37210000,30293100
243000.0,3,1.75,1320,10416,1.0,0,0,2,7,1320,0,1996,0.0,98031,47.3902,-122.208,1670,7991,9096,0.8732718894009217,1742400,108493056,106750656
253400.0,3,2.0,1400,8640,1.0,0,0,4,7,1400,0,1968,0.0,98003,47.3182,-122.319,1270,9375,7240,0.8379629629629629,1960000,74649600,72689600
292000.0,3,2.5,1600,3580,2.0,0,0,2,7,1600,0,2000,0.0,98178,47.4939,-122.26100000000001,2020,4327,1980,0.553072625698324,2560000,12816400,10256400
271500.0,3,2.5,1490,8005,1.0,0,0,2,7,1090,400,1976,0.0,98058,47.4359,-122.165,1880,7905,6515,0.8138663335415366,2220100,64080025,61859925
765000.0,2,2.5,2170,6750,1.0,0,0,2,8,2170,0,2012,0.0,98053,47.7115,-122.014,2150,6074,4580,0.6785185185185185,4708900,45562500,40853600
375000.0,3,3.25,1280,1730,2.0,0,0,2,8,1090,190,2005,0.0,98177,47.7032,-122.36,1280,2121,450,0.26011560693641617,1638400,2992900,1354500
382880.0,3,2.0,1620,9566,1.0,0,0,3,7,1620,0,1968,0.0,98059,47.474,-122.146,1660,10011,7946,0.8306502195274932,2624400,91508356,88883956
852500.0,3,2.5,2630,10100,1.0,0,0,3,9,1580,1050,1967,0.0,98006,47.5638,-122.15299999999999,2400,9700,7470,0.7396039603960396,6916900,102010000,95093100
475000.0,3,1.5,1240,8738,1.0,0,0,2,7,1240,0,1959,0.0,98005,47.5849,-122.17,1440,9344,7498,0.8580910963607232,1537600,76352644,74815044
462000.0,3,1.75,1300,2580,1.0,0,0,4,7,820,480,1919,0.0,98115,47.674,-122.319,1180,2820,1280,0.49612403100775193,1690000,6656400,4966400
762400.0,3,1.75,2430,14607,1.0,0,1,2,8,1230,1200,1949,1970.0,98040,47.5588,-122.211,2750,17425,12177,0.833641404805915,5904900,213364449,207459549
330000.0,4,1.5,1890,7540,1.0,0,0,3,7,1890,0,1967,0.0,98155,47.7534,-122.318,1890,8515,5650,0.7493368700265252,3572100,56851600,53279500
473000.0,3,2.25,1890,12236,1.0,0,0,2,8,1890,0,1978,0.0,98074,47.6232,-122.04700000000001,2390,12323,10346,0.8455377574370709,3572100,149719696,146147596
550000.0,3,1.5,2440,7200,1.0,0,0,2,7,2440,0,1949,0.0,98118,47.5604,-122.274,1920,6900,4760,0.6611111111111111,5953600,51840000,45886400
449500.0,3,2.25,1780,7280,1.0,0,2,2,7,1340,440,1972,0.0,98034,47.723,-122.215,2060,7280,5500,0.7554945054945055,3168400,52998400,49830000
744000.0,4,2.75,2830,13059,2.0,0,0,2,10,2830,0,1998,0.0,98075,47.595,-121.986,3840,11596,10229,0.7832912167853587,8008900,170537481,162528581
700000.0,4,2.0,2490,4700,1.0,0,0,3,7,1690,800,1952,0.0,98136,47.5254,-122.39200000000001,2240,5000,2210,0.4702127659574468,6200100,22090000,15889900
511100.0,4,2.5,1560,12220,1.5,0,0,3,7,1560,0,1965,0.0,98027,47.5287,-122.053,1920,12220,10660,0.8723404255319149,2433600,149328400,146894800
317950.0,3,2.5,1980,4500,2.0,0,0,2,7,1980,0,2012,0.0,98042,47.3671,-122.113,2200,4500,2520,0.56,3920400,20250000,16329600
542950.0,3,2.5,2070,39768,2.0,0,0,2,8,2070,0,1988,0.0,98077,47.7696,-122.036,2740,44866,37698,0.9479480989740495,4284900,1581493824,1577208924
490000.0,3,1.75,1490,11360,1.0,0,0,2,8,1490,0,1975,0.0,98008,47.5896,-122.12,2350,10320,9870,0.8688380281690141,2220100,129049600,126829500
760000.0,4,3.5,3090,4060,2.0,0,0,2,8,2420,670,1992,0.0,98144,47.5733,-122.287,1720,4080,970,0.23891625615763548,9548100,16483600,6935500
475000.0,3,2.25,1580,8659,1.0,0,0,3,7,1220,360,1961,0.0,98011,47.7599,-122.215,1970,9650,7079,0.8175308927127843,2496400,74978281,72481881
1700000.0,5,4.5,5190,23716,2.0,0,2,2,11,3390,1800,1987,2000.0,98040,47.5846,-122.223,4460,22748,18526,0.7811603980435149,26936100,562448656,535512556
435000.0,3,2.75,2692,6197,2.0,0,0,2,9,2692,0,2007,0.0,98030,47.3569,-122.20200000000001,2336,5700,3505,0.5655962562530257,7246864,38402809,31155945
399000.0,3,2.5,1740,3690,2.0,0,0,2,8,1740,0,2000,0.0,98065,47.5345,-121.867,2100,4944,1950,0.5284552845528455,3027600,13616100,10588500
627000.0,3,2.0,1940,3800,1.0,0,0,3,7,1050,890,1927,0.0,98115,47.6842,-122.309,1700,3800,1860,0.48947368421052634,3763600,14440000,10676400
346500.0,4,2.5,2150,5100,1.5,0,0,2,7,1290,860,1991,0.0,98106,47.5338,-122.36,1920,5100,2950,0.5784313725490197,4622500,26010000,21387500
412000.0,3,1.5,1320,8000,1.0,0,0,2,7,1320,0,1957,0.0,98008,47.6027,-122.12200000000001,1720,8100,6680,0.835,1742400,64000000,62257600
845000.0,4,2.5,3360,40471,2.0,0,0,3,10,3360,0,1994,0.0,98077,47.742,-122.035,3150,36823,37111,0.9169775888908107,11289600,1637901841,1626612241
373000.0,3,1.75,1850,9655,1.0,0,0,2,7,1100,750,1959,0.0,98155,47.7358,-122.319,1480,8683,7805,0.8083894355256344,3422500,93219025,89796525
725000.0,4,2.25,2880,8882,2.0,0,0,3,8,2480,400,1965,0.0,98115,47.6999,-122.28399999999999,2460,9610,6002,0.675748705246566,8294400,78889924,70595524
376000.0,6,2.5,2420,11662,1.0,0,2,3,7,1420,1000,1965,0.0,98188,47.4459,-122.27799999999999,1630,11662,9242,0.7924884239410049,5856400,136002244,130145844
552500.0,3,1.0,2020,4120,1.5,0,0,3,7,1520,500,1929,0.0,98118,47.5514,-122.271,1200,4635,2100,0.5097087378640777,4080400,16974400,12894000
365000.0,5,2.0,2280,19000,1.5,0,0,2,6,2280,0,1924,0.0,98166,47.4683,-122.359,1790,11800,16720,0.88,5198400,361000000,355801600
700000.0,4,2.5,3010,46173,2.0,0,0,2,9,3010,0,1996,0.0,98053,47.6471,-121.964,2590,49222,43163,0.9348103870227189,9060100,2131945929,2122885829
315000.0,4,2.25,2550,9736,1.0,0,0,3,8,2550,0,1967,0.0,98002,47.3193,-122.212,1770,9686,7186,0.7380854560394412,6502500,94789696,88287196
262500.0,4,2.0,1540,5110,1.0,0,0,2,7,1540,0,1957,0.0,98118,47.5164,-122.26799999999999,1540,5110,3570,0.6986301369863014,2371600,26112100,23740500
660000.0,3,2.25,2280,6150,2.0,0,2,2,8,2280,0,1984,0.0,98136,47.5423,-122.385,1920,6150,3870,0.6292682926829268,5198400,37822500,32624100
340000.0,4,2.5,2450,6941,2.0,0,0,2,7,2450,0,2006,0.0,98042,47.4006,-122.162,3300,6941,4491,0.6470249243624838,6002500,48177481,42174981
660500.0,5,2.5,2950,5500,1.5,0,0,4,7,1720,1230,1918,0.0,98144,47.5785,-122.29299999999999,2200,5000,2550,0.4636363636363636,8702500,30250000,21547500
280000.0,1,1.0,690,1950,1.0,0,0,2,6,690,0,1928,0.0,98117,47.6849,-122.374,1650,4864,1260,0.6461538461538462,476100,3802500,3326400
267000.0,1,1.0,800,2480,1.0,0,0,3,6,800,0,1919,0.0,98108,47.5581,-122.316,1490,4650,1680,0.6774193548387096,640000,6150400,5510400
230000.0,2,1.0,1470,25661,1.5,0,0,2,4,1470,0,1932,0.0,98059,47.4878,-122.13,1670,43301,24191,0.942714625306886,2160900,658486921,656326021
417000.0,3,2.25,1840,11403,2.0,0,0,2,8,1840,0,1993,0.0,98045,47.4862,-121.79700000000001,2150,11403,9563,0.8386389546610541,3385600,130028409,126642809
252000.0,3,1.0,1170,9730,1.0,0,0,2,7,1170,0,1968,1986.0,98055,47.4562,-122.196,1680,10125,8560,0.8797533401849948,1368900,94672900,93304000
791000.0,5,1.75,2344,4800,1.5,0,0,3,7,1544,800,1921,0.0,98103,47.6537,-122.335,1770,4200,2456,0.5116666666666667,5494336,23040000,17545664
415000.0,1,1.0,1230,3774,1.0,0,0,3,6,830,400,1924,0.0,98103,47.6886,-122.354,1300,3774,2544,0.6740858505564388,1512900,14243076,12730176
339000.0,3,1.75,1150,13278,1.0,0,0,4,7,1150,0,1966,0.0,98053,47.6384,-121.969,1560,12400,12128,0.9133905708691068,1322500,176305284,174982784
158000.0,3,1.0,1140,10477,1.0,0,0,2,6,1140,0,1942,0.0,98168,47.4874,-122.306,1190,9750,9337,0.8911902262097929,1299600,109767529,108467929
535000.0,3,1.0,1660,5100,1.0,0,0,2,7,1260,400,1957,0.0,98136,47.5323,-122.383,1230,5100,3440,0.6745098039215687,2755600,26010000,23254400
818900.0,3,1.0,1080,4120,1.0,0,0,2,7,980,100,1919,0.0,98115,47.6771,-122.319,1280,3090,3040,0.7378640776699029,1166400,16974400,15808000
550000.0,4,2.0,1720,4000,1.0,0,0,2,7,1420,300,1950,0.0,98105,47.6651,-122.285,1350,1281,2280,0.57,2958400,16000000,13041600
240000.0,2,1.0,590,8717,1.0,0,0,2,6,590,0,1953,0.0,98133,47.7343,-122.335,1370,6760,8127,0.9323161638178272,348100,75986089,75637989
590000.0,3,3.25,1290,1230,2.0,0,2,2,9,1090,200,2008,0.0,98119,47.6367,-122.37,1710,1797,-60,-0.04878048780487805,1664100,1512900,-151200
369300.0,3,1.5,1480,21320,1.0,0,0,3,7,1480,0,1967,0.0,98027,47.5234,-122.04299999999999,1850,17825,19840,0.9305816135084428,2190400,454542400,452352000
510000.0,4,2.5,2600,118666,1.0,0,0,2,7,1400,1200,1981,0.0,98027,47.54,-121.97,2440,131116,116066,0.978089764549239,6760000,14081619556,14074859556
542500.0,3,2.5,2040,10086,2.0,0,0,2,8,2040,0,1987,0.0,98052,47.678999999999995,-122.113,1940,10272,8046,0.7977394408090422,4161600,101727396,97565796
262500.0,3,1.0,970,7854,1.0,0,0,3,7,970,0,1980,0.0,98056,47.4899,-122.185,1480,7800,6884,0.8764960529666412,940900,61685316,60744416
900000.0,6,3.0,2620,4350,1.0,0,0,2,7,1760,860,1957,0.0,98117,47.678000000000004,-122.37299999999999,1760,4300,1730,0.39770114942528734,6864400,18922500,12058100
1100000.0,4,3.5,4560,41636,2.0,0,0,2,9,4170,390,1995,0.0,98006,47.5589,-122.116,2990,11381,37076,0.8904793928331252,20793600,1733556496,1712762896
368000.0,3,1.75,1750,14400,1.0,0,0,3,7,1750,0,1951,0.0,98166,47.4535,-122.361,2030,14400,12650,0.8784722222222222,3062500,207360000,204297500
825000.0,4,3.5,3620,6499,2.5,0,0,2,9,3620,0,2003,2009.0,98177,47.7326,-122.36,2330,7200,2879,0.44299122941991076,13104400,42237001,29132601
343500.0,3,2.0,1660,7509,1.0,0,0,2,7,1660,0,2002,0.0,98059,47.4872,-122.14399999999999,2380,8598,5849,0.7789319483286723,2755600,56385081,53629481
273500.0,4,1.0,1360,6000,1.0,0,0,3,6,1020,340,1944,0.0,98168,47.4783,-122.285,1230,6000,4640,0.7733333333333333,1849600,36000000,34150400
1000000.0,3,2.5,2044,5610,2.0,0,0,3,9,2044,0,1996,0.0,98033,47.6791,-122.209,2440,5610,3566,0.635650623885918,4177936,31472100,27294164
770000.0,5,3.0,2370,6000,1.5,0,2,2,8,1340,1030,1926,2003.0,98107,47.6645,-122.35799999999999,1350,4500,3630,0.605,5616900,36000000,30383100
400000.0,3,2.0,1170,3868,1.5,0,0,3,7,1170,0,1925,0.0,98118,47.5543,-122.29,1400,3800,2698,0.6975180972078594,1368900,14961424,13592524
225000.0,3,1.0,1660,7210,1.0,0,0,2,7,1100,560,1963,0.0,98001,47.3394,-122.281,1660,7245,5550,0.7697642163661581,2755600,51984100,49228500
345000.0,4,1.0,2020,18150,1.0,0,0,3,7,2020,0,1955,0.0,98028,47.739,-122.249,1530,11970,16130,0.8887052341597796,4080400,329422500,325342100
450000.0,3,2.5,2530,8116,2.0,0,0,2,8,2530,0,2001,0.0,98011,47.7597,-122.167,2280,8791,5586,0.6882700837851158,6400900,65869456,59468556
334850.0,2,1.0,870,5635,1.0,0,0,2,7,870,0,1948,0.0,98116,47.5676,-122.398,1310,5750,4765,0.8456078083407276,756900,31753225,30996325
605000.0,5,3.0,3670,9600,1.0,0,1,2,8,1980,1690,1955,0.0,98108,47.5648,-122.316,1730,4933,5930,0.6177083333333333,13468900,92160000,78691100
760000.0,5,3.5,3180,14000,2.0,0,0,4,10,3180,0,1997,0.0,98006,47.5501,-122.12799999999999,3670,14450,10820,0.7728571428571429,10112400,196000000,185887600
390000.0,2,1.5,1870,12960,1.5,0,0,3,6,1350,520,1926,0.0,98118,47.5234,-122.288,1380,7800,11090,0.8557098765432098,3496900,167961600,164464700
488000.0,3,2.5,1940,5660,2.0,0,0,2,8,1940,0,2001,0.0,98072,47.7511,-122.17,2110,4581,3720,0.657243816254417,3763600,32035600,28272000
3300000.0,3,3.25,4220,41300,1.0,1,4,3,11,2460,1760,1958,1987.0,98008,47.6083,-122.11,3810,30401,37080,0.897820823244552,17808400,1705690000,1687881600
1060000.0,5,4.5,4820,13165,2.0,0,0,3,11,3950,870,1990,0.0,98077,47.7295,-122.057,3880,13810,8345,0.633877706038739,23232400,173317225,150084825
608000.0,3,2.0,2400,217800,2.0,0,0,2,8,1590,810,1975,0.0,98038,47.4166,-121.94,2340,207781,215400,0.9889807162534435,5760000,47436840000,47431080000
1390000.0,3,2.25,2930,6000,2.0,0,2,2,11,1920,1010,2000,0.0,98112,47.6301,-122.301,1870,5040,3070,0.5116666666666667,8584900,36000000,27415100
299950.0,2,1.0,800,3000,1.0,0,0,2,6,800,0,1904,0.0,98118,47.5602,-122.292,1640,3400,2200,0.7333333333333333,640000,9000000,8360000
818000.0,3,3.25,2200,4800,2.0,0,2,2,7,1910,290,1943,1996.0,98103,47.6551,-122.353,1410,4800,2600,0.5416666666666666,4840000,23040000,18200000
355000.0,3,2.5,2400,9701,1.0,0,0,2,9,2400,0,1990,0.0,98023,47.3081,-122.39200000000001,2400,8258,7301,0.7526028244510875,5760000,94109401,88349401
1860000.0,5,3.25,5570,9600,2.0,0,0,4,9,3860,1710,1952,0.0,98105,47.6708,-122.262,3170,10400,4030,0.4197916666666667,31024900,92160000,61135100
660000.0,3,3.25,1980,2850,3.0,0,0,2,7,1980,0,1987,0.0,98103,47.6597,-122.331,1630,4560,870,0.30526315789473685,3920400,8122500,4202100
2370000.0,3,2.25,3530,17450,1.0,0,3,2,9,1840,1690,1930,1993.0,98040,47.5358,-122.213,3530,17310,13920,0.7977077363896848,12460900,304502500,292041600
1210000.0,4,2.5,3430,35120,2.0,0,0,2,10,3430,0,1984,0.0,98033,47.6484,-122.182,3920,35230,31690,0.9023348519362187,11764900,1233414400,1221649500
255950.0,3,2.5,1720,3676,2.0,0,0,2,7,1720,0,1992,0.0,98031,47.4039,-122.18799999999999,1720,3510,1956,0.5321001088139282,2958400,13512976,10554576
475000.0,3,1.5,1930,11092,1.0,0,0,2,7,1500,430,1983,0.0,98074,47.63399999999999,-122.03299999999999,1230,10964,9162,0.8260007212405337,3724900,123032464,119307564
362950.0,4,1.75,2140,159865,1.0,0,0,3,7,1140,1000,1960,0.0,98031,47.4235,-122.21799999999999,1830,15569,157725,0.9866137053138586,4579600,25556818225,25552238625
452000.0,3,1.75,1110,9012,1.0,0,0,3,7,1110,0,1966,0.0,98052,47.6563,-122.131,1800,8679,7902,0.8768308921438083,1232100,81216144,79984044
315000.0,3,1.75,1970,8200,1.0,0,0,2,7,1270,700,1964,0.0,98168,47.4731,-122.32700000000001,1890,8348,6230,0.7597560975609756,3880900,67240000,63359100
330950.0,3,2.5,1630,2844,2.0,0,0,2,7,1630,0,2003,0.0,98118,47.5413,-122.288,1610,2582,1214,0.4268635724331927,2656900,8088336,5431436
535000.0,5,2.25,2520,49222,2.0,0,0,3,8,2520,0,1978,0.0,98027,47.4918,-122.064,2780,55321,46702,0.9488033806021697,6350400,2422805284,2416454884
479000.0,4,2.25,2270,9464,1.5,0,0,3,7,1520,750,1940,0.0,98146,47.5007,-122.359,1770,9464,7194,0.7601437024513947,5152900,89567296,84414396
340000.0,3,2.5,1212,1174,3.0,0,0,2,7,1212,0,2004,0.0,98125,47.7145,-122.311,1256,1226,-38,-0.03236797274275979,1468944,1378276,-90668
312000.0,4,2.0,1890,8362,1.0,0,0,2,7,1890,0,1966,0.0,98188,47.4377,-122.279,1600,9257,6472,0.7739775173403493,3572100,69923044,66350944
305000.0,3,2.25,1370,6600,2.0,0,0,3,7,1370,0,1993,0.0,98038,47.3504,-122.035,1370,6600,5230,0.7924242424242425,1876900,43560000,41683100
270000.0,3,2.5,1770,7336,2.0,0,0,2,7,1770,0,1996,0.0,98030,47.3639,-122.185,1770,7349,5566,0.7587241003271538,3132900,53816896,50683996
529999.0,3,2.5,1710,1664,2.0,0,0,4,8,1300,410,2003,0.0,98199,47.6456,-122.383,1470,5400,-46,-0.027644230769230768,2924100,2768896,-155204
587100.0,2,1.0,1190,6967,1.0,0,0,2,7,1190,0,1946,0.0,98040,47.5896,-122.243,1700,6968,5777,0.8291947753695995,1416100,48539089,47122989
459800.0,3,2.0,1690,16061,1.0,0,0,2,7,1690,0,1984,0.0,98074,47.6359,-122.035,1280,12436,14371,0.8947761658676296,2856100,257955721,255099621
451000.0,4,1.75,1680,7800,1.0,0,0,2,7,1330,350,1966,0.0,98008,47.6286,-122.118,1680,7210,6120,0.7846153846153846,2822400,60840000,58017600
2480000.0,3,3.25,4340,4947,2.0,0,3,2,11,3060,1280,1993,0.0,98107,47.6709,-122.406,1680,5250,607,0.12270062664240954,18835600,24472809,5637209
525000.0,3,2.25,2040,435600,2.0,0,2,3,7,2040,0,1983,0.0,98022,47.2328,-121.945,2020,223027,433560,0.9953168044077135,4161600,189747360000,189743198400
250000.0,2,1.0,1110,26051,1.0,0,0,2,6,1110,0,1951,0.0,98168,47.4711,-122.291,2240,12255,24941,0.9573912709684849,1232100,678654601,677422501
475000.0,5,2.0,2040,6180,2.0,0,0,3,7,2040,0,1908,0.0,98118,47.5503,-122.28,1870,4365,4140,0.6699029126213593,4161600,38192400,34030800
235000.0,4,1.5,1920,11595,1.0,0,0,3,7,1920,0,1962,0.0,98002,47.2858,-122.212,1400,10550,9675,0.8344113842173351,3686400,134444025,130757625
230000.0,3,1.5,1330,9548,1.0,0,0,4,7,1330,0,1967,0.0,98042,47.3675,-122.11,1420,9548,8218,0.8607038123167156,1768900,91164304,89395404
581000.0,4,1.0,1630,2566,1.5,0,0,2,7,1630,0,1921,0.0,98122,47.6183,-122.3,1220,2314,936,0.36477007014809043,2656900,6584356,3927456
415000.0,3,1.0,1520,9030,1.0,0,0,2,7,1520,0,1956,0.0,98007,47.586999999999996,-122.134,1470,8712,7510,0.831672203765227,2310400,81540900,79230500
522500.0,3,1.0,1520,9030,1.0,0,0,2,7,1520,0,1956,0.0,98007,47.586999999999996,-122.134,1470,8712,7510,0.831672203765227,2310400,81540900,79230500
383000.0,3,1.5,1340,7725,1.0,0,0,3,8,1340,0,1967,0.0,98056,47.5389,-122.17299999999999,1990,7725,6385,0.8265372168284789,1795600,59675625,57880025
315000.0,3,1.75,2500,8289,1.0,0,0,3,7,1250,1250,1958,0.0,98056,47.4973,-122.177,1710,8205,5789,0.6983954638677766,6250000,68707521,62457521
591000.0,3,2.0,1460,3600,2.0,0,0,2,7,1460,0,1902,0.0,98122,47.6123,-122.314,1590,1210,2140,0.5944444444444444,2131600,12960000,10828400
750000.0,4,2.25,3140,12150,2.0,0,0,2,9,3140,0,1979,0.0,98074,47.6361,-122.04700000000001,2370,12054,9010,0.7415637860082305,9859600,147622500,137762900
430000.0,3,1.75,2150,4333,1.0,0,0,2,7,1200,950,1956,0.0,98136,47.5537,-122.38799999999999,1480,6500,2183,0.5038079852296331,4622500,18774889,14152389
712000.0,4,2.5,3140,32336,1.5,0,0,2,10,3140,0,1995,0.0,98072,47.7412,-122.087,2340,19965,29196,0.902894606630381,9859600,1045616896,1035757296
510000.0,3,2.5,2310,53578,1.0,0,0,3,8,1340,970,1981,0.0,98072,47.7677,-122.135,2660,49658,51268,0.9568852887379148,5336100,2870602084,2865265984
480000.0,2,1.0,710,4800,1.0,0,0,1,6,710,0,1950,0.0,98112,47.6212,-122.29799999999999,1480,1721,4090,0.8520833333333333,504100,23040000,22535900
538000.0,3,1.0,1460,7200,1.0,0,0,2,7,1260,200,1906,0.0,98103,47.6875,-122.336,1430,4650,5740,0.7972222222222223,2131600,51840000,49708400
464000.0,2,2.75,730,5000,1.0,0,0,2,7,730,0,1929,0.0,98126,47.5381,-122.374,980,5000,4270,0.854,532900,25000000,24467100
476000.0,3,2.5,1440,3840,2.0,0,0,2,7,1440,0,2001,0.0,98053,47.6873,-122.04299999999999,1600,3131,2400,0.625,2073600,14745600,12672000
349500.0,3,2.0,1130,16875,1.0,0,0,3,7,1130,0,1947,0.0,98155,47.7489,-122.3,1600,14300,15745,0.933037037037037,1276900,284765625,283488725
270000.0,3,2.25,1810,8262,2.0,0,0,3,8,1810,0,1981,0.0,98023,47.2994,-122.37,1820,8262,6452,0.7809247155652385,3276100,68260644,64984544
740000.0,3,2.5,2710,18480,2.0,0,2,2,10,2000,710,1978,0.0,98034,47.7256,-122.259,2710,18077,15770,0.8533549783549783,7344100,341510400,334166300
395000.0,4,2.5,2740,8336,2.0,0,0,3,9,2740,0,1990,0.0,98031,47.3904,-122.176,2460,9189,5596,0.6713051823416507,7507600,69488896,61981296
498000.0,3,2.5,1690,4088,2.0,0,0,2,7,1690,0,2004,0.0,98053,47.6779,-122.03399999999999,1950,4088,2398,0.5865949119373777,2856100,16711744,13855644
339900.0,3,2.5,1470,4675,2.0,0,0,2,7,1470,0,1999,0.0,98065,47.5261,-121.82700000000001,1500,4385,3205,0.6855614973262032,2160900,21855625,19694725
539000.0,3,2.5,2830,9972,2.0,0,0,2,9,2830,0,2006,0.0,98019,47.7382,-121.975,3557,9159,7142,0.7162053750501404,8008900,99440784,91431884
400000.0,3,1.0,1410,9704,1.0,0,0,2,8,1140,270,1983,0.0,98074,47.6203,-122.036,1910,13639,8294,0.8546990931574608,1988100,94167616,92179516
225000.0,3,2.5,2170,11745,1.0,0,0,3,7,1410,760,1967,0.0,98058,47.4342,-122.17,1860,8643,9575,0.8152405278842061,4708900,137945025,133236125
330000.0,3,2.25,1340,4080,1.5,0,0,2,6,1170,170,1907,0.0,98144,47.5722,-122.291,1670,4080,2740,0.6715686274509803,1795600,16646400,14850800
1390000.0,3,3.0,2480,5500,2.0,0,3,2,10,1730,750,1950,2005.0,98199,47.6466,-122.404,2950,5670,3020,0.5490909090909091,6150400,30250000,24099600
490000.0,3,2.75,1990,31200,1.0,0,0,2,8,1990,0,1986,0.0,98029,47.5544,-122.035,3120,29625,29210,0.9362179487179487,3960100,973440000,969479900
260000.0,4,2.75,2240,7200,1.0,0,0,2,7,1140,1100,1967,0.0,98001,47.3357,-122.275,1580,7416,4960,0.6888888888888889,5017600,51840000,46822400
469900.0,4,2.5,2990,8913,2.0,0,0,3,9,2990,0,1991,0.0,98058,47.4353,-122.15899999999999,2740,8030,5923,0.6645349489509705,8940100,79441569,70501469
493000.0,6,1.75,2120,3801,1.5,0,0,3,7,1220,900,1925,0.0,98115,47.6832,-122.311,1850,4181,1681,0.4422520389371218,4494400,14447601,9953201
740000.0,4,2.25,2920,46355,2.0,0,0,3,9,2920,0,1998,0.0,98024,47.568999999999996,-121.962,2310,184694,43435,0.937007874015748,8526400,2148786025,2140259625
148900.0,4,1.75,1700,6000,1.0,0,0,2,7,1700,0,1967,0.0,98002,47.3252,-122.208,1280,6000,4300,0.7166666666666667,2890000,36000000,33110000
475000.0,2,2.5,1620,14467,2.0,0,0,2,7,1620,0,1981,0.0,98074,47.6306,-122.035,1470,13615,12847,0.8880210133407065,2624400,209294089,206669689
415000.0,2,1.0,760,4000,1.0,0,0,2,7,760,0,1944,0.0,98117,47.6896,-122.396,1520,4000,3240,0.81,577600,16000000,15422400
229500.0,3,1.0,1230,6000,1.0,0,0,3,7,1230,0,1967,0.0,98002,47.3256,-122.209,1240,6000,4770,0.795,1512900,36000000,34487100
1360000.0,5,3.75,4960,13990,2.0,0,2,2,11,3760,1200,2001,0.0,98006,47.5491,-122.137,5200,18116,9030,0.6454610436025733,24601600,195720100,171118500
385000.0,4,2.5,2030,11375,1.0,0,0,2,7,1330,700,1969,0.0,98028,47.7765,-122.26100000000001,1500,9160,9345,0.8215384615384616,4120900,129390625,125269725
230000.0,3,2.25,1830,11331,1.0,0,0,2,7,1250,580,1965,0.0,98001,47.2899,-122.287,2240,16433,9501,0.8384961609743182,3348900,128391561,125042661
425000.0,2,1.0,970,2700,1.0,0,0,3,7,770,200,1926,0.0,98115,47.6852,-122.31200000000001,1570,3348,1730,0.6407407407407407,940900,7290000,6349100
189900.0,2,1.0,1000,4179,1.0,0,0,4,5,1000,0,1914,0.0,98002,47.297,-122.227,1010,6327,3179,0.7607083034218712,1000000,17464041,16464041
238000.0,2,1.0,750,6480,1.0,0,0,2,6,750,0,1943,0.0,98106,47.5195,-122.35,1050,6390,5730,0.8842592592592593,562500,41990400,41427900
968060.0,4,2.5,2620,16200,1.0,0,2,3,7,1570,1050,1950,1993.0,98033,47.6623,-122.196,3050,11875,13580,0.8382716049382716,6864400,262440000,255575600
921000.0,4,1.5,2220,9496,1.0,0,0,3,7,1490,730,1954,0.0,98004,47.6233,-122.206,1800,8286,7276,0.7662173546756529,4928400,90174016,85245616
380000.0,5,1.75,3000,6000,1.0,0,0,4,7,1500,1500,1958,0.0,98178,47.492,-122.225,2230,7125,3000,0.5,9000000,36000000,27000000
285000.0,1,1.0,1060,54846,1.0,1,4,2,5,1060,0,1935,0.0,98070,47.4716,-122.445,2258,31762,53786,0.9806731575684644,1123600,3008083716,3006960116
449000.0,4,2.5,1980,5400,2.0,0,0,2,8,1980,0,1998,0.0,98056,47.5182,-122.20700000000001,1980,5400,3420,0.6333333333333333,3920400,29160000,25239600
625000.0,4,1.0,1600,5500,1.5,0,0,3,7,1600,0,1946,0.0,98117,47.6983,-122.39299999999999,1900,5500,3900,0.7090909090909091,2560000,30250000,27690000
318989.0,4,2.25,2000,9000,1.0,0,0,3,8,2000,0,1978,0.0,98023,47.3125,-122.387,2190,8374,7000,0.7777777777777778,4000000,81000000,77000000
445000.0,3,1.5,1310,1266,2.0,0,0,2,8,1120,190,2002,0.0,98116,47.5663,-122.40799999999999,1310,1378,-44,-0.03475513428120063,1716100,1602756,-113344
750000.0,3,1.0,1120,8549,1.0,0,0,2,7,1120,0,1952,0.0,98004,47.6294,-122.205,1440,8640,7429,0.8689905252076267,1254400,73085401,71831001
959000.0,3,2.5,3320,11875,1.0,0,0,4,10,3320,0,1979,0.0,98034,47.7212,-122.26,3730,11875,8555,0.720421052631579,11022400,141015625,129993225
330000.0,3,2.5,2370,9102,2.0,0,0,2,9,2370,0,1990,0.0,98023,47.3067,-122.39399999999999,2530,9883,6732,0.7396176664469347,5616900,82846404,77229504
425000.0,2,1.5,830,1241,2.0,0,0,2,7,830,0,2005,0.0,98119,47.6363,-122.368,1610,2666,411,0.3311845286059629,688900,1540081,851181
280000.0,3,1.0,940,7913,1.0,0,0,2,6,940,0,1948,0.0,98155,47.7657,-122.321,940,7913,6973,0.8812081385062556,883600,62615569,61731969
476500.0,4,2.5,2250,50155,2.0,0,0,2,8,2250,0,1998,0.0,98045,47.449,-121.756,2040,57857,47905,0.955139068886452,5062500,2515524025,2510461525
556000.0,3,2.25,2020,3600,2.0,0,0,2,8,2020,0,1998,0.0,98033,47.6678,-122.165,2070,3699,1580,0.4388888888888889,4080400,12960000,8879600
1860000.0,4,5.25,5240,320917,2.0,0,2,2,10,5240,0,2006,0.0,98024,47.5605,-121.905,1930,68824,315677,0.983671790525276,27457600,102987720889,102960263289
637000.0,4,3.5,4083,68377,2.0,0,0,2,10,4083,0,2005,0.0,98001,47.3114,-122.262,2430,41382,64294,0.9402869385904618,16670889,4675414129,4658743240
405000.0,3,2.0,1450,6081,1.0,0,0,3,7,1450,0,1969,0.0,98155,47.7522,-122.27799999999999,1880,6000,4631,0.7615523762539056,2102500,36978561,34876061
397000.0,5,1.0,1170,6757,1.0,0,0,3,6,800,370,1944,0.0,98125,47.7332,-122.304,1590,6794,5587,0.8268462335355927,1368900,45657049,44288149
895990.0,4,2.75,3555,6565,2.0,0,0,2,9,3555,0,2014,0.0,98053,47.6847,-122.01700000000001,3625,5637,3010,0.4584920030464585,12638025,43099225,30461200
259000.0,3,2.0,1610,14046,2.0,0,0,2,7,1610,0,1933,1988.0,98028,47.7704,-122.264,2410,9000,12436,0.8853766196782002,2592100,197290116,194698016
420000.0,2,1.0,960,112384,1.0,0,0,2,7,960,0,1955,0.0,98028,47.7642,-122.234,1210,24875,111424,0.9914578587699316,921600,12630163456,12629241856
518000.0,3,2.5,1680,2096,2.0,0,0,2,8,1380,300,2008,0.0,98117,47.6904,-122.37,1360,2096,416,0.1984732824427481,2822400,4393216,1570816
425000.0,3,1.75,1380,8182,1.0,0,0,4,7,1380,0,1942,0.0,98133,47.7513,-122.34899999999999,1300,8188,6802,0.8313370813981912,1904400,66945124,65040724
182500.0,2,1.0,1040,13920,1.0,0,0,2,6,1040,0,1973,0.0,98198,47.3756,-122.306,1100,7575,12880,0.9252873563218391,1081600,193766400,192684800
549900.0,3,1.5,1380,3031,1.5,0,0,3,7,1380,0,1929,0.0,98117,47.6889,-122.38,1440,4005,1651,0.5447047179148796,1904400,9186961,7282561
445000.0,3,1.75,1850,16863,1.0,0,0,3,7,1280,570,1980,0.0,98034,47.7166,-122.225,1790,9000,15013,0.8902923560457807,3422500,284360769,280938269
452000.0,2,1.75,1740,5400,1.0,0,0,3,7,990,750,1946,0.0,98115,47.6971,-122.28200000000001,1980,5400,3660,0.6777777777777778,3027600,29160000,26132400
715000.0,5,1.75,1920,6500,1.0,0,0,2,7,1260,0,1951,0.0,98112,47.6394,-122.30799999999999,1970,5500,4580,0.7046153846153846,3686400,42250000,38563600
559000.0,3,2.5,2010,5200,2.0,0,0,2,8,2010,0,1989,0.0,98034,47.7142,-122.20299999999999,1860,4400,3190,0.6134615384615385,4040100,27040000,22999900
3300000.0,5,6.25,8020,21738,2.0,0,0,2,11,8020,0,2001,0.0,98006,47.5675,-122.189,4160,18969,13718,0.6310608151623884,64320400,472540644,408220244
250000.0,4,1.75,1860,7350,1.0,0,0,3,7,1090,770,1977,0.0,98031,47.3979,-122.17399999999999,1710,7350,5490,0.746938775510204,3459600,54022500,50562900
1230000.0,5,4.0,4390,6656,2.0,0,0,2,9,2930,1460,2008,0.0,98199,47.648,-122.397,1560,6656,2266,0.34044471153846156,19272100,44302336,25030236
276500.0,4,2.25,2380,128937,1.0,0,0,3,7,2380,0,1960,0.0,98038,47.4253,-122.04299999999999,1030,114998,126557,0.9815413729185571,5664400,16624749969,16619085569
440000.0,4,2.5,2880,7386,2.0,0,0,3,9,2880,0,1987,0.0,98058,47.4397,-122.15,2420,7663,4506,0.6100731112916328,8294400,54552996,46258596
543200.0,6,2.25,2820,15600,1.5,0,2,4,7,1970,850,1940,0.0,98166,47.4635,-122.36200000000001,2520,7797,12780,0.8192307692307692,7952400,243360000,235407600
250000.0,1,1.0,750,4000,1.0,0,0,2,6,750,0,1918,0.0,98136,47.5243,-122.39,1770,4850,3250,0.8125,562500,16000000,15437500
625000.0,4,2.5,1750,9000,1.0,0,0,2,8,1410,340,1977,2003.0,98052,47.6403,-122.105,2120,9600,7250,0.8055555555555556,3062500,81000000,77937500
530100.0,3,1.0,1540,3399,1.5,0,0,2,7,1200,340,1926,0.0,98117,47.6853,-122.359,1500,3914,1859,0.5469255663430421,2371600,11553201,9181601
549900.0,2,1.75,1140,936,2.0,0,0,2,8,940,200,2014,0.0,98105,47.6647,-122.28399999999999,1160,1327,-204,-0.21794871794871795,1299600,876096,-423504
430000.0,4,1.5,1560,6534,1.0,0,0,3,7,1560,0,1962,0.0,98007,47.6012,-122.152,1560,6969,4974,0.761248852157943,2433600,42693156,40259556
835000.0,3,2.5,2960,6856,2.0,0,0,2,10,2960,0,2009,0.0,98074,47.5906,-122.057,3320,6856,3896,0.5682613768961493,8761600,47004736,38243136
409500.0,4,2.75,2140,13000,1.0,0,0,2,7,1320,820,1968,0.0,98028,47.7683,-122.25200000000001,2360,11000,10860,0.8353846153846154,4579600,169000000,164420400
329000.0,4,2.5,1600,6765,1.0,0,0,2,7,830,770,1947,2011.0,98106,47.5469,-122.365,1600,8942,5165,0.7634885439763488,2560000,45765225,43205225
940000.0,4,2.75,2080,4000,1.5,0,0,2,8,2080,0,1912,2000.0,98107,47.6737,-122.35799999999999,1730,5000,1920,0.48,4326400,16000000,11673600
539950.0,3,2.0,1560,3200,1.5,0,0,2,7,1560,0,1910,2007.0,98109,47.6398,-122.35600000000001,1240,3600,1640,0.5125,2433600,10240000,7806400
579950.0,4,2.5,2880,213444,1.0,0,0,4,8,2140,740,1984,0.0,98092,47.2887,-122.109,2810,213444,210564,0.9865069994940124,8294400,45558341136,45550046736
881000.0,5,3.0,2510,4125,1.5,0,3,4,8,1590,920,1925,0.0,98144,47.5968,-122.29,2190,5415,1615,0.39151515151515154,6300100,17015625,10715525
362500.0,3,1.0,960,5424,1.5,0,0,2,6,960,0,1916,0.0,98115,47.6997,-122.32,1550,5687,4464,0.8230088495575221,921600,29419776,28498176
243950.0,2,1.0,1120,35500,1.0,0,0,4,6,1120,0,1961,0.0,98022,47.2411,-122.04299999999999,1680,66022,34380,0.9684507042253521,1254400,1260250000,1258995600
658000.0,4,2.75,3310,6166,2.0,0,0,2,9,3310,0,2008,0.0,98065,47.521,-121.87700000000001,3200,7027,2856,0.46318520921180667,10956100,38019556,27063456
218250.0,3,1.5,1080,9774,1.0,0,0,2,7,1080,0,1968,0.0,98023,47.3155,-122.40100000000001,1190,9611,8694,0.8895027624309392,1166400,95531076,94364676
655000.0,4,2.5,2860,12394,2.0,0,0,2,10,2860,0,1999,0.0,98075,47.5832,-122.02600000000001,3070,8515,9534,0.7692431821849282,8179600,153611236,145431636
255000.0,3,2.0,1490,7599,1.0,0,0,2,7,1490,0,1990,0.0,98042,47.3687,-122.088,1560,7710,6109,0.803921568627451,2220100,57744801,55524701
215000.0,3,1.0,1210,7175,1.0,0,0,2,7,1210,0,1918,0.0,98106,47.5339,-122.35600000000001,1640,5850,5965,0.8313588850174216,1464100,51480625,50016525
1270000.0,3,1.75,2240,5657,1.5,0,2,3,8,1910,330,1941,0.0,98105,47.6621,-122.27,2970,5657,3417,0.6040304048082022,5017600,32001649,26984049
2920000.0,4,4.75,4575,24085,2.5,0,2,4,10,3905,670,1926,0.0,98112,47.6263,-122.28399999999999,3900,9687,19510,0.8100477475607224,20930625,580087225,559156600
424305.0,3,2.5,1600,5960,2.0,0,2,4,8,1600,0,1910,0.0,98168,47.4758,-122.265,1410,13056,4360,0.7315436241610739,2560000,35521600,32961600
494000.0,4,1.75,2090,4300,1.5,0,0,3,7,1250,0,1925,0.0,98136,47.5555,-122.397,1670,5000,2210,0.513953488372093,4368100,18490000,14121900
560000.0,4,2.5,2260,3713,2.0,0,0,2,9,2260,0,2003,0.0,98034,47.7247,-122.165,2260,3713,1453,0.39132776730406676,5107600,13786369,8678769
130000.0,3,1.0,1200,7000,2.0,0,0,0,7,1200,0,1908,0.0,98116,47.5883,-122.384,3290,6000,5800,0.8285714285714286,1440000,49000000,47560000
468000.0,4,2.5,2480,176418,1.5,0,3,4,8,2480,0,1927,0.0,98022,47.1941,-122.038,1640,112384,173938,0.9859424775249691,6150400,31123310724,31117160324
480000.0,5,3.0,2240,15435,1.0,0,1,4,7,1390,850,1952,0.0,98155,47.7426,-122.288,2240,10750,13195,0.854875283446712,5017600,238239225,233221625
475000.0,3,1.75,1550,4054,1.5,0,0,3,7,1550,0,1926,0.0,98115,47.6743,-122.301,1510,3889,2504,0.6176615688209176,2402500,16434916,14032416
285000.0,4,1.75,2130,8151,1.0,0,0,3,7,1330,800,1967,0.0,98031,47.3932,-122.20100000000001,1600,8587,6021,0.7386823702613177,4536900,66438801,61901901
765000.0,5,3.0,2870,5700,1.0,0,0,2,7,1950,920,1964,0.0,98103,47.6621,-122.33,1730,5529,2830,0.4964912280701754,8236900,32490000,24253100
208000.0,2,1.0,1160,5750,1.0,0,0,3,6,1160,0,1924,0.0,98065,47.5322,-121.829,1160,8250,4590,0.7982608695652174,1345600,33062500,31716900
372000.0,3,2.5,2430,5000,2.0,0,0,2,8,2430,0,2001,0.0,98042,47.3786,-122.12700000000001,2910,5620,2570,0.514,5904900,25000000,19095100
470000.0,2,1.0,900,5512,1.0,0,0,2,7,900,0,1947,0.0,98115,47.6877,-122.289,1270,5512,4612,0.8367198838896952,810000,30382144,29572144
451000.0,5,2.75,2830,8925,1.5,0,0,2,7,2830,0,1967,0.0,98034,47.731,-122.179,1700,8539,6095,0.6829131652661065,8008900,79655625,71646725
442200.0,4,1.75,1620,8132,1.0,0,0,2,8,1620,0,1974,0.0,98052,47.6788,-122.11,1920,8400,6512,0.8007870142646335,2624400,66129424,63505024
330000.0,4,2.5,2510,8580,2.0,0,0,3,8,2510,0,1991,0.0,98023,47.295,-122.37,2290,7809,6070,0.7074592074592074,6300100,73616400,67316300
335000.0,3,1.75,1790,5120,1.0,0,0,3,6,940,850,1949,0.0,98106,47.5277,-122.355,1160,5120,3330,0.650390625,3204100,26214400,23010300
280000.0,3,2.0,1640,13249,1.0,0,0,2,7,1640,0,1995,0.0,98032,47.3589,-122.281,1640,9240,11609,0.8762170729866405,2689600,175536001,172846401
625000.0,3,1.75,2240,6050,1.0,0,0,3,8,1250,990,1950,0.0,98116,47.5658,-122.4,1720,6050,3810,0.6297520661157024,5017600,36602500,31584900
345000.0,3,2.5,1870,3584,2.0,0,0,2,8,1870,0,2003,0.0,98058,47.4521,-122.12100000000001,1900,3920,1714,0.47823660714285715,3496900,12845056,9348156
255950.0,4,1.0,1500,11050,1.0,0,0,4,7,1500,0,1964,0.0,98058,47.4509,-122.088,1970,20800,9550,0.8642533936651584,2250000,122102500,119852500
570000.0,4,1.0,1490,6000,1.5,0,0,2,7,1490,0,1918,0.0,98136,47.5518,-122.385,1700,6000,4510,0.7516666666666667,2220100,36000000,33779900
685000.0,3,1.5,2230,8558,2.0,0,0,2,8,2230,0,1960,0.0,98040,47.5833,-122.219,2200,8558,6328,0.7394250993222715,4972900,73239364,68266464
273148.0,3,1.75,1710,7210,1.0,0,0,3,7,1240,470,1974,0.0,98031,47.4094,-122.175,1840,7245,5500,0.7628294036061026,2924100,51984100,49060000
246500.0,3,2.5,1620,7686,2.0,0,0,2,7,1620,0,1989,0.0,98038,47.3613,-122.053,1370,7686,6066,0.7892271662763466,2624400,59074596,56450196
349950.0,5,2.5,2250,7176,1.0,0,0,2,7,1310,940,1983,0.0,98055,47.4486,-122.194,1550,9081,4926,0.6864548494983278,5062500,51494976,46432476
545000.0,4,2.0,1700,2350,1.0,0,0,2,6,850,850,1926,2014.0,98117,47.6865,-122.366,1600,4160,650,0.2765957446808511,2890000,5522500,2632500
403000.0,3,2.5,1502,1400,3.0,0,0,2,7,1502,0,2005,0.0,98115,47.6951,-122.305,1377,1466,-102,-0.07285714285714286,2256004,1960000,-296004
299950.0,4,2.5,1900,4054,2.0,0,0,2,7,1900,0,2003,0.0,98042,47.3767,-122.124,2520,4085,2154,0.5313270843611249,3610000,16434916,12824916
792000.0,3,2.5,3320,12840,1.0,0,0,2,10,2600,720,1990,0.0,98075,47.5783,-121.994,3230,14933,9520,0.7414330218068536,11022400,164865600,153843200
418000.0,5,2.5,1980,10205,1.0,0,0,3,7,1080,900,1929,0.0,98115,47.699,-122.307,1310,5413,8225,0.8059774620284175,3920400,104142025,100221625
332500.0,4,1.0,1670,8102,1.5,0,0,2,6,1670,0,1944,0.0,98166,47.4692,-122.355,1310,7906,6432,0.7938780548012836,2788900,65642404,62853504
337000.0,3,2.5,2235,43560,1.0,0,0,4,7,990,1245,1975,0.0,98010,47.3326,-122.046,1460,29621,41325,0.9486914600550964,4995225,1897473600,1892478375
212000.0,2,1.0,1070,7386,1.0,0,0,2,6,1070,0,1949,0.0,98108,47.5434,-122.29799999999999,1330,6351,6316,0.8551313295423775,1144900,54552996,53408096
542000.0,2,2.25,1800,2819,2.0,0,2,3,9,1800,0,1979,0.0,98008,47.6104,-122.113,1800,2755,1019,0.36147570060305073,3240000,7946761,4706761
622500.0,4,2.5,2980,8107,2.0,0,0,2,9,2980,0,2000,0.0,98065,47.5389,-121.876,2750,7760,5127,0.6324164302454669,8880400,65723449,56843049
260000.0,3,1.75,1670,8511,1.0,0,0,2,7,1340,330,1985,0.0,98001,47.3257,-122.27600000000001,1580,7218,6841,0.8037833392080836,2788900,72437121,69648221
525000.0,3,1.75,2620,38350,1.0,0,0,3,8,1320,1300,1977,0.0,98027,47.4619,-121.991,2170,36962,35730,0.9316818774445893,6864400,1470722500,1463858100
975000.0,5,3.5,5470,35071,2.0,0,0,2,11,4590,880,1976,0.0,98005,47.6368,-122.15899999999999,3600,35074,29601,0.8440306806193151,29920900,1229975041,1200054141
1140000.0,4,1.75,3080,6500,1.0,0,0,3,9,1700,1380,1941,0.0,98199,47.6353,-122.402,2960,5711,3420,0.5261538461538462,9486400,42250000,32763600
500000.0,3,1.0,940,10360,1.0,0,0,3,7,940,0,1964,0.0,98033,47.688,-122.19,2019,10360,9420,0.9092664092664092,883600,107329600,106446000
554000.0,5,2.25,1870,11411,1.0,0,0,3,8,1170,700,1961,0.0,98155,47.7445,-122.289,2420,10793,9541,0.8361230391727281,3496900,130210921,126714021
343000.0,4,2.5,2070,4500,2.0,0,0,2,7,2070,0,2004,0.0,98038,47.3497,-122.02600000000001,2760,5173,2430,0.54,4284900,20250000,15965100
515000.0,2,1.75,950,15219,1.0,0,0,2,8,950,0,2009,0.0,98028,47.7723,-122.262,1560,12416,14269,0.9375780274656679,902500,231617961,230715461
492000.0,2,1.0,1290,6272,1.0,0,0,3,6,890,400,1922,0.0,98115,47.6777,-122.305,1260,5376,4982,0.7943239795918368,1664100,39337984,37673884
655000.0,4,3.0,2570,8022,1.0,0,0,3,8,1370,1200,1984,0.0,98052,47.6956,-122.09899999999999,2090,8022,5452,0.6796310147095488,6604900,64352484,57747584
290000.0,3,2.5,1600,6848,2.0,0,0,2,7,1600,0,2000,0.0,98001,47.3303,-122.271,1700,7210,5248,0.7663551401869159,2560000,46895104,44335104
952500.0,4,1.5,2550,5055,2.0,0,0,3,10,2550,0,1910,0.0,98112,47.636,-122.301,1970,4431,2505,0.49554896142433236,6502500,25553025,19050525
235000.0,2,1.0,1010,7500,1.0,0,0,2,7,1010,0,1941,0.0,98108,47.5283,-122.32,1220,6000,6490,0.8653333333333333,1020100,56250000,55229900
323000.0,3,1.5,1720,7110,1.0,0,0,2,8,1720,0,1955,0.0,98106,47.5417,-122.355,1730,6840,5390,0.7580872011251758,2958400,50552100,47593700
1050000.0,3,2.5,2200,1970,2.0,0,0,2,9,1610,590,2008,0.0,98102,47.6426,-122.32700000000001,1890,3505,-230,-0.116751269035533,4840000,3880900,-959100
200000.0,2,1.0,1400,9600,1.5,0,0,3,6,1400,0,1941,0.0,98022,47.2113,-121.993,1230,9600,8200,0.8541666666666666,1960000,92160000,90200000
419995.0,3,2.25,1830,7500,1.0,0,0,3,7,1330,500,1968,0.0,98155,47.7574,-122.31,1830,8720,5670,0.756,3348900,56250000,52901100
1500000.0,3,3.0,3110,9015,1.0,0,4,3,10,1590,1520,1980,0.0,98033,47.6624,-122.20200000000001,3150,11447,5905,0.6550194120909595,9672100,81270225,71598125
455000.0,3,2.5,1600,7829,2.0,0,0,2,7,1600,0,1987,0.0,98034,47.7288,-122.227,1580,9104,6229,0.7956316260058756,2560000,61293241,58733241
660000.0,3,3.5,3600,37982,2.0,0,0,3,8,3600,0,1996,0.0,98014,47.6982,-121.917,2050,18019,34382,0.9052182612816597,12960000,1442632324,1429672324
319000.0,3,1.0,1390,12823,1.0,0,0,3,7,1390,0,1968,0.0,98077,47.7438,-122.075,1390,10095,11433,0.8916010294002964,1932100,164429329,162497229
390000.0,3,1.75,2092,250905,1.0,0,0,2,7,2092,0,1981,0.0,98022,47.2664,-122.027,2092,217800,248813,0.9916621828979095,4376464,62953319025,62948942561
718500.0,3,1.5,1200,6240,1.0,0,0,2,8,1030,170,1952,0.0,98112,47.6222,-122.287,2810,6240,5040,0.8076923076923077,1440000,38937600,37497600
474000.0,2,1.0,1090,3160,1.0,0,0,2,7,840,250,1926,0.0,98109,47.6385,-122.344,1070,3160,2070,0.6550632911392406,1188100,9985600,8797500
615750.0,4,2.0,2140,6360,2.0,0,0,2,7,1840,300,1945,0.0,98115,47.687,-122.286,1690,6360,4220,0.6635220125786163,4579600,40449600,35870000
551000.0,3,2.5,2010,17362,2.0,0,0,2,8,2010,0,1994,0.0,98033,47.6904,-122.176,1920,7200,15352,0.8842299274277157,4040100,301439044,297398944
230000.0,3,2.25,1500,7210,1.0,0,0,2,7,1150,350,1984,0.0,98023,47.3124,-122.352,1500,7210,5710,0.7919556171983356,2250000,51984100,49734100
790000.0,4,2.5,3500,9198,2.0,0,0,2,9,3500,0,2004,0.0,98053,47.6785,-122.025,3990,8598,5698,0.619482496194825,12250000,84603204,72353204
1230000.0,3,2.5,2660,1967,3.0,0,3,2,9,1870,790,2007,0.0,98119,47.6264,-122.363,1640,1369,-693,-0.35231316725978645,7075600,3869089,-3206511
325000.0,3,2.25,1440,6443,2.0,0,0,2,7,1440,0,1995,0.0,98019,47.7471,-121.979,1700,6749,5003,0.776501629675617,2073600,41512249,39438649
705000.0,4,2.75,2780,6207,2.0,0,0,2,8,2780,0,2001,0.0,98053,47.6867,-122.038,2660,5592,3427,0.5521185758015145,7728400,38526849,30798449
259000.0,4,1.75,1580,8856,2.0,0,0,2,7,1580,0,1979,0.0,98045,47.4694,-121.745,1390,9490,7276,0.8215898825654924,2496400,78428736,75932336
306000.0,3,1.5,1250,8700,1.0,0,0,3,7,1250,0,1959,0.0,98168,47.4744,-122.32799999999999,1300,8700,7450,0.8563218390804598,1562500,75690000,74127500
315000.0,3,1.0,970,6828,1.0,0,0,2,6,970,0,1928,0.0,98106,47.5476,-122.36,1160,11666,5858,0.8579379027533685,940900,46621584,45680684
392500.0,3,1.0,1100,7650,1.0,0,0,2,7,1100,0,1952,0.0,98133,47.7219,-122.354,1430,7650,6550,0.8562091503267973,1210000,58522500,57312500
1070000.0,4,2.25,3240,12930,2.0,0,0,3,9,2730,510,1968,0.0,98040,47.5373,-122.22,2610,12884,9690,0.7494199535962877,10497600,167184900,156687300
350500.0,2,2.5,1290,1445,3.0,0,0,2,8,1290,0,1999,0.0,98117,47.6955,-122.376,1470,1503,155,0.10726643598615918,1664100,2088025,423925
825000.0,4,3.5,3810,9792,2.0,0,0,2,9,3810,0,1938,2013.0,98146,47.5018,-122.38,1950,9792,5982,0.6109068627450981,14516100,95883264,81367164
235000.0,4,1.0,1500,6360,1.5,0,0,2,6,1500,0,1944,0.0,98178,47.4979,-122.24,1190,6360,4860,0.7641509433962265,2250000,40449600,38199600
650000.0,3,2.0,2660,257875,1.0,0,2,3,8,1530,1130,1976,0.0,98024,47.553000000000004,-121.887,1710,64033,255215,0.989684924866699,7075600,66499515625,66492440025
675000.0,4,3.0,2400,3340,1.0,0,0,3,7,1200,1200,1964,0.0,98107,47.6646,-122.365,1520,3758,940,0.281437125748503,5760000,11155600,5395600
265000.0,4,1.0,1860,8505,1.0,0,0,3,7,1860,0,1955,0.0,98055,47.4406,-122.194,1560,8505,6645,0.781305114638448,3459600,72335025,68875425
822500.0,2,1.0,1450,7098,1.0,0,4,2,7,1450,0,1924,0.0,98109,47.63,-122.34899999999999,2390,6098,5648,0.7957171034094112,2102500,50381604,48279104
705000.0,3,2.75,2260,4000,2.0,0,0,3,8,1540,720,1956,0.0,98109,47.6435,-122.353,2120,4000,1740,0.435,5107600,16000000,10892400
2630000.0,6,4.75,5540,7200,2.5,0,2,3,11,3950,1590,1909,0.0,98119,47.6361,-122.366,2930,7200,1660,0.23055555555555557,30691600,51840000,21148400
685000.0,2,1.5,1300,1676,1.0,0,2,2,7,1300,0,1943,0.0,98122,47.6133,-122.30799999999999,1260,1740,376,0.2243436754176611,1690000,2808976,1118976
630000.0,4,2.0,1610,5000,2.0,0,0,4,7,1610,0,1946,0.0,98117,47.6775,-122.398,1300,4950,3390,0.678,2592100,25000000,22407900
1250000.0,4,3.25,3820,24166,2.0,0,1,3,11,3310,510,1990,0.0,98040,47.5263,-122.227,2900,18786,20346,0.8419266738392783,14592400,583995556,569403156
359000.0,4,2.5,1820,11325,1.0,0,0,2,8,1390,430,1976,0.0,98166,47.4574,-122.361,1990,10802,9505,0.8392935982339956,3312400,128255625,124943225
784500.0,4,5.0,5820,13906,2.0,0,0,2,11,3750,2070,1993,0.0,98042,47.3814,-122.164,2980,13000,8086,0.5814756220336545,33872400,193376836,159504436
850000.0,3,2.0,2470,8800,2.0,0,0,2,9,2470,0,1961,2004.0,98040,47.5753,-122.22200000000001,2340,10980,6330,0.7193181818181819,6100900,77440000,71339100
410000.0,3,2.5,3040,6054,2.0,0,0,2,9,3040,0,2005,0.0,98042,47.3508,-122.163,2650,6054,3014,0.4978526593987446,9241600,36650916,27409316
252000.0,4,1.75,1120,8250,1.0,0,0,3,7,1120,0,1966,0.0,98058,47.4555,-122.177,1330,7975,7130,0.8642424242424243,1254400,68062500,66808100
618000.0,5,1.75,1880,18295,1.0,0,0,3,7,1880,0,1955,0.0,98005,47.6059,-122.154,2180,20674,16415,0.89723968297349,3534400,334707025,331172625
265000.0,3,1.0,1070,4800,1.0,0,0,2,6,970,100,1947,0.0,98126,47.5187,-122.37700000000001,1120,1198,3730,0.7770833333333333,1144900,23040000,21895100
465000.0,3,2.0,1560,8509,1.0,0,0,2,8,790,770,1969,0.0,98034,47.7261,-122.22,1410,7428,6949,0.8166647079562815,2433600,72403081,69969481
240000.0,2,1.0,870,6552,1.0,0,0,2,6,870,0,1947,0.0,98133,47.7188,-122.353,1500,6678,5682,0.8672161172161172,756900,42928704,42171804
217000.0,3,1.0,1000,12000,1.0,0,0,2,7,1000,0,1959,0.0,98023,47.3321,-122.346,1490,14940,11000,0.9166666666666666,1000000,144000000,143000000
415000.0,4,2.25,2520,4200,1.5,0,0,3,7,1510,1010,1909,0.0,98144,47.5814,-122.31200000000001,1460,4200,1680,0.4,6350400,17640000,11289600
274000.0,2,2.0,1700,7992,1.0,0,0,3,7,950,750,1980,0.0,98023,47.3031,-122.385,1700,8030,6292,0.7872872872872873,2890000,63872064,60982064
420000.0,5,3.0,2150,6117,1.0,0,0,2,7,1370,780,2003,0.0,98106,47.538000000000004,-122.35600000000001,1990,6064,3967,0.6485205165931012,4622500,37417689,32795189
1060000.0,4,2.75,1590,6000,1.5,0,0,3,8,1590,0,1925,0.0,98112,47.6401,-122.29899999999999,1590,4000,4410,0.735,2528100,36000000,33471900
1420000.0,4,5.25,4670,43950,2.0,0,0,2,12,4670,0,1989,0.0,98006,47.5456,-122.126,4900,35000,39280,0.8937428896473265,21808900,1931602500,1909793600
618500.0,3,2.0,1800,5000,1.0,0,0,3,7,1080,0,1942,0.0,98115,47.6738,-122.29700000000001,1800,5000,3200,0.64,3240000,25000000,21760000
295000.0,3,1.5,1670,10800,1.0,0,0,3,8,1670,0,1956,0.0,98022,47.2004,-122.00299999999999,1670,9169,9130,0.8453703703703703,2788900,116640000,113851100
400000.0,3,2.0,1010,12252,1.0,0,0,2,8,1010,0,1980,0.0,98074,47.6224,-122.045,1840,11497,11242,0.9175644792686908,1020100,150111504,149091404
595000.0,3,2.5,2550,6677,2.0,0,0,2,8,2550,0,2002,0.0,98028,47.7336,-122.23200000000001,1930,7217,4127,0.6180919574659278,6502500,44582329,38079829
1730000.0,4,3.0,3700,20570,1.0,0,0,3,10,1850,1850,1976,0.0,98004,47.6212,-122.22399999999999,3080,17595,16870,0.8201263976665046,13690000,423124900,409434900
261000.0,3,1.75,1350,7686,1.0,0,0,2,7,1350,0,1987,0.0,98038,47.3617,-122.052,1370,7686,6336,0.8243559718969555,1822500,59074596,57252096
780000.0,5,2.5,1660,4000,1.5,0,0,4,8,1660,0,1929,0.0,98109,47.6452,-122.352,1210,4000,2340,0.585,2755600,16000000,13244400
589000.0,3,1.5,1390,5040,1.0,0,0,2,7,1090,300,1947,0.0,98105,47.6611,-122.28200000000001,1910,4800,3650,0.7242063492063492,1932100,25401600,23469500
230000.0,3,1.75,1720,9125,1.0,0,0,3,7,1140,580,1981,0.0,98092,47.3173,-122.181,1120,7506,7405,0.8115068493150684,2958400,83265625,80307225
690000.0,4,3.5,2980,2147,2.5,0,0,2,10,2490,490,2006,0.0,98029,47.5463,-121.995,2880,2428,-833,-0.3879832324173265,8880400,4609609,-4270791
524000.0,4,2.25,2190,15491,2.0,0,0,2,8,2190,0,1981,0.0,98074,47.6299,-122.039,2090,15039,13301,0.8586275902136724,4796100,239971081,235174981
380000.0,2,2.5,1230,987,2.0,0,0,2,7,1060,170,2011,0.0,98144,47.6007,-122.305,1290,1328,-243,-0.24620060790273557,1512900,974169,-538731
357500.0,3,1.0,1000,4080,1.0,0,0,3,7,740,260,1945,0.0,98126,47.5351,-122.381,1480,4080,3080,0.7549019607843137,1000000,16646400,15646400
330000.0,3,2.0,2500,10697,1.0,0,0,2,8,2500,0,1994,0.0,98022,47.1927,-122.01,2560,9772,8197,0.7662896139104421,6250000,114425809,108175809
635000.0,5,1.75,2240,4750,1.0,0,0,3,7,1120,1120,1920,0.0,98115,47.6727,-122.29299999999999,1980,4750,2510,0.5284210526315789,5017600,22562500,17544900
934000.0,9,3.0,2820,4480,2.0,0,0,2,7,1880,940,1918,0.0,98105,47.6654,-122.307,2460,4400,1660,0.3705357142857143,7952400,20070400,12118000
358500.0,2,1.75,1400,865,2.0,0,0,2,8,1110,0,2005,0.0,98029,47.5478,-121.999,1380,1107,-535,-0.6184971098265896,1960000,748225,-1211775
401000.0,3,1.5,1470,6867,1.0,0,0,2,8,1470,0,1955,0.0,98155,47.7495,-122.32700000000001,1470,6523,5397,0.7859327217125383,2160900,47155689,44994789
270000.0,3,2.0,1820,7750,1.0,0,0,2,8,1820,0,1992,0.0,98023,47.3169,-122.352,2080,8084,5930,0.7651612903225806,3312400,60062500,56750100
705000.0,4,2.0,2060,6000,1.0,0,1,3,8,1370,690,1954,0.0,98136,47.5237,-122.383,2060,6600,3940,0.6566666666666666,4243600,36000000,31756400
325000.0,3,2.0,1670,17071,1.0,0,0,2,7,1100,570,1988,0.0,98014,47.69,-121.913,1660,15593,15401,0.9021732763165603,2788900,291419041,288630141
384950.0,3,1.0,1540,7740,1.0,0,0,3,7,1540,0,1909,0.0,98126,47.522,-122.375,1220,7740,6200,0.8010335917312662,2371600,59907600,57536000
310000.0,3,1.0,1210,9730,1.0,0,0,3,7,1210,0,1953,0.0,98133,47.762,-122.355,1470,9730,8520,0.8756423432682425,1464100,94672900,93208800
829950.0,4,2.5,3430,42775,2.0,0,0,2,10,3430,0,1992,0.0,98077,47.765,-122.045,3190,36820,39345,0.919812974868498,11764900,1829700625,1817935725
353000.0,3,2.5,2550,6021,2.0,0,0,2,7,2550,0,2002,0.0,98030,47.3828,-122.211,2080,6021,3471,0.5764823119083209,6502500,36252441,29749941
170500.0,2,1.0,1060,7700,1.0,0,0,2,7,820,240,1981,0.0,98055,47.4599,-122.205,1370,8833,6640,0.8623376623376623,1123600,59290000,58166400
885250.0,4,2.5,3670,49658,2.0,0,0,2,10,3670,0,1999,0.0,98074,47.6219,-122.015,3040,49658,45988,0.9260944862861976,13468900,2465916964,2452448064
2700000.0,4,3.25,4420,7850,2.0,1,4,2,11,3150,1270,2001,0.0,98008,47.571999999999996,-122.102,2760,8525,3430,0.4369426751592357,19536400,61622500,42086100
245000.0,3,1.5,1550,9126,1.0,0,0,4,7,1550,0,1957,0.0,98022,47.2012,-122.0,1450,9282,7576,0.8301555993863686,2402500,83283876,80881376
469000.0,3,2.5,1190,1290,3.0,0,0,2,8,1190,0,2008,0.0,98107,47.6762,-122.37799999999999,1410,1923,100,0.07751937984496124,1416100,1664100,248000
455000.0,3,1.0,1300,3550,1.5,0,0,2,7,1300,0,1927,0.0,98105,47.6696,-122.32,1410,4080,2250,0.6338028169014085,1690000,12602500,10912500
305000.0,4,2.5,2430,5959,2.0,0,0,2,8,2430,0,2002,0.0,98092,47.3348,-122.19,2100,5414,3529,0.592213458633999,5904900,35509681,29604781
840000.0,7,4.5,4290,37607,1.5,0,0,4,10,4290,0,1982,0.0,98027,47.4812,-122.03299999999999,2810,40510,33317,0.8859254925944638,18404100,1414286449,1395882349
905000.0,5,3.5,3500,10155,2.0,0,0,2,10,2570,930,1996,0.0,98006,47.5415,-122.133,2940,10753,6655,0.65534219596258,12250000,103124025,90874025
219200.0,3,2.0,1680,7000,1.5,0,0,3,7,1680,0,1968,0.0,98002,47.2775,-122.20299999999999,1540,7480,5320,0.76,2822400,49000000,46177600
455000.0,3,1.5,1250,8004,1.0,0,0,2,7,1250,0,1965,0.0,98008,47.6285,-122.117,1450,7931,6754,0.8438280859570215,1562500,64064016,62501516
195000.0,2,1.0,1020,8100,1.0,0,0,2,6,1020,0,1940,0.0,98168,47.4971,-122.334,1200,12500,7080,0.8740740740740741,1040400,65610000,64569600
799000.0,3,1.0,1510,4178,2.0,0,0,2,8,1510,0,1902,0.0,98103,47.6849,-122.335,2140,4916,2668,0.6385830540928674,2280100,17455684,15175584
285000.0,2,1.0,910,8155,1.0,0,0,3,6,910,0,1948,0.0,98155,47.7399,-122.3,1240,8155,7245,0.8884120171673819,828100,66504025,65675925
300000.0,3,1.5,1320,15053,1.0,0,0,2,7,1320,0,1979,0.0,98072,47.7405,-122.095,1250,13368,13733,0.9123098385703846,1742400,226592809,224850409
83000.0,2,1.0,900,8580,1.0,0,0,2,5,900,0,1918,0.0,98168,47.4727,-122.27,2060,6533,7680,0.8951048951048951,810000,73616400,72806400
220000.0,2,1.0,890,4804,1.0,0,0,3,7,890,0,1928,0.0,98133,47.7027,-122.346,1010,3844,3914,0.8147377185678601,792100,23078416,22286316
174500.0,2,2.5,1240,2689,2.0,0,0,2,7,1240,0,1986,0.0,98003,47.3236,-122.323,1430,3609,1449,0.5388620304946077,1537600,7230721,5693121
695000.0,4,2.5,2960,10760,2.0,0,0,2,9,2960,0,1987,0.0,98029,47.5677,-122.01299999999999,2480,9528,7800,0.724907063197026,8761600,115777600,107016000
255000.0,3,1.5,1020,11410,1.0,0,0,2,7,1020,0,1959,0.0,98059,47.4811,-122.162,1290,8400,10390,0.9106047326906223,1040400,130188100,129147700
539000.0,5,2.25,2590,7245,1.0,0,0,2,8,1510,1080,1973,0.0,98008,47.6398,-122.111,1930,7245,4655,0.642512077294686,6708100,52490025,45781925
552700.0,2,1.0,1100,2800,1.0,0,0,2,7,1100,0,1925,0.0,98119,47.6361,-122.37100000000001,1110,1673,1700,0.6071428571428571,1210000,7840000,6630000
571500.0,3,1.0,1300,6710,1.0,0,0,3,6,1300,0,1952,0.0,98040,47.5851,-122.242,1630,9946,5410,0.8062593144560357,1690000,45024100,43334100
263700.0,3,1.0,1200,6561,1.0,0,0,2,6,1200,0,1950,1968.0,98177,47.7763,-122.36,1340,9450,5361,0.8171010516689529,1440000,43046721,41606721
3300000.0,8,4.0,7710,11750,3.5,0,0,4,12,6090,1620,1904,0.0,98112,47.6263,-122.314,4210,8325,4040,0.34382978723404256,59444100,138062500,78618400
186950.0,2,2.0,1390,1302,2.0,0,0,2,7,1390,0,1986,0.0,98003,47.3089,-122.33,1390,1302,-88,-0.06758832565284179,1932100,1695204,-236896
520000.0,3,1.75,1430,53628,2.0,0,0,2,8,1430,0,1985,0.0,98024,47.5577,-121.891,2100,53628,52198,0.9733348250913701,2044900,2875962384,2873917484
358000.0,3,1.5,1250,7194,1.0,0,0,3,7,1250,0,1969,0.0,98034,47.7298,-122.23100000000001,1340,7242,5944,0.8262440922991382,1562500,51753636,50191136
210000.0,2,0.75,840,49658,1.0,0,0,1,6,840,0,1948,0.0,98168,47.4727,-122.292,1240,11000,48818,0.9830842965886665,705600,2465916964,2465211364
3650000.0,5,3.75,5020,8694,2.0,0,1,2,12,3970,1050,2007,0.0,98004,47.6146,-122.213,4190,11275,3674,0.42259029215550953,25200400,75585636,50385236
543000.0,4,2.25,2060,8767,2.0,0,0,2,8,2060,0,1983,0.0,98052,47.7228,-122.103,1610,8062,6707,0.7650279457054865,4243600,76860289,72616689
330000.0,4,2.25,2000,10679,1.0,0,0,2,7,1350,650,1960,0.0,98148,47.4238,-122.329,1650,8875,8679,0.8127165464931173,4000000,114041041,110041041
529000.0,3,2.0,1530,3400,1.0,0,0,2,7,990,540,1907,2014.0,98112,47.6204,-122.296,1880,4212,1870,0.55,2340900,11560000,9219100
295000.0,1,1.0,700,2500,1.0,0,0,3,7,700,0,1907,0.0,98106,47.5662,-122.36399999999999,1340,5000,1800,0.72,490000,6250000,5760000
365000.0,3,1.0,950,8450,1.0,0,0,2,7,950,0,1962,0.0,98033,47.6884,-122.186,1610,10080,7500,0.8875739644970414,902500,71402500,70500000
473000.0,3,3.0,1380,1081,3.0,0,0,2,8,1380,0,2005,0.0,98107,47.6692,-122.39,1390,1140,-299,-0.2765957446808511,1904400,1168561,-735839
403500.0,3,1.0,1830,8004,1.0,0,0,2,8,1200,630,1960,0.0,98125,47.7259,-122.29700000000001,1860,7971,6174,0.7713643178410795,3348900,64064016,60715116
544000.0,3,1.5,1790,8203,1.5,0,1,2,7,1790,0,1910,0.0,98116,47.5768,-122.40299999999999,1960,6047,6413,0.7817871510423016,3204100,67289209,64085109
621000.0,3,1.0,1340,4000,1.5,0,0,3,7,1340,0,1927,0.0,98105,47.6652,-122.288,1510,4000,2660,0.665,1795600,16000000,14204400
672600.0,3,2.25,1520,5750,2.0,0,0,2,8,1400,120,1908,2006.0,98116,47.5787,-122.38799999999999,1420,5650,4230,0.7356521739130435,2310400,33062500,30752100
689800.0,2,1.75,1370,3125,1.0,0,0,2,7,1090,280,1950,0.0,98199,47.6492,-122.391,1730,5966,1755,0.5616,1876900,9765625,7888725
613000.0,3,1.5,1470,4480,1.0,0,0,3,7,1130,340,1918,0.0,98105,47.6693,-122.291,2120,4480,3010,0.671875,2160900,20070400,17909500
808000.0,4,2.25,2500,8866,2.0,0,0,3,9,2500,0,1987,0.0,98007,47.6604,-122.146,2630,8847,6366,0.7180239115722987,6250000,78605956,72355956
301000.0,3,1.0,1060,9241,1.0,0,0,3,7,1060,0,1956,0.0,98133,47.7465,-122.339,1900,6484,8181,0.8852937993723623,1123600,85396081,84272481
340000.0,3,1.75,1210,9635,1.0,0,0,3,7,1210,0,1987,0.0,98019,47.7382,-121.98,1550,10707,8425,0.8744161909704203,1464100,92833225,91369125
206000.0,3,1.0,920,8400,1.0,0,0,2,7,920,0,1963,0.0,98032,47.3771,-122.287,1260,8400,7480,0.8904761904761904,846400,70560000,69713600
550000.0,3,1.5,1340,6000,1.0,0,0,3,7,1340,0,1960,0.0,98040,47.5866,-122.25,1590,9000,4660,0.7766666666666666,1795600,36000000,34204400
325000.0,2,1.0,960,4800,1.5,0,0,1,6,960,0,1912,0.0,98116,47.5752,-122.411,1440,4800,3840,0.8,921600,23040000,22118400
475000.0,3,2.5,1630,7586,2.0,0,0,2,8,1630,0,1986,0.0,98029,47.5689,-122.023,2090,7330,5956,0.785130503559188,2656900,57547396,54890496
432100.0,3,1.75,1840,7350,1.0,0,0,2,8,1310,530,1976,0.0,98034,47.7089,-122.23,1860,7000,5510,0.7496598639455783,3385600,54022500,50636900
359000.0,3,2.0,3085,7280,1.0,0,0,3,7,1560,1525,1959,0.0,98056,47.4956,-122.181,1480,7900,4195,0.5762362637362637,9517225,52998400,43481175
490000.0,3,1.0,920,4800,1.0,0,0,3,6,780,140,1926,0.0,98117,47.6937,-122.36200000000001,1370,4800,3880,0.8083333333333333,846400,23040000,22193600
648360.0,4,1.75,2260,7005,1.0,0,1,3,7,1130,1130,1947,0.0,98033,47.6895,-122.20700000000001,2330,9180,4745,0.6773733047822984,5107600,49070025,43962425
340000.0,3,1.75,1730,11986,1.0,0,3,4,6,1730,0,1918,0.0,98198,47.3595,-122.323,2490,9264,10256,0.8556649424328383,2992900,143664196,140671296
545000.0,3,2.0,1610,8069,1.0,0,0,4,7,1090,520,1955,0.0,98006,47.5754,-122.15,1510,8803,6459,0.800470938158384,2592100,65108761,62516661
115000.0,2,0.75,550,7980,1.0,0,0,2,5,550,0,1952,0.0,98146,47.511,-122.348,1330,7980,7430,0.931077694235589,302500,63680400,63377900
705640.0,3,2.25,2400,12350,1.0,0,0,3,8,1420,980,1968,0.0,98033,47.6533,-122.19200000000001,2615,12043,9950,0.805668016194332,5760000,152522500,146762500
300000.0,3,2.25,1960,1585,2.0,0,0,2,7,1750,210,2003,0.0,98118,47.5414,-122.288,1760,1958,-375,-0.23659305993690852,3841600,2512225,-1329375
1650000.0,4,2.75,3190,14904,1.0,0,3,3,9,1940,1250,1949,1992.0,98004,47.6178,-122.214,2600,11195,11714,0.7859634997316157,10176100,222129216,211953116
1140000.0,4,3.5,3160,4200,2.0,0,4,2,8,2180,980,1999,0.0,98144,47.5963,-122.292,2180,5200,1040,0.24761904761904763,9985600,17640000,7654400
280000.0,3,1.75,1550,7410,1.5,0,0,4,7,1550,0,1944,0.0,98178,47.4951,-122.23700000000001,1250,7467,5860,0.7908232118758435,2402500,54908100,52505600
245000.0,4,1.75,1930,7650,1.0,0,0,3,8,1280,650,1981,0.0,98023,47.3078,-122.38600000000001,1860,8800,5720,0.7477124183006536,3724900,58522500,54797600
564000.0,4,1.0,1170,4590,1.5,0,0,3,7,1170,0,1925,0.0,98115,47.6804,-122.311,1430,4080,3420,0.7450980392156863,1368900,21068100,19699200
849000.0,3,1.75,2520,4534,1.0,0,0,4,9,1460,1060,1954,0.0,98199,47.6381,-122.40100000000001,1870,5023,2014,0.4441993824437583,6350400,20557156,14206756
698000.0,3,1.75,1220,7447,1.0,0,0,3,7,1220,0,1964,0.0,98033,47.6886,-122.211,1340,7200,6227,0.8361756411977977,1488400,55457809,53969409
319000.0,3,1.0,960,8556,1.0,0,0,2,7,960,0,1971,0.0,98034,47.7245,-122.22,1320,7528,7596,0.8877980364656382,921600,73205136,72283536
1450000.0,3,3.5,4110,15720,1.0,0,1,2,10,2230,1880,2000,0.0,98034,47.6996,-122.229,2500,15400,11610,0.7385496183206107,16892100,247118400,230226300
695000.0,4,3.5,3310,21050,2.0,0,0,4,9,2400,910,1992,0.0,98027,47.5197,-122.041,2260,23400,17740,0.8427553444180522,10956100,443102500,432146400
680000.0,4,2.75,2220,5310,1.0,0,0,4,7,1170,1050,1951,0.0,98144,47.5801,-122.294,1540,4200,3090,0.5819209039548022,4928400,28196100,23267700
287500.0,4,2.25,2250,12000,2.0,0,0,2,8,2250,0,1985,0.0,98032,47.3715,-122.274,2140,11871,9750,0.8125,5062500,144000000,138937500
465000.0,3,3.25,1510,1850,2.0,0,2,2,8,1230,280,2001,0.0,98107,47.6683,-122.36200000000001,1540,1840,340,0.1837837837837838,2280100,3422500,1142400
335000.0,3,1.0,1350,14212,1.0,0,0,3,6,1350,0,1981,0.0,98053,47.6606,-122.06,1520,14404,12862,0.9050098508302843,1822500,201980944,200158444
602000.0,4,1.75,2420,37800,1.0,0,0,3,8,1880,540,1981,0.0,98053,47.6688,-122.024,2780,35532,35380,0.935978835978836,5856400,1428840000,1422983600
482000.0,3,2.5,2950,6545,2.0,0,0,2,8,2950,0,2003,0.0,98059,47.4828,-122.139,2400,6550,3595,0.5492742551566081,8702500,42837025,34134525
220000.0,5,1.0,1260,8382,1.5,0,0,2,7,1260,0,1918,0.0,98146,47.5058,-122.355,910,8382,7122,0.8496778811739442,1587600,70257924,68670324
206000.0,4,2.0,1700,6025,1.0,0,0,2,6,1700,0,1978,0.0,98002,47.3029,-122.221,1320,5956,4325,0.7178423236514523,2890000,36300625,33410625
1100000.0,4,3.0,3320,5760,2.0,0,0,2,9,2120,1200,1954,2007.0,98199,47.6474,-122.389,2400,6144,2440,0.4236111111111111,11022400,33177600,22155200
491150.0,3,2.5,1470,3971,2.0,0,0,2,7,1470,0,2003,0.0,98053,47.6816,-122.035,1650,3148,2501,0.6298161672122891,2160900,15768841,13607941
390000.0,4,2.75,2500,12848,1.0,0,1,2,8,2120,380,1975,0.0,98003,47.3364,-122.321,2370,12497,10348,0.8054171855541719,6250000,165071104,158821104
393000.0,4,2.5,2641,8091,2.0,0,0,2,7,2641,0,1998,0.0,98031,47.4043,-122.213,2641,8535,5450,0.6735879372141886,6974881,65464281,58489400
635000.0,4,2.0,2260,8457,2.0,0,0,2,9,2260,0,1992,0.0,98074,47.6251,-122.03,2410,7713,6197,0.7327657561783139,5107600,71520849,66413249
490000.0,2,1.0,1160,5000,1.0,0,0,3,8,1160,0,1937,0.0,98117,47.6865,-122.399,1750,5000,3840,0.768,1345600,25000000,23654400
770000.0,4,3.5,3680,2242,2.5,0,0,2,9,2670,1010,1930,0.0,98112,47.6192,-122.307,1350,1288,-1438,-0.6413916146297948,13542400,5026564,-8515836
665000.0,2,2.0,1615,4590,1.5,0,0,4,8,1615,0,1906,0.0,98103,47.6886,-122.348,1470,4590,2975,0.6481481481481481,2608225,21068100,18459875
287000.0,3,1.0,1250,26862,1.0,0,0,2,7,1250,0,1965,0.0,98058,47.426,-122.154,1530,24463,25612,0.9534658625567717,1562500,721567044,720004544
410000.0,3,1.0,1230,7020,1.0,0,0,2,7,1090,140,1924,0.0,98116,47.5719,-122.39,1390,5850,5790,0.8247863247863247,1512900,49280400,47767500
562000.0,3,2.0,2510,5200,1.0,0,0,4,8,1470,1040,1925,0.0,98106,47.5631,-122.366,990,5400,2690,0.5173076923076924,6300100,27040000,20739900
475000.0,2,2.0,1540,54450,2.0,0,0,2,7,1540,0,1983,0.0,98053,47.63800000000001,-121.95299999999999,2280,29918,52910,0.9717171717171718,2371600,2964802500,2962430900
387500.0,3,3.25,1860,2218,3.0,0,0,2,8,1860,0,2001,0.0,98125,47.7185,-122.31299999999999,1860,2218,358,0.16140667267808836,3459600,4919524,1459924
580000.0,5,2.0,2700,10875,1.0,0,0,3,7,1540,1160,1962,0.0,98007,47.6163,-122.13799999999999,2040,7464,8175,0.7517241379310344,7290000,118265625,110975625
930000.0,3,2.5,3290,6830,2.0,0,0,2,10,3290,0,2000,0.0,98052,47.6702,-122.14200000000001,3200,6227,3540,0.5183016105417276,10824100,46648900,35824800
625000.0,3,1.75,2700,18893,1.0,0,0,3,7,2110,590,1948,1983.0,98010,47.3397,-122.04799999999999,2260,17494,16193,0.8570899274863706,7290000,356945449,349655449
325000.0,3,2.0,1570,5600,1.0,0,0,2,8,1570,0,1999,0.0,98058,47.4286,-122.185,2010,5600,4030,0.7196428571428571,2464900,31360000,28895100
235000.0,3,1.75,1950,8712,1.0,0,0,2,7,1950,0,1960,0.0,98055,47.4391,-122.189,1820,11520,6762,0.7761707988980716,3802500,75898944,72096444
450000.0,2,1.0,1380,4390,1.0,0,0,3,8,880,500,1931,0.0,98115,47.6947,-122.323,1390,5234,3010,0.6856492027334852,1904400,19272100,17367700
745000.0,4,2.75,2410,5650,1.5,0,0,4,8,2070,340,1909,0.0,98116,47.5651,-122.391,1960,5650,3240,0.5734513274336284,5808100,31922500,26114400
223000.0,4,2.0,1200,8470,1.0,0,0,3,7,1200,0,1961,0.0,98023,47.3262,-122.338,1110,8400,7270,0.8583234946871311,1440000,71740900,70300900
630000.0,4,1.75,1770,12278,1.0,0,0,2,7,1350,420,1937,0.0,98115,47.7004,-122.295,1670,9336,10508,0.8558397133083564,3132900,150749284,147616384
413450.0,3,2.5,1540,1614,3.0,0,0,2,8,1470,70,2008,0.0,98103,47.6961,-122.34100000000001,1540,1418,74,0.04584882280049566,2371600,2604996,233396
720000.0,5,2.75,2860,5379,2.0,0,0,2,9,2860,0,2005,0.0,98052,47.7082,-122.104,2980,6018,2519,0.46830265848670755,8179600,28933641,20754041
339000.0,3,1.5,1740,21980,1.0,0,0,3,7,1740,0,1973,0.0,98042,47.3644,-122.132,1400,16100,20240,0.9208371246587808,3027600,483120400,480092800
1120000.0,4,3.5,2830,4000,1.5,0,0,2,7,1840,990,1919,2014.0,98144,47.5842,-122.292,2340,4000,1170,0.2925,8008900,16000000,7991100
839000.0,5,4.0,4280,11307,2.0,0,0,2,10,2710,1570,1996,0.0,98027,47.5503,-122.081,3080,11307,7027,0.621473423542938,18318400,127848249,109529849
2950000.0,4,3.25,3890,25470,2.0,1,3,4,10,3030,860,1923,0.0,98105,47.6608,-122.26899999999999,4140,19281,21580,0.8472712995681193,15132100,648720900,633588800
568000.0,4,2.0,2340,50233,1.0,0,0,3,7,1170,1170,1966,0.0,98075,47.5905,-122.022,2470,62290,47893,0.9534170764238648,5475600,2523354289,2517878689
269000.0,3,2.0,1410,10577,1.0,0,0,2,7,1410,0,1994,0.0,98030,47.3642,-122.18700000000001,1660,6757,9167,0.8666918786045192,1988100,111872929,109884829
382000.0,2,2.0,1350,2560,1.0,0,0,3,8,1350,0,1974,0.0,98052,47.6338,-122.10600000000001,1800,2560,1210,0.47265625,1822500,6553600,4731100
574000.0,2,2.25,1100,1114,2.0,0,0,2,8,900,200,2009,0.0,98122,47.6199,-122.304,1230,1800,14,0.012567324955116697,1210000,1240996,30996
405000.0,3,2.5,2070,4697,2.0,0,0,2,7,2070,0,2002,0.0,98065,47.5307,-121.875,2230,4437,2627,0.5592931658505429,4284900,22061809,17776909
572000.0,3,2.5,2360,9938,1.0,0,0,2,8,1690,670,1987,0.0,98027,47.5374,-122.053,2280,9626,7578,0.7625276715636949,5569600,98763844,93194244
675000.0,4,2.25,2760,12100,2.0,0,0,3,9,2760,0,1976,0.0,98074,47.6285,-122.05799999999999,2850,12410,9340,0.771900826446281,7617600,146410000,138792400
165000.0,4,1.0,1220,7980,1.5,0,0,2,6,1220,0,1944,0.0,98178,47.4924,-122.23700000000001,1210,7920,6760,0.8471177944862155,1488400,63680400,62192000
260000.0,4,1.0,1220,7980,1.5,0,0,2,6,1220,0,1944,0.0,98178,47.4924,-122.23700000000001,1210,7920,6760,0.8471177944862155,1488400,63680400,62192000
196000.0,3,1.0,1220,6719,1.0,0,0,2,6,1220,0,1953,0.0,98198,47.4187,-122.329,1580,7200,5499,0.8184253609168031,1488400,45144961,43656561
515000.0,3,2.5,3020,12184,2.0,0,0,2,8,3020,0,2003,0.0,98019,47.744,-121.976,2980,10029,9164,0.752133946158897,9120400,148449856,139329456
810000.0,4,3.5,3470,7396,2.0,0,3,2,8,2520,950,1979,0.0,98125,47.7146,-122.279,2360,10541,3926,0.5308274743104381,12040900,54700816,42659916
365650.0,4,2.25,2380,7700,2.0,0,0,3,8,2380,0,1977,0.0,98055,47.4391,-122.194,2100,7700,5320,0.6909090909090909,5664400,59290000,53625600
651000.0,3,3.0,2260,1834,2.0,0,0,2,8,1660,600,2002,0.0,98122,47.6111,-122.30799999999999,2260,1834,-426,-0.23227917121046893,5107600,3363556,-1744044
240000.0,2,1.0,720,6345,1.0,0,0,2,6,720,0,1943,0.0,98106,47.5201,-122.35,720,6345,5625,0.8865248226950354,518400,40259025,39740625
299000.0,3,2.0,1730,6007,1.0,0,0,2,8,1730,0,2004,0.0,98030,47.3573,-122.2,2000,6245,4277,0.712002663559181,2992900,36084049,33091149
768000.0,3,2.5,2660,10928,2.0,0,0,2,9,1830,830,1988,0.0,98006,47.5442,-122.141,2800,10025,8268,0.7565885797950219,7075600,119421184,112345584
397380.0,2,1.0,1030,5072,1.0,0,0,2,6,1030,0,1924,1958.0,98115,47.6962,-122.294,1220,6781,4042,0.7969242902208202,1060900,25725184,24664284
476000.0,4,3.0,2890,6885,1.0,0,0,2,7,1590,1300,1945,2015.0,98115,47.6763,-122.28200000000001,2180,6885,3995,0.5802469135802469,8352100,47403225,39051125
315000.0,3,1.0,890,5200,1.0,0,0,2,7,890,0,1957,0.0,98118,47.559,-122.277,1420,6000,4310,0.8288461538461539,792100,27040000,26247900
240000.0,3,2.25,1410,7290,1.0,0,0,2,7,940,470,1980,0.0,98118,47.5396,-122.274,1550,7375,5880,0.8065843621399177,1988100,53144100,51156000
325000.0,2,1.0,810,4080,1.0,0,0,3,6,810,0,1941,0.0,98126,47.5337,-122.37899999999999,1400,4080,3270,0.8014705882352942,656100,16646400,15990300
160000.0,3,1.75,1370,8006,2.0,0,0,2,7,1370,0,1990,0.0,98001,47.258,-122.25200000000001,1530,8006,6636,0.8288783412440669,1876900,64096036,62219136
435000.0,3,2.5,2260,5100,2.0,0,0,2,8,2260,0,2007,0.0,98019,47.7341,-121.96799999999999,2260,5100,2840,0.5568627450980392,5107600,26010000,20902400
427500.0,3,1.75,1430,16200,1.0,0,0,3,7,1430,0,1967,0.0,98027,47.5223,-122.04299999999999,1690,13125,14770,0.9117283950617284,2044900,262440000,260395100
450000.0,5,2.5,2510,10240,1.0,0,0,3,8,1410,1100,1984,0.0,98059,47.4732,-122.141,2170,10500,7730,0.7548828125,6300100,104857600,98557500
688000.0,3,1.5,1760,4880,1.5,0,3,2,8,1290,470,1928,0.0,98136,47.5334,-122.38799999999999,1840,4998,3120,0.639344262295082,3097600,23814400,20716800
285000.0,4,1.0,1430,3600,1.0,0,0,2,6,980,450,1947,0.0,98106,47.5343,-122.355,1170,4000,2170,0.6027777777777777,2044900,12960000,10915100
530000.0,3,3.25,1510,1125,3.0,0,0,2,8,1510,0,2006,0.0,98107,47.6711,-122.39,1390,1174,-385,-0.3422222222222222,2280100,1265625,-1014475
195000.0,4,1.75,1320,7694,1.0,0,0,2,7,1320,0,1928,1972.0,98148,47.4297,-122.325,1620,8468,6374,0.8284377436963868,1742400,59197636,57455236
250200.0,3,1.5,1180,7384,1.0,0,0,4,7,1180,0,1959,0.0,98032,47.3838,-122.287,1150,7455,6204,0.8401950162513543,1392400,54523456,53131056
1100000.0,3,2.25,1560,8570,1.0,0,0,4,7,1080,480,1977,0.0,98004,47.6155,-122.21,2660,9621,7010,0.8179696616102684,2433600,73444900,71011300
732500.0,3,2.5,2470,10321,2.0,0,0,2,9,2470,0,1988,0.0,98052,47.6694,-122.141,2450,8440,7851,0.7606821044472435,6100900,106523041,100422141
194250.0,3,2.25,2190,8834,1.0,0,0,2,7,1390,800,1987,0.0,98001,47.2633,-122.244,1490,8766,6644,0.7520941815712022,4796100,78039556,73243456
526000.0,4,2.0,1610,8000,1.0,0,0,2,7,1190,420,1966,0.0,98008,47.6301,-122.118,1560,7896,6390,0.79875,2592100,64000000,61407900
520000.0,4,2.75,2700,9882,2.0,0,0,2,7,2700,0,1958,1989.0,98155,47.7671,-122.291,2250,10797,7182,0.726775956284153,7290000,97653924,90363924
526000.0,3,1.75,1530,6125,1.0,0,0,2,7,1120,410,1958,0.0,98116,47.5687,-122.397,1360,6125,4595,0.7502040816326531,2340900,37515625,35174725
1140000.0,5,4.0,7320,217800,2.0,0,0,2,11,7320,0,1992,0.0,98058,47.4473,-122.086,3270,34500,210480,0.9663911845730028,53582400,47436840000,47383257600
202000.0,2,1.0,920,7569,1.0,0,0,3,6,920,0,1950,0.0,98168,47.4951,-122.302,1280,7627,6649,0.878451578808297,846400,57289761,56443361
645500.0,4,2.5,2990,8622,2.0,0,0,2,9,2990,0,2000,0.0,98065,47.5394,-121.875,2980,8622,5632,0.6532127116678265,8940100,74338884,65398784
570000.0,1,1.0,720,7540,1.0,1,4,3,6,720,0,1905,0.0,98198,47.3509,-122.323,1120,9736,6820,0.9045092838196287,518400,56851600,56333200
325000.0,3,2.0,1750,9000,1.5,0,0,3,5,1750,0,1936,0.0,98133,47.7489,-122.35,1830,8100,7250,0.8055555555555556,3062500,81000000,77937500
725000.0,2,1.0,2410,5930,2.0,0,0,2,9,1930,480,2007,0.0,98116,47.5657,-122.395,1540,5892,3520,0.5935919055649241,5808100,35164900,29356800
192000.0,3,1.75,1240,10361,1.0,0,0,2,6,1240,0,1987,0.0,98042,47.37,-122.15100000000001,1240,8834,9121,0.8803204323906959,1537600,107350321,105812721
560000.0,2,1.0,1010,9219,1.0,0,0,3,7,1010,0,1960,0.0,98033,47.6886,-122.20200000000001,1610,9219,8209,0.8904436489857902,1020100,84989961,83969861
283450.0,5,2.75,2770,6116,1.0,0,0,2,7,1490,1280,1979,0.0,98168,47.4847,-122.291,1920,6486,3346,0.5470896010464356,7672900,37405456,29732556
863000.0,4,1.75,2800,5400,1.0,0,0,2,9,1400,1400,1924,2006.0,98115,47.6803,-122.31299999999999,1490,5400,2600,0.48148148148148145,7840000,29160000,21320000
815000.0,4,2.0,1400,4800,2.0,0,0,2,7,1400,0,1986,0.0,98122,47.6168,-122.29799999999999,1620,2595,3400,0.7083333333333334,1960000,23040000,21080000
245000.0,2,1.0,1020,7679,1.0,0,0,4,6,1020,0,1942,0.0,98056,47.4915,-122.18799999999999,1280,6497,6659,0.867170204453705,1040400,58967041,57926641
1320000.0,4,3.0,2860,10292,1.0,0,0,3,8,2860,0,1953,1999.0,98004,47.6286,-122.206,1840,10273,7432,0.7221142635056355,8179600,105925264,97745664
1160000.0,4,3.5,4270,12305,2.0,0,2,2,10,4270,0,1994,0.0,98006,47.5489,-122.118,4190,13137,8035,0.6529865908167412,18232900,151413025,133180125
480000.0,3,2.5,2270,4488,2.0,0,0,2,7,2270,0,1999,0.0,98065,47.5329,-121.87899999999999,2360,4427,2218,0.4942067736185383,5152900,20142144,14989244
600000.0,4,2.5,2560,5593,2.0,0,0,2,7,2560,0,2001,0.0,98053,47.6886,-122.037,2800,5890,3033,0.5422849991060253,6553600,31281649,24728049
329950.0,2,1.0,900,5220,1.0,0,0,3,6,900,0,1956,0.0,98146,47.5105,-122.387,1480,6660,4320,0.8275862068965517,810000,27248400,26438400
299500.0,4,2.5,2010,12085,2.0,0,0,2,8,2010,0,1986,0.0,98042,47.3406,-122.057,1910,12133,10075,0.8336781133636739,4040100,146047225,142007125
460000.0,3,2.5,1690,5131,1.0,0,0,2,7,1690,0,1941,1998.0,98126,47.5234,-122.38,860,5137,3441,0.6706295069187292,2856100,26327161,23471061
515000.0,5,3.5,2310,5249,2.0,0,0,2,8,1560,750,2000,0.0,98118,47.5463,-122.272,1900,7296,2939,0.5599161745094303,5336100,27552001,22215901
405000.0,3,2.25,1520,1245,3.0,0,0,2,8,1520,0,2004,0.0,98103,47.6907,-122.34,1520,1470,-275,-0.22088353413654618,2310400,1550025,-760375
483000.0,4,1.5,1220,3780,1.5,0,0,2,7,1220,0,1927,0.0,98107,47.6667,-122.36,1400,3185,2560,0.6772486772486772,1488400,14288400,12800000
377000.0,4,2.5,2170,11511,2.0,0,0,2,8,2170,0,1992,0.0,98031,47.3886,-122.18799999999999,1900,8961,9341,0.8114846668404135,4708900,132503121,127794221
568000.0,4,1.75,2790,17476,1.0,0,2,2,7,1450,1340,1956,0.0,98166,47.4556,-122.369,2790,16401,14686,0.8403524834058137,7784100,305410576,297626476
355000.0,2,1.75,1760,4600,1.0,0,0,3,7,850,910,1926,0.0,98126,47.5654,-122.37200000000001,1150,4800,2840,0.6173913043478261,3097600,21160000,18062400
640000.0,4,1.75,2100,3000,1.5,0,0,3,7,1500,600,1911,0.0,98103,47.6721,-122.329,1690,4000,900,0.3,4410000,9000000,4590000
270000.0,4,1.0,1430,5909,1.0,0,0,2,6,1070,360,1947,0.0,98155,47.7623,-122.31299999999999,1460,8433,4479,0.757996276865798,2044900,34916281,32871381
559950.0,5,3.5,2450,8193,2.0,0,0,2,9,2450,0,2005,0.0,98028,47.7721,-122.241,2310,8193,5743,0.7009642377639448,6002500,67125249,61122749
515000.0,4,3.0,1820,8261,1.0,0,0,2,7,1420,400,1969,0.0,98034,47.7197,-122.219,1920,7961,6441,0.7796876891417504,3312400,68244121,64931721
352000.0,4,1.75,1850,5712,1.0,0,0,2,7,1850,0,1954,0.0,98115,47.6966,-122.324,1510,6038,3862,0.6761204481792717,3422500,32626944,29204444
595888.0,3,1.75,1870,9000,1.0,0,0,4,9,1870,0,1958,0.0,98177,47.7203,-122.361,2030,8160,7130,0.7922222222222223,3496900,81000000,77503100
588000.0,4,2.25,2580,7344,2.0,0,0,2,8,2580,0,1977,0.0,98027,47.5647,-122.09,2390,7507,4764,0.6486928104575164,6656400,53934336,47277936
1050000.0,4,3.25,3680,8580,1.0,0,0,4,10,1840,1840,1959,0.0,98136,47.5266,-122.387,2700,9100,4900,0.5710955710955711,13542400,73616400,60074000
260000.0,3,1.5,1750,7000,2.0,0,0,2,8,1750,0,1983,0.0,98023,47.3108,-122.346,1840,9305,5250,0.75,3062500,49000000,45937500
1600000.0,4,3.5,3890,3600,2.0,0,0,2,9,2860,1030,2005,0.0,98112,47.6342,-122.28200000000001,2460,6050,-290,-0.08055555555555556,15132100,12960000,-2172100
380000.0,2,1.0,1000,4800,1.0,0,0,2,6,1000,0,1952,0.0,98117,47.6926,-122.36200000000001,1000,4800,3800,0.7916666666666666,1000000,23040000,22040000
802000.0,2,2.5,2210,6327,1.0,0,0,2,8,2210,0,2003,0.0,98053,47.7114,-122.03,2170,6327,4117,0.6507033349138612,4884100,40030929,35146829
1330000.0,4,3.25,2850,4800,2.5,0,0,4,10,2700,0,1905,0.0,98112,47.6292,-122.31200000000001,2850,4800,1950,0.40625,8122500,23040000,14917500
710000.0,4,2.75,2460,3600,2.0,0,0,2,8,1640,820,1907,2007.0,98122,47.6093,-122.29700000000001,1890,3600,1140,0.31666666666666665,6051600,12960000,6908400
600000.0,3,2.5,2630,77972,2.0,0,0,2,9,2630,0,2004,0.0,98019,47.745,-121.916,2250,75794,75342,0.9662699430564818,6916900,6079632784,6072715884
707900.0,3,1.0,1750,5355,2.0,0,0,3,7,1750,0,1929,0.0,98115,47.6792,-122.31,2240,4590,3605,0.673202614379085,3062500,28676025,25613525
179950.0,2,1.0,1100,7323,1.0,0,0,2,7,780,320,1982,0.0,98023,47.2874,-122.37,1410,7227,6223,0.8497883381127953,1210000,53626329,52416329
683000.0,4,2.5,2620,10489,2.0,0,0,2,9,2620,0,1990,0.0,98052,47.6732,-122.14299999999999,2430,7701,7869,0.750214510439508,6864400,110019121,103154721
222400.0,3,2.0,1200,9566,1.0,0,0,2,7,1200,0,1995,0.0,98001,47.2649,-122.25200000000001,1590,9518,8366,0.8745557181685135,1440000,91508356,90068356
517000.0,2,1.5,1920,3408,1.0,0,0,3,7,960,960,1912,0.0,98122,47.6118,-122.29899999999999,1130,3408,1488,0.43661971830985913,3686400,11614464,7928064
410000.0,3,2.75,1690,5763,1.0,0,0,4,7,1180,510,1985,0.0,98011,47.7336,-122.20200000000001,1560,7518,4073,0.7067499566198161,2856100,33212169,30356069
480000.0,3,1.75,1680,2552,1.0,0,0,3,7,840,840,1952,0.0,98117,47.6848,-122.391,1220,3880,872,0.34169278996865204,2822400,6512704,3690304
430000.0,3,1.75,3440,10428,1.5,0,0,4,8,3440,0,1974,0.0,98058,47.449,-122.12799999999999,2160,8400,6988,0.6701189106252398,11833600,108743184,96909584
439950.0,5,1.75,2190,7500,1.0,0,0,2,7,1290,900,1979,0.0,98133,47.7766,-122.355,1790,8820,5310,0.708,4796100,56250000,51453900
797500.0,4,2.5,3270,8223,2.0,0,0,2,10,3270,0,1998,0.0,98075,47.6018,-122.073,3460,8872,4953,0.6023349142648668,10692900,67617729,56924829
379000.0,4,1.5,1280,5460,1.5,0,0,4,7,1080,200,1920,0.0,98118,47.5348,-122.26799999999999,1470,5934,4180,0.7655677655677655,1638400,29811600,28173200
575000.0,1,1.0,1310,8667,1.5,0,0,0,6,1310,0,1918,0.0,98122,47.6059,-122.31299999999999,1130,4800,7357,0.8488519672320295,1716100,75116889,73400789
247500.0,3,1.0,1660,11060,1.0,0,0,3,7,1110,550,1962,0.0,98003,47.3311,-122.32600000000001,1890,11060,9400,0.8499095840867993,2755600,122323600,119568000
385000.0,4,2.75,2700,37011,2.0,0,0,2,9,2700,0,1984,0.0,98042,47.3496,-122.088,2700,37457,34311,0.9270487152468185,7290000,1369814121,1362524121
423000.0,4,1.75,1940,6909,1.0,0,0,3,7,970,970,1941,0.0,98133,47.7108,-122.352,1460,6906,4969,0.7192068316688377,3763600,47734281,43970681
550000.0,3,1.75,1520,5618,1.0,0,0,2,7,1170,350,1953,0.0,98115,47.68,-122.28399999999999,1550,5618,4098,0.7294410822356711,2310400,31561924,29251524
415000.0,4,1.0,1620,4329,1.5,0,0,2,7,1620,0,1927,0.0,98116,47.5728,-122.38799999999999,1220,5520,2709,0.6257796257796258,2624400,18740241,16115841
693000.0,3,2.25,2090,45535,1.0,0,2,4,8,1280,810,1952,0.0,98006,47.5538,-122.191,3090,12889,43445,0.9541012408037773,4368100,2073436225,2069068125
543000.0,2,1.0,1070,4700,1.0,0,0,4,7,1070,0,1910,0.0,98117,47.6887,-122.368,1370,4700,3630,0.7723404255319148,1144900,22090000,20945100
465000.0,5,1.75,2000,10246,1.0,0,2,2,7,1200,800,1953,0.0,98178,47.5084,-122.24600000000001,2340,9030,8246,0.8048018739020105,4000000,104980516,100980516
280000.0,3,2.5,1020,2217,2.0,0,0,2,7,720,300,2004,0.0,98106,47.5343,-122.348,1060,1524,1197,0.5399188092016238,1040400,4915089,3874689
1390000.0,3,1.25,2400,6653,3.0,0,2,2,11,2400,0,1992,0.0,98122,47.6019,-122.29,1910,6653,4253,0.6392604839921839,5760000,44262409,38502409
665000.0,6,3.0,2480,9720,2.0,0,0,2,8,2480,0,1972,0.0,98007,47.6127,-122.145,2480,9200,7240,0.7448559670781894,6150400,94478400,88328000
237950.0,3,1.75,1310,7314,1.0,0,0,4,6,1310,0,1960,0.0,98002,47.2888,-122.221,1010,7314,6004,0.8208914410719169,1716100,53494596,51778496
440000.0,4,2.75,2420,10200,1.0,0,0,2,8,1220,1200,1962,0.0,98034,47.72,-122.236,2240,9750,7780,0.7627450980392156,5856400,104040000,98183600
618000.0,2,1.0,1890,4700,1.0,0,0,3,7,1030,860,1928,0.0,98107,47.6747,-122.391,2150,4700,2810,0.597872340425532,3572100,22090000,18517900
572000.0,3,2.25,1860,4000,1.5,0,0,4,7,1020,840,1920,0.0,98118,47.5539,-122.26700000000001,1180,4000,2140,0.535,3459600,16000000,12540400
725000.0,3,1.5,2500,4774,1.5,0,2,2,7,1450,1050,1940,0.0,98107,47.6567,-122.35799999999999,1300,4000,2274,0.4763301214914118,6250000,22791076,16541076
454000.0,3,1.0,1970,22144,1.0,0,0,3,7,1970,0,1970,0.0,98065,47.5234,-121.84100000000001,1970,13500,20174,0.9110368497109826,3880900,490356736,486475836
535000.0,4,1.0,1660,10656,1.5,0,0,3,7,1180,480,1920,0.0,98136,47.5391,-122.385,1120,8816,8996,0.8442192192192193,2755600,113550336,110794736
249000.0,3,2.5,1850,7200,1.0,0,0,2,7,1500,350,1979,0.0,98023,47.3063,-122.384,2140,7500,5350,0.7430555555555556,3422500,51840000,48417500
395000.0,4,2.75,1970,37026,1.0,0,0,3,8,1970,0,1961,0.0,98070,47.4375,-122.446,1970,51836,35056,0.9467941446551073,3880900,1370924676,1367043776
690000.0,3,2.0,1890,6620,1.0,0,3,3,8,1890,0,1954,0.0,98125,47.7016,-122.274,2590,7188,4730,0.7145015105740181,3572100,43824400,40252300
526500.0,3,1.5,1310,7236,1.0,0,0,3,7,1170,140,1928,0.0,98103,47.6944,-122.333,1680,8431,5926,0.8189607517965727,1716100,52359696,50643596
325000.0,4,1.5,1870,7220,2.0,0,0,2,7,1870,0,1956,0.0,98155,47.77,-122.319,1550,7592,5350,0.7409972299168975,3496900,52128400,48631500
495000.0,3,3.0,1520,4080,2.0,0,0,4,7,1520,0,1948,0.0,98144,47.571999999999996,-122.29,1320,4080,2560,0.6274509803921569,2310400,16646400,14336000
825000.0,5,3.0,3070,8474,2.0,0,0,2,9,3070,0,2011,0.0,98033,47.6852,-122.184,3070,8527,5404,0.6377153646447958,9424900,71808676,62383776
383000.0,3,1.5,1400,14850,1.5,0,0,3,7,1400,0,1910,0.0,98070,47.4471,-122.464,1350,14850,13450,0.9057239057239057,1960000,220522500,218562500
320000.0,3,1.75,1960,11931,1.0,0,0,2,7,980,980,1954,0.0,98118,47.5432,-122.272,1460,4498,9971,0.8357220685608918,3841600,142348761,138507161
475000.0,3,2.5,2680,87117,1.0,0,0,2,7,1340,1340,1989,0.0,98024,47.5646,-121.935,2580,87117,84437,0.9692367735344422,7182400,7589371689,7582189289
275000.0,3,2.5,2030,6326,2.0,0,0,2,7,2030,0,1993,0.0,98038,47.3491,-122.029,1810,6825,4296,0.6791021182421751,4120900,40018276,35897376
1150000.0,2,2.25,2320,9300,1.5,0,4,4,9,1920,400,1937,0.0,98115,47.681000000000004,-122.273,2790,9300,6980,0.7505376344086021,5382400,86490000,81107600
455000.0,3,1.75,1760,11371,1.0,0,0,4,8,1760,0,1959,0.0,98155,47.7616,-122.273,2220,19884,9611,0.8452202972473837,3097600,129299641,126202041
262000.0,5,1.0,1870,7800,1.0,0,0,2,7,1580,290,1962,0.0,98168,47.5127,-122.321,1740,7808,5930,0.7602564102564102,3496900,60840000,57343100
390000.0,4,1.0,1280,4840,1.0,0,0,2,7,940,340,1950,0.0,98136,47.5477,-122.395,1360,4840,3560,0.7355371900826446,1638400,23425600,21787200
300000.0,3,2.25,1730,10030,1.0,0,0,3,8,1730,0,1985,0.0,98023,47.3108,-122.345,2090,8823,8300,0.827517447657029,2992900,100600900,97608000
746300.0,3,1.75,2060,5721,1.0,0,2,2,9,1140,920,1964,0.0,98136,47.5268,-122.38799999999999,2060,8124,3661,0.6399230903688167,4243600,32729841,28486241
267000.0,3,1.5,1030,8223,1.0,0,0,3,7,1030,0,1952,0.0,98148,47.4282,-122.331,1460,9463,7193,0.8747415784993311,1060900,67617729,66556829
525000.0,3,2.5,1720,7950,1.5,0,0,3,7,1720,0,1972,0.0,98034,47.7178,-122.16799999999999,1790,7030,6230,0.7836477987421384,2958400,63202500,60244100
570000.0,3,1.75,1210,7350,1.0,0,0,2,7,1210,0,1977,0.0,98033,47.7,-122.17200000000001,1610,7313,6140,0.8353741496598639,1464100,54022500,52558400
360000.0,4,2.25,2620,8100,1.0,0,0,3,7,1550,1070,1964,0.0,98166,47.4564,-122.351,1650,8100,5480,0.6765432098765433,6864400,65610000,58745600
1050000.0,3,1.0,1860,44431,1.0,0,0,3,6,1860,0,1947,0.0,98074,47.6057,-122.038,2000,44431,42571,0.9581373365443047,3459600,1974113761,1970654161
699950.0,3,2.5,2510,4106,2.0,0,0,2,9,2510,0,2003,0.0,98029,47.5494,-121.994,2470,4106,1596,0.3886994641987336,6300100,16859236,10559136
375000.0,4,2.5,2040,109336,1.5,0,0,3,8,2040,0,1973,0.0,98038,47.4193,-121.958,2370,133729,107296,0.9813419184897929,4161600,11954360896,11950199296
625000.0,4,1.75,2410,6770,1.0,0,0,3,7,1220,1190,1924,0.0,98103,47.6946,-122.336,1440,6770,4360,0.6440177252584933,5808100,45832900,40024800
464050.0,2,1.0,780,2750,1.0,0,0,3,7,780,0,1928,0.0,98116,47.5842,-122.38799999999999,1320,4440,1970,0.7163636363636363,608400,7562500,6954100
470000.0,5,2.5,2210,9655,1.0,0,0,2,8,1460,750,1976,0.0,98011,47.7698,-122.22200000000001,2080,8633,7445,0.7711030554117038,4884100,93219025,88334925
330000.0,4,2.0,1590,9100,1.0,0,0,2,7,1040,550,1967,0.0,98058,47.4465,-122.156,1670,9100,7510,0.8252747252747252,2528100,82810000,80281900
537000.0,4,1.75,2230,7957,1.0,0,0,3,7,2230,0,1967,0.0,98008,47.5859,-122.12200000000001,2230,8040,5727,0.7197436219680784,4972900,63313849,58340949
250000.0,3,2.0,1560,32137,1.0,0,0,4,7,910,650,1976,0.0,98092,47.3197,-122.117,1470,29150,30577,0.9514578212029747,2433600,1032786769,1030353169
835000.0,4,2.5,2950,48351,2.0,0,0,2,10,2950,0,1986,0.0,98075,47.5938,-122.04799999999999,2870,34417,45401,0.9389878182457446,8702500,2337819201,2329116701
770000.0,4,1.0,1480,3750,1.5,0,0,3,7,1480,0,1912,0.0,98103,47.6737,-122.354,1570,3750,2270,0.6053333333333333,2190400,14062500,11872100
650000.0,4,2.0,2850,4497,1.5,0,1,2,7,1730,1120,1910,0.0,98144,47.5876,-122.292,2450,6000,1647,0.36624416277518346,8122500,20223009,12100509
335000.0,3,1.75,2390,30409,1.0,0,0,2,7,1560,830,1953,0.0,98168,47.4789,-122.296,1750,13500,28019,0.9214048472491696,5712100,924707281,918995181
350000.0,3,1.75,1740,29597,1.0,0,0,3,7,1740,0,1965,0.0,98059,47.481,-122.115,1560,20741,27857,0.9412102577963983,3027600,875982409,872954809
415000.0,5,2.75,2060,8906,1.0,0,0,3,7,1220,840,1978,0.0,98118,47.5358,-122.289,1840,8906,6846,0.7686952616213788,4243600,79316836,75073236
788000.0,4,2.5,2680,8778,2.0,0,0,3,8,2680,0,1977,0.0,98006,47.5516,-122.161,2680,10020,6098,0.694691273638642,7182400,77053284,69870884
640000.0,4,2.75,3150,7379,1.5,0,0,3,7,2430,720,1915,0.0,98115,47.6968,-122.3,1990,7379,4229,0.5731128879251931,9922500,54449641,44527141
388000.0,4,2.5,2440,7155,2.0,0,0,2,8,2440,0,1993,0.0,98058,47.4501,-122.126,2450,8109,4715,0.6589797344514325,5953600,51194025,45240425
360000.0,6,1.75,2230,10080,1.0,0,0,2,7,1390,840,1969,0.0,98034,47.7089,-122.20100000000001,2110,8475,7850,0.7787698412698413,4972900,101606400,96633500
692500.0,6,1.75,2230,10080,1.0,0,0,2,7,1390,840,1969,0.0,98034,47.7089,-122.20100000000001,2110,8475,7850,0.7787698412698413,4972900,101606400,96633500
425000.0,4,1.5,1600,6180,1.5,0,0,2,6,1600,0,1946,0.0,98118,47.5681,-122.285,1410,6180,4580,0.7411003236245954,2560000,38192400,35632400
645000.0,4,1.5,1600,6180,1.5,0,0,2,6,1600,0,1946,0.0,98118,47.5681,-122.285,1410,6180,4580,0.7411003236245954,2560000,38192400,35632400
340000.0,3,1.0,1580,8308,1.5,0,0,2,7,1580,0,1948,0.0,98146,47.5075,-122.37899999999999,1200,8308,6728,0.809821858449687,2496400,69022864,66526464
713000.0,4,3.25,2840,54400,1.0,0,0,3,8,2840,0,1984,0.0,98053,47.6707,-122.045,2550,43560,51560,0.9477941176470588,8065600,2959360000,2951294400
430000.0,3,2.75,2550,11160,2.0,0,0,2,8,2550,0,1994,0.0,98155,47.7351,-122.323,1020,7440,8610,0.771505376344086,6502500,124545600,118043100
280000.0,3,2.25,1700,7210,1.0,0,0,3,7,1250,450,1974,0.0,98003,47.3546,-122.318,2070,7300,5510,0.7642163661581137,2890000,51984100,49094100
215000.0,3,2.0,1470,2052,1.5,0,0,2,7,1470,0,1986,0.0,98003,47.3084,-122.331,1390,2052,582,0.28362573099415206,2160900,4210704,2049804
306000.0,3,2.5,1680,11193,2.0,0,0,2,8,1680,0,1984,0.0,98058,47.4482,-122.125,2080,8084,9513,0.849906191369606,2822400,125283249,122460849
299900.0,3,1.0,1110,8593,1.0,0,0,2,7,1110,0,1979,0.0,98155,47.7595,-122.309,1780,8593,7483,0.8708250901896892,1232100,73839649,72607549
534000.0,5,1.75,2120,8625,1.0,0,0,2,7,1200,920,1959,0.0,98008,47.6118,-122.131,1930,8625,6505,0.7542028985507246,4494400,74390625,69896225
1160000.0,3,2.75,2380,5572,2.0,0,4,2,9,1930,450,1939,0.0,98105,47.6626,-122.271,3370,5500,3192,0.5728643216080402,5664400,31047184,25382784
1170000.0,3,2.5,2670,5000,2.0,0,3,4,9,2000,670,1942,1995.0,98144,47.5855,-122.292,2320,5000,2330,0.466,7128900,25000000,17871100
199990.0,2,1.0,890,6430,1.0,0,0,2,6,890,0,1935,1997.0,98022,47.2003,-121.99600000000001,1460,6430,5540,0.8615863141524106,792100,41344900,40552800
946000.0,4,3.0,3140,9058,1.0,0,0,2,9,2140,1000,1989,0.0,98006,47.5462,-122.154,2760,10018,5918,0.6533451092956503,9859600,82047364,72187764
295000.0,4,1.0,1260,7800,1.5,0,0,2,7,1260,0,1947,2007.0,98125,47.7334,-122.307,1639,7492,6540,0.8384615384615385,1587600,60840000,59252400
475000.0,2,1.0,920,5157,1.0,0,0,2,6,920,0,1909,0.0,98118,47.5499,-122.26899999999999,1700,5150,4237,0.8216017064184603,846400,26594649,25748249
750000.0,5,3.5,2990,212137,2.0,0,0,2,8,2450,540,1994,0.0,98024,47.5298,-121.887,1060,69260,209147,0.9859053347600842,8940100,45002106769,44993166669
1230000.0,4,2.5,3120,49456,2.0,1,4,3,9,2590,530,1974,1989.0,98198,47.3535,-122.323,2030,32181,46336,0.9369136201876416,9734400,2445895936,2436161536
183500.0,3,1.0,1010,7520,1.0,0,0,3,6,1010,0,1975,0.0,98001,47.2699,-122.255,1370,8469,6510,0.8656914893617021,1020100,56550400,55530300
450000.0,2,1.0,1010,3627,1.0,0,2,3,6,1010,0,1924,0.0,98144,47.5873,-122.294,1630,4040,2617,0.721532947339399,1020100,13155129,12135029
180000.0,3,1.0,1020,5500,1.5,0,0,2,7,1020,0,1961,0.0,98118,47.5502,-122.286,1160,5500,4480,0.8145454545454546,1040400,30250000,29209600
707000.0,5,4.5,3540,21217,2.0,0,0,3,8,2940,600,1926,0.0,98188,47.4274,-122.28,1290,12040,17677,0.8331526606023472,12531600,450161089,437629489
230000.0,2,0.75,900,3527,1.0,0,0,2,6,900,0,1939,0.0,98146,47.5083,-122.336,1220,4080,2627,0.744825630847746,810000,12439729,11629729
192500.0,3,1.0,1100,9750,1.0,0,0,3,7,1100,0,1966,0.0,98023,47.3248,-122.345,1190,9750,8650,0.8871794871794871,1210000,95062500,93852500
309000.0,3,2.5,1990,3614,2.0,0,0,2,7,1990,0,2005,0.0,98038,47.36,-122.039,1980,3800,1624,0.44936358605423354,3960100,13060996,9100896
759000.0,3,1.5,1980,5800,1.0,0,0,3,8,1520,460,1949,0.0,98199,47.6499,-122.413,2280,5800,3820,0.6586206896551724,3920400,33640000,29719600
1120000.0,4,3.75,4040,14212,2.0,0,0,2,11,4040,0,2002,0.0,98059,47.5189,-122.147,3940,14212,10172,0.7157331832254433,16321600,201980944,185659344
462000.0,5,1.75,1250,10530,1.0,0,0,3,7,1250,0,1966,0.0,98007,47.6101,-122.13799999999999,1560,8190,9280,0.8812915479582146,1562500,110880900,109318400
229000.0,4,1.5,1820,22814,1.5,0,0,2,7,1820,0,1920,0.0,98125,47.7321,-122.296,1770,9150,20994,0.9202244235995442,3312400,520478596,517166196
399950.0,2,2.25,1140,1184,2.0,0,0,2,8,1010,130,1999,0.0,98103,47.659,-122.346,1140,1339,44,0.037162162162162164,1299600,1401856,102256
325000.0,5,2.0,1730,10532,1.0,0,0,3,5,1730,0,1943,0.0,98056,47.5076,-122.178,1940,8501,8802,0.8357387011014052,2992900,110923024,107930124
512000.0,2,2.25,1170,1313,3.0,0,0,2,8,1170,0,2007,0.0,98107,47.6712,-122.37799999999999,1310,1304,143,0.10891089108910891,1368900,1723969,355069
410000.0,5,2.75,2910,5802,2.0,0,0,2,7,2910,0,2006,0.0,98038,47.3591,-122.036,2910,5000,2892,0.4984488107549121,8468100,33663204,25195104
210000.0,2,1.0,970,5500,1.0,0,0,2,7,970,0,1956,0.0,98118,47.556000000000004,-122.291,1180,6000,4530,0.8236363636363636,940900,30250000,29309100
325000.0,4,2.25,2130,8499,1.0,0,0,3,7,1600,0,1975,0.0,98030,47.3657,-122.21,1890,11368,6369,0.7493822802682668,4536900,72233001,67696101
685000.0,3,2.5,2520,10175,1.0,0,0,2,8,1630,890,1979,0.0,98027,47.5652,-122.089,2220,8388,7655,0.7523341523341524,6350400,103530625,97180225
488000.0,2,2.0,1360,4688,1.0,0,0,2,7,780,580,1944,0.0,98115,47.6874,-122.315,1340,4750,3328,0.7098976109215017,1849600,21977344,20127744
247500.0,3,2.25,1620,6000,1.0,0,0,2,7,1280,340,1998,0.0,98002,47.2835,-122.2,1710,6318,4380,0.73,2624400,36000000,33375600
489000.0,4,2.0,2120,11479,1.0,0,0,3,7,1060,1060,1940,0.0,98125,47.7084,-122.303,1540,11000,9359,0.8153149229026919,4494400,131767441,127273041
725000.0,4,1.75,2700,6000,1.0,0,0,3,8,1450,1250,1953,0.0,98199,47.6539,-122.395,2080,6000,3300,0.55,7290000,36000000,28710000
199950.0,3,1.5,1370,10317,1.5,0,0,2,6,1370,0,1958,0.0,98168,47.4731,-122.29799999999999,1370,9884,8947,0.8672094601143744,1876900,106440489,104563589
670000.0,5,3.0,2520,13001,2.0,0,1,2,8,2010,510,1973,0.0,98008,47.6385,-122.11399999999999,2170,8215,10481,0.8061687562495192,6350400,169026001,162675601
275000.0,3,2.0,1540,10410,1.0,0,0,3,7,1540,0,1967,0.0,98198,47.3662,-122.315,1590,7725,8870,0.8520653218059558,2371600,108368100,105996500
1000000.0,3,1.75,2610,6360,2.0,0,2,2,8,2130,480,1924,0.0,98109,47.6287,-122.351,3010,6000,3750,0.589622641509434,6812100,40449600,33637500
255000.0,3,2.0,1490,8371,1.5,0,0,2,7,1490,0,1984,0.0,98031,47.3962,-122.189,1350,7846,6881,0.8220045394815434,2220100,70073641,67853541
465000.0,3,1.75,2760,9137,1.0,0,0,2,7,1380,1380,1960,0.0,98007,47.6079,-122.132,1980,9137,6377,0.6979314873590894,7617600,83484769,75867169
259000.0,3,1.75,1260,3604,1.0,0,0,2,7,1260,0,2012,0.0,98042,47.3612,-122.103,1430,3767,2344,0.6503884572697003,1587600,12988816,11401216
695000.0,3,3.5,2630,4713,2.0,0,2,2,9,2030,600,2008,0.0,98027,47.5473,-122.016,2450,4187,2083,0.44196902185444514,6916900,22212369,15295469
505000.0,3,1.75,1800,7210,1.0,0,0,2,7,1370,430,1976,0.0,98072,47.7346,-122.17,1820,8100,5410,0.7503467406380028,3240000,51984100,48744100
631500.0,2,1.0,1130,2640,1.0,0,0,3,8,1130,0,1927,0.0,98109,47.6438,-122.35700000000001,1680,3200,1510,0.571969696969697,1276900,6969600,5692700
630500.0,3,1.0,1180,3600,1.5,0,0,2,7,1180,0,1926,0.0,98112,47.6337,-122.28,1900,3600,2420,0.6722222222222223,1392400,12960000,11567600
999000.0,4,2.75,2800,19168,2.0,0,0,2,10,2800,0,1992,0.0,98075,47.5911,-122.037,2010,16020,16368,0.8539232053422371,7840000,367412224,359572224
740000.0,3,1.5,1830,4000,1.0,0,0,3,7,1350,480,1910,0.0,98119,47.6453,-122.37100000000001,1570,3672,2170,0.5425,3348900,16000000,12651100
650000.0,3,2.5,2220,6380,1.5,0,0,3,8,1660,560,1931,0.0,98115,47.6974,-122.31299999999999,950,6380,4160,0.6520376175548589,4928400,40704400,35776000
554000.0,2,2.0,1870,5580,1.0,0,0,2,8,1870,0,2004,0.0,98053,47.7101,-122.031,1670,4500,3710,0.6648745519713262,3496900,31136400,27639500
400000.0,3,2.5,2580,214315,1.5,0,0,2,8,2580,0,1946,1986.0,98053,47.6465,-122.024,2580,70131,211735,0.987961645241817,6656400,45930919225,45924262825
529941.0,3,2.0,1660,10000,1.0,0,0,3,7,1010,650,1961,0.0,98005,47.5852,-122.17399999999999,2020,9720,8340,0.834,2755600,100000000,97244400
310000.0,3,1.0,1330,3740,1.5,0,0,2,6,1330,0,1903,0.0,98118,47.5502,-122.274,1330,5053,2410,0.6443850267379679,1768900,13987600,12218700
389000.0,3,1.0,1330,3740,1.5,0,0,2,6,1330,0,1903,0.0,98118,47.5502,-122.274,1330,5053,2410,0.6443850267379679,1768900,13987600,12218700
731781.0,3,3.0,2630,4972,2.0,0,0,2,9,2630,0,2006,0.0,98052,47.69300000000001,-122.133,2880,4972,2342,0.47103781174577636,6916900,24720784,17803884
502501.0,2,1.0,1100,4750,1.0,0,0,2,7,1100,0,1946,0.0,98116,47.5772,-122.381,1830,4750,3650,0.7684210526315789,1210000,22562500,21352500
443000.0,3,1.75,1810,7950,1.0,0,0,3,7,1810,0,1968,0.0,98008,47.6236,-122.117,1680,7725,6140,0.7723270440251573,3276100,63202500,59926400
607000.0,3,2.0,2060,4080,1.0,0,0,4,7,1060,1000,1921,0.0,98144,47.574,-122.289,1400,4080,2020,0.4950980392156863,4243600,16646400,12402800
2150000.0,3,3.5,4660,5500,2.0,0,4,4,10,3040,1620,1909,0.0,98102,47.6465,-122.319,2980,5500,840,0.15272727272727274,21715600,30250000,8534400
585000.0,4,2.5,2370,15200,1.0,0,0,2,8,1660,710,1975,0.0,98052,47.6295,-122.089,2360,13879,12830,0.844078947368421,5616900,231040000,225423100
1030000.0,3,2.5,2430,10500,2.0,0,1,2,9,2430,0,1989,0.0,98004,47.5818,-122.198,3440,12842,8070,0.7685714285714286,5904900,110250000,104345100
315000.0,3,2.5,1880,7000,2.0,0,0,2,8,1880,0,1993,0.0,98031,47.4206,-122.184,1880,7000,5120,0.7314285714285714,3534400,49000000,45465600
180000.0,2,1.0,1150,5695,1.0,0,0,3,6,1150,0,1958,0.0,98056,47.4989,-122.171,1150,5695,4545,0.7980684811237928,1322500,32433025,31110525
322500.0,3,2.0,1350,14200,1.0,0,0,2,7,1350,0,1989,0.0,98019,47.7315,-121.97200000000001,2100,15101,12850,0.9049295774647887,1822500,201640000,199817500
568500.0,3,2.75,2180,7519,1.0,0,0,3,7,1310,870,1981,0.0,98052,47.6959,-122.125,1510,7107,5339,0.7100678281686394,4752400,56535361,51782961
813000.0,4,2.75,3370,6675,1.0,0,3,3,8,1920,1450,1948,0.0,98144,47.5887,-122.291,2250,5550,3305,0.4951310861423221,11356900,44555625,33198725
1090000.0,5,2.25,3650,13068,1.0,0,0,3,10,1850,1800,1976,0.0,98040,47.5458,-122.23100000000001,2760,13927,9418,0.7206917661463116,13322500,170772624,157450124
424000.0,4,2.0,2100,4857,2.0,0,0,2,8,2100,0,1965,1984.0,98155,47.7521,-122.279,1450,5965,2757,0.5676343421865349,4410000,23590449,19180449
235000.0,2,1.0,670,5600,1.0,0,0,2,6,670,0,1903,0.0,98108,47.5498,-122.304,1960,7176,4930,0.8803571428571428,448900,31360000,30911100
740000.0,3,3.5,2420,4000,2.0,0,0,4,9,1820,600,1907,0.0,98122,47.6054,-122.295,2030,4550,1580,0.395,5856400,16000000,10143600
415000.0,1,1.0,760,3000,1.0,0,0,2,7,760,0,1900,0.0,98122,47.6059,-122.303,1270,3000,2240,0.7466666666666667,577600,9000000,8422400
432000.0,3,2.75,2200,14925,1.0,0,0,2,6,1100,1100,1982,0.0,98053,47.6606,-122.059,1520,14212,12725,0.8525963149078727,4840000,222755625,217915625
1270000.0,5,3.25,4410,35192,2.0,0,2,2,12,3880,530,1990,0.0,98072,47.7522,-122.13,4410,59677,30782,0.8746874289611275,19448100,1238476864,1219028764
676500.0,3,1.75,1300,2446,1.0,0,3,2,8,880,420,1961,0.0,98122,47.6071,-122.285,2440,5051,1146,0.46852003270645953,1690000,5982916,4292916
419000.0,2,1.0,720,4592,1.0,0,0,3,6,720,0,1943,0.0,98199,47.6534,-122.404,1030,5816,3872,0.8432055749128919,518400,21086464,20568064
650000.0,3,2.5,2180,37042,2.0,0,0,2,9,2180,0,1998,0.0,98077,47.722,-122.02600000000001,2880,32688,34862,0.9411478861832514,4752400,1372109764,1367357364
239000.0,2,1.0,1130,15190,1.0,0,0,3,7,1130,0,1954,0.0,98032,47.3902,-122.28299999999999,1490,16920,14060,0.9256089532587228,1276900,230736100,229459200
900000.0,4,2.5,2230,4372,2.0,0,0,4,8,1540,690,1935,0.0,98103,47.6698,-122.334,2020,4372,2142,0.489935956084172,4972900,19114384,14141484
330000.0,5,1.75,2100,7347,1.0,0,0,2,7,1070,1030,1981,0.0,98028,47.7751,-122.26799999999999,2170,9418,5247,0.7141690485912617,4410000,53978409,49568409
510000.0,3,1.75,2060,58341,1.0,0,4,2,8,1100,960,1982,0.0,98070,47.4193,-122.439,1230,14904,56281,0.9646903549819167,4243600,3403672281,3399428681
465000.0,4,2.5,3060,6000,2.0,0,0,2,9,3060,0,2012,0.0,98038,47.3689,-122.05799999999999,3040,6000,2940,0.49,9363600,36000000,26636400
1700000.0,3,2.75,2810,18731,2.0,1,4,3,10,2810,0,1974,0.0,98052,47.6361,-122.09299999999999,3120,14810,15921,0.8499813143985906,7896100,350850361,342954261
490000.0,3,2.25,2550,8588,1.0,0,4,2,9,2550,0,1989,0.0,98011,47.7711,-122.195,3050,8588,6038,0.7030740568234746,6502500,73753744,67251244
2680000.0,5,3.0,4290,20445,2.0,0,0,3,11,4290,0,1985,0.0,98039,47.6217,-122.23899999999999,3620,22325,16155,0.7901687454145268,18404100,417998025,399593925
1000000.0,3,2.25,3040,52302,1.0,0,0,2,9,3040,0,2005,0.0,98072,47.7635,-122.11200000000001,2070,38600,49262,0.9418760276853657,9241600,2735499204,2726257604
469950.0,4,2.75,2530,14178,2.0,0,0,2,8,2530,0,1997,0.0,98019,47.736999999999995,-121.955,2530,14055,11648,0.8215545210890112,6400900,201015684,194614784
536000.0,3,1.75,1300,5413,1.5,0,0,2,7,1300,0,1925,0.0,98115,47.6988,-122.32,1590,6380,4113,0.7598374284130797,1690000,29300569,27610569
244950.0,4,2.5,1790,19177,1.0,0,0,3,7,1790,0,1966,0.0,98030,47.3617,-122.17200000000001,1760,11726,17387,0.9066590186160505,3204100,367757329,364553229
575000.0,3,1.0,1530,2400,1.0,0,0,3,7,890,640,1928,0.0,98103,47.6543,-122.354,1240,2400,870,0.3625,2340900,5760000,3419100
361000.0,5,2.75,2380,7500,1.0,0,0,2,7,1300,1080,1984,0.0,98178,47.5009,-122.235,2400,6000,5120,0.6826666666666666,5664400,56250000,50585600
650000.0,5,2.25,2400,13450,1.0,0,0,4,7,1200,1200,1957,0.0,98008,47.6007,-122.117,1950,10361,11050,0.8215613382899628,5760000,180902500,175142500
230005.0,2,1.0,1030,6000,1.0,0,0,1,7,830,200,1951,0.0,98118,47.5291,-122.26799999999999,1770,5000,4970,0.8283333333333334,1060900,36000000,34939100
293000.0,4,2.5,3250,235063,1.0,0,2,2,9,3250,0,1973,0.0,98092,47.2582,-122.113,1600,44287,231813,0.9861739193322642,10562500,55254613969,55244051469
445000.0,3,3.0,1970,24318,1.0,0,0,2,8,1970,0,2010,0.0,98028,47.7651,-122.24600000000001,2150,14695,22348,0.9189900485237272,3880900,591365124,587484224
280000.0,4,1.5,1940,6386,1.0,0,0,2,7,1140,800,1954,0.0,98118,47.5533,-122.285,1340,6165,4446,0.6962104603820858,3763600,40780996,37017396
520000.0,3,2.25,1850,10855,1.0,0,0,2,8,1370,480,1985,0.0,98029,47.5696,-122.02,1850,8209,9005,0.8295716259788116,3422500,117831025,114408525
780000.0,4,3.25,3900,40962,2.0,0,0,2,10,3900,0,1991,0.0,98053,47.683,-122.06299999999999,1730,11775,37062,0.9047898051852937,15210000,1677885444,1662675444
625000.0,3,1.75,3160,76230,1.0,0,0,3,8,2160,1000,1978,0.0,98001,47.273999999999994,-122.287,1990,45789,73070,0.9585465040010495,9985600,5811012900,5801027300
239950.0,3,1.75,1440,7200,1.0,0,0,2,7,1440,0,1986,0.0,98188,47.4473,-122.28399999999999,1640,9167,5760,0.8,2073600,51840000,49766400
335000.0,3,1.5,2040,6000,1.0,0,0,2,7,1340,700,1957,0.0,98118,47.5218,-122.286,1190,6000,3960,0.66,4161600,36000000,31838400
612000.0,3,2.5,2120,7401,2.0,0,0,2,8,2120,0,1989,0.0,98029,47.5781,-122.01799999999999,2010,7972,5281,0.7135522226726118,4494400,54774801,50280401
200000.0,2,1.0,830,8000,1.0,0,0,2,6,830,0,1954,0.0,98198,47.4215,-122.318,1300,8000,7170,0.89625,688900,64000000,63311100
345000.0,3,1.75,3140,8571,1.0,0,0,3,8,1670,1470,1985,0.0,98023,47.3074,-122.337,2590,7949,5431,0.6336483490841208,9859600,73462041,63602441
520000.0,4,2.5,2410,6440,1.0,0,0,2,8,1550,860,1974,0.0,98034,47.7153,-122.191,2330,6938,4030,0.6257763975155279,5808100,41473600,35665500
855000.0,4,2.25,2190,4080,2.0,0,0,2,8,1800,390,1918,0.0,98119,47.6425,-122.35799999999999,2100,4080,1890,0.4632352941176471,4796100,16646400,11850300
567500.0,4,1.75,2190,5060,1.0,0,0,2,7,1190,1000,1950,0.0,98116,47.5846,-122.387,1510,4600,2870,0.567193675889328,4796100,25603600,20807500
208000.0,3,1.5,1210,7247,1.0,0,0,3,7,1210,0,1967,0.0,98003,47.328,-122.321,1370,7869,6037,0.8330343590451221,1464100,52519009,51054909
452000.0,3,1.75,1880,16239,1.0,0,0,2,7,880,1000,1922,0.0,98115,47.7004,-122.304,1260,7528,14359,0.8842293244657923,3534400,263705121,260170721
555000.0,3,3.0,2410,12183,2.0,0,0,2,9,2410,0,1988,0.0,98011,47.747,-122.177,2540,9979,9773,0.8021833702700484,5808100,148425489,142617389
519000.0,5,2.75,2620,8861,1.0,0,0,4,8,1350,1270,1979,0.0,98056,47.5226,-122.18299999999999,1940,10800,6241,0.7043223112515518,6864400,78517321,71652921
474950.0,3,2.25,1850,2575,2.0,0,0,2,9,1850,0,2013,0.0,98118,47.5525,-122.273,1080,4120,725,0.2815533980582524,3422500,6630625,3208125
419000.0,3,2.25,1760,16418,1.0,0,0,2,7,1190,570,1990,0.0,98053,47.6525,-121.985,2260,20747,14658,0.8928005847240833,3097600,269550724,266453124
390000.0,2,1.0,860,1800,1.0,0,0,2,7,860,0,1909,0.0,98119,47.6334,-122.37100000000001,2160,3120,940,0.5222222222222223,739600,3240000,2500400
539000.0,7,2.25,2620,6890,2.0,0,0,3,7,2620,0,1961,0.0,98007,47.6123,-122.134,2070,7910,4270,0.6197387518142236,6864400,47472100,40607700
569000.0,4,1.75,2400,21196,1.0,0,0,4,8,1590,810,1956,0.0,98166,47.4282,-122.34700000000001,2200,19134,18796,0.8867710888846952,5760000,449270416,443510416
611000.0,3,1.0,1850,5000,1.5,0,0,2,7,1850,0,1922,0.0,98103,47.6727,-122.351,1850,5000,3150,0.63,3422500,25000000,21577500
760000.0,3,2.5,4040,147856,2.0,0,0,2,9,4040,0,2004,0.0,98092,47.2711,-122.06700000000001,3000,125452,143816,0.9726761173033222,16321600,21861396736,21845075136
732000.0,3,2.0,1940,55756,1.0,0,0,4,9,1940,0,1954,0.0,98007,47.5913,-122.149,2330,10018,53816,0.9652055384173901,3763600,3108731536,3104967936
1680000.0,3,2.5,3490,8343,2.0,1,4,3,9,2150,1340,1939,0.0,98125,47.7265,-122.281,2990,13104,4853,0.5816852451156658,12180100,69605649,57425549
919950.0,5,2.75,3170,7062,2.0,0,0,2,9,3170,0,2014,0.0,98074,47.5937,-122.061,3210,6891,3892,0.551118663268196,10048900,49871844,39822944
400000.0,4,2.5,2530,7563,1.0,0,0,2,7,1440,1090,1978,0.0,98011,47.7762,-122.21,1960,7811,5033,0.6654766626999867,6400900,57198969,50798069
785000.0,4,2.5,3230,21781,2.0,0,0,2,9,3230,0,1993,0.0,98053,47.6318,-122.01,3230,21780,18551,0.8517056149855379,10432900,474411961,463979061
835000.0,3,2.25,2120,54014,2.0,0,0,3,9,2120,0,1964,0.0,98005,47.6482,-122.15899999999999,3280,50690,51894,0.960750916429074,4494400,2917512196,2913017796
640500.0,2,1.75,1640,6750,1.0,0,0,3,8,1340,300,1939,0.0,98125,47.7068,-122.30799999999999,1760,7490,5110,0.7570370370370371,2689600,45562500,42872900
310000.0,4,2.5,2130,9013,2.0,0,0,2,8,2130,0,1988,0.0,98001,47.3208,-122.273,2350,8982,6883,0.7636746921113946,4536900,81234169,76697269
355000.0,4,1.0,1440,7215,1.5,0,0,2,7,1440,0,1969,0.0,98034,47.7133,-122.212,1150,7215,5775,0.8004158004158004,2073600,52056225,49982625
685000.0,3,1.75,1940,7313,1.0,0,1,3,8,1440,500,1960,0.0,98136,47.5239,-122.387,2160,7200,5373,0.734718993573089,3763600,53479969,49716369
202500.0,3,1.0,1120,8576,1.0,0,0,2,6,1120,0,1943,0.0,98178,47.4896,-122.24799999999999,1050,8812,7456,0.8694029850746269,1254400,73547776,72293376
540000.0,3,2.5,2400,5817,2.0,0,0,2,8,2400,0,1998,0.0,98065,47.5371,-121.87,2420,5817,3417,0.5874161939143888,5760000,33837489,28077489
295000.0,4,2.5,1810,4871,2.0,0,0,2,8,1810,0,1999,0.0,98031,47.4088,-122.19200000000001,1850,5003,3061,0.6284130568671731,3276100,23726641,20450541
518000.0,3,1.0,1270,6612,1.5,0,3,2,7,1270,0,1927,0.0,98118,47.5433,-122.264,2100,7680,5342,0.8079249848759831,1612900,43718544,42105644
250000.0,2,1.75,1350,4023,1.0,0,0,2,7,1350,0,2005,0.0,98038,47.3493,-122.023,1370,3570,2673,0.6644295302013423,1822500,16184529,14362029
330000.0,2,2.0,1550,435600,1.5,0,0,1,7,1550,0,1972,0.0,98065,47.5145,-121.853,1600,217800,434050,0.9964416896235078,2402500,189747360000,189744957500
481000.0,2,1.0,1620,3880,1.0,0,0,3,7,920,700,1924,0.0,98117,47.6855,-122.391,1330,3880,2260,0.5824742268041238,2624400,15054400,12430000
898000.0,3,2.25,2650,12845,1.0,0,3,2,9,1770,880,1977,0.0,98034,47.7209,-122.256,2650,12902,10195,0.7936940443752433,7022500,164994025,157971525
570000.0,5,1.75,2510,9750,1.5,0,0,2,8,2510,0,1969,0.0,98052,47.6635,-122.149,1900,9750,7240,0.7425641025641025,6300100,95062500,88762400
475000.0,4,2.5,2040,16200,2.0,0,0,2,8,2040,0,1997,0.0,98019,47.7366,-121.958,2530,15389,14160,0.8740740740740741,4161600,262440000,258278400
265000.0,3,2.5,1660,5250,2.0,0,0,3,8,1660,0,1988,0.0,98003,47.3541,-122.3,1630,5505,3590,0.6838095238095238,2755600,27562500,24806900
380000.0,3,2.5,1980,17342,2.0,1,4,2,10,1580,400,1984,0.0,98166,47.4551,-122.37299999999999,2060,17313,15362,0.8858263176104255,3920400,300744964,296824564
790000.0,4,2.5,2690,8036,2.0,0,0,3,9,2690,0,1987,0.0,98007,47.6596,-122.14399999999999,2420,8087,5346,0.6652563464410154,7236100,64577296,57341196
620000.0,2,2.25,2910,6110,2.0,0,2,3,9,2910,0,1985,0.0,98136,47.5279,-122.387,2090,5763,3200,0.5237315875613748,8468100,37332100,28864000
709050.0,4,3.5,2720,9000,2.0,0,0,2,8,2670,50,1997,0.0,98125,47.7034,-122.29700000000001,1960,7772,6280,0.6977777777777778,7398400,81000000,73601600
296500.0,3,1.0,1280,5100,1.0,0,0,2,7,1280,0,1948,0.0,98126,47.5259,-122.38,1380,7140,3820,0.7490196078431373,1638400,26010000,24371600
475000.0,3,2.5,2160,35912,2.0,0,0,2,8,2160,0,1982,0.0,98077,47.7273,-122.083,2230,35244,33752,0.9398529739362887,4665600,1289671744,1285006144
440000.0,3,2.25,1760,10835,1.0,0,0,3,8,1290,470,1976,0.0,98027,47.522,-122.04799999999999,2050,10488,9075,0.8375634517766497,3097600,117397225,114299625
405000.0,2,1.0,800,6016,1.0,0,0,2,6,800,0,1942,0.0,98117,47.6913,-122.369,1470,3734,5216,0.8670212765957447,640000,36192256,35552256
269500.0,2,1.0,930,4000,1.0,0,0,2,6,730,200,1943,0.0,98108,47.5321,-122.323,1100,5000,3070,0.7675,864900,16000000,15135100
520000.0,5,1.75,2040,5280,1.0,0,0,3,7,1020,1020,1961,0.0,98007,47.5941,-122.14399999999999,1720,7344,3240,0.6136363636363636,4161600,27878400,23716800
229500.0,1,1.0,1180,22000,1.0,0,2,2,6,1180,0,1948,0.0,98198,47.4007,-122.323,1890,11761,20820,0.9463636363636364,1392400,484000000,482607600
335000.0,4,1.75,2000,10890,1.0,0,0,3,7,1390,610,1961,0.0,98003,47.3203,-122.321,1520,9250,8890,0.8163452708907254,4000000,118592100,114592100
680000.0,4,2.75,3310,50951,2.0,0,0,2,9,3310,0,1998,0.0,98077,47.7249,-122.027,3230,39340,47641,0.9350356224607956,10956100,2596004401,2585048301
1390000.0,4,3.5,3130,3900,2.0,0,0,2,9,2550,580,2008,0.0,98115,47.6849,-122.32700000000001,1830,3900,770,0.19743589743589743,9796900,15210000,5413100
740000.0,4,2.5,2300,9900,1.0,0,2,2,8,1600,700,1961,0.0,98136,47.5256,-122.385,2510,7500,7600,0.7676767676767676,5290000,98010000,92720000
270000.0,3,2.25,2140,9990,1.0,0,0,3,8,2140,0,1962,0.0,98003,47.3484,-122.29799999999999,2060,9990,7850,0.7857857857857858,4579600,99800100,95220500
510000.0,4,2.0,2210,5572,1.5,0,3,2,7,1760,450,1911,0.0,98126,47.5727,-122.376,1760,4713,3362,0.6033740129217516,4884100,31047184,26163084
300000.0,2,1.0,970,13700,1.0,0,0,2,6,970,0,1949,0.0,98106,47.515,-122.36200000000001,1570,10880,12730,0.9291970802919708,940900,187690000,186749100
1300000.0,5,2.25,2690,10800,1.0,0,3,3,8,2020,670,1956,0.0,98040,47.5821,-122.24700000000001,3380,9134,8110,0.7509259259259259,7236100,116640000,109403900
675000.0,4,2.0,1890,5188,1.5,0,0,3,7,1670,220,1940,0.0,98105,47.6633,-122.287,1800,4848,3298,0.6356977640709329,3572100,26915344,23343244
925850.0,6,3.25,3140,14923,2.0,0,0,2,10,3140,0,1991,0.0,98006,47.5411,-122.133,2980,10758,11783,0.7895865442605374,9859600,222695929,212836329
255500.0,2,1.0,1440,43560,1.0,0,0,3,7,1150,290,1965,0.0,98027,47.4916,-122.08200000000001,1870,56628,42120,0.9669421487603306,2073600,1897473600,1895400000
450000.0,3,2.5,2910,17172,2.0,0,0,2,10,2910,0,1989,0.0,98003,47.2789,-122.331,2910,20048,14262,0.8305380852550663,8468100,294877584,286409484
280000.0,3,1.0,1310,22652,1.0,0,0,2,7,1310,0,1968,0.0,98092,47.2574,-122.072,1600,103672,21342,0.942168461945965,1716100,513113104,511397004
245000.0,4,2.25,2140,8800,2.0,0,0,3,7,2140,0,1963,0.0,98032,47.3655,-122.291,2060,9790,6660,0.7568181818181818,4579600,77440000,72860400
344950.0,3,1.0,1090,6712,1.0,0,0,3,7,1090,0,1972,0.0,98034,47.7155,-122.211,1440,7350,5622,0.8376042908224076,1188100,45050944,43862844
381000.0,3,1.75,1330,7216,1.0,0,0,2,7,1330,0,1969,0.0,98034,47.7199,-122.18,1500,8000,5886,0.8156873614190687,1768900,52070656,50301756
1950000.0,4,4.0,4690,6900,2.0,0,0,2,11,3480,1210,2001,0.0,98004,47.6165,-122.21600000000001,2800,11240,2210,0.32028985507246377,21996100,47610000,25613900
1500000.0,3,1.5,1910,21374,1.0,0,0,0,8,1910,0,1955,0.0,98004,47.6453,-122.214,2850,16167,19464,0.9106390942266305,3648100,456847876,453199776
232603.0,3,1.75,1750,11461,2.0,0,0,3,7,1750,0,1976,0.0,98002,47.3173,-122.21,2140,11276,9711,0.8473082628042928,3062500,131354521,128292021
220000.0,5,2.5,1760,10200,1.5,0,0,2,6,1760,0,1925,0.0,98106,47.5271,-122.351,1370,7620,8440,0.8274509803921568,3097600,104040000,100942400
600000.0,4,1.75,1810,7700,1.0,0,0,4,8,1390,420,1977,0.0,98033,47.6976,-122.169,2080,7700,5890,0.7649350649350649,3276100,59290000,56013900
239000.0,3,2.5,1360,5754,2.0,0,0,2,7,1360,0,1994,0.0,98030,47.3645,-122.18299999999999,1360,7050,4394,0.7636426833507125,1849600,33108516,31258916
400000.0,3,1.75,1730,9211,1.0,0,0,2,8,1730,0,1961,0.0,98125,47.7149,-122.322,1440,9211,7481,0.8121810878297687,2992900,84842521,81849621
2180000.0,6,2.75,4710,11000,2.0,0,3,2,10,3690,1020,1931,0.0,98105,47.6622,-122.272,2950,5300,6290,0.5718181818181818,22184100,121000000,98815900
350000.0,3,1.0,1010,8551,1.0,0,0,4,7,1010,0,1953,0.0,98155,47.7351,-122.295,1310,8504,7541,0.8818851596304526,1020100,73119601,72099501
562000.0,3,2.5,2400,97138,2.0,0,0,4,8,2400,0,1983,0.0,98077,47.7361,-122.046,2230,54450,94738,0.9752928822911734,5760000,9435791044,9430031044
380000.0,3,1.5,1540,8400,1.0,0,0,4,7,1540,0,1968,0.0,98056,47.5237,-122.199,1690,7689,6860,0.8166666666666667,2371600,70560000,68188400
511200.0,4,1.75,1480,7875,1.0,0,0,2,7,740,740,1927,0.0,98199,47.643,-122.397,1680,5851,6395,0.812063492063492,2190400,62015625,59825225
680000.0,4,2.5,2520,5000,2.0,0,0,2,9,2520,0,2004,0.0,98029,47.5524,-121.992,2910,5001,2480,0.496,6350400,25000000,18649600
350000.0,3,3.25,1210,941,2.0,0,0,2,8,1000,210,2002,0.0,98133,47.7114,-122.35600000000001,1650,1493,-269,-0.2858660998937301,1464100,885481,-578619
410000.0,5,2.5,2670,184140,1.0,0,0,2,8,1410,1260,1980,0.0,98042,47.3429,-122.09700000000001,1860,35719,181470,0.9855001629195178,7128900,33907539600,33900410700
1050000.0,4,2.5,3030,12590,1.5,0,0,3,10,3030,0,1988,0.0,98004,47.5806,-122.193,2980,11635,9560,0.7593328038125496,9180900,158508100,149327200
391265.0,3,2.0,1440,3900,1.0,0,0,2,8,1440,0,2002,0.0,98053,47.7022,-122.021,1350,3900,2460,0.6307692307692307,2073600,15210000,13136400
1410000.0,4,2.25,3250,16684,2.0,0,0,2,9,3250,0,1979,0.0,98039,47.6334,-122.229,2890,16927,13434,0.8052025893071206,10562500,278355856,267793356
575000.0,3,2.0,1750,5750,1.0,0,2,4,7,870,880,1956,0.0,98116,47.5579,-122.384,1750,5750,4000,0.6956521739130435,3062500,33062500,30000000
316000.0,4,1.5,2120,46173,2.0,0,0,2,7,2120,0,1974,0.0,98053,47.6503,-121.96799999999999,2000,46173,44053,0.9540857210924133,4494400,2131945929,2127451529
165000.0,3,1.0,1050,5156,1.5,0,0,2,7,1050,0,1919,0.0,98106,47.5169,-122.35799999999999,1050,5502,4106,0.7963537626066718,1102500,26584336,25481836
850000.0,3,2.25,1950,3600,1.5,0,0,4,8,1430,520,1911,0.0,98119,47.637,-122.363,1950,3600,1650,0.4583333333333333,3802500,12960000,9157500
210000.0,3,1.0,1020,6000,1.0,0,0,2,5,1020,0,1900,0.0,98027,47.5281,-122.031,2070,7200,4980,0.83,1040400,36000000,34959600
325000.0,4,2.5,1820,9161,1.0,0,0,3,7,1220,600,1975,0.0,98058,47.4333,-122.16799999999999,1860,7650,7341,0.8013317323436306,3312400,83923921,80611521
682000.0,4,2.5,2390,53941,2.0,0,0,2,8,2390,0,1989,0.0,98053,47.7066,-122.08,2610,104108,51551,0.9556923305092602,5712100,2909631481,2903919381
430000.0,3,2.5,1400,7508,2.0,0,0,3,7,1400,0,1987,0.0,98034,47.7233,-122.167,1710,7700,6108,0.813532232285562,1960000,56370064,54410064
325500.0,3,1.5,1540,8110,1.0,0,0,3,7,1190,350,1959,0.0,98125,47.7329,-122.291,1290,8110,6570,0.8101109741060419,2371600,65772100,63400500
385000.0,3,1.75,2370,6360,1.0,0,3,2,7,1280,1090,1954,0.0,98178,47.5039,-122.24,1990,6360,3990,0.6273584905660378,5616900,40449600,34832700
435000.0,1,1.0,670,1800,1.0,0,0,4,6,670,0,1905,0.0,98103,47.653999999999996,-122.35,1330,3360,1130,0.6277777777777778,448900,3240000,2791100
550000.0,4,1.0,2420,15520,2.0,0,0,3,7,2420,0,1945,0.0,98006,47.5744,-122.137,1630,9965,13100,0.8440721649484536,5856400,240870400,235014000
400000.0,3,1.0,1000,7800,1.0,0,0,3,6,860,0,1930,0.0,98125,47.7098,-122.28299999999999,1700,7800,6800,0.8717948717948718,1000000,60840000,59840000
503000.0,4,2.75,2100,7350,1.0,0,0,4,7,1240,860,1978,0.0,98034,47.7194,-122.17200000000001,2490,7350,5250,0.7142857142857143,4410000,54022500,49612500
676000.0,4,2.5,2800,5368,2.0,0,0,2,8,2800,0,2003,0.0,98074,47.6076,-122.053,2790,5368,2568,0.4783904619970194,7840000,28815424,20975424
180000.0,3,1.0,940,11055,1.5,0,0,3,7,940,0,1959,0.0,98032,47.3732,-122.295,1420,9100,10115,0.9149706015377658,883600,122213025,121329425
234000.0,3,2.0,1640,5280,1.5,0,0,4,6,1640,0,1910,0.0,98002,47.3089,-122.213,1160,7875,3640,0.6893939393939394,2689600,27878400,25188800
734200.0,4,2.5,2760,5000,1.5,0,0,4,7,1680,1080,1928,0.0,98107,47.6726,-122.37100000000001,1850,5000,2240,0.448,7617600,25000000,17382400
920000.0,3,3.25,3660,66211,2.0,0,0,2,10,3660,0,2003,0.0,98038,47.4087,-122.06200000000001,3660,107153,62551,0.9447221760734621,13395600,4383896521,4370500921
1920000.0,4,2.5,3070,34412,1.0,0,3,3,9,2070,1000,1950,0.0,98039,47.64,-122.24,3780,27940,31342,0.9107869347901895,9424900,1184185744,1174760844
224000.0,3,1.75,1100,10125,1.0,0,0,3,7,1100,0,1969,0.0,98092,47.3232,-122.103,1520,10125,9025,0.891358024691358,1210000,102515625,101305625
1400000.0,3,2.75,3130,19530,1.0,1,4,2,8,1690,1440,1947,1984.0,98008,47.5895,-122.111,2980,18782,16400,0.8397337429595494,9796900,381420900,371624000
185000.0,3,1.0,1320,7155,1.0,0,0,3,6,1320,0,1961,0.0,98002,47.2857,-122.22,1070,8100,5835,0.8155136268343816,1742400,51194025,49451625
554600.0,3,1.75,1470,5000,1.5,0,0,4,7,1470,0,1900,0.0,98107,47.6755,-122.369,1530,5000,3530,0.706,2160900,25000000,22839100
268000.0,3,1.75,1480,8009,1.0,0,0,2,7,980,500,1980,0.0,98032,47.3657,-122.28,1790,7678,6529,0.8152078911224871,2190400,64144081,61953681
675000.0,4,2.25,2260,8715,1.0,0,0,3,8,1530,730,1976,0.0,98008,47.6237,-122.10600000000001,2220,8650,6455,0.7406769936890418,5107600,75951225,70843625
620000.0,4,2.25,2210,10039,1.0,0,0,3,8,1710,500,1967,0.0,98052,47.63399999999999,-122.101,2070,10965,7829,0.7798585516485705,4884100,100781521,95897421
396450.0,3,1.75,1540,12446,1.0,0,0,4,8,1540,0,1967,0.0,98027,47.5172,-122.027,1330,11508,10906,0.876265466816648,2371600,154902916,152531316
565000.0,5,1.75,1910,9720,1.0,0,0,3,7,1390,520,1955,0.0,98006,47.5772,-122.15899999999999,1750,9720,7810,0.8034979423868313,3648100,94478400,90830300
410000.0,3,1.75,1760,3520,1.0,0,0,2,7,1160,600,1966,0.0,98144,47.5773,-122.303,1840,5000,1760,0.5,3097600,12390400,9292800
1190000.0,4,3.0,2240,6000,1.5,0,0,3,8,1270,970,1914,0.0,98109,47.6369,-122.35,2240,4250,3760,0.6266666666666667,5017600,36000000,30982400
716125.0,3,2.25,2110,7279,1.0,0,0,3,9,2110,0,1984,0.0,98033,47.6669,-122.17,2130,7279,5169,0.7101250171726886,4452100,52983841,48531741
225000.0,2,1.0,1396,111949,1.0,0,0,2,7,1396,0,1940,1997.0,98053,47.6374,-122.007,2020,111949,110553,0.9875300359985351,1948816,12532578601,12530629785
640000.0,4,2.75,3040,7274,2.0,0,3,2,9,2320,720,1986,0.0,98125,47.7184,-122.28,2830,10080,4234,0.5820731372009899,9241600,52911076,43669476
374000.0,2,1.0,1140,5650,1.0,0,1,2,6,980,160,1920,0.0,98116,47.5634,-122.391,1220,5700,4510,0.7982300884955752,1299600,31922500,30622900
415000.0,4,2.0,1780,12161,1.0,0,0,4,7,1160,620,1950,0.0,98155,47.7746,-122.323,1780,8170,10381,0.8536304580215442,3168400,147889921,144721521
592500.0,4,2.5,3370,35150,1.0,0,0,4,8,1770,1600,1993,0.0,98027,47.46100000000001,-122.00200000000001,2920,41241,31780,0.9041251778093883,11356900,1235522500,1224165600
365000.0,3,2.5,1484,1761,3.0,0,0,2,7,1484,0,2003,0.0,98115,47.6844,-122.31700000000001,1484,4320,277,0.1572969903463941,2202256,3101121,898865
600000.0,4,2.5,2230,12753,1.0,0,0,3,7,1180,1050,1981,0.0,98074,47.6297,-122.03299999999999,1860,12753,10523,0.8251391829373481,4972900,162639009,157666109
465000.0,4,2.5,2820,39413,2.0,0,0,3,9,2820,0,1989,0.0,98092,47.3064,-122.1,2910,39413,36593,0.9284500038058509,7952400,1553384569,1545432169
254999.0,3,1.0,1580,7560,1.0,0,0,3,7,1000,580,1976,0.0,98001,47.3318,-122.277,1580,7560,5980,0.791005291005291,2496400,57153600,54657200
279000.0,4,2.5,2040,8076,2.0,0,0,2,7,2040,0,1994,0.0,98042,47.3691,-122.074,2040,8408,6036,0.7473997028231798,4161600,65221776,61060176
460000.0,3,2.5,2720,40813,2.0,0,0,2,8,2720,0,2001,0.0,98001,47.2619,-122.271,2250,40511,38093,0.9333545683973243,7398400,1665700969,1658302569
507000.0,4,2.25,1490,956,2.0,0,0,2,7,1020,470,2005,0.0,98122,47.6184,-122.301,1510,1350,-534,-0.5585774058577406,2220100,913936,-1306164
291000.0,3,1.75,1560,9788,1.0,0,0,2,7,1560,0,1964,0.0,98178,47.4876,-122.226,1840,11180,8228,0.8406211687780957,2433600,95804944,93371344
350000.0,2,1.5,830,1077,2.0,0,0,2,7,830,0,2006,0.0,98122,47.6058,-122.319,830,1366,247,0.22934076137418755,688900,1159929,471029
90000.0,3,1.0,980,2490,2.0,0,0,3,6,980,0,1969,0.0,98092,47.317,-122.182,980,3154,1510,0.606425702811245,960400,6200100,5239700
329000.0,3,1.75,1980,7000,1.0,0,0,3,8,1360,620,1977,0.0,98058,47.4442,-122.12899999999999,1880,7200,5020,0.7171428571428572,3920400,49000000,45079600
909000.0,4,2.5,3680,11648,2.0,0,0,2,10,3680,0,1986,0.0,98006,47.5604,-122.10700000000001,2830,11251,7968,0.6840659340659341,13542400,135675904,122133504
187000.0,2,1.0,860,5400,1.0,0,0,3,5,860,0,1953,0.0,98056,47.492,-122.171,960,5400,4540,0.8407407407407408,739600,29160000,28420400
580000.0,3,1.75,1850,5100,1.0,0,0,2,7,1020,830,1909,0.0,98105,47.6605,-122.32600000000001,1850,5100,3250,0.6372549019607843,3422500,26010000,22587500
345000.0,3,2.5,1620,5992,2.0,0,0,2,7,1620,0,2001,0.0,98019,47.736000000000004,-121.965,1620,4644,4372,0.7296395193591455,2624400,35904064,33279664
497000.0,4,2.5,2240,7200,2.0,0,0,2,8,2240,0,1995,0.0,98118,47.5636,-122.275,1860,6600,4960,0.6888888888888889,5017600,51840000,46822400
345000.0,3,1.0,1010,3060,1.5,0,0,2,6,1010,0,1904,0.0,98118,47.5657,-122.285,1330,4590,2050,0.6699346405228758,1020100,9363600,8343500
313500.0,3,1.75,1610,7350,1.0,0,0,2,8,1610,0,1974,0.0,98058,47.4503,-122.131,2120,7350,5740,0.780952380952381,2592100,54022500,51430400
910000.0,3,2.5,2720,7250,2.0,0,0,2,9,2720,0,1990,0.0,98033,47.6894,-122.195,2870,7250,4530,0.6248275862068966,7398400,52562500,45164100
399950.0,3,1.5,2080,5244,1.0,0,0,2,7,1190,890,1959,0.0,98125,47.7144,-122.29299999999999,1850,6982,3164,0.6033562166285278,4326400,27499536,23173136
268000.0,4,2.0,1930,6600,1.0,0,0,3,7,1030,900,1967,0.0,98168,47.482,-122.33200000000001,1220,6600,4670,0.7075757575757575,3724900,43560000,39835100
559000.0,4,1.75,2250,8458,1.0,0,0,2,8,1450,800,1954,0.0,98136,47.5235,-122.383,1950,7198,6208,0.7339796642232206,5062500,71537764,66475264
309000.0,3,2.25,1980,8755,1.0,0,0,3,7,1300,680,1963,0.0,98198,47.3922,-122.321,2030,8671,6775,0.7738435179897202,3920400,76650025,72729625
410000.0,3,2.5,1960,4400,2.0,0,0,2,7,1960,0,2006,0.0,98065,47.5384,-121.889,2060,4400,2440,0.5545454545454546,3841600,19360000,15518400
259000.0,3,1.0,1320,8625,1.0,0,0,3,7,1320,0,1957,0.0,98056,47.4902,-122.179,1370,8295,7305,0.8469565217391304,1742400,74390625,72648225
950000.0,5,2.0,2940,5500,2.0,0,0,3,9,2340,600,1909,0.0,98102,47.6466,-122.321,2940,5500,2560,0.46545454545454545,8643600,30250000,21606400
320000.0,4,1.0,1460,7200,1.5,0,0,3,7,1460,0,1955,0.0,98155,47.7602,-122.306,1690,7357,5740,0.7972222222222223,2131600,51840000,49708400
1150000.0,4,2.5,2330,30122,1.0,0,1,2,8,1490,840,1951,0.0,98115,47.6843,-122.26700000000001,2430,6726,27792,0.9226478985459133,5428900,907334884,901905984
394250.0,3,2.0,2620,10107,1.0,0,3,2,7,2620,0,1982,0.0,98198,47.4096,-122.329,1730,7812,7487,0.7407737211833383,6864400,102151449,95287049
315000.0,1,1.0,700,3876,1.0,0,0,2,6,700,0,1910,0.0,98103,47.6886,-122.352,1150,3952,3176,0.8194014447884417,490000,15023376,14533376
480000.0,2,2.0,1140,12000,1.0,0,0,2,6,1140,0,1943,0.0,98027,47.5277,-122.031,1880,6125,10860,0.905,1299600,144000000,142700400
556000.0,3,2.5,2750,35440,2.0,0,0,2,9,2750,0,1994,0.0,98045,47.4745,-121.723,2710,35440,32690,0.9224040632054176,7562500,1255993600,1248431100
450000.0,3,2.5,2480,5647,2.0,0,0,2,7,2480,0,2002,0.0,98065,47.5355,-121.88,2510,5018,3167,0.5608287586329024,6150400,31888609,25738209
420000.0,3,1.5,1130,5413,1.0,0,0,2,7,940,190,1946,0.0,98125,47.7021,-122.32,1400,7168,4283,0.7912433031590616,1276900,29300569,28023669
890000.0,6,3.75,2770,5000,1.0,0,0,2,8,1870,900,1969,0.0,98107,47.669,-122.365,1570,2108,2230,0.446,7672900,25000000,17327100
295000.0,4,2.0,1710,8814,1.0,0,0,4,7,1030,0,1975,0.0,98031,47.395,-122.17399999999999,1710,7272,7104,0.8059904697072838,2924100,77686596,74762496
410000.0,4,2.25,2150,27345,2.0,0,0,4,8,2150,0,1976,0.0,98059,47.468999999999994,-122.12100000000001,2200,11923,25195,0.921375022856098,4622500,747749025,743126525
308900.0,3,2.5,2250,7294,2.0,0,0,2,8,2250,0,1994,0.0,98092,47.2636,-122.212,2140,7363,5044,0.691527282698108,5062500,53202436,48139936
1160000.0,4,2.5,2960,26742,1.0,0,3,2,8,1480,1480,1949,1996.0,98115,47.6846,-122.26799999999999,2500,9460,23782,0.8893126916460997,8761600,715134564,706372964
665000.0,2,2.5,2300,6984,1.0,0,0,2,8,2300,0,2006,0.0,98053,47.7087,-122.015,1820,4950,4684,0.6706758304696449,5290000,48776256,43486256
577000.0,3,1.75,1740,5500,1.0,0,0,4,7,970,770,1953,0.0,98116,47.577,-122.395,1740,7250,3760,0.6836363636363636,3027600,30250000,27222400
959000.0,3,2.5,2830,3750,3.0,0,0,2,10,2830,0,2014,0.0,98117,47.6799,-122.385,1780,5000,920,0.24533333333333332,8008900,14062500,6053600
471000.0,2,1.75,1240,6417,1.0,0,0,4,7,1240,0,1924,0.0,98126,47.5439,-122.37899999999999,1800,6417,5177,0.8067632850241546,1537600,41177889,39640289
560000.0,3,2.5,2180,7169,2.0,0,0,2,8,2180,0,1990,0.0,98029,47.5714,-122.00200000000001,2150,5914,4989,0.6959129585716278,4752400,51394561,46642161
955000.0,5,2.25,2510,9887,2.0,0,0,2,8,2510,0,1972,0.0,98040,47.5339,-122.223,2510,10006,7377,0.7461312835035906,6300100,97752769,91452669
1240000.0,7,5.5,6630,13782,2.0,0,0,2,10,4930,1700,2004,0.0,98006,47.5399,-122.118,4470,8639,7152,0.5189377448846322,43956900,189943524,145986624
579000.0,3,2.5,2300,18540,1.0,0,0,2,8,1800,500,1961,0.0,98177,47.7767,-122.369,2460,18540,16240,0.8759439050701187,5290000,343731600,338441600
335000.0,4,2.25,3220,7889,2.0,0,0,2,8,3220,0,1978,0.0,98023,47.3112,-122.339,2120,7651,4669,0.5918367346938775,10368400,62236321,51867921
485000.0,3,2.5,2270,7887,2.0,0,2,2,8,2270,0,2004,0.0,98065,47.5326,-121.855,2550,7133,5617,0.7121846075820971,5152900,62204769,57051869
552000.0,3,2.5,1840,9900,1.0,0,0,2,9,1840,0,1978,0.0,98007,47.6131,-122.15100000000001,2730,9900,8060,0.8141414141414142,3385600,98010000,94624400
950000.0,4,3.25,3820,15293,2.0,0,0,2,10,3820,0,2003,0.0,98074,47.6097,-122.01700000000001,2790,7142,11473,0.750212515529981,14592400,233875849,219283449
203700.0,3,2.0,1660,7958,1.0,0,0,2,7,1130,530,1983,0.0,98092,47.3187,-122.171,1550,7647,6298,0.7914048755968837,2755600,63329764,60574164
412000.0,4,3.5,3360,9767,2.0,0,0,2,9,2450,910,1990,0.0,98023,47.3047,-122.34700000000001,2580,8757,6407,0.6559844373912154,11289600,95394289,84104689
237500.0,3,2.0,1350,8960,1.0,0,0,3,7,1350,0,1986,0.0,98038,47.3614,-122.045,1470,8288,7610,0.8493303571428571,1822500,80281600,78459100
866800.0,4,3.5,2970,5000,2.0,0,2,2,9,2200,770,2001,0.0,98117,47.6772,-122.399,1470,4560,2030,0.406,8820900,25000000,16179100
425000.0,3,1.0,1000,5100,1.0,0,0,2,7,860,140,1946,0.0,98115,47.6857,-122.29299999999999,1000,5100,4100,0.803921568627451,1000000,26010000,25010000
200000.0,3,2.0,1190,6833,1.0,0,0,2,7,1190,0,1995,0.0,98092,47.3191,-122.18,1540,8000,5643,0.8258451631786916,1416100,46689889,45273789
280000.0,3,1.75,1670,6034,1.0,0,0,2,7,990,680,1957,0.0,98118,47.5209,-122.286,1230,6034,4364,0.7232350016572754,2788900,36409156,33620256
140000.0,3,1.5,1200,2002,2.0,0,0,2,8,1200,0,1966,0.0,98055,47.4659,-122.189,1270,1848,802,0.4005994005994006,1440000,4008004,2568004
370000.0,5,2.5,2250,10400,1.0,0,0,2,8,1280,970,1973,0.0,98058,47.4501,-122.139,2140,9592,8150,0.7836538461538461,5062500,108160000,103097500
550000.0,2,0.75,1040,4000,1.0,0,0,2,7,930,110,1909,0.0,98119,47.6489,-122.37200000000001,1700,4800,2960,0.74,1081600,16000000,14918400
1410000.0,2,2.5,3180,9400,2.0,0,4,4,10,2610,570,1985,0.0,98006,47.5617,-122.15799999999999,3760,9450,6220,0.6617021276595745,10112400,88360000,78247600
1510000.0,2,2.5,3180,9400,2.0,0,4,4,10,2610,570,1985,0.0,98006,47.5617,-122.15799999999999,3760,9450,6220,0.6617021276595745,10112400,88360000,78247600
510000.0,4,1.5,2040,8800,1.0,0,0,3,7,1020,1020,1961,0.0,98007,47.5965,-122.139,1490,8800,6760,0.7681818181818182,4161600,77440000,73278400
351000.0,3,1.0,1160,10518,1.0,0,0,2,7,1160,0,1960,0.0,98028,47.7343,-122.22,1670,9380,9358,0.8897128731698042,1345600,110628324,109282724
210000.0,3,1.0,880,10800,1.0,0,0,2,6,880,0,1942,0.0,98146,47.4949,-122.338,1100,8820,9920,0.9185185185185185,774400,116640000,115865600
449999.0,4,1.75,2290,36900,1.5,0,2,4,7,1690,600,1938,0.0,98022,47.2034,-122.00299999999999,2170,12434,34610,0.937940379403794,5244100,1361610000,1356365900
137000.0,3,1.0,950,7620,1.0,0,0,2,6,950,0,1954,0.0,98106,47.5178,-122.346,1260,7620,6670,0.8753280839895013,902500,58064400,57161900
270000.0,3,1.0,1010,14510,1.0,0,0,4,7,1010,0,1974,0.0,98042,47.3437,-122.07799999999999,2020,44866,13500,0.9303928325292902,1020100,210540100,209520000
540000.0,3,2.5,3100,100188,1.0,0,0,3,7,1820,0,1981,0.0,98038,47.3928,-122.066,2430,104979,97088,0.9690581706391983,9610000,10037635344,10028025344
565000.0,5,3.0,2560,12480,1.0,0,0,2,8,1590,970,2012,0.0,98155,47.7657,-122.28399999999999,2500,17299,9920,0.7948717948717948,6553600,155750400,149196800
940000.0,4,1.5,2430,3600,2.5,0,0,2,8,2430,0,1980,0.0,98112,47.6351,-122.285,2020,4800,1170,0.325,5904900,12960000,7055100
385000.0,2,1.0,830,26329,1.0,1,3,3,6,830,0,1928,0.0,98070,47.4012,-122.425,2030,27338,25499,0.9684758251357818,688900,693216241,692527341
400000.0,3,3.0,2090,7634,1.0,0,0,2,8,1450,640,2001,0.0,98019,47.7408,-121.97399999999999,2090,9600,5544,0.7262247838616714,4368100,58277956,53909856
365000.0,3,2.0,2030,8649,1.0,0,0,2,7,2030,0,1998,0.0,98056,47.5082,-122.166,1760,7200,6619,0.7652907850618569,4120900,74805201,70684301
353250.0,2,1.0,1060,1600,2.0,0,0,2,7,1060,0,1979,0.0,98144,47.5888,-122.294,1360,3360,540,0.3375,1123600,2560000,1436400
455000.0,2,1.5,1090,6750,1.0,0,0,2,7,950,140,1942,0.0,98117,47.6836,-122.397,1640,6750,5660,0.8385185185185186,1188100,45562500,44374400
475000.0,4,3.5,3400,234352,2.0,0,0,2,8,2500,900,1991,0.0,98070,47.4335,-122.449,1300,39639,230952,0.9854919096060627,11560000,54920859904,54909299904
571500.0,4,1.75,1920,7455,1.0,0,0,3,7,960,960,1939,1964.0,98125,47.7106,-122.286,1920,7455,5535,0.7424547283702213,3686400,55577025,51890625
441000.0,2,1.0,1150,3000,1.0,0,0,2,6,780,370,1915,0.0,98118,47.5624,-122.291,1150,5000,1850,0.6166666666666667,1322500,9000000,7677500
810000.0,6,2.75,3970,9500,1.0,0,0,3,10,2180,0,1970,0.0,98005,47.5956,-122.178,2490,9775,5530,0.5821052631578948,15760900,90250000,74489100
550000.0,3,2.25,1880,11556,2.0,0,0,2,8,1880,0,1987,0.0,98074,47.6283,-122.03200000000001,1880,12000,9676,0.8373139494634821,3534400,133541136,130006736
736000.0,2,1.0,1500,4000,1.0,0,0,2,8,1100,400,1933,0.0,98109,47.6409,-122.353,1980,4000,2500,0.625,2250000,16000000,13750000
375000.0,3,1.75,2190,17550,1.0,0,0,2,7,2190,0,1989,0.0,98014,47.6984,-121.912,1700,17550,15360,0.8752136752136752,4796100,308002500,303206400
717500.0,3,2.5,2530,9932,2.0,0,0,2,8,2530,0,1995,0.0,98052,47.6853,-122.16,2140,7950,7402,0.7452678211840515,6400900,98644624,92243724
581000.0,2,1.75,1930,11200,1.0,0,2,2,8,1430,500,1951,0.0,98177,47.7576,-122.37,2840,12408,9270,0.8276785714285714,3724900,125440000,121715100
629000.0,3,2.0,1510,4560,2.0,0,0,3,7,1510,0,1909,1995.0,98116,47.5689,-122.40799999999999,1990,5000,3050,0.668859649122807,2280100,20793600,18513500
3800000.0,3,4.25,5510,35000,2.0,0,4,2,13,4910,600,1997,0.0,98177,47.7296,-122.37,3430,45302,29490,0.8425714285714285,30360100,1225000000,1194639900
225000.0,3,2.0,1100,5200,1.0,0,0,2,6,1100,0,1969,2014.0,98042,47.3606,-122.083,1050,5330,4100,0.7884615384615384,1210000,27040000,25830000
315000.0,3,2.5,1730,6368,2.0,0,0,2,7,1730,0,1993,0.0,98038,47.3505,-122.03200000000001,1780,6597,4638,0.7283291457286433,2992900,40551424,37558524
425000.0,3,2.5,1480,1386,3.0,0,0,2,8,1480,0,2005,0.0,98029,47.5468,-121.99799999999999,1470,1593,-94,-0.06782106782106782,2190400,1920996,-269404
346500.0,3,1.0,1150,11802,1.0,0,0,3,7,1150,0,1932,1958.0,98106,47.5624,-122.361,1880,6082,10652,0.9025588883240129,1322500,139287204,137964704
550000.0,3,2.25,1950,26500,1.0,0,0,3,8,1570,380,1965,0.0,98006,47.5784,-122.179,2160,12751,24550,0.9264150943396227,3802500,702250000,698447500
565000.0,3,1.75,2380,10450,1.0,0,0,2,8,1400,980,1977,0.0,98052,47.6409,-122.111,2150,9600,8070,0.7722488038277512,5664400,109202500,103538100
1000000.0,4,2.0,3100,8000,1.5,0,0,4,7,2040,1060,1939,0.0,98103,47.6852,-122.329,1650,4000,4900,0.6125,9610000,64000000,54390000
400000.0,2,2.0,2010,3797,1.5,0,0,2,7,1450,560,1922,2004.0,98108,47.5596,-122.315,1660,4650,1787,0.47063471161443243,4040100,14417209,10377109
724950.0,4,2.0,2270,5760,2.0,0,0,3,8,2270,0,1909,0.0,98116,47.5809,-122.39,1420,5760,3490,0.6059027777777778,5152900,33177600,28024700
623000.0,3,1.75,2050,16313,1.0,0,0,1,8,2050,0,1973,0.0,98040,47.5743,-122.212,3180,10264,14263,0.8743333537669343,4202500,266113969,261911469
295000.0,2,1.0,650,5400,1.0,0,0,2,6,650,0,1950,0.0,98122,47.6185,-122.295,1310,4906,4750,0.8796296296296297,422500,29160000,28737500
700000.0,4,3.25,2780,7875,2.0,0,0,2,9,2780,0,2006,0.0,98133,47.7294,-122.352,1000,7500,5095,0.646984126984127,7728400,62015625,54287225
482000.0,2,1.5,1300,1229,2.0,0,0,2,8,1160,140,2000,0.0,98107,47.6727,-122.375,1430,1255,-71,-0.05777054515866558,1690000,1510441,-179559
770000.0,3,2.5,2730,11380,2.0,0,0,2,10,2730,0,1995,0.0,98075,47.58,-122.057,2800,10070,8650,0.7601054481546573,7452900,129504400,122051500
310000.0,4,2.5,3140,22100,1.0,0,0,3,8,1820,1320,1960,0.0,98023,47.318999999999996,-122.36200000000001,2700,25500,18960,0.857918552036199,9859600,488410000,478550400
720000.0,4,2.25,2410,8400,2.0,0,0,4,8,2410,0,1965,0.0,98008,47.62600000000001,-122.119,1910,8056,5990,0.7130952380952381,5808100,70560000,64751900
355000.0,3,1.0,1180,5965,1.5,0,0,3,6,1180,0,1928,0.0,98125,47.7281,-122.29899999999999,1270,7710,4785,0.8021793797150042,1392400,35581225,34188825
512000.0,4,2.5,2600,4506,2.0,0,0,2,9,2600,0,2005,0.0,98056,47.5146,-122.18799999999999,2470,6041,1906,0.42299156679982247,6760000,20304036,13544036
303000.0,2,1.5,1400,1650,3.0,0,0,2,7,1400,0,1999,0.0,98125,47.7222,-122.29,1430,1650,250,0.15151515151515152,1960000,2722500,762500
299000.0,5,2.5,2220,9360,1.0,0,0,3,7,1110,1110,1968,0.0,98058,47.4341,-122.169,1780,7704,7140,0.7628205128205128,4928400,87609600,82681200
285000.0,3,2.5,1660,6263,2.0,0,0,2,8,1660,0,2003,0.0,98042,47.3507,-122.141,2190,6192,4603,0.7349513012933099,2755600,39225169,36469569
680000.0,3,1.75,2330,9652,1.0,0,0,3,8,1590,740,1968,0.0,98040,47.5714,-122.211,2420,9631,7322,0.7585992540406133,5428900,93161104,87732204
285000.0,4,1.75,1440,6720,1.0,0,0,4,6,720,720,1954,0.0,98166,47.4571,-122.345,1820,6784,5280,0.7857142857142857,2073600,45158400,43084800
707000.0,4,2.25,2920,17023,1.0,0,0,3,9,1690,1230,1977,0.0,98006,47.5585,-122.134,2710,10681,14103,0.8284673676790225,8526400,289782529,281256129
690000.0,3,2.0,1760,6428,1.0,0,0,3,7,980,780,1942,0.0,98199,47.6388,-122.397,1760,6004,4668,0.7261978842563783,3097600,41319184,38221584
872000.0,4,2.25,2860,40284,2.0,0,0,2,10,2860,0,1983,0.0,98072,47.7308,-122.115,2670,92782,37424,0.9290040710952239,8179600,1622800656,1614621056
290000.0,4,1.75,2090,12750,1.0,0,0,2,8,1360,730,1967,0.0,98166,47.4792,-122.35700000000001,2040,12300,10660,0.836078431372549,4368100,162562500,158194400
425000.0,4,1.75,1910,16785,1.0,0,0,3,7,1110,0,1981,0.0,98028,47.7474,-122.235,1590,9900,14875,0.8862079237414358,3648100,281736225,278088125
925000.0,3,2.75,3280,10558,1.0,0,2,3,9,2040,1240,1979,0.0,98006,47.5606,-122.133,3150,9998,7278,0.6893351013449517,10758400,111471364,100712964
340500.0,3,1.0,1770,12458,1.0,0,0,2,7,1770,0,1957,0.0,98155,47.7715,-122.27,2000,8225,10688,0.8579226200032107,3132900,155201764,152068864
365000.0,2,1.0,920,6600,1.0,0,0,3,6,920,0,1910,0.0,98118,47.5572,-122.28200000000001,1370,5500,5680,0.8606060606060606,846400,43560000,42713600
725000.0,3,1.75,1690,8489,1.0,0,0,3,7,1690,0,1959,0.0,98004,47.6079,-122.19200000000001,1850,8536,6799,0.8009188361408882,2856100,72063121,69207021
811000.0,3,3.0,2470,7410,2.0,0,0,4,8,1860,610,1977,0.0,98117,47.6937,-122.39200000000001,2390,7800,4940,0.6666666666666666,6100900,54908100,48807200
299000.0,3,1.0,1040,9514,1.0,0,0,3,7,1040,0,1969,0.0,98059,47.4936,-122.102,1040,9514,8474,0.8906874080302711,1081600,90516196,89434596
287500.0,4,2.0,1220,9147,1.0,0,0,4,7,1220,0,1953,0.0,98146,47.5011,-122.336,1220,8576,7927,0.8666229364819066,1488400,83667609,82179209
879950.0,4,2.25,3500,13875,1.0,0,4,3,9,1830,1670,1938,0.0,98146,47.5083,-122.38799999999999,2960,15000,10375,0.7477477477477478,12250000,192515625,180265625
135900.0,2,1.0,760,3800,1.0,0,0,2,6,760,0,1950,0.0,98178,47.5019,-122.26899999999999,1220,7410,3040,0.8,577600,14440000,13862400
1230000.0,4,2.25,3070,16028,1.0,0,3,2,9,1870,1200,1976,0.0,98040,47.5271,-122.228,3070,19822,12958,0.8084601946593462,9424900,256896784,247471884
522500.0,4,1.75,2100,6480,1.0,0,0,4,7,1300,800,1947,0.0,98177,47.7049,-122.359,1840,7500,4380,0.6759259259259259,4410000,41990400,37580400
399500.0,4,1.5,1660,6617,1.0,0,0,4,7,1660,0,1947,0.0,98155,47.739,-122.323,950,7440,4957,0.7491310261447786,2755600,43784689,41029089
450000.0,3,1.0,1430,5960,1.5,0,0,3,7,1430,0,1917,0.0,98118,47.562,-122.289,1140,3960,4530,0.7600671140939598,2044900,35521600,33476700
218000.0,4,1.0,1620,17500,1.0,0,0,2,7,1620,0,1962,0.0,98023,47.3021,-122.38799999999999,2400,17394,15880,0.9074285714285715,2624400,306250000,303625600
289999.0,3,2.0,1490,9285,1.0,0,0,2,8,1490,0,1995,0.0,98092,47.3248,-122.169,2040,6681,7795,0.8395261173936457,2220100,86211225,83991125
540000.0,2,1.0,1170,4750,1.0,0,0,2,6,1170,0,1903,0.0,98107,47.6729,-122.37799999999999,1170,2023,3580,0.7536842105263157,1368900,22562500,21193600
324950.0,3,1.0,1240,7500,1.0,0,0,3,7,1240,0,1976,0.0,98074,47.6199,-122.06200000000001,1240,9750,6260,0.8346666666666667,1537600,56250000,54712400
718500.0,3,2.0,2910,6600,2.0,0,0,3,7,1920,990,1900,0.0,98118,47.5576,-122.281,1370,5500,3690,0.5590909090909091,8468100,43560000,35091900
495000.0,3,2.0,2660,192099,1.0,0,0,3,9,2660,0,1964,0.0,98022,47.2098,-122.016,2570,43561,189439,0.9861529732065237,7075600,36902025801,36894950201
260000.0,6,2.0,2220,8797,1.0,0,0,2,7,2220,0,1977,0.0,98002,47.2977,-122.227,1170,5123,6577,0.7476412413322724,4928400,77387209,72458809
430000.0,4,1.5,1920,10000,1.0,0,0,3,7,1070,850,1954,0.0,98006,47.5725,-122.133,1450,10836,8080,0.808,3686400,100000000,96313600
402500.0,3,3.25,2780,4002,2.0,0,0,2,8,2780,0,2009,0.0,98019,47.7348,-121.96600000000001,1890,4090,1222,0.3053473263368316,7728400,16016004,8287604
1420000.0,4,3.0,3110,4408,2.5,0,3,3,10,2510,600,1931,0.0,98105,47.6583,-122.27,3250,5669,1298,0.294464609800363,9672100,19430464,9758364
275000.0,3,2.25,1820,9766,1.0,0,0,3,7,1450,370,1987,0.0,98031,47.397,-122.20299999999999,1860,8236,7946,0.8136391562563997,3312400,95374756,92062356
250000.0,3,2.25,1765,7652,2.0,0,0,2,7,1765,0,1996,0.0,98003,47.3072,-122.32799999999999,1765,7719,5887,0.7693413486670152,3115225,58553104,55437879
665000.0,3,2.75,1800,9550,1.0,0,0,3,7,1320,480,1966,0.0,98006,47.5679,-122.178,1890,9902,7750,0.8115183246073299,3240000,91202500,87962500
425000.0,3,2.5,2650,144183,1.0,0,0,2,8,2650,0,1967,0.0,98042,47.4212,-122.14399999999999,1940,41210,141533,0.9816205794025648,7022500,20788737489,20781714989
760000.0,2,1.0,1410,3600,1.5,0,0,3,7,1310,100,1925,0.0,98103,47.6695,-122.338,1740,4200,2190,0.6083333333333333,1988100,12960000,10971900
447000.0,3,2.5,1650,3076,2.0,0,0,2,7,1650,0,2003,0.0,98053,47.681999999999995,-122.035,1560,3064,1426,0.4635890767230169,2722500,9461776,6739276
205000.0,3,1.0,1180,8240,1.0,0,0,3,7,1180,0,1967,0.0,98003,47.3325,-122.321,1180,7840,7060,0.8567961165048543,1392400,67897600,66505200
191000.0,3,1.5,800,8850,1.0,0,0,3,6,800,0,1959,0.0,98023,47.3266,-122.348,820,8775,8050,0.9096045197740112,640000,78322500,77682500
350000.0,2,1.75,1430,7921,1.0,0,0,2,7,1430,0,1983,0.0,98146,47.5088,-122.37100000000001,1290,8040,6491,0.8194672389849766,2044900,62742241,60697341
789888.0,5,3.5,3300,7860,2.0,0,0,2,9,2410,890,2001,0.0,98006,47.5463,-122.19200000000001,2540,9920,4560,0.5801526717557252,10890000,61779600,50889600
443000.0,2,1.0,1220,10170,1.0,0,0,2,7,980,240,1948,0.0,98125,47.7297,-122.32700000000001,1990,9064,8950,0.880039331366765,1488400,103428900,101940500
695000.0,4,3.5,3530,7202,2.0,0,0,2,9,2660,870,2000,0.0,98177,47.7339,-122.36,2810,8100,3672,0.5098583726742572,12460900,51868804,39407904
560000.0,4,2.0,1380,4048,1.5,0,0,3,7,1380,0,1906,0.0,98103,47.6583,-122.344,1440,3956,2668,0.6590909090909091,1904400,16386304,14481904
550000.0,3,1.75,1410,5000,1.0,0,0,3,7,810,600,1923,0.0,98107,47.6727,-122.395,1760,5000,3590,0.718,1988100,25000000,23011900
850000.0,2,2.5,3360,6750,2.0,0,0,2,9,3360,0,2004,0.0,98053,47.7112,-122.03299999999999,2510,6750,3390,0.5022222222222222,11289600,45562500,34272900
352750.0,4,2.75,2270,24237,1.0,0,0,3,7,1360,910,1977,0.0,98058,47.4672,-122.175,2050,8016,21967,0.9063415439204522,5152900,587432169,582279269
550000.0,4,2.5,2890,9045,2.0,0,0,2,8,2890,0,2001,0.0,98019,47.7385,-121.965,2840,10114,6155,0.6804864566058596,8352100,81812025,73459925
774900.0,5,1.0,1750,3861,1.5,0,0,2,7,1750,0,1903,0.0,98122,47.6075,-122.295,1700,4255,2111,0.5467495467495468,3062500,14907321,11844821
250000.0,3,1.0,1010,8711,1.0,0,0,4,6,1010,0,1944,0.0,98056,47.4914,-122.186,1250,8053,7701,0.884054643554127,1020100,75881521,74861421
962800.0,4,2.5,3780,23623,2.0,0,0,2,9,3780,0,1997,0.0,98006,47.559,-122.118,3370,10210,19843,0.8399864538796935,14288400,558046129,543757729
299500.0,3,1.75,1880,11700,1.0,0,0,3,7,1880,0,1968,0.0,98092,47.3213,-122.18700000000001,2230,35200,9820,0.8393162393162393,3534400,136890000,133355600
250000.0,2,1.0,800,5220,1.0,0,0,2,6,800,0,1943,0.0,98125,47.7037,-122.32,1910,5376,4420,0.8467432950191571,640000,27248400,26608400
745000.0,5,4.0,4720,493534,2.0,0,0,4,9,3960,760,1975,0.0,98027,47.4536,-122.009,2160,219542,488814,0.9904363225228657,22278400,243575809156,243553530756
279475.0,2,1.0,1060,10600,1.5,0,0,2,6,1060,0,1968,0.0,98065,47.5375,-121.742,1560,21344,9540,0.9,1123600,112360000,111236400
450000.0,3,2.25,2530,27227,2.0,0,0,2,8,2530,0,1987,0.0,98056,47.527,-122.193,2160,30192,24697,0.9070775333308848,6400900,741309529,734908629
307700.0,5,2.25,1980,13132,1.0,0,0,3,7,1260,720,1962,0.0,98198,47.3984,-122.301,1880,11325,11152,0.8492232713981115,3920400,172449424,168529024
665000.0,3,1.0,1650,5102,1.0,0,0,3,8,1300,350,1953,0.0,98199,47.6524,-122.404,1440,5102,3452,0.6765974127793022,2722500,26030404,23307904
375000.0,3,2.75,1890,3930,2.0,0,0,2,8,1890,0,1999,0.0,98065,47.5337,-121.867,2100,4259,2040,0.5190839694656488,3572100,15444900,11872800
420000.0,4,2.5,3360,11637,2.0,0,0,2,11,3360,0,1990,0.0,98023,47.3018,-122.34200000000001,3530,11205,8277,0.711265790152101,11289600,135419769,124130169
148000.0,2,1.0,630,4200,1.0,0,0,2,6,630,0,1930,0.0,98106,47.5329,-122.348,970,4200,3570,0.85,396900,17640000,17243100
707000.0,3,1.5,1980,4000,2.0,0,0,2,8,1980,0,1919,0.0,98109,47.6364,-122.351,1980,3600,2020,0.505,3920400,16000000,12079600
399000.0,3,1.0,990,4250,1.0,0,0,3,7,840,150,1924,0.0,98136,47.5392,-122.39,990,4500,3260,0.7670588235294118,980100,18062500,17082400
570000.0,4,2.5,3420,115434,2.0,0,0,2,9,3420,0,1989,0.0,98038,47.3932,-121.988,3250,111513,112014,0.970372680492749,11696400,13325008356,13313311956
853000.0,4,2.25,3440,35025,2.0,0,0,2,10,3440,0,1988,0.0,98053,47.6674,-122.055,3210,35005,31585,0.9017844396859386,11833600,1226750625,1214917025
400000.0,3,1.0,1300,14138,1.0,0,0,3,7,1300,0,1943,0.0,98005,47.593,-122.165,2440,12196,12838,0.9080492290281511,1690000,199883044,198193044
615000.0,2,1.75,2040,28593,1.5,1,3,3,7,2040,0,1919,1990.0,98070,47.3979,-122.465,2040,35124,26553,0.9286538663309202,4161600,817559649,813398049
463000.0,3,1.0,1250,7700,1.0,0,0,3,7,1250,0,1955,0.0,98007,47.5974,-122.149,1520,7700,6450,0.8376623376623377,1562500,59290000,57727500
600000.0,4,2.5,1960,14242,1.0,0,1,3,8,1290,670,1958,0.0,98146,47.4947,-122.369,2490,10907,12282,0.8623788793708749,3841600,202834564,198992964
429000.0,5,2.5,2720,8120,1.0,0,0,2,7,1360,1360,1970,0.0,98108,47.556999999999995,-122.30799999999999,2020,8120,5400,0.6650246305418719,7398400,65934400,58536000
980000.0,4,4.25,3250,11780,2.0,0,0,2,8,2360,890,1944,2001.0,98004,47.6322,-122.20299999999999,1800,9000,8530,0.7241086587436333,10562500,138768400,128205900
359500.0,6,3.75,3190,4700,2.0,0,0,2,8,3190,0,2003,0.0,98042,47.3724,-122.105,2680,5640,1510,0.32127659574468087,10176100,22090000,11913900
715000.0,4,2.5,2570,7980,2.0,0,0,2,9,2570,0,1998,0.0,98074,47.6378,-122.065,2760,6866,5410,0.6779448621553885,6604900,63680400,57075500
240000.0,3,1.75,1420,6984,1.0,0,0,3,7,980,440,1980,0.0,98030,47.3748,-122.18,1430,7875,5564,0.7966781214203894,2016400,48776256,46759856
455000.0,4,2.0,2120,9442,1.0,0,0,4,7,1060,1060,1968,0.0,98011,47.7675,-122.226,1290,9600,7322,0.7754712984537174,4494400,89151364,84656964
610000.0,3,2.5,2080,167270,1.0,0,0,2,7,2080,0,2000,0.0,98038,47.4032,-121.963,2080,55321,165190,0.987565014646978,4326400,27979252900,27974926500
675000.0,3,2.75,2740,5735,2.0,0,0,2,9,2740,0,2004,0.0,98052,47.6862,-122.09299999999999,2210,5026,2995,0.5222319093286836,7507600,32890225,25382625
283500.0,3,1.75,1250,5375,1.0,0,0,2,7,1250,0,1985,0.0,98198,47.3787,-122.323,1320,6258,4125,0.7674418604651163,1562500,28890625,27328125
235000.0,2,1.0,2150,4500,1.5,0,0,2,7,1260,890,1917,0.0,98118,47.5158,-122.26700000000001,1590,5010,2350,0.5222222222222223,4622500,20250000,15627500
827000.0,4,2.5,3230,12100,1.0,0,0,2,9,1870,1360,1977,0.0,98006,47.562,-122.146,2670,10200,8870,0.7330578512396694,10432900,146410000,135977100
353000.0,2,1.0,860,8511,1.0,0,0,2,7,860,0,1949,0.0,98125,47.7312,-122.3,1554,8499,7651,0.8989542944424862,739600,72437121,71697521
747500.0,4,2.5,2810,11902,2.0,0,0,3,9,2810,0,1993,0.0,98059,47.5303,-122.14299999999999,2990,10754,9092,0.7639052260124349,7896100,141657604,133761504
341000.0,2,1.0,1040,4000,1.0,0,0,2,6,1040,0,1914,0.0,98144,47.5753,-122.303,1740,4000,2960,0.74,1081600,16000000,14918400
182000.0,3,1.0,1160,18055,1.0,0,0,1,5,1160,0,1950,0.0,98168,47.4772,-122.26899999999999,1340,10324,16895,0.9357518692882858,1345600,325983025,324637425
250000.0,3,2.0,1470,2781,2.0,0,0,2,6,1470,0,2003,0.0,98038,47.349,-122.024,1360,3008,1311,0.4714131607335491,2160900,7733961,5573061
655000.0,4,3.5,2350,13402,2.0,0,3,2,8,1670,680,1994,0.0,98033,47.6947,-122.19,2250,9474,11052,0.8246530368601701,5522500,179613604,174091104
405000.0,3,2.25,1660,8307,1.0,0,0,3,8,1660,0,1961,0.0,98133,47.7575,-122.352,2510,7800,6647,0.8001685325628988,2755600,69006249,66250649
390000.0,4,1.75,2020,9750,1.0,0,0,2,7,1100,920,1975,0.0,98074,47.6192,-122.055,1670,9600,7730,0.7928205128205128,4080400,95062500,90982100
275400.0,2,1.0,890,8180,1.0,0,0,2,7,890,0,1947,0.0,98155,47.736999999999995,-122.3,1130,8180,7290,0.89119804400978,792100,66912400,66120300
791000.0,3,2.25,2430,5500,2.0,0,0,2,8,1810,620,1989,0.0,98033,47.6812,-122.196,2040,5500,3070,0.5581818181818182,5904900,30250000,24345100
424500.0,3,1.75,1460,7700,1.0,0,0,2,7,1460,0,1979,0.0,98052,47.6981,-122.12700000000001,1720,7280,6240,0.8103896103896104,2131600,59290000,57158400
430000.0,3,1.0,980,7200,1.0,0,0,3,7,980,0,1950,0.0,98116,47.5718,-122.395,1180,6572,6220,0.8638888888888889,960400,51840000,50879600
865000.0,4,2.5,2580,10631,2.0,0,2,3,9,2580,0,1992,0.0,98033,47.6993,-122.206,4220,10631,8051,0.7573135170727119,6656400,113018161,106361761
163000.0,2,2.0,1250,7543,1.0,0,0,2,7,1250,0,1962,0.0,98198,47.4051,-122.296,1250,7506,6293,0.8342834416014848,1562500,56896849,55334349
920000.0,4,2.75,3140,9085,1.0,0,2,4,8,1570,1570,1961,0.0,98006,47.5675,-122.16,2430,9350,5945,0.6543753439735829,9859600,82537225,72677625
1030000.0,5,3.25,2680,3011,2.0,0,0,2,9,1870,810,1910,0.0,98122,47.6115,-122.287,3440,5165,331,0.10993025572899369,7182400,9066121,1883721
325000.0,3,1.75,1810,8048,1.0,0,0,3,7,1290,520,1983,0.0,98055,47.4484,-122.194,1550,9081,6238,0.7750994035785288,3276100,64770304,61494204
315000.0,5,2.5,2090,4698,2.0,0,0,2,7,2090,0,1998,0.0,98038,47.3538,-122.025,2070,4698,2608,0.5551298424861644,4368100,22071204,17703104
227000.0,4,1.0,1120,8763,1.0,0,0,2,6,1120,0,1971,0.0,98146,47.508,-122.35799999999999,1120,8636,7643,0.8721898893073149,1254400,76790169,75535769
179000.0,4,1.75,1790,7175,1.5,0,0,2,6,1410,380,1900,0.0,98168,47.4963,-122.318,1790,8417,5385,0.7505226480836237,3204100,51480625,48276525
276000.0,2,1.0,870,2676,1.0,0,0,2,7,820,50,2004,0.0,98144,47.5702,-122.287,1500,1719,1806,0.6748878923766816,756900,7160976,6404076
335000.0,4,1.5,3160,19745,1.5,0,0,3,6,1840,1320,1968,0.0,98010,47.3103,-122.006,1540,8611,16585,0.8399594834135224,9985600,389865025,379879425
430000.0,3,2.0,2350,12480,1.0,0,0,2,7,1600,750,1981,0.0,98028,47.7661,-122.262,2160,12000,10130,0.811698717948718,5522500,155750400,150227900
266490.0,3,2.5,1810,4113,2.0,0,0,2,7,1810,0,2004,0.0,98042,47.3715,-122.126,1880,4465,2303,0.5599319231704352,3276100,16916769,13640669
655000.0,4,2.75,3160,8197,1.0,0,0,2,8,1580,1580,1962,0.0,98115,47.7004,-122.287,2050,8197,5037,0.614493107234354,9985600,67190809,57205209
635500.0,3,2.0,1660,3600,1.0,0,0,2,7,1000,660,1939,2006.0,98103,47.6789,-122.351,1700,4356,1940,0.5388888888888889,2755600,12960000,10204400
235000.0,5,2.5,2500,9583,1.0,0,0,2,7,1300,1200,1979,0.0,98198,47.3946,-122.31200000000001,2120,19352,7083,0.7391213607429824,6250000,91833889,85583889
885000.0,3,2.5,2880,11443,2.0,0,0,3,9,2880,0,1986,0.0,98006,47.5633,-122.111,2840,12530,8563,0.7483177488420869,8294400,130942249,122647849
352500.0,3,1.0,1470,8400,1.0,0,0,3,7,1470,0,1953,0.0,98133,47.7628,-122.354,1470,8400,6930,0.825,2160900,70560000,68399100
450000.0,3,2.5,1460,7573,2.0,0,0,2,8,1460,0,1983,0.0,98007,47.6012,-122.141,1910,7668,6113,0.8072098243760729,2131600,57350329,55218729
3640000.0,5,6.0,5490,19897,2.0,0,0,2,12,5490,0,2005,0.0,98039,47.6165,-122.236,2910,17600,14407,0.7240790068854601,30140100,395890609,365750509
1050000.0,3,2.25,2480,15022,1.0,0,4,2,9,1330,1150,1967,2003.0,98136,47.5497,-122.396,2500,8178,12542,0.8349088004260418,6150400,225660484,219510084
476000.0,2,2.25,1140,1332,3.0,0,0,2,8,1140,0,1999,0.0,98103,47.6543,-122.35600000000001,1140,1267,192,0.14414414414414414,1299600,1774224,474624
375000.0,3,2.5,1830,13042,2.0,0,0,2,8,1830,0,1990,0.0,98038,47.3738,-122.042,1940,6996,11212,0.8596840975310536,3348900,170093764,166744864
600600.0,4,3.5,3110,6829,2.0,0,0,2,8,3110,0,2014,0.0,98148,47.4349,-122.32799999999999,2910,7425,3719,0.5445892517206034,9672100,46635241,36963141
567000.0,4,1.75,2630,11213,1.0,0,2,3,8,1430,1200,1948,0.0,98177,47.7158,-122.366,2240,15186,8583,0.765450816017123,6916900,125731369,118814469
650000.0,4,1.75,2390,12000,1.0,0,0,2,8,1470,920,1979,0.0,98052,47.7061,-122.163,2110,12000,9610,0.8008333333333333,5712100,144000000,138287900
190000.0,5,2.0,1750,10284,1.0,0,0,3,5,1750,0,1943,0.0,98056,47.5094,-122.182,1560,9010,8534,0.8298327499027616,3062500,105760656,102698156
858000.0,4,3.5,4370,422967,1.0,0,2,3,10,2580,1790,1978,0.0,98022,47.2332,-122.029,3260,422967,418597,0.9896682247078378,19096900,178901083089,178881986189
435500.0,1,1.75,1020,4512,1.0,0,0,2,7,770,250,1937,0.0,98115,47.6724,-122.266,1230,5029,3492,0.773936170212766,1040400,20358144,19317744
685000.0,3,2.0,2500,6733,1.0,0,0,2,8,1770,730,1979,0.0,98107,47.6691,-122.36,1770,6343,4233,0.628694489826229,6250000,45333289,39083289
252000.0,3,2.0,1540,7210,2.0,0,0,3,7,1540,0,1984,0.0,98023,47.3128,-122.351,1500,7210,5670,0.7864077669902912,2371600,51984100,49612500
512500.0,4,2.25,2200,6900,2.0,0,0,3,8,2200,0,1975,0.0,98028,47.7682,-122.26100000000001,2400,6900,4700,0.6811594202898551,4840000,47610000,42770000
423800.0,3,2.5,1940,7415,2.0,0,0,2,8,1940,0,1965,0.0,98006,47.542,-122.176,1940,8425,5475,0.7383681726230613,3763600,54982225,51218625
460000.0,3,2.25,1453,2225,2.0,0,0,3,8,1453,0,1986,0.0,98006,47.5429,-122.18799999999999,1860,2526,772,0.34696629213483143,2111209,4950625,2839416
434000.0,3,2.75,1830,3200,2.0,0,0,2,8,1830,0,1991,0.0,98034,47.7155,-122.21799999999999,2030,3331,1370,0.428125,3348900,10240000,6891100
244000.0,3,1.0,2000,15900,1.0,0,0,2,6,1000,1000,1948,0.0,98178,47.4816,-122.23299999999999,1760,10500,13900,0.8742138364779874,4000000,252810000,248810000
348125.0,3,1.0,1400,8451,1.5,0,0,2,7,1400,0,1953,0.0,98133,47.7719,-122.337,1590,8433,7051,0.8343391314637321,1960000,71419401,69459401
585000.0,4,3.25,2400,29252,2.0,0,0,3,8,2400,0,1982,0.0,98072,47.743,-122.131,2280,45000,26852,0.9179543279092028,5760000,855679504,849919504
230000.0,3,1.0,1390,16000,1.0,0,0,3,6,1390,0,1960,0.0,98001,47.2898,-122.251,1420,10000,14610,0.913125,1932100,256000000,254067900
450000.0,3,2.0,1680,11250,1.0,0,0,3,8,1680,0,1967,0.0,98045,47.4861,-121.786,1760,12160,9570,0.8506666666666667,2822400,126562500,123740100
393000.0,5,2.0,1820,5054,1.0,0,0,3,7,910,910,1970,0.0,98108,47.5547,-122.29899999999999,1180,5628,3234,0.6398891966759003,3312400,25542916,22230516
517000.0,2,1.0,1140,3750,1.0,0,0,3,7,1140,0,1925,0.0,98103,47.6619,-122.34299999999999,1660,4000,2610,0.696,1299600,14062500,12762900
400000.0,3,1.0,1060,12690,1.0,0,0,2,7,1060,0,1969,0.0,98033,47.6736,-122.167,1920,10200,11630,0.9164696611505122,1123600,161036100,159912500
890000.0,2,1.75,3050,50965,2.0,0,0,2,10,3050,0,1991,0.0,98053,47.6744,-122.05,3050,40107,47915,0.9401550083390562,9302500,2597431225,2588128725
205950.0,3,1.0,970,11963,1.0,0,0,3,6,970,0,1970,0.0,98198,47.3776,-122.315,1210,11963,10993,0.918916659700744,940900,143113369,142172469
209000.0,3,1.0,1320,3954,1.5,0,0,2,6,1320,0,1912,2014.0,98022,47.202,-121.994,1270,5184,2634,0.6661608497723824,1742400,15634116,13891716
430000.0,4,1.75,1890,6000,1.0,0,0,3,6,1110,780,1947,0.0,98125,47.7274,-122.305,1560,6356,4110,0.685,3572100,36000000,32427900
534000.0,4,1.75,2040,2750,1.5,0,0,3,6,1260,780,1926,0.0,98105,47.6698,-122.3,1940,3750,710,0.2581818181818182,4161600,7562500,3400900
735000.0,4,3.0,2370,3672,1.5,0,0,4,7,1650,720,1916,0.0,98115,47.678000000000004,-122.311,2140,4182,1302,0.3545751633986928,5616900,13483584,7866684
873000.0,3,2.25,2720,54450,2.0,0,0,2,11,2720,0,1997,0.0,98027,47.5473,-122.09200000000001,3170,60548,51730,0.9500459136822773,7398400,2964802500,2957404100
475000.0,4,2.25,1970,7532,1.0,0,0,2,8,1390,580,1983,0.0,98052,47.7219,-122.109,1970,8248,5562,0.7384492830589485,3880900,56731024,52850124
325000.0,3,1.75,2180,10230,1.0,0,0,3,7,1090,1090,1961,0.0,98118,47.5158,-122.281,2130,7200,8050,0.7869012707722385,4752400,104652900,99900500
500000.0,3,2.25,2990,216057,2.0,0,0,2,9,2990,0,1994,0.0,98019,47.754,-121.94200000000001,2840,215622,213067,0.9861610593500789,8940100,46680627249,46671687149
279000.0,4,2.75,2180,8475,1.0,0,0,3,7,1330,850,1987,0.0,98031,47.4045,-122.17399999999999,1500,7140,6295,0.7427728613569321,4752400,71825625,67073225
350000.0,3,2.0,1440,5469,1.0,0,0,2,8,1440,0,1988,0.0,98029,47.5753,-122.01700000000001,1980,6198,4029,0.7366977509599562,2073600,29909961,27836361
660000.0,4,2.25,3180,13653,2.0,0,0,2,9,3180,0,1978,0.0,98074,47.6316,-122.05,2910,12350,10473,0.7670841573280598,10112400,186404409,176292009
324950.0,2,1.5,1643,14616,1.0,0,1,3,7,1643,0,1954,0.0,98198,47.3973,-122.31200000000001,2270,9940,12973,0.8875889436234263,2699449,213627456,210928007
500000.0,4,2.0,1530,7816,1.0,0,0,2,7,1530,0,1955,0.0,98133,47.7309,-122.33200000000001,1480,7816,6286,0.8042476970317298,2340900,61089856,58748956
187300.0,2,1.0,1310,7697,1.0,0,0,2,6,850,460,1950,0.0,98146,47.4982,-122.348,1270,6410,6387,0.8298038196700013,1716100,59243809,57527709
345600.0,5,3.5,2800,5120,2.5,0,0,2,9,2800,0,1903,2005.0,98122,47.6059,-122.31,1780,5120,2320,0.453125,7840000,26214400,18374400
400000.0,3,1.5,1510,7642,1.0,0,0,2,7,1510,0,1959,0.0,98008,47.5978,-122.116,2180,8357,6132,0.8024077466631772,2280100,58400164,56120064
935000.0,5,3.0,2700,5001,2.0,0,0,2,10,2700,0,2009,0.0,98115,47.6811,-122.288,1610,5191,2301,0.46010797840431916,7290000,25010001,17720001
374000.0,4,1.75,2220,15600,1.0,0,0,4,7,1140,1080,1963,0.0,98056,47.492,-122.166,1670,4800,13380,0.8576923076923076,4928400,243360000,238431600
328000.0,3,1.75,1440,45302,2.0,0,0,2,7,1440,0,1977,0.0,98019,47.7078,-121.915,2080,49658,43862,0.968213323915059,2073600,2052271204,2050197604
257500.0,3,2.0,1300,9334,1.0,0,0,4,7,1300,0,1981,0.0,98178,47.4865,-122.238,2210,9636,8034,0.8607242339832869,1690000,87123556,85433556
1000000.0,4,2.5,2230,3600,2.0,0,0,4,8,1630,600,1906,0.0,98112,47.6304,-122.309,2410,4800,1370,0.38055555555555554,4972900,12960000,7987100
216500.0,2,1.75,1390,4482,1.0,0,0,3,8,1390,0,1980,0.0,98198,47.3785,-122.32,1390,4680,3092,0.6898705934850513,1932100,20088324,18156224
1190000.0,3,2.25,2760,40946,2.0,0,0,4,10,2760,0,1978,0.0,98005,47.6501,-122.164,3030,42253,38186,0.9325941483905632,7617600,1676574916,1668957316
360000.0,4,2.5,3200,7282,2.0,0,0,2,9,3200,0,2007,0.0,98188,47.4318,-122.286,3030,7290,4082,0.5605602856358143,10240000,53027524,42787524
699999.0,3,0.75,1240,4000,1.0,0,0,3,7,1240,0,1968,0.0,98112,47.6239,-122.29700000000001,1460,4000,2760,0.69,1537600,16000000,14462400
535000.0,3,2.5,1960,47044,2.0,0,0,3,8,1960,0,1978,0.0,98077,47.7573,-122.07,2020,29004,45084,0.9583368761159765,3841600,2213137936,2209296336
464950.0,3,2.0,2190,19800,1.0,0,0,2,7,2190,0,1994,0.0,98146,47.5106,-122.365,1640,9719,17610,0.8893939393939394,4796100,392040000,387243900
925000.0,4,2.5,3540,18168,2.0,0,0,2,10,3540,0,1996,0.0,98006,47.5441,-122.131,4130,11180,14628,0.8051519154557464,12531600,330076224,317544624
930000.0,3,3.25,2640,4080,2.0,0,0,2,9,1840,800,1912,2000.0,98105,47.6636,-122.32600000000001,1990,4080,1440,0.35294117647058826,6969600,16646400,9676800
727500.0,3,2.0,2660,5000,1.5,0,3,2,8,1940,720,1910,0.0,98116,47.5829,-122.382,2270,5000,2340,0.468,7075600,25000000,17924400
325000.0,4,1.75,1670,9500,1.0,0,0,2,7,1670,0,1976,0.0,98125,47.7254,-122.31,1620,9500,7830,0.8242105263157895,2788900,90250000,87461100
695000.0,3,3.25,3080,12100,2.0,0,0,2,8,2080,1000,1984,0.0,98117,47.695,-122.399,2100,6581,9020,0.7454545454545455,9486400,146410000,136923600
585000.0,4,2.75,2890,6825,1.0,0,0,2,8,1560,1330,1973,0.0,98034,47.733999999999995,-122.182,1900,10120,3935,0.5765567765567765,8352100,46580625,38228525
319000.0,3,2.25,1800,9597,1.0,0,2,2,7,1200,600,1963,0.0,98188,47.4516,-122.26700000000001,1700,13502,7797,0.8124413879337293,3240000,92102409,88862409
265000.0,6,2.5,2000,7650,1.5,0,0,3,7,1790,210,1960,0.0,98032,47.3841,-122.288,1710,7650,5650,0.738562091503268,4000000,58522500,54522500
359000.0,5,1.75,1940,6654,1.5,0,0,3,7,1940,0,1953,0.0,98166,47.4663,-122.359,2300,9500,4714,0.7084460474902314,3763600,44275716,40512116
390000.0,5,1.75,1940,6654,1.5,0,0,3,7,1940,0,1953,0.0,98166,47.4663,-122.359,2300,9500,4714,0.7084460474902314,3763600,44275716,40512116
374500.0,3,1.0,960,9531,1.0,0,0,4,7,960,0,1969,0.0,98072,47.7619,-122.162,1670,9250,8571,0.8992760465848284,921600,90839961,89918361
661000.0,2,1.5,1750,46173,2.0,0,0,3,8,1750,0,1964,0.0,98072,47.7397,-122.126,2220,42224,44423,0.962099062222511,3062500,2131945929,2128883429
900000.0,3,2.5,2320,5000,2.0,0,0,2,8,1620,700,1907,1993.0,98112,47.6278,-122.292,2160,5000,2680,0.536,5382400,25000000,19617600
600000.0,5,2.5,2380,8204,1.0,0,0,2,8,1540,840,1957,0.0,98115,47.7,-122.287,2270,8204,5824,0.7098976109215017,5664400,67305616,61641216
2000000.0,5,4.25,6490,10862,2.0,0,3,3,11,3940,2550,1991,0.0,98040,47.5728,-122.205,3290,14080,4372,0.4025041428834469,42120100,117983044,75862944
512500.0,4,1.75,1620,4240,1.5,0,0,4,7,1620,0,1916,0.0,98144,47.5746,-122.311,1450,4240,2620,0.6179245283018868,2624400,17977600,15353200
229500.0,3,1.75,1770,33224,1.0,0,0,3,8,1770,0,1968,0.0,98092,47.3377,-122.194,1690,22069,31454,0.9467252588490248,3132900,1103834176,1100701276
589000.0,3,2.5,2320,5663,2.0,0,0,2,8,2320,0,2003,0.0,98027,47.538999999999994,-122.07,2500,4500,3343,0.5903231502737065,5382400,32069569,26687169
539950.0,3,2.5,1330,2183,3.0,0,0,2,8,1330,0,2014,0.0,98117,47.6987,-122.365,1310,5000,853,0.3907466788822721,1768900,4765489,2996589
640000.0,4,2.5,3420,21344,2.0,0,0,2,9,3420,0,2002,0.0,98166,47.45,-122.334,2110,21344,17924,0.8397676161919041,11696400,455566336,443869936
218250.0,3,1.0,1270,7344,1.0,0,0,2,7,970,300,1967,0.0,98023,47.305,-122.37100000000001,1290,7300,6074,0.8270697167755992,1612900,53934336,52321436
675000.0,4,3.5,2550,3600,2.0,0,2,2,8,1880,670,1997,0.0,98177,47.7709,-122.39,2090,6000,1050,0.2916666666666667,6502500,12960000,6457500
338000.0,5,2.0,1860,9000,2.0,0,0,2,7,1860,0,1980,0.0,98045,47.4484,-121.772,1390,9752,7140,0.7933333333333333,3459600,81000000,77540400
231750.0,3,1.0,1020,7615,1.0,0,0,2,7,1020,0,1981,0.0,98058,47.4292,-122.152,1470,9515,6595,0.866053841103086,1040400,57988225,56947825
199900.0,1,1.0,720,7140,1.0,0,0,2,6,720,0,1930,0.0,98146,47.5119,-122.339,1140,7577,6420,0.8991596638655462,518400,50979600,50461200
1060000.0,4,3.5,4460,16271,2.0,0,2,2,11,4460,0,2001,0.0,98075,47.5862,-121.97,4540,17122,11811,0.7258926925204351,19891600,264745441,244853841
263000.0,4,2.75,1830,7315,1.0,0,0,4,7,1250,580,1979,0.0,98023,47.2989,-122.38,1730,7208,5485,0.7498291182501708,3348900,53509225,50160325
279950.0,3,1.5,1520,7200,1.0,0,0,3,7,1160,360,1990,0.0,98198,47.3855,-122.302,1460,7200,5680,0.7888888888888889,2310400,51840000,49529600
395000.0,3,1.5,1080,2940,1.5,0,0,3,7,1080,0,1920,0.0,98115,47.6832,-122.304,1400,4930,1860,0.6326530612244898,1166400,8643600,7477200
252500.0,3,2.0,1900,8002,1.0,0,0,2,7,1900,0,1991,0.0,98023,47.2909,-122.352,1900,6086,6102,0.7625593601599601,3610000,64032004,60422004
1150000.0,4,3.75,5300,37034,2.0,0,0,2,11,5300,0,1989,0.0,98077,47.7283,-122.07600000000001,3730,37034,31734,0.8568882648377167,28090000,1371517156,1343427156
205000.0,3,1.0,1370,10708,1.0,0,0,2,7,1370,0,1969,0.0,98001,47.2769,-122.264,1770,14482,9338,0.8720582741875234,1876900,114661264,112784364
654000.0,5,2.5,2960,8968,1.0,0,0,3,8,1640,1320,1965,0.0,98008,47.6233,-122.102,1890,9077,6008,0.6699375557537912,8761600,80425024,71663424
200000.0,3,1.0,960,213008,1.0,0,0,1,6,960,0,1933,0.0,98024,47.5621,-121.86200000000001,1520,57499,212048,0.9954931270187035,921600,45372408064,45371486464
700000.0,3,2.5,2190,7982,2.0,0,0,2,8,2190,0,2004,0.0,98033,47.6869,-122.18700000000001,2090,8888,5792,0.7256326735154097,4796100,63712324,58916224
2720000.0,4,3.25,3990,18115,2.0,0,0,3,11,3990,0,1989,0.0,98039,47.6177,-122.229,3450,16087,14125,0.7797405465084184,15920100,328153225,312233125
306000.0,2,1.75,1200,2622,1.0,0,0,4,7,800,400,1956,0.0,98125,47.7175,-122.292,1310,1926,1422,0.5423340961098398,1440000,6874884,5434884
270000.0,3,2.5,1780,5015,2.0,0,0,2,7,1780,0,2010,0.0,98042,47.3352,-122.052,2010,5250,3235,0.6450648055832503,3168400,25150225,21981825
340000.0,3,2.25,2630,9916,2.0,0,0,3,9,2630,0,1988,0.0,98092,47.3314,-122.20200000000001,2470,10810,7286,0.7347720855183542,6916900,98327056,91410156
450000.0,4,2.5,2300,19250,1.0,0,0,3,7,2300,0,1955,0.0,98045,47.4793,-121.77600000000001,1460,19250,16950,0.8805194805194805,5290000,370562500,365272500
580000.0,4,2.75,3210,6825,1.0,0,0,4,7,1810,1400,1975,0.0,98034,47.7338,-122.169,1840,8000,3615,0.5296703296703297,10304100,46580625,36276525
435000.0,4,1.75,2290,4400,1.0,0,3,2,7,1290,1000,1959,0.0,98126,47.5698,-122.375,1820,4000,2110,0.47954545454545455,5244100,19360000,14115900
690000.0,4,2.5,2780,4688,2.0,0,0,2,9,2780,0,2003,0.0,98059,47.5225,-122.156,3000,6029,1908,0.4069965870307167,7728400,21977344,14248944
720000.0,4,2.5,2650,11520,2.0,0,0,2,8,2110,0,1988,0.0,98033,47.683,-122.18700000000001,2000,7680,8870,0.7699652777777778,7022500,132710400,125687900
403000.0,3,2.25,1840,13020,1.0,0,0,2,8,1390,450,1980,0.0,98052,47.6923,-122.095,2210,13020,11180,0.858678955453149,3385600,169520400,166134800
440000.0,3,2.75,1560,7392,1.0,0,0,4,7,1030,530,1972,0.0,98011,47.7382,-122.182,1870,7520,5832,0.788961038961039,2433600,54641664,52208064
178500.0,3,1.0,1200,8470,1.0,0,0,4,7,1200,0,1961,0.0,98032,47.3864,-122.287,1200,7952,7270,0.8583234946871311,1440000,71740900,70300900
270000.0,4,2.5,1900,8282,1.0,0,0,2,7,1900,0,1968,1997.0,98022,47.2089,-122.00299999999999,1420,8350,6382,0.7705868147790389,3610000,68591524,64981524
129888.0,2,1.0,710,9900,1.0,0,0,2,6,710,0,1943,0.0,98166,47.479,-122.339,1070,9900,9190,0.9282828282828283,504100,98010000,97505900
260000.0,3,1.75,1360,15210,1.0,0,0,2,7,1360,0,1987,0.0,98038,47.3657,-122.04700000000001,1610,7800,13850,0.9105851413543721,1849600,231344100,229494500
339950.0,5,2.5,2990,7292,2.0,0,0,3,8,2990,0,1990,0.0,98042,47.3604,-122.09100000000001,2150,8190,4302,0.5899616017553483,8940100,53173264,44233164
250000.0,3,1.0,1640,26127,2.0,0,0,2,6,1640,0,1975,0.0,98019,47.7656,-121.905,1620,25788,24487,0.937229685765683,2689600,682620129,679930529
680000.0,3,3.5,3650,103672,1.0,0,0,2,10,2050,1600,2011,0.0,98031,47.4002,-122.21700000000001,2550,16140,100022,0.9647928080870437,13322500,10747883584,10734561084
660000.0,10,3.0,2920,3745,2.0,0,0,3,7,1860,1060,1913,0.0,98105,47.6635,-122.32,1810,3745,825,0.22029372496662217,8526400,14025025,5498625
1230000.0,3,3.5,3680,11491,2.0,0,2,2,11,3680,0,1999,0.0,98007,47.5647,-122.12799999999999,3710,10030,7811,0.6797493690714472,13542400,132043081,118500681
550000.0,3,2.0,1830,9152,1.0,0,0,4,8,1830,0,1959,0.0,98006,47.5531,-122.181,1770,9220,7322,0.8000437062937062,3348900,83759104,80410204
675000.0,5,2.75,2570,12906,2.0,0,0,2,8,2570,0,1987,0.0,98075,47.5814,-122.05,2580,12927,10336,0.8008678134201147,6604900,166564836,159959936
981000.0,3,3.25,2730,9588,2.0,0,1,2,10,1900,830,1984,0.0,98052,47.6339,-122.09,2730,12736,6858,0.7152690863579474,7452900,91929744,84476844
168000.0,3,1.0,1150,8000,1.5,0,0,3,6,1150,0,1913,1957.0,98001,47.2749,-122.25200000000001,1170,9600,6850,0.85625,1322500,64000000,62677500
1000000.0,4,3.0,4260,18687,2.0,0,0,2,11,4260,0,1996,0.0,98075,47.5874,-121.98200000000001,3490,16772,14427,0.7720340343554343,18147600,349203969,331056369
320000.0,3,1.0,1260,9600,1.0,0,0,2,7,1260,0,1970,1995.0,98045,47.4444,-121.762,1530,9790,8340,0.86875,1587600,92160000,90572400
959000.0,6,3.25,4440,17424,1.0,0,1,3,9,2220,2220,1959,0.0,98040,47.5791,-122.23,2660,10768,12984,0.7451790633608816,19713600,303595776,283882176
372000.0,4,1.0,2300,7680,1.0,0,0,2,7,1270,1030,1959,0.0,98106,47.523999999999994,-122.359,1840,5120,5380,0.7005208333333334,5290000,58982400,53692400
391500.0,3,2.5,1920,9625,2.0,0,0,2,8,1920,0,1993,0.0,98045,47.4876,-121.8,1920,10343,7705,0.8005194805194805,3686400,92640625,88954225
390000.0,2,1.0,1080,4725,1.5,0,0,2,7,1080,0,1944,0.0,98126,47.5275,-122.381,1520,4961,3645,0.7714285714285715,1166400,22325625,21159225
302000.0,2,1.0,890,5000,1.0,0,0,3,6,890,0,1947,0.0,98118,47.5526,-122.287,1160,5000,4110,0.822,792100,25000000,24207900
495000.0,3,3.5,1650,1577,2.0,0,0,2,7,1100,550,2012,0.0,98109,47.6302,-122.344,1580,1280,-73,-0.046290424857324035,2722500,2486929,-235571
504500.0,3,2.5,1820,1545,3.0,0,2,2,8,1640,180,1998,0.0,98103,47.6523,-122.346,1440,1290,-275,-0.1779935275080906,3312400,2387025,-925375
555000.0,4,1.75,2320,4800,1.5,0,0,2,7,2170,150,1918,0.0,98117,47.6893,-122.365,1390,4800,2480,0.5166666666666667,5382400,23040000,17657600
1550000.0,4,3.5,3260,5000,2.0,0,0,4,9,2630,630,1937,0.0,98105,47.6598,-122.273,2600,5000,1740,0.348,10627600,25000000,14372400
550000.0,3,1.5,1730,5750,1.0,0,0,2,7,1250,480,1947,0.0,98116,47.5645,-122.397,1370,5750,4020,0.6991304347826087,2992900,33062500,30069600
1800000.0,4,2.5,3320,8325,2.5,0,0,4,10,3320,0,1905,0.0,98112,47.6263,-122.314,3680,6050,5005,0.6012012012012012,11022400,69305625,58283225
655000.0,1,1.0,1660,5422,1.0,0,0,3,7,830,830,1908,0.0,98117,47.6821,-122.38799999999999,1100,5356,3762,0.6938399114717816,2755600,29398084,26642484
685000.0,3,2.5,3290,90796,2.0,0,0,3,10,3290,0,1992,0.0,98042,47.3154,-122.079,2700,55023,87506,0.9637649235649147,10824100,8243913616,8233089516
721000.0,4,2.0,2280,8339,1.0,0,0,3,7,1220,1060,1954,0.0,98115,47.6986,-122.29700000000001,1970,8340,6059,0.7265859215733301,5198400,69538921,64340521
1520000.0,4,4.25,3650,5328,1.5,0,0,2,9,2330,1320,1907,2014.0,98119,47.63800000000001,-122.36200000000001,1710,3600,1678,0.31493993993993996,13322500,28387584,15065084
365000.0,4,2.5,1620,219542,2.0,0,0,2,7,1620,0,1980,0.0,98038,47.4014,-122.069,2240,217800,217922,0.9926210019039637,2624400,48198689764,48196065364
458000.0,3,2.0,2020,8555,1.0,0,0,3,7,1220,800,1957,0.0,98125,47.7278,-122.287,1600,8148,6535,0.7638807714786674,4080400,73188025,69107625
280000.0,2,1.0,1150,12861,1.0,0,0,2,6,1150,0,1959,0.0,98058,47.4493,-122.171,1170,7574,11711,0.9105823808413032,1322500,165405321,164082821
628000.0,4,1.75,1940,3060,1.0,0,0,3,7,1000,940,1911,0.0,98115,47.6786,-122.31700000000001,1320,3060,1120,0.3660130718954248,3763600,9363600,5600000
781500.0,4,2.5,3440,6332,2.0,0,0,2,10,3440,0,2001,0.0,98059,47.5347,-122.155,3310,6528,2892,0.4567277321541377,11833600,40094224,28260624
295000.0,3,1.75,2000,7560,1.0,0,0,3,7,1300,700,1968,0.0,98058,47.4346,-122.171,1900,8301,5560,0.7354497354497355,4000000,57153600,53153600
435000.0,2,1.0,750,2786,1.0,0,0,4,7,750,0,1947,0.0,98117,47.6892,-122.39299999999999,1700,4653,2036,0.7307968413496052,562500,7761796,7199296
300000.0,3,1.75,1420,7200,1.0,0,0,2,7,1000,420,1979,0.0,98146,47.5069,-122.367,1550,8640,5780,0.8027777777777778,2016400,51840000,49823600
208500.0,2,1.0,880,4814,1.0,0,0,3,5,880,0,1906,0.0,98010,47.3107,-121.999,1010,6160,3934,0.8171998338180307,774400,23174596,22400196
930000.0,2,2.5,2680,11214,1.0,0,0,2,9,2680,0,2006,0.0,98053,47.7078,-122.01899999999999,2305,6908,8534,0.7610130194399858,7182400,125753796,118571396
316000.0,2,2.0,860,3000,1.0,0,0,2,6,860,0,1906,0.0,98118,47.5633,-122.288,1290,3500,2140,0.7133333333333334,739600,9000000,8260400
249900.0,3,2.0,1310,6738,1.0,0,0,3,7,1310,0,1990,0.0,98042,47.3694,-122.083,1290,8067,5428,0.8055802908875037,1716100,45400644,43684544
675000.0,3,2.25,1780,4252,2.0,0,0,3,8,1540,240,1989,0.0,98144,47.6004,-122.292,2220,4000,2472,0.58137347130762,3168400,18079504,14911104
447000.0,3,2.25,1440,4667,2.0,0,0,2,7,1440,0,1985,0.0,98029,47.5662,-122.01700000000001,1610,4756,3227,0.6914506106706664,2073600,21780889,19707289
675000.0,3,2.0,1510,3817,1.5,0,0,2,8,1510,0,1905,1994.0,98122,47.6088,-122.294,1510,3817,2307,0.6044013623264344,2280100,14569489,12289389
546000.0,4,2.5,2100,1397,3.0,0,0,2,8,1580,520,2008,0.0,98144,47.5928,-122.295,1490,1201,-703,-0.5032211882605584,4410000,1951609,-2458391
310000.0,3,2.0,1310,1361,3.0,0,0,2,7,1310,0,2003,0.0,98133,47.7337,-122.34299999999999,1370,1608,51,0.03747244673034533,1716100,1852321,136221
190000.0,3,1.0,1280,5100,1.0,0,0,2,7,880,400,1961,0.0,98178,47.5035,-122.259,1360,6120,3820,0.7490196078431373,1638400,26010000,24371600
650000.0,3,1.5,1320,8114,1.0,0,0,2,8,1320,0,1951,0.0,98004,47.5827,-122.195,2110,8114,6794,0.8373182154301207,1742400,65836996,64094596
585000.0,3,2.5,1740,2350,2.0,0,0,2,8,1130,610,1995,0.0,98112,47.6207,-122.29700000000001,1740,3201,610,0.25957446808510637,3027600,5522500,2494900
1430000.0,4,2.5,2910,7364,2.0,0,0,2,10,2910,0,2003,0.0,98033,47.6906,-122.213,2480,8400,4454,0.6048343291689299,8468100,54228496,45760396
565000.0,4,2.5,2500,12090,1.0,0,0,2,9,2500,0,1983,0.0,98074,47.6346,-122.045,3380,12760,9590,0.7932175351530191,6250000,146168100,139918100
174900.0,3,1.0,1100,6000,1.5,0,0,1,6,1100,0,1926,0.0,98108,47.5279,-122.318,960,5880,4900,0.8166666666666667,1210000,36000000,34790000
360000.0,3,2.25,1381,1180,3.0,0,0,2,8,1381,0,2007,0.0,98125,47.71100000000001,-122.32,1381,1180,-201,-0.17033898305084746,1907161,1392400,-514761
234000.0,3,1.0,960,9624,1.0,0,0,2,7,960,0,1953,0.0,98155,47.7758,-122.301,1540,9624,8664,0.9002493765586035,921600,92621376,91699776
575000.0,8,3.0,3840,15990,1.0,0,0,2,7,2530,1310,1961,0.0,98034,47.7111,-122.211,1380,8172,12150,0.7598499061913696,14745600,255680100,240934500
315000.0,3,2.5,2200,5954,2.0,0,0,2,7,2200,0,2004,0.0,98042,47.3709,-122.125,2200,5046,3754,0.6305005038629493,4840000,35450116,30610116
225000.0,3,1.0,1250,7820,1.0,0,0,2,7,1250,0,1967,0.0,98001,47.3397,-122.291,1300,7920,6570,0.840153452685422,1562500,61152400,59589900
370000.0,3,1.5,2380,14500,1.0,0,0,3,7,1850,530,1961,0.0,98028,47.7714,-122.256,1830,13600,12120,0.8358620689655173,5664400,210250000,204585600
606000.0,3,1.0,1500,3920,1.0,0,0,2,7,1000,500,1947,0.0,98107,47.6718,-122.359,1640,4017,2420,0.6173469387755102,2250000,15366400,13116400
272500.0,3,2.0,1410,7622,1.0,0,0,3,7,1410,0,1983,0.0,98058,47.4273,-122.147,1830,8330,6212,0.8150091839412228,1988100,58094884,56106784
475000.0,3,1.75,1680,3420,1.0,0,0,2,7,960,720,1992,0.0,98115,47.6855,-122.291,1680,4080,1740,0.5087719298245614,2822400,11696400,8874000
270000.0,3,1.0,1500,13500,1.0,0,0,3,7,1500,0,1968,0.0,98059,47.4666,-122.072,1350,13680,12000,0.8888888888888888,2250000,182250000,180000000
624000.0,4,1.75,2710,9216,1.0,0,0,2,8,1440,1270,1961,0.0,98126,47.5523,-122.37899999999999,1960,6350,6506,0.7059461805555556,7344100,84934656,77590556
355000.0,3,1.75,1730,7416,1.5,0,0,2,7,1730,0,1954,0.0,98133,47.76,-122.34899999999999,1390,6490,5686,0.7667206040992449,2992900,54997056,52004156
345000.0,3,1.0,960,3844,1.0,0,0,2,7,960,0,1972,0.0,98133,47.7027,-122.346,1020,3844,2884,0.7502601456815817,921600,14776336,13854736
342000.0,4,2.5,2380,7792,2.0,0,0,2,8,2380,0,1993,0.0,98092,47.3273,-122.17299999999999,2260,7378,5412,0.694558521560575,5664400,60715264,55050864
316000.0,3,1.75,1120,98445,1.5,0,2,3,7,1120,0,1917,0.0,98022,47.1853,-122.01700000000001,1620,34200,97325,0.9886230890344863,1254400,9691418025,9690163625
539950.0,4,2.5,2960,37430,2.0,0,0,2,9,2960,0,1990,0.0,98038,47.3988,-122.023,2800,36384,34470,0.9209190488912637,8761600,1401004900,1392243300
221347.0,3,2.0,1580,6655,1.0,0,0,2,6,790,790,1944,0.0,98178,47.4927,-122.24799999999999,1090,6655,5075,0.7625845229151015,2496400,44289025,41792625
330000.0,3,2.5,1870,4657,2.0,0,0,2,8,1870,0,2000,0.0,98055,47.4615,-122.214,2290,4795,2787,0.5984539403049173,3496900,21687649,18190749
279000.0,4,2.5,1810,13000,1.0,0,0,3,8,1470,340,1977,0.0,98022,47.2202,-121.993,1850,13000,11190,0.8607692307692307,3276100,169000000,165723900
850000.0,4,3.0,2550,3784,1.5,0,0,3,8,1750,800,1900,0.0,98103,47.6559,-122.338,2100,4560,1234,0.32610993657505283,6502500,14318656,7816156
746000.0,3,1.75,1910,12321,1.0,0,0,3,7,1100,810,1952,0.0,98004,47.5995,-122.198,1910,11761,10411,0.8449801152503855,3648100,151807041,148158941
478000.0,2,2.0,1200,1867,1.0,0,0,2,7,600,600,1924,1998.0,98109,47.626999999999995,-122.345,1790,2221,667,0.35725763256561327,1440000,3485689,2045689
820000.0,4,2.75,2420,4635,1.5,0,0,4,7,2420,0,1905,0.0,98103,47.681999999999995,-122.34700000000001,1590,3150,2215,0.4778856526429342,5856400,21483225,15626825
2160000.0,3,3.5,3080,6495,2.0,0,3,2,11,2530,550,1996,2006.0,98199,47.6321,-122.39299999999999,4120,8620,3415,0.5257890685142417,9486400,42185025,32698625
820000.0,3,3.0,3850,38830,2.0,0,1,2,10,3850,0,2000,0.0,98006,47.5535,-122.191,2970,14050,34980,0.9008498583569405,14822500,1507768900,1492946400
887000.0,3,2.0,3000,22040,2.0,0,2,3,8,2470,530,1942,0.0,98177,47.7745,-122.368,2600,7947,19040,0.8638838475499092,9000000,485761600,476761600
159000.0,3,1.0,1360,20000,1.0,0,0,3,7,1360,0,1953,0.0,98001,47.2861,-122.25299999999999,1530,9997,18640,0.932,1849600,400000000,398150400
824000.0,7,4.25,3670,4000,2.0,0,1,2,8,2800,870,1964,0.0,98199,47.6375,-122.38799999999999,2010,4000,330,0.0825,13468900,16000000,2531100
812000.0,4,2.5,2270,5000,2.0,0,0,2,9,2270,0,2014,0.0,98117,47.6916,-122.37,1210,5000,2730,0.546,5152900,25000000,19847100
242000.0,4,2.5,1750,11400,2.0,0,0,3,7,1750,0,1975,0.0,98023,47.3149,-122.38600000000001,1890,9024,9650,0.8464912280701754,3062500,129960000,126897500
625000.0,4,2.5,3550,8048,2.0,0,0,2,9,3550,0,2007,0.0,98065,47.5422,-121.88799999999999,3920,7871,4498,0.55889662027833,12602500,64770304,52167804
399888.0,4,1.0,2370,30200,1.5,0,0,3,7,1570,800,1948,0.0,98146,47.5108,-122.366,1640,9719,27830,0.921523178807947,5616900,912040000,906423100
289000.0,3,2.25,1670,6600,2.0,0,0,3,7,1670,0,1990,0.0,98042,47.3604,-122.089,1670,6801,4930,0.746969696969697,2788900,43560000,40771100
400000.0,3,2.0,1860,12944,1.0,0,0,2,9,1860,0,2002,0.0,98058,47.4298,-122.102,2500,29279,11084,0.8563040791100124,3459600,167547136,164087536
1550000.0,3,2.5,4460,26027,2.0,0,0,2,12,4460,0,1992,0.0,98033,47.6573,-122.17299999999999,3770,26027,21567,0.8286394897606332,19891600,677404729,657513129
345000.0,2,1.0,1080,4000,1.0,0,0,2,7,1080,0,1940,0.0,98117,47.6902,-122.387,1530,4240,2920,0.73,1166400,16000000,14833600
874950.0,2,1.0,1080,4000,1.0,0,0,2,7,1080,0,1940,0.0,98117,47.6902,-122.387,1530,4240,2920,0.73,1166400,16000000,14833600
875000.0,3,2.75,2280,4280,1.0,0,0,4,7,1280,1000,1917,0.0,98103,47.6685,-122.335,1650,4280,2000,0.4672897196261682,5198400,18318400,13120000
628990.0,4,2.5,2540,32647,2.0,0,0,2,9,2540,0,1996,0.0,98053,47.6324,-121.988,2740,32647,30107,0.9221980580145189,6451600,1065826609,1059375009
535000.0,2,3.5,2560,5000,1.0,0,0,3,6,1280,1280,1944,0.0,98107,47.6681,-122.368,1390,4000,2440,0.488,6553600,25000000,18446400
770126.0,4,2.75,2390,9300,1.0,0,0,2,8,1430,960,1979,0.0,98004,47.6035,-122.206,1910,9348,6910,0.7430107526881721,5712100,86490000,80777900
710000.0,4,2.5,2870,8995,1.0,0,0,4,8,1870,1000,1968,0.0,98006,47.5678,-122.12799999999999,2670,9672,6125,0.6809338521400778,8236900,80910025,72673125
465000.0,3,1.75,1510,4800,1.0,0,2,2,7,860,650,1925,0.0,98126,47.5667,-122.37200000000001,1510,4800,3290,0.6854166666666667,2280100,23040000,20759900
359000.0,3,1.75,2200,11520,1.0,0,0,3,7,2200,0,1952,0.0,98133,47.7659,-122.34100000000001,1690,8038,9320,0.8090277777777778,4840000,132710400,127870400
151000.0,2,0.75,720,5040,1.0,0,0,2,4,720,0,1949,0.0,98106,47.5323,-122.34700000000001,1290,4120,4320,0.8571428571428571,518400,25401600,24883200
820000.0,3,2.5,2970,9600,2.0,0,0,2,9,2970,0,1994,0.0,98006,47.5422,-122.132,2970,9707,6630,0.690625,8820900,92160000,83339100
160000.0,3,1.5,960,6497,1.0,0,0,3,7,960,0,1970,0.0,98023,47.3018,-122.37799999999999,1160,7080,5537,0.8522394951516085,921600,42211009,41289409
535000.0,4,1.75,1420,5000,1.5,0,0,3,7,1420,0,1945,0.0,98117,47.6771,-122.397,1490,5000,3580,0.716,2016400,25000000,22983600
365000.0,3,2.25,1800,9010,1.0,0,0,2,7,1300,500,1975,0.0,98155,47.7722,-122.31200000000001,1950,10240,7210,0.8002219755826859,3240000,81180100,77940100
708000.0,4,2.5,3090,5600,2.0,0,0,2,9,3090,0,2005,0.0,98075,47.597,-121.979,3080,5788,2510,0.44821428571428573,9548100,31360000,21811900
215000.0,3,1.0,1200,7280,1.0,0,0,3,7,1200,0,1967,0.0,98032,47.3724,-122.277,1200,8400,6080,0.8351648351648352,1440000,52998400,51558400
1950000.0,4,3.5,4065,18713,2.0,0,0,3,10,4065,0,1987,0.0,98039,47.6209,-122.23700000000001,3070,18713,14648,0.7827713354352589,16524225,350176369,333652144
390000.0,4,2.5,2570,22215,2.0,0,0,4,7,2570,0,1958,0.0,98059,47.4833,-122.15700000000001,2460,6533,19645,0.8843124015304974,6604900,493506225,486901325
570000.0,3,2.0,1530,5401,1.0,0,0,3,7,1530,0,1937,0.0,98115,47.68600000000001,-122.304,1640,5467,3871,0.7167191260877616,2340900,29170801,26829901
383000.0,3,1.75,1500,13430,1.0,0,0,2,7,1500,0,1977,0.0,98072,47.7527,-122.08200000000001,1500,13430,11930,0.8883097542814594,2250000,180364900,178114900
370000.0,4,3.0,2490,5706,2.0,0,0,2,9,2490,0,2005,0.0,98042,47.3509,-122.165,2650,5880,3216,0.5636172450052577,6200100,32558436,26358336
454000.0,4,2.5,3040,12522,2.0,0,0,2,7,3040,0,2000,0.0,98019,47.7247,-121.959,2490,9742,9482,0.7572272799872225,9241600,156800484,147558884
1400000.0,5,3.25,4140,32700,1.0,0,4,2,10,2190,1950,1973,0.0,98177,47.7633,-122.369,3220,22077,28560,0.8733944954128441,17139600,1069290000,1052150400
371000.0,4,1.75,1690,10854,1.0,0,0,2,7,1690,0,1977,0.0,98056,47.5241,-122.199,2390,7000,9164,0.8442970333517598,2856100,117809316,114953216
530000.0,3,1.75,1430,10350,1.0,0,0,2,7,1430,0,1959,0.0,98008,47.6353,-122.12299999999999,1890,10350,8920,0.8618357487922705,2044900,107122500,105077600
608000.0,4,2.75,2490,9714,1.0,0,0,3,8,1400,1090,1983,0.0,98011,47.7496,-122.20100000000001,2060,15300,7224,0.74366893143916,6200100,94361796,88161696
450000.0,3,1.75,1350,7200,1.0,0,0,4,7,1350,0,1954,0.0,98125,47.713,-122.28399999999999,1100,7200,5850,0.8125,1822500,51840000,50017500
780000.0,4,2.5,3140,14421,2.0,0,0,2,10,3140,0,1994,0.0,98075,47.5943,-122.01799999999999,3140,17417,11281,0.7822619790583177,9859600,207965241,198105641
290000.0,4,2.5,2340,52272,2.0,0,0,1,8,2340,0,1978,0.0,98042,47.3468,-122.09100000000001,2480,40500,49932,0.9552341597796143,5475600,2732361984,2726886384
225000.0,3,1.75,1610,14182,1.0,0,0,3,7,1100,510,1978,0.0,98092,47.3174,-122.18,1510,8400,12572,0.8864758144126358,2592100,201129124,198537024
805000.0,4,2.5,3320,38032,2.0,0,0,3,10,3320,0,1991,0.0,98077,47.7478,-122.036,3270,37804,34712,0.9127050904501472,11022400,1446433024,1435410624
660000.0,3,2.5,2390,15669,2.0,0,0,2,9,2390,0,1991,0.0,98011,47.7446,-122.193,2640,12500,13279,0.8474695258153041,5712100,245517561,239805461
299000.0,3,1.75,1180,13927,1.0,0,0,4,7,1180,0,1962,0.0,98059,47.4818,-122.094,1400,13173,12747,0.9152724922811805,1392400,193961329,192568929
530000.0,2,2.25,1260,1312,3.0,0,0,2,8,1260,0,2007,0.0,98103,47.6538,-122.35600000000001,1300,1312,52,0.039634146341463415,1587600,1721344,133744
680000.0,3,2.5,1800,4400,1.0,0,0,4,7,1350,450,1970,0.0,98199,47.6599,-122.396,1920,4400,2600,0.5909090909090909,3240000,19360000,16120000
199900.0,4,1.75,1790,12000,1.0,0,0,4,6,1790,0,1944,0.0,98001,47.2664,-122.256,1550,9840,10210,0.8508333333333333,3204100,144000000,140795900
224000.0,3,1.75,1760,6300,1.0,0,0,2,7,1060,700,1963,0.0,98178,47.5003,-122.26,1340,7300,4540,0.7206349206349206,3097600,39690000,36592400
244000.0,3,1.75,1540,8885,1.0,0,0,3,7,1440,100,1980,0.0,98031,47.4031,-122.20100000000001,1540,12734,7345,0.8266741699493528,2371600,78943225,76571625
485000.0,4,1.75,1260,3880,1.0,0,0,4,7,860,400,1918,0.0,98117,47.687,-122.391,1000,3880,2620,0.6752577319587629,1587600,15054400,13466800
330000.0,4,2.5,2240,7589,2.0,0,0,2,8,2240,0,1994,0.0,98030,47.3824,-122.20700000000001,2250,7300,5349,0.7048359467650547,5017600,57592921,52575321
509000.0,4,2.0,1630,1724,1.5,0,0,2,6,1030,600,1915,1970.0,98119,47.6472,-122.36200000000001,1780,3810,94,0.054524361948955914,2656900,2972176,315276
440000.0,4,2.5,2350,7203,2.0,0,0,2,8,2350,0,1989,0.0,98059,47.5123,-122.15100000000001,2260,7274,4853,0.6737470498403443,5522500,51883209,46360709
244000.0,3,2.0,1350,8587,1.0,0,0,2,7,1350,0,1998,0.0,98022,47.2073,-122.012,1350,8587,7237,0.8427856061488296,1822500,73736569,71914069
399700.0,4,1.75,1320,4800,1.0,0,0,3,7,870,450,1930,0.0,98106,47.5534,-122.365,940,4800,3480,0.725,1742400,23040000,21297600
519000.0,4,2.5,1950,2617,1.5,0,0,3,7,1250,700,1910,0.0,98107,47.6696,-122.37200000000001,1520,1438,667,0.2548719908291937,3802500,6848689,3046189
211000.0,4,1.0,2100,9200,1.0,0,0,2,7,1050,1050,1959,0.0,98168,47.476000000000006,-122.292,1540,10033,7100,0.7717391304347826,4410000,84640000,80230000
950000.0,3,2.5,3480,7800,1.0,0,0,3,7,1750,1730,1941,1998.0,98177,47.7047,-122.37799999999999,3010,9918,4320,0.5538461538461539,12110400,60840000,48729600
410000.0,3,2.5,1830,2839,2.0,0,0,2,8,1830,0,1999,0.0,98074,47.6022,-122.021,1830,3011,1009,0.35540683339203943,3348900,8059921,4711021
750000.0,4,2.0,2640,5000,2.0,0,0,2,7,2040,600,1949,0.0,98117,47.678000000000004,-122.375,1330,5000,2360,0.472,6969600,25000000,18030400
133400.0,3,1.0,900,2550,1.0,0,0,3,6,900,0,1978,0.0,98023,47.3036,-122.363,1120,2550,1650,0.6470588235294118,810000,6502500,5692500
240000.0,3,2.0,1553,6550,1.0,0,0,2,7,1553,0,1900,0.0,98022,47.2056,-121.994,1010,10546,4997,0.7629007633587787,2411809,42902500,40490691
539000.0,3,2.5,1710,2300,2.0,0,0,2,8,1570,140,2005,0.0,98052,47.6743,-122.14200000000001,2120,2856,590,0.2565217391304348,2924100,5290000,2365900
688000.0,4,3.0,3400,292723,2.0,0,0,2,10,3400,0,1998,0.0,98045,47.4883,-121.725,1760,69696,289323,0.9883849236308728,11560000,85686754729,85675194729
465000.0,3,1.5,1270,5112,1.0,0,0,2,7,1270,0,1950,0.0,98115,47.676,-122.288,1580,5080,3842,0.7515649452269171,1612900,26132544,24519644
936000.0,3,1.75,2960,12420,1.0,0,2,3,8,1480,1480,1952,0.0,98116,47.5739,-122.406,2700,9106,9460,0.7616747181964574,8761600,154256400,145494800
620000.0,4,2.5,3040,9606,2.0,0,0,2,7,3040,0,2003,0.0,98053,47.6884,-122.044,1690,3849,6566,0.6835311263793462,9241600,92275236,83033636
429950.0,3,1.75,1430,9750,1.0,0,0,4,7,1430,0,1962,0.0,98133,47.7441,-122.35700000000001,1630,9282,8320,0.8533333333333334,2044900,95062500,93017600
296475.0,3,2.5,1520,4170,2.0,0,0,2,7,1520,0,2004,0.0,98038,47.3842,-122.04,1560,4237,2650,0.6354916067146283,2310400,17388900,15078500
330000.0,4,2.0,1820,9450,1.0,0,0,2,7,1100,720,1962,0.0,98155,47.7607,-122.329,1540,9450,7630,0.8074074074074075,3312400,89302500,85990100
445000.0,3,2.25,1800,11200,1.0,0,0,2,8,1270,530,1979,0.0,98052,47.7072,-122.164,1940,11250,9400,0.8392857142857143,3240000,125440000,122200000
846000.0,4,3.25,2720,4000,2.0,0,1,2,10,2070,650,2014,0.0,98118,47.5554,-122.26700000000001,1450,4000,1280,0.32,7398400,16000000,8601600
725000.0,4,1.75,1980,5850,1.0,0,1,3,8,1380,600,1960,0.0,98116,47.5607,-122.391,1810,5850,3870,0.6615384615384615,3920400,34222500,30302100
369000.0,4,2.5,2550,7349,2.0,0,0,2,9,2550,0,1989,0.0,98023,47.3059,-122.34899999999999,2400,8508,4799,0.6530140155123146,6502500,54007801,47505301
625000.0,3,1.75,2210,16200,1.0,0,0,2,8,1390,820,1958,0.0,98005,47.5924,-122.175,2050,16200,13990,0.8635802469135803,4884100,262440000,257555900
535000.0,3,2.0,2120,4080,2.0,0,0,2,7,2120,0,2003,0.0,98053,47.681999999999995,-122.037,2280,4080,1960,0.4803921568627451,4494400,16646400,12152000
229950.0,4,1.5,1570,6717,1.0,0,0,4,6,1570,0,1911,0.0,98002,47.306999999999995,-122.21700000000001,1140,6716,5147,0.7662647015036474,2464900,45118089,42653189
229999.0,3,1.75,1310,6960,1.0,0,0,3,7,1310,0,1974,0.0,98092,47.2761,-122.15299999999999,1580,7200,5650,0.8117816091954023,1716100,48441600,46725500
850000.0,5,3.5,3150,4120,2.0,0,0,2,8,2460,690,1911,2007.0,98115,47.6754,-122.315,2080,4160,970,0.2354368932038835,9922500,16974400,7051900
589900.0,4,4.5,3870,35889,2.0,0,0,2,10,2530,1340,2001,0.0,98027,47.4677,-122.01,3020,35366,32019,0.8921675165092369,14976900,1288020321,1273043421
513000.0,2,1.0,1840,4322,1.0,0,0,3,7,1160,680,1914,0.0,98144,47.5764,-122.289,1750,4322,2482,0.5742711707542805,3385600,18679684,15294084
401000.0,3,1.0,1120,8321,1.0,0,0,3,6,1120,0,1941,0.0,98027,47.5631,-122.09100000000001,1980,8671,7201,0.8654007931738974,1254400,69239041,67984641
260000.0,3,2.5,1440,2500,2.0,0,0,2,7,1440,0,2006,0.0,98146,47.511,-122.359,1440,5000,1060,0.424,2073600,6250000,4176400
525000.0,4,2.75,2300,26650,1.0,0,0,3,8,2300,0,1950,0.0,98177,47.7771,-122.36200000000001,2000,9879,24350,0.9136960600375235,5290000,710222500,704932500
470000.0,3,3.5,2070,11658,1.0,0,0,3,8,1370,700,1977,0.0,98056,47.537,-122.178,1930,8744,9588,0.822439526505404,4284900,135908964,131624064
205000.0,4,1.5,1420,8063,1.0,0,0,2,7,940,480,1962,0.0,98198,47.4174,-122.316,1330,7515,6643,0.8238868907354583,2016400,65011969,62995569
620000.0,3,2.25,2010,7495,1.0,0,0,3,8,1570,440,1979,0.0,98027,47.5613,-122.083,2050,8402,5485,0.7318212141427618,4040100,56175025,52134925
229000.0,3,1.5,1200,5000,1.0,0,0,2,6,1200,0,1979,0.0,98146,47.5122,-122.35700000000001,1440,2500,3800,0.76,1440000,25000000,23560000
445000.0,2,2.0,1150,6634,1.0,0,0,2,7,860,290,1940,0.0,98115,47.7001,-122.309,1680,6892,5484,0.826650587880615,1322500,44009956,42687456
215000.0,2,1.0,1240,7200,1.0,0,0,2,7,1240,0,1967,0.0,98168,47.4971,-122.28200000000001,1130,9200,5960,0.8277777777777777,1537600,51840000,50302400
504975.0,2,2.5,1900,4871,2.0,0,0,2,8,1900,0,2005,0.0,98053,47.7132,-122.03399999999999,1640,4780,2971,0.609936358037364,3610000,23726641,20116641
495000.0,4,2.25,2350,10072,2.0,0,0,2,8,2350,0,1980,0.0,98011,47.7628,-122.16799999999999,2210,9687,7722,0.7666799046862589,5522500,101445184,95922684
205000.0,3,1.0,1120,8342,1.0,0,0,3,7,1120,0,1976,0.0,98042,47.3732,-122.116,1190,6660,7222,0.8657396307839846,1254400,69588964,68334564
152275.0,1,1.0,1020,6871,1.0,0,0,2,6,1020,0,1937,0.0,98146,47.5051,-122.338,1260,6933,5851,0.8515499927230389,1040400,47210641,46170241
586000.0,4,2.25,1930,8338,1.0,0,0,2,8,1930,0,1968,0.0,98125,47.7026,-122.285,2280,7616,6408,0.7685296234108899,3724900,69522244,65797344
779950.0,2,2.5,2680,7625,1.0,0,0,2,9,2680,0,2002,0.0,98053,47.7094,-122.024,2310,7395,4945,0.6485245901639344,7182400,58140625,50958225
557000.0,4,1.75,2660,11315,2.0,0,0,3,8,2660,0,1983,0.0,98074,47.6204,-122.044,1980,11315,8655,0.7649138311975254,7075600,128029225,120953625
610000.0,4,2.25,2200,7200,1.0,0,2,3,8,1220,980,1958,0.0,98144,47.5818,-122.296,1940,6000,5000,0.6944444444444444,4840000,51840000,47000000
405000.0,3,1.5,1010,7683,1.5,0,0,4,7,1010,0,1953,0.0,98125,47.72,-122.318,1550,7271,6673,0.8685409345307823,1020100,59028489,58008389
320000.0,4,2.25,2310,7490,2.0,0,0,2,8,2310,0,1980,0.0,98055,47.4379,-122.19200000000001,2310,8480,5180,0.6915887850467289,5336100,56100100,50764000
356000.0,3,1.0,920,3863,1.0,0,0,2,6,920,0,1970,0.0,98118,47.5524,-122.27,1080,5150,2943,0.7618431271032876,846400,14922769,14076369
794500.0,5,3.0,3030,4120,1.5,0,0,3,7,1930,1100,1913,0.0,98115,47.6771,-122.319,1280,3090,1090,0.2645631067961165,9180900,16974400,7793500
349000.0,3,1.75,1590,9620,1.0,0,0,2,7,1590,0,1988,0.0,98059,47.4815,-122.152,2980,9398,8030,0.8347193347193347,2528100,92544400,90016300
549000.0,4,2.25,2740,88426,2.0,0,0,2,7,2740,0,1991,0.0,98027,47.4734,-122.006,2740,62726,85686,0.9690136385226065,7507600,7819157476,7811649876
193000.0,3,1.0,960,10761,1.0,0,0,3,6,960,0,1962,0.0,98002,47.2819,-122.22399999999999,960,10761,9801,0.9107889601338166,921600,115799121,114877521
700000.0,3,1.5,2240,7227,2.0,0,1,2,9,1440,800,1977,0.0,98008,47.6208,-122.09299999999999,3150,16150,4987,0.690051196900512,5017600,52229529,47211929
523000.0,3,2.5,2400,6182,2.0,0,0,2,8,2400,0,1998,0.0,98065,47.5363,-121.87,2420,5829,3782,0.6117761242316403,5760000,38217124,32457124
565000.0,5,3.25,2860,20790,1.0,0,0,3,7,1800,1060,1965,0.0,98155,47.7757,-122.295,1920,9612,17930,0.8624338624338624,8179600,432224100,424044500
500000.0,4,2.5,2960,5027,2.0,0,0,2,7,2960,0,2000,0.0,98065,47.5328,-121.881,2760,5500,2067,0.4111796299980107,8761600,25270729,16509129
1450000.0,4,3.25,3770,4103,2.0,0,0,4,9,2710,1060,1925,0.0,98109,47.64100000000001,-122.34899999999999,2560,4160,333,0.08116012673653425,14212900,16834609,2621709
710000.0,6,3.5,3830,68825,2.0,0,0,2,9,3830,0,1995,0.0,98027,47.4574,-122.00299999999999,2410,68825,64995,0.9443516164184526,14668900,4736880625,4722211725
333000.0,4,2.0,2750,9001,1.0,0,0,2,8,2750,0,2008,0.0,98055,47.457,-122.189,1340,11050,6251,0.6944783912898567,7562500,81018001,73455501
580000.0,3,1.75,2100,6874,1.0,0,0,2,7,1300,800,1943,0.0,98115,47.6724,-122.279,2220,5912,4774,0.6945010183299389,4410000,47251876,42841876
289950.0,4,1.75,1500,8400,1.0,0,0,2,7,1200,300,1956,0.0,98188,47.4531,-122.273,1780,9913,6900,0.8214285714285714,2250000,70560000,68310000
375000.0,2,1.0,710,4618,1.0,0,1,2,5,710,0,1925,0.0,98199,47.64,-122.39399999999999,1810,4988,3908,0.8462537895192724,504100,21325924,20821824
505000.0,2,3.0,2770,10800,1.5,0,0,4,8,1910,860,1984,0.0,98074,47.6082,-122.057,2140,10800,8030,0.7435185185185185,7672900,116640000,108967100
324950.0,3,1.75,2050,6720,1.0,0,2,2,7,1050,1000,1939,0.0,98178,47.5058,-122.235,2380,7260,4670,0.6949404761904762,4202500,45158400,40955900
490000.0,4,2.25,1960,10275,2.0,0,0,2,7,1960,0,1965,0.0,98052,47.6887,-122.124,1560,10275,8315,0.8092457420924575,3841600,105575625,101734025
630000.0,4,2.0,1770,6000,2.0,0,0,4,7,1770,0,1911,0.0,98199,47.6493,-122.40100000000001,1340,6000,4230,0.705,3132900,36000000,32867100
595000.0,3,2.75,3290,22649,2.0,0,0,3,8,3290,0,1993,0.0,98056,47.5241,-122.193,2750,6119,19359,0.8547397236081063,10824100,512977201,502153101
872500.0,4,2.0,1990,6000,1.0,0,0,2,9,1260,730,1956,2015.0,98199,47.6515,-122.397,1770,6000,4010,0.6683333333333333,3960100,36000000,32039900
490000.0,2,1.0,1760,5250,1.0,0,2,3,7,1000,0,1951,0.0,98126,47.5577,-122.37899999999999,1760,5400,3490,0.6647619047619048,3097600,27562500,24464900
1900000.0,4,3.25,5080,27755,2.0,0,0,2,11,5080,0,2001,0.0,98006,47.5423,-122.111,4730,22326,22675,0.8169699153305711,25806400,770340025,744533625
310000.0,2,1.0,1020,8102,1.0,0,0,2,7,1020,0,1956,0.0,98056,47.5135,-122.193,1770,7291,7082,0.8741051592199457,1040400,65642404,64602004
450000.0,3,1.0,1350,92721,1.0,0,0,1,6,1200,150,1946,0.0,98055,47.4657,-122.198,1860,8096,91371,0.9854401915423691,1822500,8597183841,8595361341
539000.0,3,1.5,1740,12000,2.0,0,0,2,9,1740,0,1974,0.0,98074,47.6276,-122.053,2580,12224,10260,0.855,3027600,144000000,140972400
888550.0,3,2.5,3540,38322,2.0,0,0,2,10,3540,0,1989,0.0,98053,47.6892,-122.04799999999999,3540,35926,34782,0.9076248630029748,12531600,1468575684,1456044084
269950.0,3,2.5,1520,8720,1.0,0,0,2,7,1080,440,1981,0.0,98058,47.4267,-122.15700000000001,1720,7551,7200,0.8256880733944955,2310400,76038400,73728000
300000.0,3,1.75,1310,9761,1.0,0,0,2,7,1310,0,1967,0.0,98034,47.721000000000004,-122.228,1490,9600,8451,0.8657924392992521,1716100,95277121,93561021
780000.0,2,3.25,3000,24004,1.0,0,0,2,10,2410,590,1952,0.0,98005,47.611000000000004,-122.15700000000001,4270,24506,21004,0.8750208298616897,9000000,576192016,567192016
545000.0,3,2.5,2660,20369,2.0,0,0,2,8,2660,0,1992,0.0,98027,47.5234,-122.055,2720,12927,17709,0.8694093966321371,7075600,414896161,407820561
278000.0,3,2.25,2120,9804,2.0,0,0,2,7,2120,0,1994,0.0,98042,47.3596,-122.16,2120,7200,7684,0.7837617299061608,4494400,96118416,91624016
342000.0,3,2.25,1200,2845,2.0,0,0,2,7,1200,0,1986,0.0,98034,47.7151,-122.20299999999999,1220,2140,1645,0.5782073813708261,1440000,8094025,6654025
190000.0,4,1.75,1900,9861,1.0,0,0,3,7,1900,0,1967,0.0,98038,47.3615,-122.057,1720,7967,7961,0.8073217726396917,3610000,97239321,93629321
387000.0,2,1.5,1010,948,3.0,0,0,2,8,1010,0,1999,0.0,98103,47.6529,-122.355,1330,1318,-62,-0.06540084388185655,1020100,898704,-121396
279950.0,3,2.25,1850,7480,2.0,0,0,2,7,1850,0,1978,0.0,98058,47.452,-122.15899999999999,1870,7480,5630,0.7526737967914439,3422500,55950400,52527900
550000.0,6,4.5,4520,40164,2.0,0,0,2,9,3580,940,1953,2008.0,98031,47.407,-122.21600000000001,2870,13068,35644,0.8874614082262723,20430400,1613146896,1592716496
439000.0,3,2.0,2010,251341,2.0,0,0,2,8,1510,500,2003,0.0,98019,47.7416,-121.91,1780,108900,249331,0.9920028964633705,4040100,63172298281,63168258181
774888.0,3,2.25,2420,23507,1.0,0,0,3,8,2420,0,1969,0.0,98027,47.5107,-122.027,2540,22257,21087,0.8970519419747309,5856400,552579049,546722649
480000.0,5,2.5,2732,9500,1.0,0,2,3,8,1870,862,1975,0.0,98003,47.3436,-122.323,2720,10000,6768,0.712421052631579,7463824,90250000,82786176
835000.0,4,2.0,1910,6960,1.5,0,0,4,8,1910,0,1941,0.0,98103,47.6893,-122.348,1360,3300,5050,0.7255747126436781,3648100,48441600,44793500
1500000.0,5,3.5,3520,5400,2.0,0,0,2,9,2400,1120,2008,0.0,98119,47.6364,-122.363,1360,3600,1880,0.34814814814814815,12390400,29160000,16769600
771000.0,4,2.0,2220,3760,1.5,0,0,3,7,1370,850,1929,0.0,98117,47.6876,-122.368,1620,3760,1540,0.4095744680851064,4928400,14137600,9209200
1230000.0,4,2.25,2020,5800,1.0,0,3,3,9,1760,260,1941,0.0,98199,47.6471,-122.412,3100,5800,3780,0.6517241379310345,4080400,33640000,29559600
600000.0,4,2.5,2090,7290,1.0,0,0,4,8,1420,670,1966,0.0,98007,47.623999999999995,-122.14200000000001,2110,8436,5200,0.7133058984910837,4368100,53144100,48776000
305000.0,3,1.0,1580,7424,1.0,0,0,2,7,1010,570,1962,0.0,98058,47.4607,-122.171,1710,7772,5844,0.787176724137931,2496400,55115776,52619376
1390000.0,5,1.75,2650,11340,1.0,0,0,2,8,2650,0,1955,0.0,98004,47.62600000000001,-122.213,2780,13204,8690,0.7663139329805997,7022500,128595600,121573100
216500.0,3,1.0,1020,11652,1.0,0,0,3,6,1020,0,1971,0.0,98188,47.4459,-122.27799999999999,1690,11652,10632,0.9124613800205973,1040400,135769104,134728704
370000.0,3,2.5,1070,1219,2.0,0,0,2,7,720,350,2004,0.0,98116,47.5618,-122.384,1070,1254,149,0.12223133716160788,1144900,1485961,341061
492650.0,4,1.75,2120,9786,1.0,0,0,2,8,1640,480,1967,0.0,98177,47.7753,-122.365,2310,8787,7666,0.783363989372573,4494400,95765796,91271396
431200.0,5,1.75,1360,10609,1.0,0,0,2,7,1060,300,1966,0.0,98034,47.7203,-122.229,1490,9935,9249,0.8718069563578094,1849600,112550881,110701281
277500.0,4,2.0,1700,12048,2.0,0,0,2,7,1700,0,1990,0.0,98030,47.3748,-122.186,1960,7650,10348,0.8588977423638778,2890000,145154304,142264304
278000.0,5,1.5,1820,8712,1.0,0,0,4,7,1090,730,1960,0.0,98032,47.3712,-122.289,1820,8712,6892,0.7910927456382002,3312400,75898944,72586544
351000.0,4,1.0,1430,8400,1.0,0,0,2,6,730,700,1969,0.0,98072,47.7417,-122.17200000000001,1310,8240,6970,0.8297619047619048,2044900,70560000,68515100
850000.0,4,3.5,4140,7089,2.0,0,0,2,10,3160,980,2003,0.0,98034,47.7059,-122.2,2640,8896,2949,0.41599661447312736,17139600,50253921,33114321
885000.0,2,2.0,1313,3600,1.0,0,0,2,8,1313,0,1904,2012.0,98119,47.6369,-122.365,1080,3600,2287,0.6352777777777778,1723969,12960000,11236031
399950.0,3,2.0,1590,87120,1.0,0,3,2,8,1590,0,1998,0.0,98022,47.2241,-122.072,2780,183161,85530,0.9817493112947658,2528100,7589894400,7587366300
185000.0,3,1.75,1080,9262,1.0,0,0,2,7,1080,0,1968,0.0,98178,47.4883,-122.24799999999999,1090,9262,8182,0.8833945152234939,1166400,85784644,84618244
440000.0,5,3.0,2730,6000,1.0,0,0,2,8,1470,1260,1979,0.0,98178,47.4994,-122.234,2590,6000,3270,0.545,7452900,36000000,28547100
2400000.0,4,3.25,3800,19798,2.0,0,0,2,10,3800,0,1969,2009.0,98006,47.5684,-122.19,3940,18975,15998,0.8080614203454894,14440000,391960804,377520804
299000.0,3,2.25,2540,9961,1.0,0,0,3,8,1320,1220,1969,0.0,98031,47.41,-122.208,1870,10251,7421,0.7450055215339826,6451600,99221521,92769921
299500.0,3,1.75,1810,34500,1.0,0,0,2,8,1230,580,1980,0.0,98032,47.3707,-122.275,2090,9735,32690,0.947536231884058,3276100,1190250000,1186973900
420000.0,3,1.5,1540,7506,1.0,0,0,4,7,1540,0,1961,0.0,98155,47.7565,-122.325,2180,7653,5966,0.7948308020250466,2371600,56340036,53968436
234000.0,4,1.0,1390,18000,1.0,0,0,2,7,1390,0,1955,2013.0,98032,47.3885,-122.28399999999999,1390,18000,16610,0.9227777777777778,1932100,324000000,322067900
540000.0,2,1.75,1460,4800,1.0,0,0,4,7,850,610,1950,0.0,98103,47.6928,-122.339,2050,5592,3340,0.6958333333333333,2131600,23040000,20908400
649950.0,4,2.5,2350,63162,2.0,0,0,3,8,2350,0,1994,0.0,98077,47.7545,-122.04700000000001,2370,63162,60812,0.9627940850511384,5522500,3989438244,3983915744
330000.0,3,1.0,1160,7912,1.0,0,0,3,7,1160,0,1956,0.0,98125,47.7336,-122.306,1190,7482,6752,0.8533872598584429,1345600,62599744,61254144
840000.0,4,3.25,3500,5960,2.0,0,0,2,9,3500,0,2010,0.0,98053,47.6944,-122.022,3390,6856,2460,0.412751677852349,12250000,35521600,23271600
370000.0,3,2.5,1980,6922,2.0,0,0,4,8,1980,0,1991,0.0,98031,47.396,-122.184,2090,7697,4942,0.7139555041895406,3920400,47914084,43993684
410000.0,3,1.5,1250,7700,1.0,0,0,4,7,1250,0,1968,0.0,98056,47.5383,-122.178,1430,7700,6450,0.8376623376623377,1562500,59290000,57727500
257000.0,2,1.0,770,7200,1.0,0,0,2,7,770,0,1951,0.0,98125,47.7143,-122.325,1320,7139,6430,0.8930555555555556,592900,51840000,51247100
350000.0,3,1.0,1920,6710,1.0,0,0,2,7,1320,600,1959,0.0,98118,47.5346,-122.286,1810,5600,4790,0.713859910581222,3686400,45024100,41337700
380000.0,2,1.0,1120,7560,1.0,0,1,2,6,1120,0,1947,0.0,98177,47.77,-122.39,1120,7200,6440,0.8518518518518519,1254400,57153600,55899200
344000.0,3,1.0,1150,12402,1.0,0,0,3,6,1150,0,1969,0.0,98072,47.7422,-122.09899999999999,1400,13600,11252,0.9072730204805677,1322500,153809604,152487104
488000.0,3,2.5,1590,2550,3.0,0,0,2,7,1590,0,1985,0.0,98117,47.6772,-122.39299999999999,1260,5100,960,0.3764705882352941,2528100,6502500,3974400
465000.0,3,1.0,910,3880,1.0,0,0,2,7,780,130,1942,0.0,98117,47.6862,-122.39200000000001,1220,3880,2970,0.7654639175257731,828100,15054400,14226300
229500.0,2,1.75,1870,6625,1.0,0,0,2,7,960,910,1948,0.0,98178,47.5071,-122.249,1680,6000,4755,0.7177358490566038,3496900,43890625,40393725
445000.0,5,3.0,2420,11250,2.0,0,0,2,8,2420,0,2013,0.0,98146,47.5082,-122.36200000000001,1510,9950,8830,0.7848888888888889,5856400,126562500,120706100
246000.0,4,1.5,2120,7110,1.5,0,0,2,6,2120,0,1919,0.0,98030,47.3846,-122.227,1540,7110,4990,0.7018284106891702,4494400,50552100,46057700
545000.0,5,2.5,2730,17240,1.0,0,0,4,7,1660,1070,1958,0.0,98028,47.7646,-122.26700000000001,2250,13200,14510,0.8416473317865429,7452900,297217600,289764700
518000.0,4,2.5,2560,5672,2.0,0,1,2,8,2560,0,2005,0.0,98056,47.5222,-122.20100000000001,2190,6788,3112,0.5486600846262342,6553600,32171584,25617984
565000.0,4,2.5,2620,10016,2.0,0,0,2,8,2620,0,1996,0.0,98056,47.5295,-122.179,2620,10016,7396,0.7384185303514377,6864400,100320256,93455856
445000.0,4,2.5,2760,8558,2.0,0,0,2,7,2760,0,2001,0.0,98056,47.4802,-122.189,2760,7703,5798,0.6774947417620939,7617600,73239364,65621764
968000.0,5,2.5,2900,9799,1.0,0,0,2,8,1450,1450,1959,0.0,98004,47.6255,-122.208,2810,9687,6899,0.7040514338197775,8410000,96020401,87610401
725000.0,3,2.0,1820,6324,1.0,0,0,4,7,910,910,1945,0.0,98115,47.6823,-122.27,1850,6440,4504,0.7122074636306135,3312400,39992976,36680576
315500.0,3,1.75,1870,8400,1.0,0,0,2,7,990,880,1977,0.0,98058,47.45399999999999,-122.164,1750,8400,6530,0.7773809523809524,3496900,70560000,67063100
487585.0,4,1.75,2010,9211,1.0,0,0,2,7,1470,540,1977,0.0,98034,47.7206,-122.171,1840,8500,7201,0.7817826511779394,4040100,84842521,80802421
246500.0,2,1.0,940,6000,1.0,0,0,1,7,940,0,1954,0.0,98148,47.4631,-122.329,1890,8547,5060,0.8433333333333334,883600,36000000,35116400
819000.0,3,1.75,1850,6000,1.5,0,0,2,8,1650,200,1913,1999.0,98199,47.6528,-122.40100000000001,1540,6000,4150,0.6916666666666667,3422500,36000000,32577500
349900.0,5,2.5,2530,4229,2.0,0,0,2,7,2530,0,2004,0.0,98038,47.3531,-122.021,2070,4879,1699,0.4017498226531095,6400900,17884441,11483541
267000.0,3,1.0,940,4700,1.0,0,0,3,6,940,0,1942,0.0,98146,47.5117,-122.37799999999999,1020,5700,3760,0.8,883600,22090000,21206400
480000.0,3,2.25,1820,15000,1.0,0,0,2,7,1480,340,1978,0.0,98028,47.7401,-122.249,1930,13600,13180,0.8786666666666667,3312400,225000000,221687600
525000.0,2,1.0,1510,3360,1.0,0,0,2,7,880,630,1924,0.0,98122,47.6135,-122.29700000000001,1330,3360,1850,0.5505952380952381,2280100,11289600,9009500
578000.0,4,2.5,2070,5415,2.0,0,0,2,8,2070,0,1996,0.0,98029,47.5706,-122.006,2120,5331,3345,0.6177285318559557,4284900,29322225,25037325
345000.0,3,2.5,1380,1547,3.0,0,0,2,8,1380,0,2000,0.0,98103,47.6908,-122.34100000000001,1380,1465,167,0.10795087265675501,1904400,2393209,488809
499000.0,3,1.0,1270,6250,1.0,0,0,2,7,910,360,1955,0.0,98116,47.5694,-122.397,2000,6250,4980,0.7968,1612900,39062500,37449600
425000.0,3,1.5,1390,9680,1.0,0,0,3,7,1390,0,1956,0.0,98008,47.63399999999999,-122.125,1460,10050,8290,0.856404958677686,1932100,93702400,91770300
268000.0,4,3.0,1840,7510,2.0,0,0,4,8,1840,0,1988,2013.0,98092,47.2595,-122.21799999999999,1650,7957,5670,0.7549933422103862,3385600,56400100,53014500
240000.0,3,1.0,1600,12566,1.0,0,0,3,7,1600,0,1971,0.0,98045,47.4431,-121.765,1600,10650,10966,0.8726722903071781,2560000,157904356,155344356
147000.0,3,1.5,1480,9606,1.0,0,0,3,7,1100,380,1964,0.0,98023,47.2978,-122.363,1600,9619,8126,0.8459296273162606,2190400,92275236,90084836
500000.0,4,2.0,2120,7806,1.0,0,0,3,6,1770,350,1949,0.0,98033,47.6859,-122.166,1560,9920,5686,0.7284140404816808,4494400,60933636,56439236
1010000.0,4,2.75,2940,5400,1.5,0,2,4,8,1940,1000,1910,0.0,98119,47.6366,-122.369,1970,2008,2460,0.45555555555555555,8643600,29160000,20516400
991500.0,4,3.0,3820,26895,2.0,0,2,2,11,3820,0,1995,0.0,98072,47.7253,-122.09200000000001,3820,24751,23075,0.8579661647146309,14592400,723341025,708748625
510000.0,5,2.0,2740,3838,1.0,0,0,3,7,1370,1370,1959,0.0,98117,47.6819,-122.39299999999999,1660,4040,1098,0.28608650338718083,7507600,14730244,7222644
1980000.0,4,4.0,4360,12081,2.0,0,0,2,10,4360,0,2007,0.0,98004,47.6377,-122.219,2180,10800,7721,0.6391027232844964,19009600,145950561,126940961
484998.0,4,2.5,1540,1870,2.0,0,0,2,8,1540,0,2014,0.0,98029,47.5524,-121.999,1540,1619,330,0.17647058823529413,2371600,3496900,1125300
1280000.0,4,3.5,4660,17398,2.0,0,2,2,11,4660,0,2003,0.0,98006,47.5422,-122.11200000000001,5080,24913,12738,0.7321531210483964,21715600,302690404,280974804
210000.0,3,1.75,1590,7617,2.0,0,0,2,7,1590,0,1986,0.0,98198,47.3819,-122.31200000000001,1490,7450,6027,0.7912564001575424,2528100,58018689,55490589
450000.0,2,1.0,1180,10720,1.0,0,0,3,7,1180,0,1955,0.0,98007,47.5893,-122.135,1420,10750,9540,0.8899253731343284,1392400,114918400,113526000
875000.0,4,1.75,2360,8286,1.0,0,0,2,7,1320,1040,1952,0.0,98004,47.6226,-122.205,1680,7630,5926,0.7151822350953415,5569600,68657796,63088196
529950.0,4,2.75,1860,7500,1.0,0,0,4,8,1220,640,1967,0.0,98056,47.5398,-122.17299999999999,2020,8137,5640,0.752,3459600,56250000,52790400
415000.0,3,1.75,1470,4000,1.0,0,0,2,7,1070,400,1979,0.0,98122,47.6067,-122.29799999999999,1280,3500,2530,0.6325,2160900,16000000,13839100
590000.0,4,2.0,2990,12970,1.5,0,2,3,7,1960,1030,1948,0.0,98028,47.7605,-122.258,2500,10680,9980,0.7694680030840401,8940100,168220900,159280800
379950.0,3,1.5,1690,9144,1.0,0,0,3,7,1140,550,1956,0.0,98028,47.739,-122.25299999999999,1840,10600,7454,0.8151793525809273,2856100,83612736,80756636
385000.0,1,1.0,660,3570,1.0,0,0,2,6,660,0,1906,0.0,98118,47.5659,-122.28399999999999,1520,4080,2910,0.8151260504201681,435600,12744900,12309300
588000.0,3,1.75,2310,7620,2.0,0,0,2,8,2310,0,1942,1988.0,98177,47.7266,-122.363,2200,7672,5310,0.6968503937007874,5336100,58064400,52728300
252500.0,2,1.0,770,2191,1.0,0,0,2,6,770,0,1937,0.0,98108,47.5512,-122.323,940,5000,1421,0.6485623003194888,592900,4800481,4207581
530000.0,3,3.5,2320,3174,2.0,0,0,2,9,2060,260,1997,0.0,98033,47.6897,-122.175,2320,3187,854,0.26906112161310647,5382400,10074276,4691876
385000.0,2,1.5,1370,159865,1.0,0,0,2,7,1370,0,1960,0.0,98072,47.7592,-122.09200000000001,1370,16217,158495,0.9914302692897132,1876900,25556818225,25554941325
419000.0,3,2.25,1700,7650,1.0,0,0,3,7,1340,360,1975,0.0,98034,47.7214,-122.166,1980,7200,5950,0.7777777777777778,2890000,58522500,55632500
175000.0,2,1.0,960,5508,1.0,0,0,2,6,770,190,1951,0.0,98118,47.5307,-122.277,1280,5304,4548,0.8257080610021786,921600,30338064,29416464
515000.0,2,1.0,1150,5664,1.0,0,0,2,7,870,280,1948,0.0,98115,47.6894,-122.28399999999999,1380,5664,4514,0.7969632768361582,1322500,32080896,30758396
945000.0,4,2.5,2910,4680,1.5,0,0,4,9,1850,1060,1937,0.0,98115,47.6745,-122.31,1960,4120,1770,0.3782051282051282,8468100,21902400,13434300
359900.0,5,2.25,2290,7420,1.0,0,0,2,7,1290,1000,1973,0.0,98058,47.4375,-122.166,1660,7526,5130,0.6913746630727763,5244100,55056400,49812300
419950.0,4,2.5,2260,5164,2.0,0,0,2,8,2260,0,1996,0.0,98056,47.50899999999999,-122.166,2260,5866,2904,0.5623547637490317,5107600,26666896,21559296
460000.0,3,1.75,1300,4000,1.0,0,0,2,7,900,400,1953,0.0,98199,47.6368,-122.38799999999999,1750,4000,2700,0.675,1690000,16000000,14310000
255000.0,3,2.25,1850,7151,2.0,0,0,2,7,1850,0,1989,0.0,98023,47.2843,-122.352,1710,6827,5301,0.741294923786883,3422500,51136801,47714301
481000.0,4,1.75,1920,9500,1.0,0,0,3,7,1470,450,1966,0.0,98006,47.5683,-122.177,1820,10091,7580,0.7978947368421052,3686400,90250000,86563600
719521.0,4,1.75,1920,9500,1.0,0,0,3,7,1470,450,1966,0.0,98006,47.5683,-122.177,1820,10091,7580,0.7978947368421052,3686400,90250000,86563600
1080000.0,3,3.0,4910,43560,2.0,0,0,3,10,4000,910,1989,0.0,98007,47.5911,-122.131,3540,12288,38650,0.8872819100091828,24108100,1897473600,1873365500
334000.0,4,2.5,2210,6080,1.0,0,2,3,8,1410,800,1965,0.0,98178,47.4915,-122.228,2210,6175,3870,0.6365131578947368,4884100,36966400,32082300
675000.0,4,2.75,2280,3200,1.5,0,0,4,8,1520,760,1931,0.0,98105,47.6709,-122.28200000000001,1970,4687,920,0.2875,5198400,10240000,5041600
556000.0,3,1.75,1640,7437,1.0,0,0,2,7,1090,550,1948,0.0,98126,47.5324,-122.38,1640,7436,5797,0.7794809735108242,2689600,55308969,52619369
900000.0,4,2.0,1980,7200,2.0,0,3,2,8,1700,280,1910,0.0,98119,47.6318,-122.369,2490,4200,5220,0.725,3920400,51840000,47919600
400000.0,3,1.0,900,4084,1.5,0,0,2,7,900,0,1910,0.0,98117,47.684,-122.39299999999999,1280,4080,3184,0.7796278158667973,810000,16679056,15869056
724950.0,4,1.75,1960,4340,1.0,0,0,4,8,980,980,1912,0.0,98117,47.6847,-122.37,1630,4360,2380,0.5483870967741935,3841600,18835600,14994000
321000.0,4,2.25,1800,4500,2.0,0,0,3,8,1800,0,2004,0.0,98031,47.394,-122.18299999999999,2010,5050,2700,0.6,3240000,20250000,17010000
1360000.0,4,3.5,4270,5800,2.0,0,3,4,10,3170,1100,1937,0.0,98199,47.6474,-122.411,3100,5800,1530,0.2637931034482759,18232900,33640000,15407100
171000.0,4,2.0,1520,19672,1.0,0,0,2,6,1020,500,1920,0.0,98188,47.4683,-122.281,1810,7840,18152,0.9227328182187882,2310400,386987584,384677184
1360000.0,4,3.0,5430,108900,2.0,0,0,3,10,5430,0,1987,0.0,98053,47.6582,-122.038,3170,107076,103470,0.9501377410468319,29484900,11859210000,11829725100
323000.0,3,1.75,1950,15037,1.0,0,0,2,7,1950,0,1989,0.0,98014,47.6892,-121.913,1760,15181,13087,0.8703198776351666,3802500,226111369,222308869
491500.0,4,1.75,2190,125452,1.0,0,2,2,9,2190,0,1968,0.0,98092,47.2703,-122.069,3000,125017,123262,0.9825431240633868,4796100,15738204304,15733408204
226000.0,4,1.5,1200,10890,1.0,0,0,4,7,1200,0,1972,0.0,98042,47.3423,-122.088,1250,10139,9690,0.8898071625344353,1440000,118592100,117152100
580000.0,6,1.75,2180,4000,1.5,0,0,3,7,1380,800,1926,0.0,98105,47.6643,-122.29,1720,4000,1820,0.455,4752400,16000000,11247600
640000.0,4,2.5,2320,11259,2.0,0,0,2,9,2320,0,1982,0.0,98004,47.6443,-122.194,2820,11770,8939,0.7939426236788347,5382400,126765081,121382681
619790.0,3,1.75,1040,5097,1.0,0,0,3,7,800,240,1944,0.0,98199,47.6385,-122.40100000000001,1630,5097,4057,0.7959584069060232,1081600,25979409,24897809
383962.0,4,2.5,2700,6998,2.0,0,0,2,8,2700,0,2001,0.0,98188,47.4694,-122.26299999999999,2350,10550,4298,0.6141754787082023,7290000,48972004,41682004
373000.0,3,2.0,1400,2445,1.0,0,0,2,7,840,560,2002,0.0,98144,47.5926,-122.29899999999999,1400,3200,1045,0.4274028629856851,1960000,5978025,4018025
541338.0,3,2.5,2060,8123,2.0,0,0,2,8,1010,1050,1977,0.0,98052,47.6642,-122.13,1760,6170,6063,0.74639911362797,4243600,65983129,61739529
254922.0,2,1.0,780,8160,1.0,0,0,3,6,780,0,1953,0.0,98133,47.7356,-122.34,1310,8160,7380,0.9044117647058824,608400,66585600,65977200
575000.0,3,2.25,2400,5000,1.5,0,0,3,7,1440,960,1926,0.0,98117,47.6897,-122.39299999999999,1630,5000,2600,0.52,5760000,25000000,19240000
650000.0,4,3.0,2900,15535,1.0,0,2,3,7,1870,1030,1961,0.0,98008,47.611999999999995,-122.119,2330,10217,12635,0.8133247505632443,8410000,241336225,232926225
269950.0,3,1.5,1740,9547,1.0,0,0,3,7,1740,0,1962,0.0,98055,47.4475,-122.213,1780,9936,7807,0.8177437938619462,3027600,91145209,88117609
270950.0,2,1.0,780,6250,1.0,0,0,2,6,780,0,1942,0.0,98168,47.5099,-122.33,1280,7100,5470,0.8752,608400,39062500,38454100
495000.0,3,2.75,2430,14861,1.0,0,0,2,9,1530,900,1988,0.0,98028,47.7461,-122.24700000000001,2230,10300,12431,0.8364847587645515,5904900,220849321,214944421
794154.0,4,2.0,2210,8556,1.0,0,1,3,8,1210,1000,1954,0.0,98199,47.6498,-122.396,2190,7975,6346,0.7417017297802712,4884100,73205136,68321036
340768.0,3,1.5,1510,11200,1.0,0,0,3,8,1510,0,1960,0.0,98003,47.3347,-122.325,2110,12070,9690,0.8651785714285715,2280100,125440000,123159900
375000.0,2,1.0,900,5413,1.0,0,0,2,7,900,0,1947,0.0,98125,47.7047,-122.307,1280,6380,4513,0.8337336042859782,810000,29300569,28490569
820000.0,4,2.5,3670,7000,2.0,0,0,2,10,3670,0,2005,0.0,98075,47.5854,-122.08,3680,7437,3330,0.4757142857142857,13468900,49000000,35531100
555000.0,2,2.25,1160,954,2.0,0,0,2,8,960,200,2014,0.0,98105,47.6647,-122.28399999999999,1160,1327,-206,-0.21593291404612158,1345600,910116,-435484
312500.0,2,1.5,1070,1200,2.0,0,0,2,7,1070,0,1999,0.0,98103,47.696999999999996,-122.34700000000001,1070,1200,130,0.10833333333333334,1144900,1440000,295100
450000.0,2,1.0,950,4560,1.5,0,0,2,7,950,0,1925,0.0,98112,47.6288,-122.3,2040,4560,3610,0.7916666666666666,902500,20793600,19891100
739000.0,3,2.75,2950,6667,2.0,0,0,2,9,2950,0,2003,0.0,98029,47.5577,-122.02600000000001,3340,6667,3717,0.5575221238938053,8702500,44448889,35746389
320000.0,3,2.0,1420,1716,2.0,0,0,2,7,1050,370,2003,0.0,98155,47.7364,-122.295,1420,8150,296,0.17249417249417248,2016400,2944656,928256
235000.0,3,1.0,1590,13000,1.5,0,0,2,6,1590,0,1944,0.0,98166,47.4789,-122.346,1460,8400,11410,0.8776923076923077,2528100,169000000,166471900
275500.0,4,1.0,1290,5000,1.5,0,0,2,7,1290,0,1957,0.0,98146,47.5128,-122.35799999999999,1440,2500,3710,0.742,1664100,25000000,23335900
564000.0,2,2.0,1690,4500,1.0,0,0,2,8,1690,0,2004,0.0,98053,47.7133,-122.031,1640,4500,2810,0.6244444444444445,2856100,20250000,17393900
263000.0,4,1.75,1340,8700,1.5,0,0,2,6,1340,0,1958,0.0,98188,47.4514,-122.287,1240,8700,7360,0.8459770114942529,1795600,75690000,73894400
257000.0,3,1.75,1397,18000,1.0,0,0,2,7,1397,0,1965,2014.0,98092,47.3388,-122.166,1950,31294,16603,0.9223888888888889,1951609,324000000,322048391
725000.0,4,2.5,3750,218506,2.0,0,0,2,10,3750,0,1991,0.0,98092,47.3045,-122.103,2540,39413,214756,0.982837999871857,14062500,47744872036,47730809536
300000.0,3,2.25,2000,7560,1.0,0,0,2,7,1400,600,1979,0.0,98055,47.4798,-122.228,2040,6949,5560,0.7354497354497355,4000000,57153600,53153600
328000.0,3,2.0,2250,7904,1.5,0,0,2,8,2250,0,1998,0.0,98001,47.3165,-122.25200000000001,2460,8622,5654,0.715334008097166,5062500,62473216,57410716
187500.0,3,1.0,840,8400,1.0,0,0,2,6,840,0,1959,0.0,98023,47.3281,-122.344,1030,8640,7560,0.9,705600,70560000,69854400
400000.0,3,1.0,1100,5100,2.0,0,0,3,7,1100,0,1900,0.0,98117,47.678999999999995,-122.38600000000001,1540,5100,4000,0.7843137254901961,1210000,26010000,24800000
515000.0,3,1.5,1660,5100,1.0,0,0,3,7,1210,450,1954,0.0,98136,47.5345,-122.383,1440,5100,3440,0.6745098039215687,2755600,26010000,23254400
1410000.0,2,2.0,2180,18525,1.0,1,4,4,9,1580,0,1952,0.0,98146,47.5036,-122.387,2480,21503,16345,0.8823211875843455,4752400,343175625,338423225
235000.0,3,1.0,1460,8400,1.0,0,0,2,7,1460,0,1958,0.0,98055,47.4243,-122.198,1460,9600,6940,0.8261904761904761,2131600,70560000,68428400
669000.0,4,2.5,2470,4945,2.0,0,0,2,8,2470,0,2012,0.0,98053,47.6898,-122.015,2510,4988,2475,0.5005055611729019,6100900,24453025,18352125
282000.0,3,1.0,1250,13503,1.5,0,0,3,6,1250,0,1931,0.0,98065,47.526,-121.829,1450,13503,12253,0.9074279789676368,1562500,182331009,180768509
663000.0,3,2.0,1480,3876,1.0,0,0,4,7,860,620,1928,0.0,98117,47.6808,-122.382,1660,3774,2396,0.6181630546955624,2190400,15023376,12832976
279900.0,3,3.25,2240,5000,2.0,0,0,2,9,1540,700,1989,0.0,98198,47.4114,-122.334,1800,7500,2760,0.552,5017600,25000000,19982400
335000.0,3,2.0,1570,7200,1.0,0,0,3,7,1570,0,1952,0.0,98155,47.7501,-122.314,1410,7434,5630,0.7819444444444444,2464900,51840000,49375100
689000.0,4,2.75,3250,10000,2.0,0,0,2,9,3250,0,2014,0.0,98155,47.7557,-122.309,1620,10089,6750,0.675,10562500,100000000,89437500
413100.0,3,2.25,1790,231303,1.0,0,0,2,7,1250,540,1980,0.0,98077,47.7558,-122.027,2090,93654,229513,0.9922612331011703,3204100,53501077809,53497873709
506950.0,3,2.5,2080,4931,2.0,0,0,2,8,2080,0,2000,0.0,98065,47.5342,-121.868,1890,4229,2851,0.578178868383695,4326400,24314761,19988361
500000.0,3,2.5,1480,1171,3.0,0,0,2,8,1480,0,2006,0.0,98112,47.62,-122.3,1480,1231,-309,-0.26387702818104186,2190400,1371241,-819159
540000.0,5,3.0,3610,9775,2.0,0,0,2,8,3610,0,2003,0.0,98038,47.3545,-122.01100000000001,2800,8582,6165,0.6306905370843989,13032100,95550625,82518525
812000.0,3,2.5,2040,4559,2.0,0,0,2,9,2040,0,1998,0.0,98122,47.6156,-122.295,1500,4500,2519,0.5525334503180522,4161600,20784481,16622881
1200000.0,4,3.25,3850,19842,2.0,0,3,2,11,3180,670,1989,0.0,98074,47.6239,-122.065,4320,19500,15992,0.8059671404092329,14822500,393704964,378882464
370000.0,3,2.25,3230,35306,2.0,0,0,2,9,3230,0,1987,0.0,98092,47.3065,-122.113,2760,35285,32076,0.9085141335750297,10432900,1246513636,1236080736
338000.0,3,2.0,2440,23512,1.0,0,0,2,6,1640,800,1933,0.0,98148,47.4594,-122.32600000000001,1630,19613,21072,0.8962232051718272,5953600,552814144,546860544
185000.0,4,1.0,1490,6600,1.0,0,0,2,7,1490,0,1969,0.0,98168,47.4835,-122.33200000000001,1280,6600,5110,0.7742424242424243,2220100,43560000,41339900
450000.0,3,1.0,1150,35415,1.0,0,0,3,7,1010,0,1950,0.0,98008,47.5974,-122.12899999999999,2460,11781,34265,0.9675278836651137,1322500,1254222225,1252899725
451000.0,2,1.0,900,6000,1.0,0,0,2,7,900,0,1944,2004.0,98115,47.6855,-122.289,1460,4800,5100,0.85,810000,36000000,35190000
785000.0,4,2.5,3210,24527,1.5,0,0,2,11,3210,0,1984,0.0,98074,47.6399,-122.052,3280,24527,21317,0.8691238227259754,10304100,601573729,591269629
850000.0,5,3.0,3900,5250,1.5,0,1,4,8,2620,1280,1931,0.0,98116,47.5577,-122.389,1950,5700,1350,0.2571428571428571,15210000,27562500,12352500
235000.0,3,1.0,1240,18000,1.0,0,0,1,7,1240,0,1943,0.0,98198,47.3514,-122.315,1240,18000,16760,0.9311111111111111,1537600,324000000,322462400
1150000.0,3,1.75,1760,6788,2.0,1,4,2,7,1760,0,1940,0.0,98125,47.7336,-122.28399999999999,1630,7588,5028,0.7407189157336476,3097600,46076944,42979344
377500.0,3,2.25,1410,1377,2.0,0,0,2,7,1290,120,2005,0.0,98027,47.5342,-122.06700000000001,1445,1370,-33,-0.023965141612200435,1988100,1896129,-91971
825500.0,3,2.5,2780,11964,2.0,0,0,2,9,2780,0,2009,0.0,98034,47.7127,-122.21600000000001,1760,9640,9184,0.7676362420595119,7728400,143137296,135408896
1060000.0,5,3.25,3230,3825,2.0,0,0,2,9,2480,750,2014,0.0,98117,47.6785,-122.39200000000001,1480,5100,595,0.15555555555555556,10432900,14630625,4197725
880000.0,5,3.5,4600,8764,2.0,0,0,2,10,3180,1420,2007,0.0,98006,47.5491,-122.19,3210,9431,4164,0.4751255134641716,21160000,76807696,55647696
413800.0,3,2.0,1440,4421,1.0,0,0,2,8,1440,0,2007,0.0,98053,47.7188,-122.024,1440,4157,2981,0.674281836688532,2073600,19545241,17471641
504200.0,2,1.5,1200,1687,3.0,0,0,2,8,1200,0,2008,0.0,98103,47.6491,-122.334,1240,1296,487,0.2886781268524007,1440000,2845969,1405969
421500.0,4,3.0,2793,5703,2.0,0,0,2,9,2793,0,2009,0.0,98030,47.3682,-122.178,2793,5704,2910,0.5102577590741715,7800849,32524209,24723360
855169.0,4,2.5,2970,5050,2.0,0,0,2,8,2970,0,2014,0.0,98052,47.7043,-122.12200000000001,2810,4998,2080,0.41188118811881186,8820900,25502500,16681600
380000.0,3,2.0,1440,3218,1.0,0,0,2,7,850,590,2008,0.0,98106,47.5655,-122.36,1170,5000,1778,0.5525170913610938,2073600,10355524,8281924
580000.0,3,2.25,1480,1026,3.0,0,0,2,8,1480,0,2014,0.0,98103,47.6536,-122.354,1570,1283,-454,-0.442495126705653,2190400,1052676,-1137724
377000.0,3,2.5,1870,5333,2.0,0,0,2,8,1870,0,2012,0.0,98019,47.7447,-121.984,2100,3730,3463,0.6493530845677855,3496900,28440889,24943989
329900.0,4,2.75,2475,4000,2.0,0,0,2,7,2475,0,2014,0.0,98002,47.3452,-122.209,2475,4000,1525,0.38125,6125625,16000000,9874375
921800.0,4,2.5,2950,7024,2.0,0,0,2,10,2950,0,2012,0.0,98199,47.6651,-122.40299999999999,2950,6339,4074,0.5800113895216401,8702500,49336576,40634076
529500.0,3,2.25,1410,905,3.0,0,0,2,9,1410,0,2014,0.0,98116,47.5818,-122.402,1510,1352,-505,-0.5580110497237569,1988100,819025,-1169075
363990.0,4,2.5,2240,3712,2.0,0,0,2,8,2240,0,2014,0.0,98038,47.3551,-122.061,2530,4315,1472,0.39655172413793105,5017600,13778944,8761344
834950.0,5,2.75,3230,6500,2.0,0,0,2,9,3230,0,2014,0.0,98074,47.6237,-122.023,3180,7624,3270,0.5030769230769231,10432900,42250000,31817100
399000.0,3,2.0,2100,31550,1.0,0,0,2,8,2100,0,2010,0.0,98014,47.6907,-121.917,1860,18452,29450,0.9334389857369255,4410000,995402500,990992500
338900.0,3,2.25,1936,9495,1.0,0,0,2,8,1936,0,2013,0.0,98030,47.3714,-122.197,1410,12770,7559,0.7961032122169563,3748096,90155025,86406929
419950.0,3,2.5,3120,6000,2.0,0,0,2,9,3120,0,2007,0.0,98038,47.3473,-122.03,2670,6000,2880,0.48,9734400,36000000,26265600
493000.0,4,2.5,2070,4270,2.0,0,0,2,8,2070,0,2010,0.0,98028,47.773,-122.265,2070,4610,2200,0.5152224824355972,4284900,18232900,13948000
650000.0,4,2.5,3700,4500,2.0,0,0,2,9,3700,0,2007,0.0,98028,47.7473,-122.23,3050,5047,800,0.17777777777777778,13690000,20250000,6560000
456000.0,3,2.5,2130,5205,2.0,0,0,2,8,2130,0,2013,0.0,98045,47.4832,-121.774,2250,5462,3075,0.590778097982709,4536900,27092025,22555125
425000.0,3,2.25,1620,997,2.5,0,0,2,8,1540,80,2010,0.0,98027,47.54,-122.02600000000001,1620,1068,-623,-0.6248746238716149,2624400,994009,-1630391
348000.0,3,2.5,1490,2478,3.0,0,0,2,8,1490,0,2009,0.0,98133,47.7236,-122.353,1270,1156,988,0.3987086359967716,2220100,6140484,3920384
1040000.0,5,4.0,4180,7232,2.0,0,0,2,9,4180,0,2014,0.0,98052,47.7049,-122.125,3570,6054,3052,0.42201327433628316,17472400,52301824,34829424
299000.0,2,2.5,1400,1262,2.0,0,0,2,8,1160,240,2008,0.0,98106,47.5342,-122.34899999999999,1060,1524,-138,-0.10935023771790808,1960000,1592644,-367356
1260000.0,4,3.75,3490,9170,2.0,0,0,2,9,3490,0,2012,0.0,98004,47.5991,-122.2,1810,8470,5680,0.6194111232279171,12180100,84088900,71908800
155000.0,3,1.0,1300,6098,1.0,0,0,2,7,1300,0,2013,0.0,98014,47.7074,-121.36399999999999,1300,6849,4798,0.7868153492948508,1690000,37185604,35495604
319500.0,4,2.5,2730,4962,2.0,0,0,2,8,2730,0,2006,0.0,98002,47.3363,-122.21600000000001,2150,3802,2232,0.4498186215235792,7452900,24621444,17168544
274000.0,3,2.5,1830,2517,2.0,0,0,2,8,1830,0,2005,0.0,98055,47.4496,-122.189,1610,2762,687,0.2729439809296782,3348900,6335289,2986389
429000.0,5,2.5,2340,4500,2.0,0,0,2,7,2340,0,2009,0.0,98059,47.4911,-122.154,2190,4500,2160,0.48,5475600,20250000,14774400
267800.0,3,1.75,1410,1899,2.0,0,0,2,8,1410,0,2014,0.0,98106,47.5171,-122.34700000000001,1410,1811,489,0.2575039494470774,1988100,3606201,1618101
369950.0,3,2.5,1930,8254,2.0,0,0,2,7,1930,0,2014,0.0,98146,47.4973,-122.346,1540,8849,6324,0.7661739762539375,3724900,68128516,64403616
480000.0,6,5.0,3028,18055,2.0,0,0,2,7,3028,0,2005,0.0,98030,47.3651,-122.197,1400,34575,15027,0.8322902243145943,9168784,325983025,316814241
440000.0,4,3.5,3180,4869,2.0,0,0,2,8,2390,790,2007,0.0,98055,47.4482,-122.206,2850,4500,1689,0.34688847812692547,10112400,23707161,13594761
839704.0,4,3.25,2950,4161,2.0,0,0,2,10,2210,740,2014,0.0,98027,47.5297,-122.073,2790,3693,1211,0.29103580869983176,8702500,17313921,8611421
535000.0,3,3.25,1430,1276,3.0,0,0,2,8,1430,0,2007,0.0,98107,47.6712,-122.38,1430,1243,-154,-0.1206896551724138,2044900,1628176,-416724
290000.0,2,1.5,1020,1275,3.0,0,0,2,8,1020,0,2008,0.0,98103,47.7003,-122.346,980,1415,255,0.2,1040400,1625625,585225
370000.0,3,2.5,1650,1793,3.0,0,0,2,8,1650,0,2007,0.0,98133,47.7107,-122.33200000000001,1650,1863,143,0.07975460122699386,2722500,3214849,492349
405000.0,3,2.0,1060,651,3.0,0,0,2,7,1060,0,2007,0.0,98103,47.6828,-122.345,1440,1501,-409,-0.6282642089093702,1123600,423801,-699799
499431.0,4,2.75,2620,6019,2.0,0,0,2,8,2620,0,2013,0.0,98045,47.483999999999995,-121.771,2790,6716,3399,0.5647117461372321,6864400,36228361,29363961
275000.0,4,2.5,1830,3868,2.0,0,0,2,7,1830,0,2007,0.0,98118,47.5186,-122.27600000000001,2330,3868,2038,0.5268872802481903,3348900,14961424,11612524
320000.0,3,2.25,998,844,2.0,0,0,2,7,798,200,2007,0.0,98117,47.6983,-122.367,998,1110,-154,-0.18246445497630331,996004,712336,-283668
425000.0,4,2.5,2070,4427,2.0,0,0,2,7,2070,0,2007,0.0,98065,47.5208,-121.869,2070,4556,2357,0.5324147278066411,4284900,19598329,15313429
1450000.0,4,3.5,2860,2199,3.0,0,0,2,10,2860,0,2013,0.0,98102,47.6262,-122.323,1990,1378,-661,-0.3005911778080946,8179600,4835601,-3343999
340000.0,3,2.0,1920,5688,1.0,0,3,2,9,1920,0,2007,0.0,98022,47.1952,-121.976,2384,4802,3768,0.6624472573839663,3686400,32353344,28666944
299900.0,3,2.5,1210,2046,2.0,0,0,2,9,920,290,2008,0.0,98106,47.5212,-122.35700000000001,1070,651,836,0.40860215053763443,1464100,4186116,2722016
865950.0,5,3.5,4890,12039,2.0,0,0,2,9,3590,1300,2014,0.0,98011,47.7338,-122.208,4590,10079,7149,0.5938200847246449,23912100,144937521,121025421
720000.0,4,2.5,3420,17038,2.0,0,0,2,9,3420,0,2007,0.0,98034,47.718,-122.241,2520,14190,13618,0.7992722150487146,11696400,290293444,278597044
460000.0,4,3.5,2870,3225,2.0,0,3,2,9,2070,800,2006,0.0,98178,47.5009,-122.225,1770,6450,355,0.11007751937984496,8236900,10400625,2163725
375000.0,3,2.5,1600,2042,2.0,0,0,2,8,1600,0,2005,0.0,98027,47.5341,-122.06700000000001,1445,1370,442,0.21645445641527913,2560000,4169764,1609764
386180.0,2,1.5,960,1829,2.0,0,0,2,7,960,0,2005,0.0,98122,47.6032,-122.30799999999999,1470,1829,869,0.47512301804264623,921600,3345241,2423641
280000.0,3,2.75,1740,5639,1.0,0,3,2,7,1740,0,2010,0.0,98022,47.1942,-121.977,2380,5331,3899,0.6914346515339599,3027600,31798321,28770721
359000.0,4,2.5,2575,4725,2.0,0,0,2,8,2575,0,2011,0.0,98001,47.3058,-122.277,2575,5323,2150,0.455026455026455,6630625,22325625,15695000
785000.0,5,3.25,3660,11995,2.0,0,2,2,10,3660,0,2006,0.0,98065,47.5337,-121.86,3320,11241,8335,0.6948728636932056,13395600,143880025,130484425
425000.0,3,2.25,1420,1230,2.0,0,0,2,8,940,480,2009,0.0,98144,47.5703,-122.288,1400,1230,-190,-0.15447154471544716,2016400,1512900,-503500
575000.0,5,2.5,3070,7200,2.0,0,0,2,8,3070,0,2005,0.0,98059,47.4939,-122.137,2590,7200,4130,0.5736111111111111,9424900,51840000,42415100
465000.0,3,2.5,1920,144619,1.0,0,0,2,8,1920,0,2014,0.0,98022,47.2683,-121.946,2010,48787,142699,0.9867237361619151,3686400,20914655161,20910968761
1850000.0,4,3.25,4160,10335,2.0,0,0,2,10,4160,0,2014,0.0,98004,47.6235,-122.19200000000001,1840,10333,6175,0.5974842767295597,17305600,106812225,89506625
720000.0,4,3.25,3276,10801,2.0,0,0,2,9,3276,0,2008,0.0,98166,47.4585,-122.361,2010,11656,7525,0.6966947504860661,10732176,116661601,105929425
390000.0,5,3.75,2890,5000,1.0,0,0,2,7,1310,1580,2006,0.0,98108,47.5701,-122.296,1930,5117,2110,0.422,8352100,25000000,16647900
2210000.0,3,2.5,3430,10177,2.0,0,0,2,10,3430,0,2014,0.0,98034,47.7159,-122.251,3110,12339,6747,0.6629655104647735,11764900,103571329,91806429
1050000.0,4,3.5,3390,3979,2.0,0,0,2,9,2610,780,2014,0.0,98199,47.6482,-122.40799999999999,3350,4165,589,0.1480271424981151,11492100,15832441,4340341
915000.0,6,3.75,2930,14980,2.0,0,3,2,9,2930,0,2013,0.0,98006,47.5441,-122.117,3210,10787,12050,0.8044058744993324,8584900,224400400,215815500
562000.0,2,2.25,1300,1314,3.0,0,0,2,8,1300,0,2008,0.0,98103,47.6536,-122.35600000000001,1300,1312,14,0.0106544901065449,1690000,1726596,36596
349000.0,2,1.75,1250,1208,2.0,0,0,2,7,1040,210,2007,0.0,98144,47.6004,-122.29899999999999,1250,1656,-42,-0.0347682119205298,1562500,1459264,-103236
375000.0,4,2.5,2310,7800,2.0,0,0,2,8,2310,0,2011,0.0,98042,47.3737,-122.164,2310,7140,5490,0.7038461538461539,5336100,60840000,55503900
479950.0,2,2.25,1360,1336,3.0,0,0,2,8,1360,0,2008,0.0,98107,47.6714,-122.39200000000001,1280,1295,-24,-0.017964071856287425,1849600,1784896,-64704
319000.0,4,2.5,2020,5100,2.0,0,0,2,7,2020,0,2010,0.0,98023,47.2822,-122.35700000000001,2300,5685,3080,0.6039215686274509,4080400,26010000,21929600
325000.0,3,1.5,1270,1067,3.0,0,0,2,8,1270,0,2009,0.0,98133,47.7236,-122.353,1090,1118,-203,-0.190253045923149,1612900,1138489,-474411
505657.0,4,2.75,2790,8092,2.0,0,0,2,8,2790,0,2013,0.0,98045,47.4834,-121.773,2790,6154,5302,0.6552150271873455,7784100,65480464,57696364
340000.0,4,2.5,2320,4142,2.0,0,0,2,7,2320,0,2010,0.0,98038,47.3662,-122.01899999999999,2150,4140,1822,0.4398841139546113,5382400,17156164,11773764
250000.0,3,2.5,1750,6351,2.0,0,0,2,7,1750,0,2012,0.0,98001,47.2589,-122.256,1398,6092,4601,0.7244528420721146,3062500,40335201,37272701
349500.0,4,2.5,2030,4596,2.0,0,0,2,8,2030,0,2014,0.0,98001,47.3515,-122.275,2040,4705,2566,0.5583115752828547,4120900,21123216,17002316
290750.0,3,2.5,1270,865,2.0,0,0,2,7,1080,190,2008,0.0,98118,47.5351,-122.279,1630,7752,-405,-0.4682080924855491,1612900,748225,-864675
715000.0,5,3.25,2710,2356,2.0,0,0,2,8,2230,480,2013,0.0,98027,47.5394,-122.02799999999999,2160,2108,-354,-0.1502546689303905,7344100,5550736,-1793364
689950.0,4,2.75,2520,8433,2.0,0,0,2,8,2520,0,2014,0.0,98125,47.7214,-122.289,1890,7772,5913,0.7011739594450374,6350400,71115489,64765089
425000.0,2,2.5,1340,1263,3.0,0,0,2,8,1340,0,2008,0.0,98117,47.6788,-122.38799999999999,1510,1260,-77,-0.06096595407759303,1795600,1595169,-200431
657000.0,2,3.0,1570,1281,3.0,0,0,2,8,1570,0,2014,0.0,98107,47.6741,-122.384,1570,2500,-289,-0.22560499609679938,2464900,1640961,-823939
359950.0,4,3.5,2690,5564,2.0,0,0,2,7,2690,0,2007,0.0,98038,47.3537,-122.01799999999999,2210,4046,2874,0.5165348670021567,7236100,30958096,23721996
319900.0,4,2.75,2475,4276,2.0,0,0,2,7,2475,0,2014,0.0,98002,47.345,-122.21,2475,4000,1801,0.42118802619270346,6125625,18284176,12158551
532000.0,3,3.75,2260,2050,2.0,0,0,2,9,1170,1090,2010,0.0,98118,47.566,-122.29,2130,3082,-210,-0.1024390243902439,5107600,4202500,-905100
291000.0,2,1.0,840,863,3.0,0,0,2,8,840,0,2008,0.0,98103,47.6974,-122.34899999999999,1110,1190,23,0.026651216685979143,705600,744769,39169
675000.0,3,3.25,1720,1330,2.0,0,0,2,8,1030,690,2004,0.0,98112,47.62,-122.309,1720,1520,-390,-0.2932330827067669,2958400,1768900,-1189500
885000.0,3,2.25,2940,6500,3.0,0,0,2,9,2940,0,2014,0.0,98136,47.5482,-122.38799999999999,1680,6500,3560,0.5476923076923077,8643600,42250000,33606400
1450000.0,5,3.5,4170,9090,2.0,0,0,2,10,4170,0,2008,0.0,98004,47.5918,-122.196,1930,13635,4920,0.5412541254125413,17388900,82628100,65239200
780000.0,6,4.25,4310,10000,2.0,0,0,2,8,2950,1360,2008,0.0,98074,47.6214,-122.06200000000001,2100,10000,5690,0.569,18576100,100000000,81423900
839950.0,4,2.75,3010,7200,2.0,0,0,2,9,3010,0,2014,0.0,98033,47.6948,-122.179,3010,7203,4190,0.5819444444444445,9060100,51840000,42779900
645000.0,3,2.5,2170,1984,2.5,0,0,2,8,2170,0,2008,0.0,98027,47.5401,-122.027,2150,1984,-186,-0.09375,4708900,3936256,-772644
263000.0,3,2.5,1584,3200,2.0,0,0,2,7,1584,0,2011,0.0,98002,47.3451,-122.215,1584,2800,1616,0.505,2509056,10240000,7730944
345000.0,2,2.25,1110,1290,3.0,0,0,2,8,1110,0,2006,0.0,98103,47.6968,-122.34,1360,1251,180,0.13953488372093023,1232100,1664100,432000
505000.0,4,2.5,2420,5006,2.0,0,0,2,8,2420,0,2013,0.0,98059,47.4795,-122.126,2750,5471,2586,0.5165801038753496,5856400,25060036,19203636
522500.0,2,2.25,1430,1210,2.0,0,0,2,8,1340,90,2005,0.0,98115,47.6765,-122.301,1430,1016,-220,-0.18181818181818182,2044900,1464100,-580800
400000.0,3,2.5,2393,4788,2.0,0,0,2,8,2393,0,2012,0.0,98055,47.4517,-122.204,2439,5477,2395,0.5002088554720133,5726449,22924944,17198495
543000.0,3,2.25,1240,949,3.0,0,0,2,8,1240,0,2008,0.0,98103,47.6488,-122.334,1310,1140,-291,-0.3066385669125395,1537600,900601,-636999
495000.0,4,2.5,2980,12075,1.0,0,0,2,8,1910,1070,2007,0.0,98056,47.5074,-122.17200000000001,2240,12075,9095,0.7532091097308489,8880400,145805625,136925225
549995.0,4,3.5,2970,6587,2.0,0,0,2,8,2260,710,2014,0.0,98059,47.4776,-122.12200000000001,2970,5690,3617,0.5491118870502505,8820900,43388569,34567669
327555.0,3,2.5,2329,5720,2.0,0,0,2,8,2329,0,2010,0.0,98030,47.361999999999995,-122.2,2197,5720,3391,0.5928321678321679,5424241,32718400,27294159
690000.0,5,3.25,3340,9075,2.0,0,0,2,8,2600,740,2005,0.0,98065,47.5446,-121.88,2770,6646,5735,0.6319559228650138,11155600,82355625,71200025
673000.0,4,2.25,2580,2875,2.0,0,0,2,9,2580,0,2015,0.0,98116,47.5674,-122.39200000000001,1290,5750,295,0.10260869565217391,6656400,8265625,1609225
384435.0,3,2.5,2029,3906,2.0,0,0,2,9,2029,0,2014,0.0,98003,47.341,-122.18,2029,3920,1877,0.48054275473630315,4116841,15256836,11139995
780000.0,4,2.75,3430,6500,2.0,0,0,2,9,3050,380,2006,0.0,98052,47.7079,-122.10600000000001,3070,6802,3070,0.4723076923076923,11764900,42250000,30485100
1380000.0,5,3.75,3330,5042,2.0,0,2,2,9,2470,860,2014,0.0,98103,47.6497,-122.339,1780,3990,1712,0.33954779849266165,11088900,25421764,14332864
950968.0,5,3.5,3220,5081,2.0,0,0,2,8,3220,0,2013,0.0,98052,47.7048,-122.111,2970,5753,1861,0.3662664829757922,10368400,25816561,15448161
334950.0,2,2.25,1240,750,2.0,0,0,2,7,1150,90,2008,0.0,98027,47.5322,-122.073,1240,750,-490,-0.6533333333333333,1537600,562500,-975100
489000.0,3,3.5,1500,1249,2.0,0,0,2,8,1240,260,2004,0.0,98107,47.6727,-122.37299999999999,1440,1850,-251,-0.20096076861489193,2250000,1560001,-689999
600000.0,3,3.0,3530,8345,2.0,0,0,2,10,3530,0,2006,0.0,98028,47.7338,-122.234,1940,9600,4815,0.5769922109047334,12460900,69639025,57178125
282000.0,3,2.25,1260,915,2.0,0,0,2,8,1020,240,2007,0.0,98106,47.555,-122.363,1260,1056,-345,-0.3770491803278688,1587600,837225,-750375
442000.0,4,4.0,4168,8485,2.0,0,0,2,10,3222,946,2007,0.0,98023,47.3029,-122.387,4362,8100,4317,0.5087802003535651,17372224,71995225,54623001
220000.0,2,1.5,1030,2850,2.0,0,0,2,7,1030,0,1995,0.0,98038,47.3845,-122.039,1030,3000,1820,0.6385964912280702,1060900,8122500,7061600
489000.0,3,2.5,3080,5598,2.0,0,0,2,8,3080,0,2006,0.0,98055,47.4372,-122.206,3080,5303,2518,0.4498035012504466,9486400,31337604,21851204
250000.0,3,1.5,1072,4339,2.0,0,0,2,7,1072,0,2009,0.0,98042,47.386,-122.162,1443,4341,3267,0.7529384650841208,1149184,18826921,17677737
484259.0,4,2.75,2790,5000,2.0,0,0,2,8,2790,0,2014,0.0,98045,47.4831,-121.773,2620,5527,2210,0.442,7784100,25000000,17215900
1680000.0,3,2.5,4090,16972,2.0,0,2,2,11,3590,500,2007,0.0,98177,47.7258,-122.37,3740,16972,12882,0.7590148479849164,16728100,288048784,271320684
450000.0,3,2.5,1800,4357,2.0,0,0,2,8,1800,0,2013,0.0,98065,47.5337,-121.84100000000001,1800,3663,2557,0.5868717007114987,3240000,18983449,15743449
299000.0,2,1.5,830,1276,2.0,0,0,2,7,830,0,2005,0.0,98122,47.6175,-122.29700000000001,1540,1484,446,0.3495297805642633,688900,1628176,939276
450000.0,3,2.5,2280,4557,2.0,0,0,2,8,2280,0,2010,0.0,98028,47.7733,-122.266,2070,4610,2277,0.49967083607636603,5198400,20766249,15567849
585000.0,4,3.0,2110,1286,2.0,0,0,2,9,1710,400,2007,0.0,98029,47.5444,-122.014,2000,1286,-824,-0.640746500777605,4452100,1653796,-2798304
660000.0,3,2.25,1570,1680,3.0,0,0,2,8,1570,0,2014,0.0,98103,47.6585,-122.348,1290,1870,110,0.06547619047619048,2464900,2822400,357500
301500.0,2,1.5,830,1333,2.0,0,0,2,7,830,0,2005,0.0,98136,47.5506,-122.381,1120,4822,503,0.377344336084021,688900,1776889,1087989
949950.0,4,3.75,4120,8258,2.0,0,0,2,10,4120,0,2012,0.0,98075,47.5872,-122.055,3730,8332,4138,0.5010898522644708,16974400,68194564,51220164
759990.0,4,2.5,2540,5760,2.0,0,0,2,9,2540,0,2009,0.0,98029,47.5405,-121.993,2580,3600,3220,0.5590277777777778,6451600,33177600,26726000
355000.0,4,2.75,2050,4000,2.0,0,0,2,8,2050,0,2014,0.0,98001,47.3522,-122.275,2050,4000,1950,0.4875,4202500,16000000,11797500
889950.0,4,2.75,3080,7242,2.0,0,0,2,9,3080,0,2014,0.0,98033,47.6948,-122.178,3010,7205,4162,0.5747031206848937,9486400,52446564,42960164
629800.0,3,2.5,2390,1984,2.0,0,0,2,8,2220,170,2008,0.0,98027,47.5405,-122.027,2150,1984,-406,-0.20463709677419356,5712100,3936256,-1775844
745000.0,4,2.5,3170,5100,2.0,0,0,2,9,3170,0,2012,0.0,98056,47.5187,-122.208,1580,5100,1930,0.3784313725490196,10048900,26010000,15961100
379900.0,2,1.5,1240,1331,2.0,0,0,2,7,1050,190,2007,0.0,98144,47.5959,-122.29799999999999,1250,1431,91,0.06836964688204357,1537600,1771561,233961
335000.0,3,2.5,1090,1139,2.0,0,0,2,8,960,130,2009,0.0,98126,47.5664,-122.369,1400,1348,49,0.04302019315188762,1188100,1297321,109221
809000.0,5,4.5,4630,6324,2.0,0,0,2,9,3210,1420,2006,0.0,98065,47.5382,-121.86,4420,6790,1694,0.2678684376976597,21436900,39992976,18556076
569950.0,4,2.5,3230,5899,2.0,0,0,2,8,3230,0,2012,0.0,98065,47.515,-121.869,2720,5899,2669,0.45244956772334294,10432900,34798201,24365301
723000.0,4,3.5,3510,9263,2.0,0,0,2,10,3510,0,2001,0.0,98065,47.5413,-121.87700000000001,3690,10417,5753,0.6210730864730649,12320100,85803169,73483069
282000.0,4,2.5,1785,2552,2.0,0,0,2,8,1785,0,2009,0.0,98030,47.3582,-122.2,1691,2700,767,0.30054858934169276,3186225,6512704,3326479
569900.0,5,3.25,2360,3873,2.0,0,0,2,8,1990,370,2006,0.0,98108,47.5635,-122.29899999999999,1720,3071,1513,0.3906532403821327,5569600,15000129,9430529
385000.0,4,2.0,2340,9716,1.0,0,0,2,7,2340,0,2009,0.0,98146,47.4842,-122.34700000000001,1180,13500,7376,0.7591601482091396,5475600,94400656,88925056
420000.0,3,2.25,1620,1075,3.0,0,0,2,8,1540,80,2009,0.0,98027,47.5405,-122.02600000000001,1620,1237,-545,-0.5069767441860465,2624400,1155625,-1468775
2250000.0,3,3.25,3890,3452,2.0,0,0,2,12,2890,1000,2006,0.0,98102,47.62600000000001,-122.323,2860,2199,-438,-0.126882966396292,15132100,11916304,-3215796
1210000.0,4,3.5,3590,5335,2.0,0,2,2,9,3140,450,2006,0.0,98115,47.6762,-122.26700000000001,2100,6250,1745,0.3270852858481724,12888100,28462225,15574125
292000.0,4,3.0,1984,4460,2.0,0,0,2,7,1984,0,2012,0.0,98002,47.3532,-122.211,2095,3402,2476,0.5551569506726457,3936256,19891600,15955344
645000.0,3,2.25,1640,1023,3.0,0,0,2,8,1640,0,2014,0.0,98105,47.6636,-122.319,1720,1960,-617,-0.603128054740958,2689600,1046529,-1643071
304500.0,4,2.0,1350,942,3.0,0,0,2,7,1350,0,2008,0.0,98027,47.5394,-122.02600000000001,1390,942,-408,-0.43312101910828027,1822500,887364,-935136
489500.0,4,3.5,2730,5707,2.0,0,0,2,8,2000,730,2011,0.0,98019,47.7327,-121.965,2430,5899,2977,0.5216400911161732,7452900,32569849,25116949
1580000.0,4,4.0,5610,11063,3.0,0,0,2,11,4750,860,2006,0.0,98074,47.65,-122.065,4560,11063,5453,0.49290427551297117,31472100,122389969,90917869
390000.0,2,1.0,962,1992,2.0,0,0,2,7,962,0,2012,0.0,98115,47.6911,-122.31299999999999,1130,1992,1030,0.5170682730923695,925444,3968064,3042620
815000.0,4,3.5,3040,4006,2.0,0,0,2,8,2350,690,2013,0.0,98029,47.5439,-122.01100000000001,2050,4000,966,0.24113829256115826,9241600,16048036,6806436
719000.0,3,3.5,2540,10578,2.0,0,1,2,9,2010,530,2014,0.0,98006,47.547,-122.19200000000001,3240,9831,8038,0.7598789941387786,6451600,111894084,105442484
331210.0,4,2.5,2240,4800,2.0,0,0,2,8,2240,0,2014,0.0,98001,47.2911,-122.266,2240,5040,2560,0.5333333333333333,5017600,23040000,18022400
245000.0,3,1.5,1260,1270,2.0,0,0,2,7,1040,220,2005,0.0,98133,47.7111,-122.331,1260,1472,10,0.007874015748031496,1587600,1612900,25300
465000.0,5,4.0,3210,7200,2.0,0,0,2,8,2410,800,2011,0.0,98019,47.7329,-121.96600000000001,2750,7200,3990,0.5541666666666667,10304100,51840000,41535900
580000.0,3,2.5,1620,1171,3.0,0,4,2,8,1470,150,2008,0.0,98103,47.6681,-122.355,1620,1505,-449,-0.38343296327924853,2624400,1371241,-1253159
540000.0,3,2.0,1580,1972,2.5,0,2,2,8,1180,400,2007,0.0,98116,47.5903,-122.38600000000001,1500,1908,392,0.19878296146044624,2496400,3888784,1392384
399000.0,3,2.5,1430,1250,3.0,0,0,2,7,1430,0,2007,0.0,98103,47.6904,-122.34200000000001,1360,1269,-180,-0.144,2044900,1562500,-482400
328000.0,4,2.5,1850,5388,2.0,0,0,2,8,1850,0,2009,0.0,98038,47.3494,-122.041,2140,5086,3538,0.6566443949517446,3422500,29030544,25608044
701000.0,4,2.5,3340,5314,2.0,0,0,2,10,3340,0,2010,0.0,98065,47.5167,-121.885,3220,5500,1974,0.37147158449379,11155600,28238596,17082996
408000.0,3,2.75,2670,4800,2.0,0,0,2,8,2670,0,2014,0.0,98038,47.3483,-122.042,2340,5000,2130,0.44375,7128900,23040000,15911100
2640000.0,5,4.25,4660,16200,2.0,0,2,2,11,4660,0,2005,0.0,98004,47.6326,-122.21600000000001,3340,16200,11540,0.7123456790123457,21715600,262440000,240724400
445000.0,3,2.5,1550,930,2.0,0,0,2,8,1060,490,2006,0.0,98144,47.5857,-122.314,1550,1301,-620,-0.6666666666666666,2402500,864900,-1537600
672500.0,4,2.5,3470,6651,2.0,0,0,2,9,3470,0,2005,0.0,98065,47.5426,-121.87899999999999,2730,6179,3181,0.4782739437678545,12040900,44235801,32194901
538000.0,3,2.5,3010,7014,2.0,0,0,2,8,3010,0,2009,0.0,98059,47.4949,-122.149,3030,6180,4004,0.5708582834331337,9060100,49196196,40136096
450000.0,5,3.5,3931,9497,2.0,0,0,2,10,2650,1281,2014,0.0,98023,47.3008,-122.38600000000001,3510,9497,5566,0.5860798146783195,15452761,90193009,74740248
362500.0,3,2.5,1800,2700,2.0,0,0,2,8,1800,0,2011,0.0,98126,47.5458,-122.369,1380,1200,900,0.3333333333333333,3240000,7290000,4050000
414950.0,3,2.5,1570,1551,3.0,0,0,2,8,1570,0,2008,0.0,98103,47.6961,-122.34100000000001,1570,1705,-19,-0.012250161186331399,2464900,2405601,-59299
679950.0,3,2.5,2230,3939,2.0,0,0,2,8,2230,0,2014,0.0,98133,47.73,-122.335,2230,4200,1709,0.43386646356943387,4972900,15515721,10542821
290000.0,4,2.5,2423,7292,2.0,0,0,2,8,2423,0,2005,0.0,98023,47.3227,-122.37,2495,7489,4869,0.6677180471749863,5870929,53173264,47302335
230000.0,3,2.0,1160,1174,2.0,0,0,2,7,790,370,2007,0.0,98106,47.5225,-122.35700000000001,1160,994,14,0.01192504258943782,1345600,1378276,32676
439950.0,2,2.0,1440,4666,1.0,0,0,2,8,1440,0,2010,0.0,98053,47.708999999999996,-122.01899999999999,1510,4595,3226,0.6913844834976425,2073600,21771556,19697956
349900.0,4,2.5,2052,3723,2.0,0,0,2,8,2052,0,2014,0.0,98003,47.2824,-122.295,2052,5250,1671,0.44883158742949236,4210704,13860729,9650025
550000.0,5,2.5,2780,9272,2.0,0,0,2,8,2780,0,2014,0.0,98126,47.5168,-122.37799999999999,1150,8460,6492,0.7001725625539258,7728400,85969984,78241584
1050000.0,4,4.25,3720,5750,2.0,0,2,2,9,2960,760,2006,0.0,98116,47.5632,-122.399,2550,5750,2030,0.35304347826086957,13838400,33062500,19224100
655000.0,2,2.25,1460,1851,2.0,0,0,2,9,1180,280,2014,0.0,98119,47.6461,-122.36200000000001,1800,4269,391,0.21123716909778498,2131600,3426201,1294601
385000.0,3,3.5,1370,1540,2.0,0,0,2,8,1100,270,2006,0.0,98116,47.5638,-122.38799999999999,1370,915,170,0.11038961038961038,1876900,2371600,494700
729999.0,6,4.5,3600,6110,2.0,0,0,2,9,2510,0,2012,0.0,98118,47.5687,-122.291,1360,5800,2510,0.41080196399345337,12960000,37332100,24372100
523950.0,3,2.25,1420,1282,3.0,0,0,2,8,1420,0,2006,0.0,98103,47.6533,-122.346,1530,1280,-138,-0.10764430577223089,2016400,1643524,-372876
369000.0,2,2.5,980,895,2.0,0,0,2,8,670,310,2009,0.0,98116,47.5874,-122.38600000000001,980,899,-85,-0.09497206703910614,960400,801025,-159375
509900.0,3,2.5,1790,2700,2.0,0,0,2,8,1790,0,2010,0.0,98027,47.56399999999999,-122.09299999999999,1890,3078,910,0.337037037037037,3204100,7290000,4085900
282000.0,3,2.5,2010,5399,2.0,0,0,2,7,2010,0,2006,0.0,98042,47.3338,-122.052,2280,5141,3389,0.6277088349694387,4040100,29149201,25109101
387865.0,3,2.5,2370,4200,2.0,0,0,2,8,2370,0,2014,0.0,98038,47.3696,-122.01799999999999,2370,4200,1830,0.4357142857142857,5616900,17640000,12023100
385000.0,4,2.5,2560,6238,2.0,0,0,2,8,2560,0,2007,0.0,98178,47.4899,-122.255,2560,6240,3678,0.5896120551458801,6553600,38912644,32359044
536000.0,3,2.5,1900,6224,2.0,0,0,2,7,1900,0,2005,0.0,98075,47.5941,-122.00399999999999,2260,5450,4324,0.6947300771208226,3610000,38738176,35128176
395000.0,2,2.25,1350,1493,2.0,0,0,2,8,1050,300,2007,0.0,98136,47.5421,-122.38799999999999,1250,1202,143,0.09578030810448761,1822500,2229049,406549
545000.0,4,2.75,2650,6717,2.0,0,0,2,10,2650,0,2014,0.0,98056,47.4947,-122.171,2740,7923,4067,0.6054786362959654,7022500,45118089,38095589
715000.0,4,2.5,3020,7035,2.0,0,4,2,9,3020,0,2001,0.0,98065,47.5344,-121.874,3020,6771,4015,0.5707178393745558,9120400,49491225,40370825
348000.0,3,2.5,1500,2255,2.0,0,0,2,7,1500,0,2005,0.0,98029,47.5538,-121.99700000000001,1440,2040,755,0.3348115299334812,2250000,5085025,2835025
455000.0,3,1.75,1320,1014,3.0,0,0,2,9,1320,0,2015,0.0,98122,47.6047,-122.305,1380,1495,-306,-0.30177514792899407,1742400,1028196,-714204
575000.0,4,2.75,3120,7644,2.0,0,0,2,10,3120,0,2010,0.0,98065,47.5156,-121.884,2980,6050,4524,0.5918367346938775,9734400,58430736,48696336
449950.0,3,2.25,1540,1270,3.0,0,0,2,7,1540,0,2014,0.0,98103,47.6935,-122.34100000000001,1230,1454,-270,-0.2125984251968504,2371600,1612900,-758700
364000.0,3,2.5,1800,2790,2.0,0,0,2,8,1800,0,2011,0.0,98126,47.5455,-122.37100000000001,1580,2036,990,0.3548387096774194,3240000,7784100,4544100
932990.0,4,2.5,3640,6389,2.0,0,0,2,9,3640,0,2014,0.0,98052,47.7049,-122.12299999999999,3570,6303,2749,0.4302707778995148,13249600,40819321,27569721
710000.0,3,2.5,2440,4153,2.0,0,0,2,9,2440,0,2003,0.0,98052,47.665,-122.087,2030,4143,1713,0.4124729111485673,5953600,17247409,11293809
949990.0,4,4.0,3970,7314,2.0,0,0,2,9,3970,0,2014,0.0,98074,47.6173,-122.056,3560,5258,3344,0.45720535958435876,15760900,53494596,37733696
326989.0,3,2.5,2060,4200,2.0,0,0,2,8,2060,0,2014,0.0,98038,47.3706,-122.01700000000001,2370,4200,2140,0.5095238095238095,4243600,17640000,13396400
335606.0,3,2.5,2538,4600,2.0,0,0,2,8,2538,0,2013,0.0,98092,47.2584,-122.196,2570,4800,2062,0.4482608695652174,6441444,21160000,14718556
1530000.0,5,4.5,4270,8076,2.0,0,0,2,11,3400,870,2007,0.0,98033,47.699,-122.206,4100,10631,3806,0.471272907379891,18232900,65221776,46988876
299950.0,3,2.5,1320,3150,2.0,0,0,2,7,1320,0,2005,0.0,98118,47.5328,-122.28200000000001,1390,1725,1830,0.580952380952381,1742400,9922500,8180100
962000.0,4,2.75,3340,5700,2.0,0,0,2,11,3340,0,2013,0.0,98059,47.5059,-122.146,3340,6940,2360,0.41403508771929826,11155600,32490000,21334400
395825.0,2,2.5,1590,1679,2.0,0,0,2,8,1590,0,2012,0.0,98029,47.5449,-122.01100000000001,1590,1680,89,0.053007742703990474,2528100,2819041,290941
419354.0,5,2.75,2710,4500,2.0,0,0,2,8,2710,0,2014,0.0,98038,47.3547,-122.06200000000001,2710,4626,1790,0.3977777777777778,7344100,20250000,12905900
920000.0,4,2.75,3140,7258,2.0,0,1,2,10,3140,0,2006,0.0,98034,47.7064,-122.23200000000001,2990,13600,4118,0.5673739322127308,9859600,52678564,42818964
366000.0,3,2.25,1445,1028,2.0,0,0,2,7,1300,145,2005,0.0,98027,47.5339,-122.06700000000001,1445,1377,-417,-0.4056420233463035,2088025,1056784,-1031241
480000.0,4,2.5,2430,5000,2.0,0,0,2,7,2430,0,2009,0.0,98065,47.515,-121.87299999999999,2430,5441,2570,0.514,5904900,25000000,19095100
388000.0,3,3.25,1370,915,2.0,0,0,2,8,1100,270,2006,0.0,98116,47.5639,-122.38799999999999,1370,1146,-455,-0.4972677595628415,1876900,837225,-1039675
2320000.0,4,3.5,5050,9520,2.0,0,0,2,11,3610,1440,2007,0.0,98004,47.6364,-122.209,2430,9248,4470,0.4695378151260504,25502500,90630400,65127900
730000.0,3,2.5,1860,1290,2.0,0,0,2,9,1240,620,2010,0.0,98122,47.6179,-122.301,1710,1525,-570,-0.4418604651162791,3459600,1664100,-1795500
950000.0,5,3.75,5330,6000,2.0,0,2,2,10,3570,1760,2006,0.0,98027,47.5401,-122.073,4420,5797,670,0.11166666666666666,28408900,36000000,7591100
358990.0,3,3.25,1710,2171,2.0,0,0,2,7,1400,310,2014,0.0,98106,47.5434,-122.368,1380,1300,461,0.21234454168585906,2924100,4713241,1789141
398651.0,4,2.5,2650,4120,2.0,0,0,2,8,2650,0,2014,0.0,98146,47.5019,-122.34,2030,3768,1470,0.3567961165048544,7022500,16974400,9951900
530000.0,4,2.5,2590,7891,2.0,0,0,2,9,2590,0,2006,0.0,98056,47.5055,-122.194,1400,7891,5301,0.6717779749081232,6708100,62267881,55559781
610360.0,4,2.5,2610,5562,2.0,0,0,2,9,2610,0,2013,0.0,98056,47.5137,-122.169,2720,7400,2952,0.5307443365695793,6812100,30935844,24123744
436110.0,3,2.5,1770,1235,3.0,0,0,2,8,1600,170,2007,0.0,98103,47.6965,-122.34200000000001,1680,1203,-535,-0.4331983805668016,3132900,1525225,-1607675
925000.0,4,2.75,3730,8014,2.0,0,0,2,10,3730,0,2012,0.0,98074,47.6036,-122.059,3670,8279,4284,0.5345645121038183,13912900,64224196,50311296
449950.0,4,2.5,2420,5244,2.0,0,0,2,9,2420,0,2007,0.0,98166,47.4729,-122.35,1400,5250,2824,0.5385202135774219,5856400,27499536,21643136
760000.0,4,2.5,3330,7399,2.0,0,0,2,9,3330,0,2009,0.0,98052,47.678999999999995,-122.15299999999999,2640,8601,4069,0.5499391809704014,11088900,54745201,43656301
293000.0,3,2.25,1910,3481,2.0,0,0,2,8,1910,0,2009,0.0,98055,47.4293,-122.18799999999999,1714,3177,1571,0.45130709566216604,3648100,12117361,8469261
695000.0,2,2.5,2170,7665,1.0,0,2,2,8,2170,0,2013,0.0,98053,47.7112,-122.01899999999999,2300,7100,5495,0.7168949771689498,4708900,58752225,54043325
285000.0,3,2.5,2437,5136,2.0,0,0,2,7,2437,0,2011,0.0,98002,47.3517,-122.21,2437,4614,2699,0.525506230529595,5938969,26378496,20439527
1260000.0,5,4.0,4180,12042,2.0,0,0,2,10,4180,0,2014,0.0,98075,47.5959,-122.014,1800,6052,7862,0.6528815811327022,17472400,145009764,127537364
379900.0,3,2.5,1800,2791,2.0,0,0,2,8,1800,0,2011,0.0,98126,47.5442,-122.37100000000001,1580,2617,991,0.3550698674310283,3240000,7789681,4549681
472000.0,5,2.5,2570,7412,2.0,0,0,2,8,2570,0,2006,0.0,98019,47.7265,-121.95700000000001,2890,8056,4842,0.6532649757150567,6604900,54937744,48332844
300000.0,4,2.5,2090,5195,2.0,0,0,2,7,2090,0,2007,0.0,98031,47.3986,-122.166,2090,5236,3105,0.5976900866217517,4368100,26988025,22619925
272000.0,4,2.5,2789,3960,2.0,0,0,2,7,2789,0,2007,0.0,98001,47.3059,-122.28,2547,3960,1171,0.2957070707070707,7778521,15681600,7903079
418395.0,4,2.5,2906,5893,2.0,0,0,2,9,2906,0,2014,0.0,98092,47.2599,-122.19200000000001,2680,4950,2987,0.506872560665196,8444836,34727449,26282613
465000.0,5,2.5,2550,6405,2.0,0,0,2,7,2550,0,2008,0.0,98065,47.5191,-121.869,2190,5900,3855,0.6018735362997658,6502500,41024025,34521525
659950.0,4,2.75,3550,9400,2.0,0,0,2,9,3550,0,2014,0.0,98059,47.4827,-122.131,3550,9421,5850,0.6223404255319149,12602500,88360000,75757500
484950.0,3,2.25,1590,926,3.0,0,0,2,8,1590,0,2014,0.0,98136,47.5402,-122.387,1640,1321,-664,-0.7170626349892009,2528100,857476,-1670624
359000.0,3,2.25,1950,1968,2.0,0,0,3,7,1160,790,1979,0.0,98056,47.5179,-122.195,1950,1968,18,0.009146341463414634,3802500,3873024,70524
519000.0,4,2.5,3250,4500,2.0,0,0,2,8,3250,0,2009,0.0,98059,47.4944,-122.149,3030,4518,1250,0.2777777777777778,10562500,20250000,9687500
1710000.0,5,4.5,4590,14685,2.0,0,0,2,10,4590,0,2009,0.0,98033,47.663999999999994,-122.2,3030,9486,10095,0.6874361593462717,21068100,215649225,194581125
535000.0,4,2.75,3070,7201,2.0,0,0,2,9,3070,0,2006,0.0,98059,47.4897,-122.147,2880,8364,4131,0.5736703235661713,9424900,51854401,42429501
622950.0,4,3.25,3030,7644,2.0,0,0,2,8,2830,200,2006,0.0,98065,47.5457,-121.881,3400,6908,4614,0.6036106750392465,9180900,58430736,49249836
515000.0,3,2.5,2610,5845,2.0,0,0,2,8,2610,0,2005,0.0,98059,47.4821,-122.14200000000001,2810,5000,3235,0.553464499572284,6812100,34164025,27351925
330000.0,4,3.5,3150,6202,2.0,0,0,2,7,3150,0,2005,0.0,98042,47.3993,-122.162,2950,5940,3052,0.49209932279909707,9922500,38464804,28542304
318000.0,3,1.5,1240,983,3.0,0,0,2,8,1240,0,2009,0.0,98133,47.7235,-122.353,1240,1026,-257,-0.2614445574771109,1537600,966289,-571311
439000.0,3,2.5,1680,2801,2.0,0,0,2,7,1680,0,2011,0.0,98011,47.745,-122.181,1920,2723,1121,0.4002142092109961,2822400,7845601,5023201
540000.0,3,2.5,2220,5279,2.0,0,0,2,8,2220,0,2006,0.0,98146,47.5132,-122.387,1610,5297,3059,0.5794658079181663,4928400,27867841,22939441
1080000.0,4,3.25,4800,12727,2.0,0,0,2,10,4800,0,2011,0.0,98059,47.5311,-122.134,4750,13602,7927,0.6228490610513082,23040000,161976529,138936529
435000.0,4,2.5,3100,4699,2.0,0,0,2,9,3100,0,2010,0.0,98038,47.3785,-122.023,2450,5130,1599,0.3402851670568206,9610000,22080601,12470601
2700000.0,4,4.0,7850,89651,2.0,0,0,2,12,7850,0,2006,0.0,98027,47.5406,-121.98200000000001,6210,95832,81801,0.9124382327023681,61622500,8037301801,7975679301
1100000.0,4,2.75,3590,5625,2.0,0,0,2,10,3590,0,2012,0.0,98052,47.6959,-122.133,3590,5625,2035,0.36177777777777775,12888100,31640625,18752525
293467.0,4,2.0,1590,942,3.0,0,0,2,7,1590,0,2008,0.0,98027,47.54,-122.02600000000001,1390,942,-648,-0.6878980891719745,2528100,887364,-1640736
328000.0,3,2.5,2242,4800,2.0,0,0,2,8,2242,0,2013,0.0,98092,47.2581,-122.2,2009,4800,2558,0.5329166666666667,5026564,23040000,18013436
550000.0,3,3.5,2490,3582,2.0,0,0,2,8,1720,770,2005,0.0,98027,47.5338,-122.06700000000001,1445,1590,1092,0.304857621440536,6200100,12830724,6630624
649000.0,3,2.0,1530,1442,3.0,0,0,2,9,1530,0,2015,0.0,98107,47.6692,-122.37200000000001,1620,1456,-88,-0.06102635228848821,2340900,2079364,-261536
435000.0,4,2.5,2150,3143,2.0,0,0,2,7,2150,0,2010,0.0,98059,47.5048,-122.154,2640,3200,993,0.3159401845370665,4622500,9878449,5255949
625000.0,3,2.5,2440,4800,2.0,0,0,2,10,2440,0,2014,0.0,98106,47.5595,-122.365,1180,5480,2360,0.49166666666666664,5953600,23040000,17086400
415000.0,3,1.5,1270,1483,3.0,0,0,2,8,1270,0,2007,0.0,98115,47.6987,-122.31700000000001,1270,1413,213,0.14362778152393796,1612900,2199289,586389
400000.0,3,2.25,1450,4706,2.0,0,0,2,7,1450,0,2009,0.0,98028,47.761,-122.23200000000001,1490,4667,3256,0.6918827029324267,2102500,22146436,20043936
979000.0,3,2.5,2690,4047,3.0,0,0,2,10,2690,0,2014,0.0,98117,47.6797,-122.385,2040,5000,1357,0.33531010625154434,7236100,16378209,9142109
625250.0,4,2.5,2755,4831,2.0,0,0,2,7,2755,0,2003,0.0,98053,47.685,-122.039,2510,4831,2076,0.4297246946801904,7590025,23338561,15748536
665000.0,4,3.5,2650,3474,2.0,0,0,2,8,2230,420,2011,0.0,98027,47.5377,-122.046,2330,3474,824,0.23719055843408174,7022500,12068676,5046176
589500.0,3,3.25,2310,3075,2.0,0,0,2,8,1730,580,2005,0.0,98116,47.5644,-122.383,2310,3075,765,0.24878048780487805,5336100,9455625,4119525
437000.0,2,3.0,1460,1452,2.0,0,0,2,8,1140,320,2007,0.0,98136,47.5224,-122.39,1460,1452,-8,-0.005509641873278237,2131600,2108304,-23296
320000.0,3,1.0,1400,9000,1.0,0,0,4,7,1400,0,1959,0.0,98059,47.5022,-122.145,1440,8400,7600,0.8444444444444444,1960000,81000000,79040000
333500.0,3,2.5,2196,7475,2.0,0,0,2,8,2196,0,2006,0.0,98030,47.3803,-122.204,1860,6755,5279,0.7062207357859531,4822416,55875625,51053209
430000.0,3,2.25,2020,2750,2.0,0,0,2,8,1680,340,2008,0.0,98108,47.5633,-122.29700000000001,1720,1546,730,0.26545454545454544,4080400,7562500,3482100
995500.0,5,4.5,4280,8465,2.0,0,0,2,10,4280,0,2014,0.0,98034,47.7325,-122.165,2990,11067,4185,0.4943886591848789,18318400,71656225,53337825
427874.0,3,3.0,2340,5002,2.0,0,0,2,8,2340,0,2013,0.0,98045,47.4831,-121.773,2790,5375,2662,0.53218712514994,5475600,25020004,19544404
334990.0,4,2.5,2220,4228,2.0,0,0,2,8,2220,0,2014,0.0,98146,47.5014,-122.34100000000001,2220,4157,2008,0.4749290444654683,4928400,17875984,12947584
909500.0,4,4.0,4420,5940,2.0,0,0,2,10,3410,1010,2006,0.0,98027,47.5397,-122.072,4510,5797,1520,0.2558922558922559,19536400,35283600,15747200
210000.0,3,2.0,1580,4961,2.0,0,0,2,7,1580,0,2006,0.0,98042,47.3338,-122.053,2280,5000,3381,0.681515823422697,2496400,24611521,22115121
952990.0,4,2.75,3550,6558,2.0,0,0,2,9,3550,0,2013,0.0,98052,47.7076,-122.115,3140,5617,3008,0.45867642573955475,12602500,43007364,30404864
622500.0,2,1.75,1510,851,3.0,0,0,2,8,1420,90,2013,0.0,98107,47.6536,-122.35799999999999,1300,1338,-659,-0.7743830787309048,2280100,724201,-1555899
515000.0,3,3.5,1360,1419,2.0,0,0,2,8,1040,320,2007,0.0,98107,47.6697,-122.37100000000001,1560,1977,59,0.041578576462297394,1849600,2013561,163961
350000.0,3,2.5,2040,13590,2.0,0,0,2,8,2040,0,2009,0.0,98042,47.3122,-122.04,1850,12485,11550,0.8498896247240618,4161600,184688100,180526500
310000.0,1,1.5,1120,912,3.0,0,0,2,7,1120,0,2011,0.0,98144,47.5924,-122.29899999999999,1380,3200,-208,-0.22807017543859648,1254400,831744,-422656
700000.0,4,3.5,4490,5099,2.0,0,0,2,9,3390,1100,2006,0.0,98065,47.5394,-121.861,4290,5537,609,0.1194351833692881,20160100,25999801,5839701
907687.0,4,2.5,3560,6786,2.0,0,0,2,9,2930,630,2014,0.0,98075,47.5756,-122.071,3560,5886,3226,0.4753905098732685,12673600,46049796,33376196
741500.0,2,2.5,2150,5760,1.0,0,0,2,8,2150,0,2010,0.0,98053,47.7094,-122.01799999999999,1640,4680,3610,0.6267361111111112,4622500,33177600,28555100
395000.0,3,2.5,2130,5088,2.0,0,0,2,8,1840,290,2011,0.0,98019,47.7329,-121.976,2130,5762,2958,0.5813679245283019,4536900,25887744,21350844
559950.0,5,2.75,2990,6370,2.0,0,0,2,8,2990,0,2014,0.0,98059,47.4853,-122.154,2730,5740,3380,0.5306122448979592,8940100,40576900,31636800
215000.0,4,2.5,1847,8000,2.0,0,0,2,7,1847,0,2008,0.0,98001,47.2872,-122.257,1847,8000,6153,0.769125,3411409,64000000,60588591
390000.0,4,2.5,2610,7227,2.0,0,0,2,9,2610,0,2011,0.0,98010,47.31399999999999,-122.023,2630,7421,4617,0.638854296388543,6812100,52229529,45417429
425000.0,3,2.25,1670,107157,1.0,0,0,2,7,1670,0,2007,0.0,98022,47.2743,-122.009,3310,108900,105487,0.9844153905017871,2788900,11482622649,11479833749
472000.0,3,2.5,1860,415126,2.0,0,0,2,7,1860,0,2006,0.0,98038,47.3974,-122.005,2070,54014,413266,0.9955194326541821,3459600,172329595876,172326136276
1330000.0,4,3.5,3440,9776,2.0,0,0,2,10,3440,0,2006,0.0,98040,47.5374,-122.21600000000001,2400,11000,6336,0.6481178396072013,11833600,95570176,83736576
695000.0,4,3.5,3510,9364,2.0,0,0,2,10,3510,0,2001,0.0,98065,47.54,-121.876,3510,9161,5854,0.6251601879538659,12320100,87684496,75364396
545000.0,3,2.5,1740,1279,3.0,0,0,2,8,1740,0,2008,0.0,98116,47.589,-122.387,1740,1280,-461,-0.3604378420641126,3027600,1635841,-1391759
389950.0,4,2.5,2240,5500,2.0,0,0,2,8,2240,0,2013,0.0,98056,47.496,-122.169,700,5500,3260,0.5927272727272728,5017600,30250000,25232400
380000.0,3,2.25,1550,1485,3.0,0,0,2,8,1550,0,2011,0.0,98103,47.6989,-122.346,1550,1480,-65,-0.04377104377104377,2402500,2205225,-197275
288790.0,4,2.0,1390,745,3.0,0,0,2,7,1390,0,2008,0.0,98027,47.5401,-122.02600000000001,1390,942,-645,-0.8657718120805369,1932100,555025,-1377075
432500.0,3,3.0,2500,6000,2.0,0,0,2,8,2500,0,2012,0.0,98058,47.4408,-122.161,2130,6000,3500,0.5833333333333334,6250000,36000000,29750000
615000.0,3,3.5,2710,3326,2.0,0,0,2,8,1650,1060,2005,0.0,98027,47.5371,-122.073,2280,2738,616,0.185207456404089,7344100,11062276,3718176
500000.0,3,2.5,1720,3012,2.0,0,0,2,9,1720,0,2011,0.0,98133,47.7312,-122.334,1720,7658,1292,0.42895086321381143,2958400,9072144,6113744
615000.0,3,2.25,1760,1146,3.0,0,0,2,9,1760,0,2014,0.0,98122,47.6073,-122.304,1346,3472,-614,-0.5357766143106457,3097600,1313316,-1784284
500000.0,4,2.25,2270,8196,1.0,0,0,4,7,1150,1120,1963,0.0,98034,47.7214,-122.227,1920,10122,5926,0.7230356271351879,5152900,67174416,62021516
622000.0,3,3.5,1690,1765,2.0,0,0,2,8,1370,320,2006,0.0,98103,47.6536,-122.34,1690,1694,75,0.042492917847025496,2856100,3115225,259125
802945.0,5,3.5,4000,9234,2.0,0,0,2,9,4000,0,2015,0.0,98024,47.5265,-121.887,3690,6600,5234,0.5668182802685726,16000000,85266756,69266756
1260000.0,4,2.5,2880,9003,2.0,0,0,2,10,2880,0,2008,0.0,98033,47.6844,-122.199,2640,8126,6123,0.680106631122959,8294400,81054009,72759609
598950.0,3,2.5,1480,1531,3.0,0,0,2,8,1480,0,2014,0.0,98107,47.669,-122.402,1530,1321,51,0.033311561071195296,2190400,2343961,153561
430000.0,3,2.5,1950,4949,2.0,0,0,2,7,1950,0,2009,0.0,98065,47.5155,-121.87,2200,5740,2999,0.6059810062638917,3802500,24492601,20690101
515000.0,4,2.75,2700,5150,2.0,0,0,2,9,2700,0,2009,0.0,98065,47.5209,-121.874,2700,5747,2450,0.47572815533980584,7290000,26522500,19232500
1260000.0,2,3.0,2210,3917,2.0,0,0,2,10,1500,710,2008,0.0,98122,47.6166,-122.291,1720,3933,1707,0.4357926984937452,4884100,15342889,10458789
400000.0,4,3.5,2370,3692,2.5,0,0,2,8,2370,0,2013,0.0,98056,47.5044,-122.17,2520,5425,1322,0.3580715059588299,5616900,13630864,8013964
390000.0,3,2.5,1310,1254,2.0,0,0,2,7,850,460,2007,0.0,98116,47.5622,-122.384,1310,1372,-56,-0.044657097288676235,1716100,1572516,-143584
450000.0,3,2.5,2410,4293,2.0,0,0,2,7,2410,0,2007,0.0,98065,47.5196,-121.869,2190,5900,1883,0.43862101094805495,5808100,18429849,12621749
804995.0,5,1.5,3360,5402,2.0,0,0,2,9,3360,0,2014,0.0,98074,47.6067,-122.053,3360,5415,2042,0.3780081451314328,11289600,29181604,17892004
825000.0,4,3.25,3040,4155,2.0,0,0,2,8,2350,690,2013,0.0,98029,47.5429,-122.012,2680,4000,1115,0.2683513838748496,9241600,17264025,8022425
435000.0,4,2.25,2140,6355,2.0,0,0,2,7,2140,0,2002,0.0,98065,47.5367,-121.88,2480,5746,4215,0.6632572777340676,4579600,40386025,35806425
398000.0,3,2.5,1720,1715,2.0,0,0,2,7,1240,480,2004,0.0,98136,47.5481,-122.384,1610,1626,-5,-0.0029154518950437317,2958400,2941225,-17175
411605.0,4,2.5,2658,3960,2.0,0,0,2,9,2658,0,2014,0.0,98092,47.2603,-122.194,2578,4200,1302,0.3287878787878788,7064964,15681600,8616636
315000.0,3,3.25,1480,983,2.0,0,0,2,8,1180,300,2013,0.0,98106,47.5555,-122.363,1330,1062,-497,-0.5055951169888098,2190400,966289,-1224111
455000.0,2,2.0,1350,1209,3.0,0,0,2,8,1350,0,2013,0.0,98199,47.648999999999994,-122.383,1310,982,-141,-0.11662531017369727,1822500,1461681,-360819
452950.0,3,2.5,1150,1194,2.0,0,0,2,8,1020,130,2006,0.0,98107,47.6684,-122.365,1450,1714,44,0.03685092127303183,1322500,1425636,103136
380000.0,3,1.75,1690,1468,2.0,0,0,2,8,1380,310,2008,0.0,98108,47.563,-122.29700000000001,1690,1936,-222,-0.15122615803814715,2856100,2155024,-701076
340000.0,2,1.75,1270,1916,2.0,0,0,2,8,1270,0,2012,0.0,98108,47.5648,-122.294,1140,1916,646,0.33716075156576203,1612900,3671056,2058156
409950.0,3,2.5,2655,5080,2.0,0,0,2,8,2655,0,2013,0.0,98023,47.2972,-122.348,2879,5232,2425,0.47736220472440943,7049025,25806400,18757375
360000.0,2,1.0,880,1165,2.0,0,0,2,8,880,0,2005,0.0,98122,47.6192,-122.29700000000001,1640,3825,285,0.2446351931330472,774400,1357225,582825
1600000.0,4,4.25,4645,7757,2.0,0,0,2,10,3855,790,2006,0.0,98112,47.6248,-122.29,2150,6970,3112,0.40118602552533195,21576025,60171049,38595024
440000.0,3,1.5,1270,1443,3.0,0,0,2,8,1270,0,2007,0.0,98115,47.699,-122.31700000000001,1270,1413,173,0.11988911988911989,1612900,2082249,469349
730000.0,2,1.75,1728,95950,1.0,0,3,2,9,1728,0,2012,0.0,98070,47.4579,-122.443,1720,35735,94222,0.981990620114643,2985984,9206402500,9203416516
408000.0,3,2.25,1950,7221,1.0,0,0,3,8,1950,0,2006,0.0,98188,47.431000000000004,-122.285,2310,8125,5271,0.7299542999584545,3802500,52142841,48340341
820000.0,4,2.5,3170,3862,3.0,0,0,2,8,3170,0,2008,0.0,98034,47.6705,-122.145,2840,4181,692,0.17918177110305541,10048900,14915044,4866144
360000.0,2,2.5,1233,1244,2.0,0,0,2,7,963,270,2007,0.0,98136,47.5533,-122.381,1230,1300,11,0.008842443729903537,1520289,1547536,27247
339990.0,3,2.5,2570,4600,2.0,0,0,2,8,2570,0,2014,0.0,98092,47.2582,-122.196,2570,5000,2030,0.44130434782608696,6604900,21160000,14555100
515000.0,3,2.0,1560,1020,3.0,0,0,2,8,1560,0,2014,0.0,98122,47.605,-122.304,1560,1728,-540,-0.5294117647058824,2433600,1040400,-1393200
541000.0,3,1.75,1630,1166,2.0,0,0,2,8,1020,610,2013,0.0,98107,47.6646,-122.367,1420,1670,-464,-0.3979416809605489,2656900,1359556,-1297344
375000.0,4,2.5,2510,7245,2.0,0,0,2,9,2510,0,2007,0.0,98146,47.5096,-122.363,1830,8900,4735,0.6535541752933057,6300100,52490025,46189925
320000.0,4,2.5,2223,5780,2.0,0,0,2,8,2223,0,2010,0.0,98042,47.3586,-122.15700000000001,1690,7766,3557,0.6153979238754326,4941729,33408400,28466671
325000.0,2,2.25,1230,1058,2.0,0,0,2,7,1160,70,2008,0.0,98027,47.5325,-122.073,1240,817,-172,-0.16257088846880907,1512900,1119364,-393536
740000.0,5,2.75,3050,7520,2.0,0,0,2,8,3050,0,2014,0.0,98056,47.5245,-122.184,2180,10800,4470,0.5944148936170213,9302500,56550400,47247900
450000.0,5,2.75,2710,6220,2.0,0,0,2,8,2710,0,2014,0.0,98038,47.3555,-122.061,2530,4759,3510,0.5643086816720257,7344100,38688400,31344300
455000.0,4,2.5,2090,4400,2.0,0,0,2,8,2090,0,2011,0.0,98118,47.5403,-122.286,2090,3430,2310,0.525,4368100,19360000,14991900
292500.0,3,2.5,1440,1068,2.0,0,0,2,8,1160,280,2006,0.0,98106,47.5393,-122.361,1580,1483,-372,-0.34831460674157305,2073600,1140624,-932976
650000.0,3,2.5,2500,51836,1.0,0,0,2,9,1510,0,2013,0.0,98027,47.4694,-121.98899999999999,2270,54450,49336,0.9517709699822517,6250000,2686970896,2680720896
530000.0,4,2.75,2740,7872,2.0,0,0,2,10,2740,0,2015,0.0,98056,47.4954,-122.17200000000001,1220,6300,5132,0.6519308943089431,7507600,61968384,54460784
829995.0,5,3.25,3360,6120,2.0,0,0,2,9,3360,0,2014,0.0,98074,47.607,-122.053,3230,5398,2760,0.45098039215686275,11289600,37454400,26164800
395000.0,4,2.75,2280,5013,2.0,0,0,2,8,2280,0,2009,0.0,98019,47.7333,-121.976,2130,5121,2733,0.5451825254338719,5198400,25130169,19931769
859990.0,4,2.75,3520,5500,2.0,0,0,2,9,3520,0,2014,0.0,98074,47.6181,-122.056,3340,5500,1980,0.36,12390400,30250000,17859600
342500.0,2,1.5,1320,826,2.0,0,0,2,8,1100,220,2008,0.0,98144,47.5879,-122.304,1340,1213,-494,-0.5980629539951574,1742400,682276,-1060124
743000.0,4,2.75,3410,5838,2.0,0,0,2,9,3410,0,2012,0.0,98053,47.6931,-122.022,3420,7048,2428,0.4158958547447756,11628100,34082244,22454144
345000.0,3,2.25,2730,9388,1.0,0,0,2,7,1390,1340,1975,0.0,98030,47.3785,-122.185,2255,5701,6658,0.7092032381763954,7452900,88134544,80681644
443000.0,3,2.5,1780,2778,2.0,0,0,2,8,1530,250,2007,0.0,98126,47.5487,-122.37200000000001,1380,1998,998,0.3592512598992081,3168400,7717284,4548884
260000.0,3,2.5,1427,4337,2.0,0,0,2,7,1427,0,2009,0.0,98042,47.3857,-122.162,1443,4347,2910,0.670970717085543,2036329,18809569,16773240
810000.0,4,2.5,2910,6555,2.0,0,0,2,9,2910,0,2005,0.0,98033,47.6659,-122.17200000000001,2910,10419,3645,0.5560640732265446,8468100,42968025,34499925
570000.0,4,2.75,3250,5600,2.0,0,0,2,8,3250,0,2011,0.0,98059,47.4806,-122.125,2730,5667,2350,0.41964285714285715,10562500,31360000,20797500
1560000.0,5,3.5,3630,8100,2.0,0,0,2,10,3630,0,2008,0.0,98004,47.5951,-122.2,1730,8246,4470,0.5518518518518518,13176900,65610000,52433100
840000.0,2,2.5,1680,975,3.0,0,0,2,9,1680,0,2009,0.0,98119,47.6321,-122.361,1680,977,-705,-0.7230769230769231,2822400,950625,-1871775
950000.0,3,2.5,2280,2296,3.0,0,0,2,9,1890,390,2013,0.0,98112,47.6256,-122.29899999999999,1390,4000,16,0.006968641114982578,5198400,5271616,73216
572800.0,3,2.5,3310,4682,2.0,0,0,2,9,2380,930,2015,0.0,98065,47.5201,-121.885,2660,5166,1372,0.29303716360529686,10956100,21921124,10965024
305000.0,3,3.0,1290,1112,3.0,0,0,2,7,1290,0,2008,0.0,98125,47.7282,-122.296,1230,9000,-178,-0.16007194244604317,1664100,1236544,-427556
1700000.0,5,4.75,3940,7067,2.0,0,0,2,10,3230,710,2008,0.0,98004,47.6232,-122.205,1910,7735,3127,0.4424791283430027,15523600,49942489,34418889
445000.0,4,2.5,2170,6000,2.0,0,0,2,7,1630,540,2008,0.0,98106,47.5589,-122.365,1720,5668,3830,0.6383333333333333,4708900,36000000,31291100
801000.0,4,3.5,3290,8059,2.0,0,0,2,9,3290,0,2012,0.0,98029,47.5573,-122.02,3290,10758,4769,0.5917607643628242,10824100,64947481,54123381
711000.0,3,2.5,2550,5376,2.0,0,0,2,9,2550,0,2004,0.0,98052,47.6647,-122.083,2250,4050,2826,0.5256696428571429,6502500,28901376,22398876
268500.0,3,2.25,1140,977,2.0,0,0,2,7,850,290,2008,0.0,98126,47.5439,-122.375,1140,976,-163,-0.1668372569089048,1299600,954529,-345071
320000.0,4,2.5,2300,3825,2.0,0,0,2,7,2300,0,2012,0.0,98042,47.3594,-122.08200000000001,2110,3825,1525,0.39869281045751637,5290000,14630625,9340625
500000.0,4,3.25,2670,5001,1.0,0,0,2,9,1640,1030,2013,0.0,98108,47.5666,-122.29299999999999,1610,5001,2331,0.46610677864427114,7128900,25010001,17881101
631625.0,4,2.5,2440,6651,2.0,0,0,2,9,2440,0,2014,0.0,98117,47.6971,-122.37100000000001,1350,7653,4211,0.6331378740039092,5953600,44235801,38282201
850000.0,2,2.5,1611,2210,2.0,0,2,2,10,1611,0,2005,0.0,98109,47.6291,-122.34700000000001,2070,2182,599,0.27104072398190043,2595321,4884100,2288779
600000.0,3,3.5,2710,3290,2.0,0,0,2,8,1650,1060,2006,0.0,98027,47.5367,-122.072,2440,3290,580,0.1762917933130699,7344100,10824100,3480000
988500.0,3,2.75,2015,16807,2.0,1,4,2,9,2015,0,2007,0.0,98166,47.45,-122.37700000000001,1780,12310,14792,0.8801094781936099,4060225,282475249,278415024
430236.0,4,3.25,3444,5166,2.0,0,0,2,8,2714,730,2014,0.0,98023,47.2966,-122.348,2848,5182,1722,0.3333333333333333,11861136,26687556,14826420
1270000.0,3,2.5,3060,9576,2.0,0,0,2,10,3060,0,2005,0.0,98004,47.5928,-122.199,3060,9579,6516,0.6804511278195489,9363600,91699776,82336176
689500.0,4,2.5,2050,2772,2.0,0,0,2,8,2050,0,2013,0.0,98029,47.5431,-122.01100000000001,1800,2886,722,0.26046176046176045,4202500,7683984,3481484
175003.0,3,1.5,1390,1882,2.0,0,0,2,7,1390,0,2014,0.0,98108,47.5667,-122.29700000000001,1490,2175,492,0.2614240170031881,1932100,3541924,1609824
459000.0,2,2.5,1240,1249,3.0,0,0,2,8,1240,0,2006,0.0,98107,47.6718,-122.38600000000001,1240,2500,9,0.007205764611689352,1537600,1560001,22401
1180000.0,4,3.25,3750,74052,2.0,0,0,2,10,3750,0,2013,0.0,98053,47.658,-122.006,4920,74052,70302,0.9493599092529574,14062500,5483698704,5469636204
358000.0,3,3.25,1410,1442,3.0,0,0,2,8,1360,50,2006,0.0,98125,47.7183,-122.31700000000001,1500,1200,32,0.022191400832177532,1988100,2079364,91264
447055.0,4,2.5,2448,4949,2.0,0,0,2,9,2448,0,2014,0.0,98030,47.3428,-122.179,2815,5446,2501,0.5053546170943625,5992704,24492601,18499897
415000.0,3,2.75,2600,64626,1.5,0,0,2,8,2600,0,2009,0.0,98014,47.7185,-121.405,1740,64626,62026,0.9597685142202829,6760000,4176519876,4169759876
1210000.0,4,3.25,3330,9000,2.0,0,0,2,9,2870,460,2004,0.0,98033,47.6836,-122.208,2550,6349,5670,0.63,11088900,81000000,69911100
495000.0,2,2.25,1160,1010,2.0,0,0,2,8,1000,160,2006,0.0,98112,47.6207,-122.301,1200,1170,-150,-0.1485148514851485,1345600,1020100,-325500
479000.0,2,2.25,1330,1380,2.0,0,0,2,8,1060,270,2005,0.0,98116,47.577,-122.41,1580,4802,50,0.036231884057971016,1768900,1904400,135500
1900000.0,3,2.5,2830,4334,3.0,1,4,2,10,2830,0,2006,0.0,98074,47.6318,-122.071,2830,38211,1504,0.34702353484079373,8008900,18783556,10774656
249900.0,3,2.5,1610,3517,2.0,0,0,2,8,1610,0,2005,0.0,98055,47.4496,-122.189,1830,2889,1907,0.5422234859255047,2592100,12369289,9777189
1470000.0,4,2.5,2800,4000,2.0,0,0,2,9,2800,0,2011,0.0,98103,47.6695,-122.339,1770,4200,1200,0.3,7840000,16000000,8160000
1040000.0,5,3.75,4570,10194,2.0,0,0,2,11,4570,0,2006,0.0,98034,47.718,-122.161,2040,7560,5624,0.5516970767117912,20884900,103917636,83032736
897000.0,4,2.5,2820,6120,2.0,0,0,2,9,2820,0,2014,0.0,98115,47.6911,-122.29299999999999,1510,6120,3300,0.5392156862745098,7952400,37454400,29502000
1100000.0,4,2.5,2570,9470,2.0,0,0,2,9,2570,0,2006,0.0,98033,47.6548,-122.19,2570,10663,6900,0.7286166842661035,6604900,89680900,83076000
685000.0,3,2.25,1710,1193,2.0,0,0,2,9,1140,570,2014,0.0,98122,47.6173,-122.31,1510,1193,-517,-0.4333612740989103,2924100,1423249,-1500851
295000.0,3,1.5,1220,3286,2.0,0,0,2,7,1220,0,1982,0.0,98033,47.7168,-122.189,1220,2640,2066,0.6287279367011565,1488400,10797796,9309396
619000.0,3,2.25,1650,946,3.0,0,0,2,8,1650,0,2014,0.0,98103,47.6536,-122.354,1570,1283,-704,-0.7441860465116279,2722500,894916,-1827584
439108.0,2,1.5,1130,1340,2.0,0,0,2,8,910,220,2008,0.0,98116,47.5761,-122.41,1310,1340,210,0.15671641791044777,1276900,1795600,518700
260000.0,3,2.25,1489,2800,2.0,0,0,2,7,1489,0,2011,0.0,98002,47.3452,-122.215,1584,3200,1311,0.4682142857142857,2217121,7840000,5622879
279000.0,5,2.5,2690,5557,2.0,0,0,2,7,2690,0,2012,0.0,98178,47.4914,-122.25299999999999,2090,10500,2867,0.5159258592765881,7236100,30880249,23644149
380000.0,3,2.25,1530,1305,2.0,0,0,2,7,1116,414,2007,0.0,98177,47.7034,-122.35700000000001,1320,1427,-225,-0.1724137931034483,2340900,1703025,-637875
287000.0,3,2.5,1600,6315,2.0,0,0,2,8,1600,0,2013,0.0,98092,47.2611,-122.198,1608,4300,4715,0.7466349960411718,2560000,39879225,37319225
377000.0,2,1.5,1000,1251,2.0,0,0,2,7,930,70,2006,0.0,98199,47.6529,-122.384,1420,1187,251,0.2006394884092726,1000000,1565001,565001
649950.0,4,3.5,2440,3012,3.0,0,1,2,8,2440,0,2005,0.0,98117,47.6923,-122.39200000000001,1860,4650,572,0.1899070385126162,5953600,9072144,3118544
445000.0,3,2.5,1260,1102,3.0,0,0,2,8,1260,0,2007,0.0,98107,47.675,-122.387,1320,2500,-158,-0.14337568058076225,1587600,1214404,-373196
605000.0,3,2.5,1660,1692,3.0,0,0,2,7,1610,50,2005,0.0,98115,47.6801,-122.322,1210,1230,32,0.018912529550827423,2755600,2862864,107264
475000.0,3,2.25,1190,1137,2.0,0,0,2,7,960,230,1999,0.0,98115,47.677,-122.325,1190,1080,-53,-0.04661389621811785,1416100,1292769,-123331
399000.0,3,3.0,1520,1884,3.0,0,0,2,8,1520,0,2009,0.0,98125,47.7176,-122.28399999999999,1360,1939,364,0.1932059447983015,2310400,3549456,1239056
718000.0,5,2.75,3250,8100,2.0,0,0,2,8,3250,0,2014,0.0,98125,47.7133,-122.311,1270,8100,4850,0.5987654320987654,10562500,65610000,55047500
1400000.0,4,3.25,4700,9160,1.0,0,0,2,11,2520,2180,2005,0.0,98116,47.5744,-122.406,2240,8700,4460,0.4868995633187773,22090000,83905600,61815600
341000.0,3,2.5,1480,1663,2.0,0,0,2,9,1180,300,2012,0.0,98126,47.5443,-122.375,1380,1537,183,0.1100420926037282,2190400,2765569,575169
818000.0,2,2.5,2380,9374,1.0,0,2,2,8,2380,0,2011,0.0,98053,47.7095,-122.01899999999999,1610,5000,6994,0.7461062513334755,5664400,87871876,82207476
759000.0,3,2.25,1640,1873,3.0,0,0,2,8,1640,0,2014,0.0,98112,47.6196,-122.29700000000001,1640,3920,233,0.12439935931660438,2689600,3508129,818529
547500.0,3,3.5,1650,2262,3.0,0,0,2,8,1650,0,2010,0.0,98103,47.6823,-122.34700000000001,1620,3166,612,0.27055702917771884,2722500,5116644,2394144
2700000.0,5,4.75,5305,8401,2.0,0,2,2,11,3745,1560,2005,0.0,98033,47.6864,-122.215,2960,7200,3096,0.36852755624330436,28143025,70576801,42433776
358000.0,2,2.5,1278,987,2.0,0,0,2,7,1002,276,2007,0.0,98136,47.5532,-122.381,1220,1287,-291,-0.2948328267477204,1633284,974169,-659115
412000.0,3,2.5,1200,813,3.0,0,0,2,9,1200,0,2010,0.0,98144,47.5894,-122.315,1750,4365,-387,-0.47601476014760147,1440000,660969,-779031
245000.0,2,1.5,690,1058,2.0,0,0,2,7,690,0,2005,0.0,98103,47.6951,-122.34299999999999,690,1058,368,0.34782608695652173,476100,1119364,643264
460940.0,4,2.5,3202,4964,2.0,0,0,2,9,3202,0,2014,0.0,98030,47.3412,-122.179,2425,4886,1762,0.35495568090249796,10252804,24641296,14388492
321000.0,3,2.25,1347,1292,3.0,0,0,2,7,1347,0,2010,0.0,98125,47.7306,-122.291,1480,1865,-55,-0.04256965944272446,1814409,1669264,-145145
633634.0,4,3.5,2960,6000,2.0,0,0,2,9,2960,0,2014,0.0,98065,47.5183,-121.88600000000001,2960,6000,3040,0.5066666666666667,8761600,36000000,27238400
290000.0,1,0.75,740,1284,1.0,0,0,3,6,740,0,1928,0.0,98107,47.6741,-122.406,1430,3988,544,0.4236760124610592,547600,1648656,1101056
445000.0,2,2.25,1200,1137,3.0,0,0,2,7,1200,0,2007,0.0,98107,47.6715,-122.39200000000001,1280,1295,-63,-0.055408970976253295,1440000,1292769,-147231
887250.0,5,3.5,4320,7502,2.0,0,0,2,9,3500,820,2012,0.0,98056,47.5235,-122.16799999999999,3250,7538,3182,0.4241535590509198,18662400,56280004,37617604
739000.0,3,2.5,2310,7348,1.0,0,3,2,8,2310,0,2010,0.0,98053,47.7116,-122.01899999999999,2310,7153,5038,0.6856287425149701,5336100,53993104,48657004
429900.0,3,2.0,1490,1286,3.0,0,0,2,8,1490,0,2014,0.0,98144,47.57,-122.288,1420,1230,-204,-0.15863141524105753,2220100,1653796,-566304
459000.0,3,2.0,1480,800,2.0,0,0,2,8,1000,480,2014,0.0,98136,47.5492,-122.387,1480,886,-680,-0.85,2190400,640000,-1550400
240000.0,3,2.25,1481,2820,2.0,0,0,2,7,1481,0,2012,0.0,98002,47.3457,-122.21700000000001,1481,3028,1339,0.474822695035461,2193361,7952400,5759039
566950.0,3,3.0,1730,1902,3.0,0,0,2,8,1730,0,2014,0.0,98117,47.6944,-122.37700000000001,1830,1804,172,0.0904311251314406,2992900,3617604,624704
1040000.0,4,3.5,3900,8391,2.0,0,0,2,10,3900,0,2006,0.0,98033,47.6979,-122.205,3820,12268,4491,0.5352163031819807,15210000,70408881,55198881
343000.0,3,3.5,1130,1449,3.0,0,0,2,7,1130,0,2005,0.0,98103,47.6968,-122.348,1130,1200,319,0.22015182884748102,1276900,2099601,822701
572115.0,4,3.25,3230,4838,2.0,0,0,2,9,3230,0,2014,0.0,98038,47.3559,-122.023,2980,5094,1608,0.33236874741628775,10432900,23406244,12973344
918000.0,5,3.5,3920,5150,2.0,0,0,2,9,2820,1100,2004,0.0,98052,47.6638,-122.084,3170,5530,1230,0.23883495145631067,15366400,26522500,11156100
555000.0,2,1.5,1190,1361,2.0,0,0,2,8,1190,0,2007,0.0,98122,47.6161,-122.302,1280,3360,171,0.12564290962527552,1416100,1852321,436221
399440.0,4,2.5,2311,4396,2.0,0,0,2,9,2311,0,2014,0.0,98092,47.3276,-122.163,2458,4616,2085,0.474294813466788,5340721,19324816,13984095
450000.0,3,2.5,1810,914,3.0,0,0,2,8,1380,430,2008,0.0,98116,47.5732,-122.387,1810,914,-896,-0.9803063457330415,3276100,835396,-2440704
648000.0,4,2.5,3290,6203,2.0,0,0,2,9,3290,0,2008,0.0,98065,47.5441,-121.86,2990,6835,2913,0.4696114783169434,10824100,38477209,27653109
580000.0,4,2.5,3250,5000,2.0,0,0,2,8,3250,0,2008,0.0,98059,47.4988,-122.148,3230,5507,1750,0.35,10562500,25000000,14437500
415000.0,4,2.5,2544,4071,2.0,0,0,2,9,2544,0,2013,0.0,98030,47.341,-122.179,2358,4179,1527,0.3750921149594694,6471936,16573041,10101105
527500.0,3,2.5,1380,1389,3.0,0,0,2,8,1380,0,2008,0.0,98102,47.6427,-122.32700000000001,1380,1249,9,0.0064794816414686825,1904400,1929321,24921
384000.0,3,2.25,1430,800,2.0,0,0,2,8,1140,290,2011,0.0,98136,47.5477,-122.38799999999999,1430,1387,-630,-0.7875,2044900,640000,-1404900
692000.0,3,2.5,3490,28213,1.5,0,2,2,9,2242,1248,2009,0.0,98070,47.365,-122.456,2120,56628,24723,0.8762981604225003,12180100,795973369,783793269
455000.0,2,1.5,910,966,2.0,0,0,2,8,820,90,2006,0.0,98119,47.626999999999995,-122.361,2740,6400,56,0.057971014492753624,828100,933156,105056
1280000.0,4,3.25,3080,4120,2.0,0,0,2,9,2380,700,2014,0.0,98117,47.6845,-122.359,1410,4120,1040,0.2524271844660194,9486400,16974400,7488000
415000.0,3,2.5,2280,6031,2.0,0,0,2,8,2280,0,2011,0.0,98019,47.7322,-121.96600000000001,2430,7200,3751,0.6219532415851434,5198400,36372961,31174561
975000.0,3,2.5,1660,1344,3.0,0,0,2,8,1660,0,2008,0.0,98102,47.644,-122.32700000000001,1750,2040,-316,-0.23511904761904762,2755600,1806336,-949264
799950.0,4,2.5,3320,7429,2.0,0,0,2,9,3320,0,2014,0.0,98034,47.7189,-122.225,1840,7429,4109,0.5531027056131377,11022400,55190041,44167641
545000.0,5,4.0,1680,7268,1.0,0,0,2,8,1370,310,2008,0.0,98106,47.5571,-122.35600000000001,2040,8259,5588,0.7688497523390203,2822400,52823824,50001424
429900.0,4,3.5,2584,5005,2.0,0,0,2,8,2584,0,2014,0.0,98023,47.29600000000001,-122.35,2767,5201,2421,0.4837162837162837,6677056,25050025,18372969
275000.0,3,2.5,2217,8019,2.0,0,0,2,7,2217,0,2009,0.0,98001,47.2776,-122.251,1470,8037,5802,0.7235316124205013,4915089,64304361,59389272
498000.0,3,2.5,2480,4136,2.0,0,0,2,8,2480,0,2009,0.0,98059,47.493,-122.147,2510,4314,1656,0.40038684719535783,6150400,17106496,10956096
754950.0,3,2.5,2610,7256,2.0,0,0,2,9,2610,0,2014,0.0,98033,47.695,-122.18,2610,7206,4646,0.6402976846747519,6812100,52649536,45837436
895000.0,4,3.0,3240,5562,2.0,0,0,2,10,3240,0,2013,0.0,98075,47.5919,-121.975,3380,5562,2322,0.4174757281553398,10497600,30935844,20438244
580000.0,4,3.25,3569,8327,2.0,0,0,2,10,3569,0,2013,0.0,98055,47.4595,-122.208,2550,5251,4758,0.5713942596373244,12737761,69338929,56601168
379900.0,4,2.5,3181,5831,2.0,0,0,2,8,3181,0,2014,0.0,98003,47.2716,-122.29700000000001,2056,24393,2650,0.45446750128622876,10118761,34000561,23881800
245000.0,4,2.5,1921,4888,2.0,0,0,2,7,1921,0,2009,0.0,98001,47.2689,-122.24,1921,9140,2967,0.6069967266775778,3690241,23892544,20202303
417000.0,3,2.5,1570,4926,2.0,0,0,2,8,1570,0,2014,0.0,98065,47.5342,-121.84200000000001,1800,3202,3356,0.681282988225741,2464900,24265476,21800576
555000.0,3,2.5,1940,3211,2.0,0,0,2,8,1940,0,2009,0.0,98027,47.5644,-122.09299999999999,1880,3078,1271,0.39582684521955774,3763600,10310521,6546921
555000.0,3,2.5,1940,3211,2.0,0,0,2,8,1940,0,2009,0.0,98027,47.5644,-122.09299999999999,1880,3078,1271,0.39582684521955774,3763600,10310521,6546921
353000.0,4,2.5,2210,13721,2.0,0,0,2,8,2210,0,2009,0.0,98042,47.3122,-122.039,1850,12951,11511,0.8389330223744625,4884100,188265841,183381741
539000.0,3,2.25,1280,1187,2.0,0,0,2,8,1080,200,2008,0.0,98107,47.6651,-122.368,1280,1681,-93,-0.07834877843302443,1638400,1408969,-229431
434900.0,3,2.0,1520,5040,2.0,0,0,2,7,1520,0,1977,2006.0,98177,47.777,-122.36200000000001,1860,8710,3520,0.6984126984126984,2310400,25401600,23091200
325000.0,2,2.25,1230,1078,2.0,0,0,2,7,1160,70,2008,0.0,98027,47.5324,-122.073,1240,817,-152,-0.14100185528756956,1512900,1162084,-350816
650000.0,3,2.5,1480,2159,3.0,0,0,2,8,1480,0,2007,0.0,98103,47.6533,-122.34100000000001,1480,1554,679,0.3144974525243168,2190400,4661281,2470881
379950.0,4,2.5,2612,5850,2.0,0,0,2,8,2612,0,2014,0.0,98030,47.3751,-122.189,2419,8984,3238,0.5535042735042736,6822544,34222500,27399956
700000.0,3,2.5,2350,4975,2.0,0,0,2,8,2350,0,2012,0.0,98029,47.5418,-122.01,2350,3951,2625,0.5276381909547738,5522500,24750625,19228125
675000.0,3,2.5,1300,1590,2.0,0,0,2,8,1100,200,2014,0.0,98109,47.6384,-122.34299999999999,1070,1223,290,0.18238993710691823,1690000,2528100,838100
379000.0,4,1.5,2020,7560,1.0,0,0,3,7,2020,0,1960,0.0,98059,47.501999999999995,-122.146,1410,8080,5540,0.7328042328042328,4080400,57153600,53073200
571000.0,3,2.5,2140,2867,2.0,0,0,2,8,1960,180,2005,0.0,98027,47.5357,-122.073,2280,2836,727,0.2535751656784095,4579600,8219689,3640089
475000.0,3,2.25,1380,1621,2.0,0,0,2,8,1140,240,2007,0.0,98117,47.678000000000004,-122.375,1460,1403,241,0.148673658235657,1904400,2627641,723241
769900.0,4,3.5,2730,3047,2.0,0,0,2,8,2400,330,2006,0.0,98116,47.5797,-122.391,1980,4600,317,0.10403675746636036,7452900,9284209,1831309
633000.0,4,3.5,4220,5817,2.0,0,0,2,9,2910,1310,2006,0.0,98065,47.5392,-121.86200000000001,4290,6637,1597,0.27454014096613377,17808400,33837489,16029089
635000.0,3,2.5,1570,1433,3.0,0,0,2,8,1570,0,2010,0.0,98103,47.6858,-122.336,1570,2652,-137,-0.09560362875087229,2464900,2053489,-411411
1240000.0,4,3.5,4670,6000,2.0,0,3,2,11,3820,850,2007,0.0,98027,47.5414,-121.994,4310,6000,1330,0.22166666666666668,21808900,36000000,14191100
524000.0,3,2.25,1370,1007,3.0,0,0,2,8,1330,40,2009,0.0,98107,47.6682,-122.361,1570,1635,-363,-0.36047666335650447,1876900,1014049,-862851
485000.0,4,3.5,3273,5115,2.0,0,0,2,8,2671,602,2014,0.0,98055,47.4477,-122.204,2996,5100,1842,0.3601173020527859,10712529,26163225,15450696
1030000.0,3,4.0,3880,13095,2.0,0,3,2,11,3700,180,2009,0.0,98034,47.6996,-122.23299999999999,3880,10830,9215,0.7037037037037037,15054400,171479025,156424625
650000.0,3,3.5,1494,1262,3.0,0,0,2,8,1494,0,2011,0.0,98115,47.6826,-122.324,1494,1264,-232,-0.1838351822503962,2232036,1592644,-639392
754842.0,3,2.5,2930,5641,2.0,0,0,2,8,2930,0,2013,0.0,98052,47.71,-122.113,3300,5641,2711,0.4805885481297642,8584900,31820881,23235981
428900.0,4,2.5,2598,5553,2.0,0,0,2,9,2598,0,2014,0.0,98092,47.3412,-122.178,2502,4900,2955,0.5321447866018368,6749604,30835809,24086205
329900.0,3,2.5,2242,4995,2.0,0,0,2,8,2242,0,2011,0.0,98092,47.2595,-122.20200000000001,1798,4942,2753,0.5511511511511511,5026564,24950025,19923461
1040000.0,4,2.5,2830,5932,2.0,0,0,2,9,2830,0,2014,0.0,98199,47.6479,-122.40799999999999,2840,5593,3102,0.5229265003371544,8008900,35188624,27179724
544999.0,4,2.5,2710,6937,2.0,0,0,2,7,2710,0,2009,0.0,98065,47.5153,-121.87100000000001,2380,5866,4227,0.6093412137811735,7344100,48121969,40777869
449950.0,4,2.75,2320,4344,2.0,0,0,2,8,2320,0,2012,0.0,98059,47.4862,-122.163,2310,3770,2024,0.46593001841620624,5382400,18870336,13487936
635000.0,4,2.5,2720,7991,2.0,0,0,2,9,2720,0,2006,0.0,98133,47.7168,-122.331,1590,8611,5271,0.6596170692028532,7398400,63856081,56457681
599000.0,3,1.75,1650,1180,3.0,0,0,2,8,1650,0,2014,0.0,98105,47.6638,-122.319,1650,1960,-470,-0.3983050847457627,2722500,1392400,-1330100
478000.0,3,3.25,1430,1348,2.0,0,0,2,8,1160,270,2008,0.0,98107,47.6743,-122.374,1160,1265,-82,-0.06083086053412463,2044900,1817104,-227796
388000.0,4,2.5,2090,5040,2.0,0,0,2,9,2090,0,2014,0.0,98055,47.4797,-122.23,1430,12000,2950,0.5853174603174603,4368100,25401600,21033500
809950.0,4,3.5,3660,4903,2.0,0,0,2,9,2760,900,2014,0.0,98034,47.7184,-122.156,3630,4992,1243,0.2535182541301244,13395600,24039409,10643809
1060000.0,4,3.5,4220,8417,3.0,0,0,2,10,4220,0,2012,0.0,98075,47.5869,-122.054,3730,8435,4197,0.49863371747653557,17808400,70845889,53037489
659000.0,2,2.5,1450,1213,2.0,0,0,2,9,1110,340,2015,0.0,98107,47.6692,-122.37200000000001,1620,1456,-237,-0.1953833470733718,2102500,1471369,-631131
971971.0,4,3.75,3460,6738,2.0,0,0,2,11,3460,0,2013,0.0,98059,47.506,-122.145,3340,6120,3278,0.4864945087563075,11971600,45400644,33429044
389000.0,3,2.5,1350,874,3.0,0,0,2,8,1270,80,2006,0.0,98136,47.5491,-122.387,1350,886,-476,-0.5446224256292906,1822500,763876,-1058624
355000.0,4,2.75,3000,5470,2.0,0,0,2,8,3000,0,2005,0.0,98038,47.3613,-122.038,2420,4891,2470,0.4515539305301645,9000000,29920900,20920900
551500.0,4,2.5,2950,10003,2.0,0,0,2,9,2950,0,2006,0.0,98059,47.489,-122.14,2790,9323,7053,0.7050884734579627,8702500,100060009,91357509
417838.0,4,2.5,2530,5048,2.0,0,0,2,8,2530,0,2014,0.0,98038,47.3559,-122.06299999999999,2530,4359,2518,0.49881141045958793,6400900,25482304,19081404
1750000.0,4,4.5,4650,7660,2.0,0,0,2,11,3640,1010,2008,0.0,98004,47.6349,-122.198,1710,8400,3010,0.39295039164490864,21622500,58675600,37053100
399950.0,2,1.0,710,1131,2.0,0,0,3,7,710,0,1943,0.0,98102,47.6413,-122.329,1370,1173,421,0.372236958443855,504100,1279161,775061
740000.0,4,2.5,3050,8000,2.0,0,0,2,9,3050,0,2007,0.0,98028,47.7465,-122.23100000000001,1910,8000,4950,0.61875,9302500,64000000,54697500
335000.0,3,2.5,1150,683,2.0,0,0,2,7,1150,0,2013,0.0,98027,47.5323,-122.071,1150,755,-467,-0.6837481698389458,1322500,466489,-856011
2250000.0,5,5.25,3410,8118,2.0,0,0,2,11,3410,0,2006,0.0,98039,47.6295,-122.236,3410,16236,4708,0.5799457994579946,11628100,65901924,54273824
667000.0,3,1.75,1370,1921,3.0,0,0,2,8,1370,0,2007,0.0,98103,47.6595,-122.351,1370,4000,551,0.2868297761582509,1876900,3690241,1813341
920000.0,4,2.5,3540,7009,2.0,0,0,2,9,3540,0,2007,0.0,98033,47.6749,-122.176,2150,10290,3469,0.4949350834641176,12531600,49126081,36594481
368000.0,3,2.5,1370,1350,2.0,0,0,2,7,1010,360,2007,0.0,98136,47.5534,-122.382,1450,6000,-20,-0.014814814814814815,1876900,1822500,-54400
307000.0,4,2.5,1714,3080,2.0,0,0,2,8,1714,0,2009,0.0,98055,47.428999999999995,-122.18799999999999,1714,3250,1366,0.4435064935064935,2937796,9486400,6548604
550000.0,4,2.75,3650,4534,2.0,0,0,2,7,2940,710,2014,0.0,98028,47.7397,-122.22399999999999,2400,7682,884,0.19497132774591971,13322500,20557156,7234656
594491.0,4,2.5,2990,6037,2.0,0,0,2,9,2990,0,2013,0.0,98045,47.4766,-121.735,2990,5992,3047,0.5047208878582077,8940100,36445369,27505269
460458.0,4,2.5,3284,6516,2.0,0,0,2,8,3284,0,2014,0.0,98092,47.3393,-122.181,2555,5008,3232,0.4960098219766728,10784656,42458256,31673600
859000.0,4,2.25,3550,13900,1.0,0,0,2,8,1830,1720,2010,0.0,98006,47.5681,-122.12700000000001,2770,12200,10350,0.7446043165467626,12602500,193210000,180607500
399950.0,3,3.0,1860,2875,2.0,0,0,2,8,1710,150,2009,0.0,98126,47.5511,-122.37299999999999,1350,4830,1015,0.35304347826086957,3459600,8265625,4806025
547500.0,3,3.25,1720,1977,2.0,0,0,2,8,1360,360,2007,0.0,98122,47.6127,-122.29899999999999,1720,3420,257,0.12999494183105717,2958400,3908529,950129
310000.0,3,2.5,2540,4775,2.0,0,0,2,7,2540,0,2006,0.0,98042,47.3341,-122.052,2270,5000,2235,0.4680628272251309,6451600,22800625,16349025
939000.0,4,2.75,3270,12880,2.0,0,0,2,9,3270,0,2014,0.0,98033,47.6679,-122.17200000000001,2420,7505,9610,0.7461180124223602,10692900,165894400,155201500
329900.0,2,2.5,980,1021,3.0,0,0,2,8,980,0,2008,0.0,98117,47.6844,-122.387,980,1023,41,0.040156709108716944,960400,1042441,82041
436000.0,3,2.5,1150,1193,2.0,0,0,2,8,1020,130,2006,0.0,98107,47.6684,-122.365,1450,1640,43,0.03604358759430008,1322500,1423249,100749
320000.0,3,2.5,1820,1855,2.0,0,0,2,8,1570,250,2008,0.0,98166,47.4643,-122.346,1470,6900,35,0.018867924528301886,3312400,3441025,128625
375000.0,3,2.5,1580,3825,2.0,0,0,2,8,1580,0,2011,0.0,98126,47.5458,-122.369,1380,1500,2245,0.5869281045751634,2496400,14630625,12134225
392137.0,3,2.0,1460,3696,2.0,0,0,2,7,1460,0,2010,0.0,98053,47.6861,-122.01299999999999,1720,3631,2236,0.604978354978355,2131600,13660416,11528816
520000.0,4,2.5,2900,4950,2.0,0,0,2,8,2900,0,2004,0.0,98028,47.7717,-122.236,2590,4950,2050,0.41414141414141414,8410000,24502500,16092500
535000.0,5,2.75,2620,6389,2.0,0,0,2,9,2620,0,2007,0.0,98028,47.77,-122.236,2620,4504,3769,0.5899201753012991,6864400,40819321,33954921
407000.0,2,2.5,1340,999,2.0,0,0,2,8,940,400,2008,0.0,98116,47.5655,-122.38600000000001,1470,1436,-341,-0.34134134134134136,1795600,998001,-797599
424950.0,4,3.25,3266,5398,2.0,0,0,2,8,3266,0,2014,0.0,98023,47.2975,-122.35,3087,5152,2132,0.3949610967024824,10666756,29138404,18471648
290000.0,2,1.5,1076,1060,3.0,0,0,2,7,1076,0,2006,0.0,98125,47.7167,-122.29799999999999,1076,1060,-16,-0.01509433962264151,1157776,1123600,-34176
399000.0,3,3.25,1680,1478,2.0,0,0,2,8,1360,320,2009,0.0,98126,47.5674,-122.369,1530,2753,-202,-0.13667117726657646,2822400,2184484,-637916
439990.0,3,2.5,1930,1348,2.0,0,0,2,8,1300,630,2005,0.0,98199,47.6513,-122.384,1630,6000,-582,-0.4317507418397626,3724900,1817104,-1907796
635000.0,4,2.5,2880,3091,2.0,0,0,2,9,1940,940,2014,0.0,98144,47.5711,-122.286,1560,4080,211,0.0682626981559366,8294400,9554281,1259881
635000.0,4,2.25,2240,5000,2.0,0,0,2,8,2240,0,2013,0.0,98074,47.6212,-122.05799999999999,1760,7500,2760,0.552,5017600,25000000,19982400
351000.0,3,2.5,2594,4455,2.0,0,0,2,8,2594,0,2012,0.0,98001,47.3054,-122.27600000000001,2981,4950,1861,0.4177328843995511,6728836,19847025,13118189
437500.0,2,1.5,1210,1232,3.0,0,0,2,8,1210,0,2007,0.0,98107,47.6712,-122.39,1330,1174,22,0.017857142857142856,1464100,1517824,53724
919204.0,4,3.5,3760,5000,2.0,0,0,2,9,2860,900,2014,0.0,98117,47.6826,-122.39399999999999,1340,5000,1240,0.248,14137600,25000000,10862400
923990.0,4,2.5,3600,6055,2.0,0,0,2,9,3600,0,2014,0.0,98052,47.7053,-122.126,3590,6050,2455,0.40545004128819156,12960000,36663025,23703025
639888.0,4,2.5,2050,2772,2.0,0,0,2,8,2050,0,2012,0.0,98029,47.5421,-122.01100000000001,2050,2934,722,0.26046176046176045,4202500,7683984,3481484
675000.0,3,3.25,1510,2064,2.0,0,0,2,8,1220,290,2008,0.0,98109,47.6398,-122.345,1670,2594,554,0.26841085271317827,2280100,4260096,1979996
899900.0,4,2.5,2580,3909,2.0,0,0,2,8,2580,0,2013,0.0,98033,47.6852,-122.21,1820,5772,1329,0.3399846508058327,6656400,15280281,8623881
252000.0,3,2.5,1670,4020,2.0,0,0,2,7,1670,0,2009,0.0,98118,47.53,-122.26799999999999,1670,4020,2350,0.5845771144278606,2788900,16160400,13371500
925000.0,4,2.5,3190,10034,2.0,0,0,2,9,3190,0,2007,0.0,98052,47.6379,-122.111,2110,9300,6844,0.6820809248554913,10176100,100681156,90505056
552000.0,3,2.5,1280,1920,3.0,0,0,2,8,1280,0,2009,0.0,98105,47.6621,-122.324,1450,1900,640,0.3333333333333333,1638400,3686400,2048000
388500.0,4,2.5,2718,6197,2.0,0,0,2,8,2718,0,2006,0.0,98092,47.3255,-122.164,2667,5000,3479,0.5614006777472971,7387524,38402809,31015285
548000.0,2,2.0,1370,1878,3.0,0,0,2,8,1370,0,2004,0.0,98107,47.6721,-122.387,1280,1878,508,0.27050053248136313,1876900,3526884,1649984
254950.0,3,2.5,1794,4769,2.0,0,0,2,7,1794,0,2005,0.0,98001,47.3052,-122.28299999999999,3557,4807,2975,0.6238205074439086,3218436,22743361,19524925
1240000.0,4,4.5,5120,41327,2.0,0,0,2,10,3290,1830,2008,0.0,98053,47.7009,-122.059,3360,82764,36207,0.8761100491204298,26214400,1707920929,1681706529
629000.0,3,2.5,2160,1912,2.0,0,0,2,9,1970,190,2014,0.0,98118,47.5642,-122.292,1810,2653,-248,-0.1297071129707113,4665600,3655744,-1009856
734000.0,4,2.5,2180,7204,2.0,0,0,2,8,2180,0,2014,0.0,98133,47.7221,-122.352,1500,7650,5024,0.6973903387007219,4752400,51897616,47145216
309000.0,3,2.25,1490,1294,2.0,0,0,2,7,1220,270,2010,0.0,98106,47.5569,-122.363,1490,1283,-196,-0.15146831530139104,2220100,1674436,-545664
554950.0,3,2.5,2950,10254,2.0,0,0,2,9,2950,0,2006,0.0,98059,47.4888,-122.14,2800,9323,7304,0.7123073922371758,8702500,105144516,96442016
785000.0,3,2.75,2990,207781,2.0,0,0,2,9,2990,0,2000,0.0,98014,47.662,-121.944,2590,218671,204791,0.9856098488312214,8940100,43172943961,43164003861
550000.0,4,2.5,2700,5150,2.0,0,0,2,9,2700,0,2007,0.0,98059,47.5071,-122.148,3160,7620,2450,0.47572815533980584,7290000,26522500,19232500
1010000.0,4,3.5,3130,5000,3.0,0,0,2,10,3130,0,2014,0.0,98116,47.5656,-122.40299999999999,1950,5152,1870,0.374,9796900,25000000,15203100
1580000.0,3,2.0,3620,14250,2.0,0,0,2,8,3220,400,2007,0.0,98040,47.5767,-122.225,2370,14250,10630,0.7459649122807017,13104400,203062500,189958100
309000.0,5,2.75,2481,4045,2.0,0,0,2,8,2481,0,2014,0.0,98001,47.2602,-122.28399999999999,2363,4175,1564,0.38665018541409146,6155361,16362025,10206664
328423.0,3,2.5,1730,3600,2.0,0,0,2,8,1730,0,2014,0.0,98146,47.5019,-122.34,2030,3600,1870,0.5194444444444445,2992900,12960000,9967100
345000.0,3,1.5,1420,1192,2.0,0,0,2,8,1140,280,2008,0.0,98144,47.5881,-122.304,1340,1213,-228,-0.1912751677852349,2016400,1420864,-595536
660000.0,5,3.5,3160,5175,2.0,0,0,2,9,3160,0,2014,0.0,98011,47.755,-122.21600000000001,2100,9351,2015,0.3893719806763285,9985600,26780625,16795025
385000.0,3,3.25,1320,1327,2.0,0,0,2,8,1040,280,2008,0.0,98199,47.6506,-122.383,1440,1263,7,0.0052750565184626974,1742400,1760929,18529
459000.0,2,2.25,1010,1107,2.0,0,0,2,8,710,300,2006,0.0,98119,47.6363,-122.37100000000001,1140,1531,97,0.08762420957542909,1020100,1225449,205349
248000.0,3,2.5,1870,4046,2.0,0,0,2,7,1870,0,2007,0.0,98042,47.342,-122.059,2130,4800,2176,0.5378151260504201,3496900,16370116,12873216
1480000.0,4,3.5,5220,15411,2.0,0,3,2,11,3550,1670,2006,0.0,98075,47.592,-122.085,3110,14124,10191,0.6612809032509247,27248400,237498921,210250521
379000.0,4,2.5,2260,5824,2.0,0,0,2,8,2260,0,2011,0.0,98038,47.3496,-122.042,2240,5561,3564,0.6119505494505495,5107600,33918976,28811376
2950000.0,5,4.5,4340,5722,3.0,0,4,2,10,4340,0,2010,0.0,98107,47.6715,-122.406,1770,5250,1382,0.24152394267738553,18835600,32741284,13905684
395000.0,2,2.25,1620,1841,2.0,0,0,2,8,1540,80,2004,0.0,98029,47.5483,-122.00399999999999,1530,1831,221,0.1200434546442151,2624400,3389281,764881
535000.0,3,2.5,2280,2289,2.0,0,0,2,8,1880,400,2006,0.0,98027,47.5375,-122.073,2280,2425,9,0.003931847968545216,5198400,5239521,41121
970000.0,5,3.5,3400,9804,2.0,0,0,2,9,2550,850,2008,0.0,98118,47.543,-122.266,2380,7440,6404,0.6532027743778049,11560000,96118416,84558416
205000.0,2,1.5,830,1020,2.0,0,0,2,7,830,0,2006,0.0,98106,47.5604,-122.363,830,1379,190,0.18627450980392157,688900,1040400,351500
310000.0,4,2.5,2310,7384,2.0,0,0,2,8,2310,0,2010,0.0,98042,47.3737,-122.165,2310,7800,5074,0.6871614301191766,5336100,54523456,49187356
334500.0,2,1.5,830,1858,2.0,0,0,2,7,830,0,2005,0.0,98144,47.5828,-122.314,1480,3030,1028,0.5532831001076426,688900,3452164,2763264
995000.0,5,3.25,4130,7197,2.0,0,0,2,10,4130,0,2012,0.0,98074,47.6022,-122.06,3730,7202,3067,0.42614978463248576,17056900,51796809,34739909
370228.0,4,3.0,2050,4000,2.0,0,0,2,8,2050,0,2014,0.0,98001,47.3525,-122.275,2050,4000,1950,0.4875,4202500,16000000,11797500
383000.0,4,2.5,2050,4953,2.0,0,0,2,9,2050,0,2014,0.0,98038,47.3448,-122.024,2340,6175,2903,0.5861094286291136,4202500,24532209,20329709
384500.0,3,2.5,1600,2610,2.0,0,0,2,8,1600,0,2005,0.0,98027,47.5344,-122.068,1445,1288,1010,0.38697318007662834,2560000,6812100,4252100
865000.0,5,2.5,3190,8160,2.0,0,0,2,9,3190,0,2014,0.0,98177,47.7246,-122.363,1650,8160,4970,0.6090686274509803,10176100,66585600,56409500
1050000.0,4,3.75,3860,5474,2.5,0,0,2,10,3860,0,2007,0.0,98029,47.5396,-121.995,3040,5474,1614,0.2948483741322616,14899600,29964676,15065076
502000.0,4,2.5,2040,5616,2.0,0,0,2,8,2040,0,2012,0.0,98028,47.7737,-122.238,2380,4737,3576,0.6367521367521367,4161600,31539456,27377856
1750000.0,4,3.5,3845,8400,2.0,0,0,2,10,3845,0,2013,0.0,98004,47.6354,-122.198,1710,8400,4555,0.5422619047619047,14784025,70560000,55775975
569995.0,4,2.5,2650,6875,2.0,0,0,2,8,2650,0,2014,0.0,98059,47.479,-122.124,2650,5831,4225,0.6145454545454545,7022500,47265625,40243125
749950.0,4,2.5,3430,64441,2.0,0,0,2,8,3430,0,2013,0.0,98077,47.7694,-122.064,3580,64441,61011,0.9467730171785044,11764900,4152642481,4140877581
550000.0,3,2.5,2430,5400,2.0,0,0,2,8,2430,0,2007,0.0,98074,47.6062,-122.057,2640,11990,2970,0.55,5904900,29160000,23255100
525000.0,3,3.5,2876,5086,2.0,0,0,2,8,2360,516,2007,0.0,98072,47.7511,-122.17299999999999,2390,4419,2210,0.43452615021628,8271376,25867396,17596020
516000.0,4,3.5,2550,8698,2.0,0,0,2,7,2550,0,2007,0.0,98065,47.5216,-121.869,2430,5519,6148,0.7068291561278455,6502500,75655204,69152704
1350000.0,4,3.75,4100,61419,2.0,0,0,2,9,4100,0,2014,0.0,98029,47.5626,-122.005,2010,32362,57319,0.933245412657321,16810000,3772293561,3755483561
440000.0,4,2.5,2730,4526,2.0,0,0,2,7,2730,0,2009,0.0,98059,47.49100000000001,-122.15299999999999,2190,4572,1796,0.39681838267786124,7452900,20484676,13031776
660000.0,3,2.5,1780,1729,2.0,0,0,2,8,1080,700,2008,0.0,98103,47.6594,-122.355,1780,1741,-51,-0.029496818970503182,3168400,2989441,-178959
261950.0,3,2.5,1880,5000,2.0,0,0,2,7,1880,0,2010,0.0,98042,47.3359,-122.054,2260,5000,3120,0.624,3534400,25000000,21465600
551000.0,5,3.75,3090,4943,2.0,0,0,2,10,3090,0,2010,0.0,98058,47.4594,-122.133,3191,5561,1853,0.37487355856767146,9548100,24433249,14885149
665000.0,3,3.5,2460,14155,2.0,0,0,2,8,1900,560,2014,0.0,98155,47.7743,-122.279,2440,14080,11695,0.8262098198516425,6051600,200364025,194312425
610000.0,4,3.5,2910,5260,2.0,0,0,2,9,2910,0,2012,0.0,98065,47.5168,-121.883,2910,5260,2350,0.4467680608365019,8468100,27667600,19199500
645000.0,4,3.5,2910,5260,2.0,0,0,2,9,2910,0,2012,0.0,98065,47.5168,-121.883,2910,5260,2350,0.4467680608365019,8468100,27667600,19199500
536751.0,3,1.75,1930,6360,1.0,0,0,2,9,1930,0,2013,0.0,98065,47.5181,-121.885,2770,6373,4430,0.6965408805031447,3724900,40449600,36724700
260000.0,3,2.25,1413,3403,2.0,0,0,2,8,1413,0,2009,0.0,98031,47.4196,-122.193,1763,3719,1990,0.5847781369379959,1996569,11580409,9583840
1310000.0,3,3.25,4030,6300,2.0,0,0,2,10,3630,400,2006,0.0,98105,47.6664,-122.27600000000001,1660,6300,2270,0.3603174603174603,16240900,39690000,23449100
429900.0,4,3.25,2880,5929,2.5,0,0,2,8,2880,0,2014,0.0,98023,47.2752,-122.34899999999999,2880,5846,3049,0.5142519817844493,8294400,35153041,26858641
535000.0,4,2.75,2360,15100,1.0,0,0,2,8,2360,0,2014,0.0,98146,47.5117,-122.365,1440,13346,12740,0.8437086092715231,5569600,228010000,222440400
462550.0,2,1.75,1070,1276,3.0,0,0,2,8,1070,0,2006,0.0,98107,47.6719,-122.39,1290,2057,206,0.1614420062695925,1144900,1628176,483276
602000.0,3,3.25,1460,1367,3.0,0,0,2,8,1460,0,2008,0.0,98103,47.6485,-122.334,1310,1191,-93,-0.06803218727139722,2131600,1868689,-262911
730000.0,4,2.75,3800,9606,2.0,0,0,2,9,3800,0,2008,0.0,98011,47.7368,-122.208,3400,9677,5806,0.6044139079741828,14440000,92275236,77835236
300500.0,2,1.5,1190,801,3.0,0,0,2,8,1190,0,2010,0.0,98106,47.5212,-122.35799999999999,1190,810,-389,-0.48564294631710364,1416100,641601,-774499
675000.0,5,2.5,3200,6455,2.0,0,0,2,9,3200,0,2009,0.0,98065,47.5446,-121.86200000000001,3290,7924,3255,0.5042602633617351,10240000,41667025,31427025
415000.0,3,2.25,1970,2377,2.0,0,0,2,8,1680,290,2008,0.0,98108,47.5631,-122.29700000000001,1690,1936,407,0.17122423222549432,3880900,5650129,1769229
614000.0,3,2.5,2830,5831,2.0,0,0,2,9,2830,0,2010,0.0,98011,47.7744,-122.22399999999999,2830,6064,3001,0.514663008060367,8008900,34000561,25991661
385000.0,4,2.5,2630,5701,2.0,0,0,2,7,2630,0,2010,0.0,98042,47.375,-122.16,2770,5939,3071,0.5386774250131556,6916900,32501401,25584501
594000.0,4,2.75,2720,4613,2.0,0,0,2,9,2720,0,2005,0.0,98028,47.7352,-122.223,2830,4836,1893,0.4103620203771949,7398400,21279769,13881369
860000.0,4,2.75,3160,8097,2.0,0,0,2,9,3160,0,2014,0.0,98033,47.6709,-122.166,2200,8097,4937,0.6097319995059899,9985600,65561409,55575809
1100000.0,4,4.0,3770,8899,2.0,0,0,2,10,2940,830,2006,0.0,98074,47.6476,-122.079,3300,8308,5129,0.5763568940330375,14212900,79192201,64979301
775000.0,4,2.75,3500,6226,2.0,0,0,2,9,3500,0,2004,0.0,98053,47.6846,-122.045,3480,7222,2726,0.43784131063283005,12250000,38763076,26513076
430760.0,5,2.75,2710,4685,2.0,0,0,2,8,2710,0,2014,0.0,98038,47.3555,-122.06200000000001,2710,4449,1975,0.4215581643543223,7344100,21949225,14605125
755000.0,2,2.5,2170,6361,1.0,0,2,2,8,2170,0,2009,0.0,98053,47.7109,-122.01700000000001,2310,7419,4191,0.6588586700204371,4708900,40462321,35753421
640000.0,2,2.25,1540,958,3.0,0,0,2,9,1540,0,2007,0.0,98122,47.6179,-122.318,1410,958,-582,-0.6075156576200418,2371600,917764,-1453836
613500.0,3,3.25,1876,1531,3.0,0,0,2,9,1876,0,2009,0.0,98115,47.6864,-122.265,1876,1533,-345,-0.22534291312867408,3519376,2343961,-1175415
780000.0,4,3.5,3720,213073,1.0,0,2,2,10,3720,0,2007,0.0,98010,47.3216,-121.94,2190,59241,209353,0.9825411948017816,13838400,45400103329,45386264929
550000.0,4,2.5,3148,9612,2.0,0,3,2,9,3148,0,2014,0.0,98198,47.3994,-122.311,3000,11475,6464,0.6724927174365377,9909904,92390544,82480640
789500.0,4,3.25,3240,4852,2.0,0,0,2,9,3240,0,2010,0.0,98053,47.695,-122.022,3320,5318,1612,0.3322341302555647,10497600,23541904,13044304
592000.0,5,3.5,3340,5000,2.0,0,0,2,8,2580,760,2012,0.0,98065,47.5168,-121.87100000000001,3420,5000,1660,0.332,11155600,25000000,13844400
454950.0,4,2.5,2413,5701,2.0,0,0,2,8,2413,0,2014,0.0,98042,47.3731,-122.15899999999999,2380,5725,3288,0.57674092264515,5822569,32501401,26678832
475000.0,4,2.5,2500,4500,2.0,0,0,2,7,2500,0,2010,0.0,98059,47.4928,-122.149,2230,4500,2000,0.4444444444444444,6250000,20250000,14000000
659000.0,2,1.75,1180,904,2.0,0,0,2,10,780,400,2014,0.0,98102,47.6396,-122.329,1380,3610,-276,-0.3053097345132743,1392400,817216,-575184
570000.0,4,2.5,2890,5801,2.0,0,0,2,9,2890,0,2005,0.0,98028,47.7349,-122.238,2890,6286,2911,0.5018100327529736,8352100,33651601,25299501
347500.0,5,3.0,2230,6551,1.0,0,0,2,7,1330,900,2014,0.0,98168,47.486999999999995,-122.32,2230,9476,4321,0.6595939551213555,4972900,42915601,37942701
205000.0,4,2.5,1767,4500,2.0,0,0,2,8,1767,0,2006,0.0,98001,47.2607,-122.25,1949,4636,2733,0.6073333333333333,3122289,20250000,17127711
380000.0,3,3.25,1450,1468,2.0,0,0,2,8,1100,350,2009,0.0,98126,47.5664,-122.37,1450,1478,18,0.01226158038147139,2102500,2155024,52524
718000.0,5,2.75,2930,7663,2.0,0,0,2,9,2930,0,2013,0.0,98056,47.5308,-122.184,2750,10335,4733,0.6176432206707556,8584900,58721569,50136669
515805.0,5,2.75,2710,4136,2.0,0,0,2,8,2710,0,2014,0.0,98059,47.4786,-122.12299999999999,2590,4136,1426,0.34477756286266925,7344100,17106496,9762396
1030000.0,4,3.25,3600,18645,2.0,0,1,2,10,3000,600,2013,0.0,98059,47.5294,-122.154,3970,10957,15045,0.8069187449718423,12960000,347636025,334676025
437718.0,3,2.5,1800,3265,2.0,0,0,2,8,1800,0,2014,0.0,98065,47.5338,-121.84100000000001,1800,3663,1465,0.44869831546707506,3240000,10660225,7420225
450000.0,4,2.5,2290,5515,2.0,0,0,2,8,2290,0,2006,0.0,98106,47.5518,-122.35700000000001,1380,5515,3225,0.5847688123300091,5244100,30415225,25171125
515000.0,3,2.5,1510,1178,2.0,0,0,2,8,1060,450,2007,0.0,98122,47.6181,-122.301,1510,1210,-332,-0.28183361629881154,2280100,1387684,-892416
204000.0,2,2.5,1090,13444,2.0,0,0,2,7,1090,0,2007,0.0,98198,47.4166,-122.319,1380,6000,12354,0.9189229396013091,1188100,180741136,179553036
360000.0,3,2.0,1270,1323,3.0,0,0,2,8,1270,0,2006,0.0,98103,47.6934,-122.34200000000001,1330,1323,53,0.0400604686318972,1612900,1750329,137429
550000.0,3,2.25,1540,1005,3.0,0,0,2,8,1540,0,2008,0.0,98103,47.6827,-122.346,1510,1501,-535,-0.5323383084577115,2371600,1010025,-1361575
650880.0,3,2.5,2930,6050,2.0,0,0,2,9,2930,0,2008,0.0,98065,47.5151,-121.883,2760,5765,3120,0.515702479338843,8584900,36602500,28017600
1790000.0,5,3.75,4360,8504,2.0,0,4,2,10,3530,830,2014,0.0,98033,47.6936,-122.19,2680,9000,4144,0.4873000940733772,19009600,72318016,53308416
895900.0,4,3.5,3640,4983,2.0,0,3,2,9,2790,850,2014,0.0,98075,47.5619,-122.027,3270,14700,1343,0.26951635560907083,13249600,24830289,11580689
585000.0,4,2.5,2430,4747,2.0,0,0,2,8,2430,0,2008,0.0,98027,47.5285,-122.031,1930,7200,2317,0.48809774594480726,5904900,22534009,16629109
380000.0,3,2.25,1520,1464,2.0,0,0,2,8,1240,280,2010,0.0,98126,47.543,-122.375,1710,1464,-56,-0.03825136612021858,2310400,2143296,-167104
565997.0,5,2.75,2730,5820,2.0,0,0,2,8,2730,0,2014,0.0,98059,47.4856,-122.154,2730,5700,3090,0.5309278350515464,7452900,33872400,26419500
459000.0,3,3.0,2440,2076,2.0,0,0,2,8,1930,510,2006,0.0,98126,47.5476,-122.37,2440,2310,-364,-0.17533718689788053,5953600,4309776,-1643824
550000.0,3,3.75,1580,1303,2.0,0,0,2,8,1340,240,2010,0.0,98144,47.5875,-122.315,1560,1294,-277,-0.21258633921719108,2496400,1697809,-798591
500000.0,3,2.25,1420,983,3.0,0,0,2,8,1420,0,2006,0.0,98103,47.6533,-122.346,1530,1280,-437,-0.44455747711088506,2016400,966289,-1050111
461500.0,5,3.25,2820,3275,2.0,0,0,2,8,2230,590,2006,0.0,98118,47.5339,-122.28399999999999,2610,3275,455,0.13893129770992366,7952400,10725625,2773225
2150000.0,4,5.5,5060,10320,2.0,0,0,2,11,5060,0,2008,0.0,98004,47.6245,-122.21,3010,10080,5260,0.5096899224806202,25603600,106502400,80898800
790000.0,4,2.5,2650,5000,2.0,0,0,2,8,2650,0,2007,0.0,98116,47.5605,-122.396,1110,6250,2350,0.47,7022500,25000000,17977500
735000.0,3,2.25,1490,1212,2.0,0,0,2,9,1040,450,2011,0.0,98112,47.6226,-122.31299999999999,1490,1337,-278,-0.22937293729372937,2220100,1468944,-751156
588000.0,4,2.5,3060,7710,2.0,0,0,2,9,3060,0,2009,0.0,98059,47.4828,-122.13600000000001,3040,7840,4650,0.603112840466926,9363600,59444100,50080500
724500.0,3,3.25,3240,4185,2.0,0,0,2,8,2770,470,2011,0.0,98075,47.5794,-122.03,2660,4692,945,0.22580645161290322,10497600,17514225,7016625
749000.0,3,2.75,2820,5348,2.0,0,0,2,9,2820,0,2008,0.0,98052,47.7073,-122.118,3140,5640,2528,0.47270007479431564,7952400,28601104,20648704
720000.0,5,3.5,4140,7642,2.0,0,0,2,8,4140,0,2003,0.0,98075,47.591,-122.008,3330,6953,3502,0.45825700078513476,17139600,58400164,41260564
250000.0,2,1.5,982,846,2.0,0,0,2,8,806,176,2006,0.0,98133,47.7034,-122.345,1010,3844,-136,-0.1607565011820331,964324,715716,-248608
790000.0,3,2.75,2460,3600,2.0,0,0,2,9,2460,0,2007,0.0,98029,47.5409,-121.994,2570,3600,1140,0.31666666666666665,6051600,12960000,6908400
392440.0,4,2.5,2547,4800,2.0,0,0,2,9,2547,0,2014,0.0,98092,47.2592,-122.194,2598,4800,2253,0.469375,6487209,23040000,16552791
280000.0,4,2.25,1834,7460,2.0,0,0,2,8,1834,0,2012,0.0,98042,47.3568,-122.163,1979,9008,5626,0.7541554959785522,3363556,55651600,52288044
1330000.0,4,4.5,3130,5126,3.0,0,0,2,10,2450,680,2014,0.0,98112,47.6239,-122.29,2540,7784,1996,0.389387436597737,9796900,26275876,16478976
649000.0,4,2.5,2730,4847,2.0,0,0,2,9,2730,0,2008,0.0,98126,47.549,-122.374,1250,4840,2117,0.43676500928409323,7452900,23493409,16040509
457000.0,2,2.5,1380,1329,2.0,0,0,2,8,1050,330,2008,0.0,98117,47.6903,-122.37,1360,3750,-51,-0.03837471783295711,1904400,1766241,-138159
2230000.0,4,4.25,4700,10800,2.0,0,1,2,11,3910,790,2002,0.0,98033,47.6882,-122.214,2370,7680,6100,0.5648148148148148,22090000,116640000,94550000
453000.0,3,3.0,2330,4284,2.0,0,0,2,9,1920,410,2004,0.0,98108,47.5547,-122.30799999999999,2330,3709,1954,0.4561157796451914,5428900,18352656,12923756
329780.0,3,2.5,1730,3600,2.0,0,0,2,8,1730,0,2014,0.0,98146,47.5014,-122.34,2030,3600,1870,0.5194444444444445,2992900,12960000,9967100
1050000.0,2,2.5,2350,2390,3.0,0,2,2,10,2000,350,2007,0.0,98144,47.5999,-122.286,1950,2390,40,0.016736401673640166,5522500,5712100,189600
771005.0,5,4.5,4000,6713,2.0,0,0,2,9,4000,0,2015,0.0,98024,47.5254,-121.88600000000001,3690,6600,2713,0.4041412185312081,16000000,45064369,29064369
1300000.0,3,2.5,3350,7752,1.0,0,0,2,9,2180,1170,2009,0.0,98008,47.6263,-122.09899999999999,2570,7988,4402,0.5678534571723426,11222500,60093504,48871004
607500.0,3,3.25,1530,1612,3.0,0,0,2,8,1530,0,2006,0.0,98107,47.6706,-122.37799999999999,1530,1611,82,0.05086848635235732,2340900,2598544,257644
278000.0,2,2.25,1610,1968,2.0,0,0,3,7,1610,0,1979,0.0,98056,47.5184,-122.196,1950,1968,358,0.18191056910569106,2592100,3873024,1280924
475000.0,4,2.75,2620,6178,2.0,0,0,2,8,2620,0,2013,0.0,98045,47.4823,-121.771,2790,6538,3558,0.5759145354483651,6864400,38167684,31303284
270000.0,3,2.0,1300,1920,2.0,0,0,2,8,850,450,2006,0.0,98126,47.5183,-122.376,1300,1344,620,0.3229166666666667,1690000,3686400,1996400
1300000.0,4,3.5,3590,5334,2.0,0,2,2,9,3140,450,2006,0.0,98115,47.6763,-122.26700000000001,2100,6250,1744,0.3269591301087364,12888100,28451556,15563456
778983.0,4,2.5,2490,5647,2.0,0,0,2,8,2490,0,2014,0.0,98052,47.7043,-122.11399999999999,2970,5450,3157,0.5590579068531963,6200100,31888609,25688509
221000.0,3,2.5,1320,1780,2.0,0,0,2,7,880,440,2005,0.0,98118,47.528,-122.26899999999999,3040,6000,460,0.25842696629213485,1742400,3168400,1426000
338800.0,4,2.25,1800,2752,2.0,0,0,2,8,1800,0,2014,0.0,98106,47.5165,-122.346,1800,2752,952,0.34593023255813954,3240000,7573504,4333504
834995.0,5,1.5,3360,5225,2.0,0,0,2,9,3360,0,2014,0.0,98074,47.6072,-122.053,3230,5368,1865,0.3569377990430622,11289600,27300625,16011025
550000.0,4,2.5,3220,9328,2.0,0,0,2,8,3220,0,2006,0.0,98019,47.7273,-121.958,3020,9300,6108,0.6548027444253859,10368400,87011584,76643184
575000.0,3,3.5,2514,1559,2.0,0,0,2,8,2024,490,2007,0.0,98034,47.7044,-122.209,2090,10454,-955,-0.6125721616420783,6320196,2430481,-3889715
649000.0,4,2.75,3130,9711,2.0,0,0,2,9,3130,0,2014,0.0,98059,47.4823,-122.124,1570,10500,6581,0.6776850993718464,9796900,94303521,84506621
545000.0,4,2.5,2720,4738,2.0,0,0,2,8,2720,0,2012,0.0,98065,47.515,-121.869,2590,5740,2018,0.42591810890671167,7398400,22448644,15050244
625000.0,2,2.25,1390,916,2.0,0,0,2,8,1165,225,2007,0.0,98122,47.6168,-122.314,1415,1488,-474,-0.517467248908297,1932100,839056,-1093044
1040000.0,4,4.5,4920,270236,2.0,0,3,2,10,3820,1100,2006,0.0,98045,47.4695,-121.775,4920,260924,265316,0.9817936914400746,24206400,73027495696,73003289296
611000.0,3,2.5,2134,1984,2.5,0,0,2,8,2134,0,2008,0.0,98027,47.5402,-122.027,2170,1984,-150,-0.07560483870967742,4553956,3936256,-617700
300000.0,3,2.5,1741,5701,2.0,0,0,2,8,1741,0,2012,0.0,98030,47.379,-122.184,2002,5700,3960,0.6946149798281004,3031081,32501401,29470320
577000.0,3,2.5,2560,5238,2.0,0,0,2,8,2560,0,2001,0.0,98053,47.6887,-122.04,2560,5185,2678,0.5112638411607484,6553600,27436644,20883044
349990.0,4,2.5,2220,3561,2.0,0,0,2,8,2220,0,2014,0.0,98038,47.3561,-122.06299999999999,2530,4449,1341,0.37657961246840777,4928400,12680721,7752321
650000.0,3,2.5,1910,4363,2.0,0,0,2,9,1910,0,2006,0.0,98029,47.5482,-121.99600000000001,1890,3732,2453,0.56222782489113,3648100,19035769,15387669
378000.0,2,1.5,980,853,2.0,0,0,2,7,820,160,2009,0.0,98144,47.5925,-122.295,1130,1270,-127,-0.1488862837045721,960400,727609,-232791
313200.0,3,2.5,1950,4197,2.0,0,0,2,7,1950,0,2013,0.0,98042,47.3613,-122.081,2300,4178,2247,0.5353824160114368,3802500,17614809,13812309
1210000.0,5,4.25,4150,12015,2.0,0,0,2,10,4150,0,2014,0.0,98075,47.5816,-122.021,3230,27520,7865,0.6545984186433624,17222500,144360225,127137725
252500.0,2,1.5,1110,986,2.0,0,0,2,7,950,160,2009,0.0,98118,47.5427,-122.272,1110,3515,-124,-0.1257606490872211,1232100,972196,-259904
308000.0,3,2.5,1250,1150,2.0,0,0,2,8,1080,170,2009,0.0,98106,47.5582,-122.363,1250,1150,-100,-0.08695652173913043,1562500,1322500,-240000
803100.0,4,2.5,3310,5404,2.0,0,0,2,9,3310,0,2004,0.0,98052,47.6635,-122.083,2600,4730,2094,0.3874907475943745,10956100,29203216,18247116
415000.0,4,2.5,2020,5501,2.0,0,0,2,7,2020,0,2010,0.0,98059,47.4937,-122.15,2020,5494,3481,0.6327940374477368,4080400,30261001,26180601
785000.0,4,3.5,3310,4850,2.0,0,0,2,9,3310,0,2010,0.0,98053,47.6954,-122.022,3320,5955,1540,0.31752577319587627,10956100,23522500,12566400
499950.0,4,2.5,2798,4473,2.0,0,0,2,9,2798,0,2012,0.0,98055,47.4295,-122.205,2358,4593,1675,0.37446903644086743,7828804,20007729,12178925
216000.0,4,2.5,1847,8000,2.0,0,0,2,7,1847,0,2008,0.0,98001,47.2874,-122.257,1767,8000,6153,0.769125,3411409,64000000,60588591
380000.0,4,2.5,2420,4981,2.0,0,0,2,9,2420,0,2009,0.0,98038,47.3785,-122.023,2420,5000,2561,0.5141537843806464,5856400,24810361,18953961
345000.0,4,2.5,2020,3600,2.0,0,0,2,7,2020,0,2012,0.0,98038,47.3535,-122.01700000000001,2210,3800,1580,0.4388888888888889,4080400,12960000,8879600
456500.0,4,2.5,2400,6811,2.0,0,0,2,8,2400,0,2007,0.0,98059,47.4959,-122.15,2710,5314,4411,0.6476288357069446,5760000,46389721,40629721
382495.0,3,2.5,1760,5390,1.0,0,0,2,8,1760,0,2014,0.0,98038,47.3482,-122.042,2310,5117,3630,0.673469387755102,3097600,29052100,25954500
324950.0,4,2.5,2110,4178,2.0,0,0,2,7,2110,0,2013,0.0,98042,47.3612,-122.081,2300,4142,2068,0.49497367161321204,4452100,17455684,13003584
436472.0,4,2.5,2692,8392,2.0,0,0,2,9,2692,0,2014,0.0,98030,47.3519,-122.197,2574,14446,5700,0.6792183031458532,7246864,70425664,63178800
365250.0,3,2.25,1490,4522,2.0,0,0,2,7,1490,0,2009,0.0,98028,47.7611,-122.23299999999999,1580,4667,3032,0.670499778858912,2220100,20448484,18228384
919990.0,5,3.25,3960,6352,2.0,0,0,2,10,3960,0,2014,0.0,98075,47.5806,-122.055,2930,9875,2392,0.3765743073047859,15681600,40347904,24666304
316475.0,4,2.5,1740,4642,2.0,0,0,2,7,1740,0,2012,0.0,98042,47.3686,-122.117,1950,4642,2902,0.6251615682895304,3027600,21548164,18520564
425000.0,4,2.5,1940,4517,1.0,0,0,2,8,1190,750,2010,0.0,98028,47.776,-122.26,1910,10410,2577,0.5705114013725924,3763600,20403289,16639689
302860.0,2,1.0,970,3279,2.0,0,0,2,7,790,180,2007,0.0,98136,47.5469,-122.383,1150,1351,2309,0.7041781030802073,940900,10751841,9810941
298000.0,3,2.5,1852,4000,2.0,0,0,2,7,1852,0,2014,0.0,98002,47.3455,-122.21,2166,4000,2148,0.537,3429904,16000000,12570096
3200000.0,4,4.0,4810,18851,2.0,0,3,2,11,4810,0,2007,0.0,98004,47.6364,-122.214,3970,19929,14041,0.7448411224868707,23136100,355360201,332224101
950000.0,4,4.0,5635,9695,2.0,0,3,2,10,4360,1275,2011,0.0,98003,47.3389,-122.334,3726,9765,4060,0.4187725631768953,31753225,93993025,62239800
333000.0,3,2.5,1520,3041,2.0,0,0,2,7,1520,0,2009,0.0,98059,47.4874,-122.152,1820,3229,1521,0.5001644195988162,2310400,9247681,6937281
289950.0,3,2.5,2099,4275,2.0,0,0,2,7,2099,0,2010,0.0,98002,47.3521,-122.211,2099,4275,2176,0.5090058479532164,4405801,18275625,13869824
419950.0,3,2.25,1250,811,3.0,0,0,2,8,1250,0,2014,0.0,98136,47.5419,-122.38799999999999,1250,1232,-439,-0.5413070283600493,1562500,657721,-904779
306000.0,2,1.5,1090,1183,3.0,0,0,2,8,1090,0,2008,0.0,98103,47.6974,-122.34899999999999,1110,1384,93,0.07861369399830938,1188100,1399489,211389
498445.0,4,2.5,3216,5902,2.0,0,0,2,9,3216,0,2014,0.0,98030,47.3425,-122.179,2815,4916,2686,0.455099966113182,10342656,34833604,24490948
775950.0,4,2.5,2970,4400,2.0,0,0,2,8,2970,0,2014,0.0,98052,47.705,-122.11399999999999,3010,4892,1430,0.325,8820900,19360000,10539100
605000.0,3,2.5,2610,6405,2.0,0,0,2,8,2610,0,2001,0.0,98065,47.5373,-121.874,2580,6285,3795,0.5925058548009368,6812100,41024025,34211925
520000.0,2,1.75,1340,1368,2.0,0,0,2,7,1060,280,2006,0.0,98122,47.618,-122.311,2480,1707,28,0.02046783625730994,1795600,1871424,75824
849990.0,4,2.75,3300,4987,2.0,0,0,2,9,3300,0,2014,0.0,98074,47.6175,-122.056,3520,5453,1687,0.33827952676960094,10890000,24870169,13980169
767450.0,3,2.0,1630,7599,1.0,0,0,2,10,1630,0,2006,0.0,98117,47.6981,-122.376,2030,7599,5969,0.7854980918541914,2656900,57744801,55087901
665000.0,3,2.25,1590,929,2.0,0,0,2,9,1060,530,2014,0.0,98122,47.6172,-122.31,1510,1193,-661,-0.7115177610333692,2528100,863041,-1665059
525000.0,2,2.75,1310,1268,3.5,0,0,2,8,1310,0,2007,0.0,98103,47.6534,-122.355,1350,1288,-42,-0.033123028391167195,1716100,1607824,-108276
870515.0,4,3.5,3600,5697,2.0,0,0,2,9,2940,660,2014,0.0,98075,47.5755,-122.071,3490,5911,2097,0.36808846761453395,12960000,32455809,19495809
390000.0,4,2.5,2154,4153,2.0,0,0,2,9,2154,0,2012,0.0,98058,47.4557,-122.13,2154,4091,1999,0.48133879123525164,4639716,17247409,12607693
500000.0,3,1.75,1530,825,3.0,0,0,2,8,1530,0,2015,0.0,98144,47.5929,-122.30799999999999,1580,1915,-705,-0.8545454545454545,2340900,680625,-1660275
399950.0,3,2.25,1360,1041,2.0,0,0,2,8,1094,266,2006,0.0,98117,47.6925,-122.375,1522,1382,-319,-0.30643611911623436,1849600,1083681,-765919
305000.0,3,2.5,1320,2480,2.0,0,0,2,7,1320,0,2005,0.0,98118,47.536,-122.28399999999999,1320,3240,1160,0.46774193548387094,1742400,6150400,4408000
255000.0,4,2.5,1660,6724,2.0,0,0,2,7,1660,0,2009,0.0,98001,47.25899999999999,-122.256,1544,6054,5064,0.7531231409875074,2755600,45212176,42456576
415000.0,4,2.5,2891,6499,2.0,0,0,2,9,2891,0,2014,0.0,98001,47.3359,-122.257,2550,8383,3608,0.5551623326665641,8357881,42237001,33879120
716500.0,3,2.5,2340,2155,2.0,0,0,2,10,2120,220,2012,0.0,98027,47.53,-122.073,2640,2680,-185,-0.08584686774941995,5475600,4644025,-831575
425000.0,3,2.5,2320,2267,3.0,0,0,2,8,2320,0,2009,0.0,98177,47.7027,-122.359,1240,1883,-53,-0.02337891486546096,5382400,5139289,-243111
540000.0,4,2.5,2190,3855,2.0,0,0,2,8,2190,0,2010,0.0,98011,47.7705,-122.169,2190,3600,1665,0.43190661478599224,4796100,14861025,10064925
324747.0,3,2.5,2060,4742,2.0,0,0,2,8,2060,0,2014,0.0,98038,47.3706,-122.01700000000001,2370,4725,2682,0.5655841417123576,4243600,22486564,18242964
385000.0,3,2.5,1740,4145,2.0,0,0,2,7,1740,0,2010,0.0,98053,47.6875,-122.015,1740,4045,2405,0.5802171290711701,3027600,17181025,14153425
270000.0,3,2.25,1400,3825,2.0,0,0,2,7,1400,0,2012,0.0,98042,47.3596,-122.08200000000001,2110,3825,2425,0.6339869281045751,1960000,14630625,12670625
1240000.0,5,4.0,4410,14380,2.0,0,0,2,11,4410,0,2006,0.0,98052,47.6463,-122.12100000000001,2720,11454,9970,0.6933240611961057,19448100,206784400,187336300
672000.0,3,2.5,1780,1647,2.0,0,0,2,8,1080,700,2008,0.0,98103,47.6597,-122.355,2000,1741,-133,-0.08075288403157256,3168400,2712609,-455791
310000.0,3,2.5,1760,10137,2.0,0,0,2,8,1760,0,2010,0.0,98038,47.355,-122.059,2000,6935,8377,0.8263786130018743,3097600,102758769,99661169
3000000.0,3,3.5,4410,10756,2.0,1,4,2,11,3430,980,2014,0.0,98056,47.5283,-122.205,3550,5634,6346,0.5899962811454073,19448100,115691536,96243436
2350000.0,6,4.25,5550,11547,2.0,0,2,2,11,4270,1280,2014,0.0,98033,47.6547,-122.20200000000001,3480,11547,5997,0.5193556767991686,30802500,133333209,102530709
427000.0,3,2.5,2432,9391,2.0,0,2,2,9,2432,0,2005,0.0,98001,47.3453,-122.26700000000001,2912,8932,6959,0.7410286444468108,5914624,88190881,82276257
389950.0,3,2.5,2283,3996,2.0,0,0,2,8,2283,0,2008,0.0,98031,47.4221,-122.19200000000001,1760,3992,1713,0.4286786786786787,5212089,15968016,10755927
309620.0,3,2.5,1860,3730,2.0,0,0,2,8,1860,0,2012,0.0,98019,47.7442,-121.984,2110,4509,1870,0.5013404825737265,3459600,13912900,10453300
399895.0,4,2.5,2701,4500,2.0,0,0,2,9,2701,0,2014,0.0,98092,47.2586,-122.194,2570,4800,1799,0.3997777777777778,7295401,20250000,12954599
442515.0,4,2.5,2930,4875,2.0,0,0,2,9,2930,0,2014,0.0,98030,47.3421,-122.179,2815,4900,1945,0.39897435897435896,8584900,23765625,15180725
375000.0,3,2.25,1540,1561,3.0,0,0,2,8,1540,0,2010,0.0,98103,47.6991,-122.346,1540,1547,21,0.013452914798206279,2371600,2436721,65121
309780.0,3,2.5,2242,4500,2.0,0,0,2,8,2242,0,2014,0.0,98092,47.2583,-122.198,2009,4500,2258,0.5017777777777778,5026564,20250000,15223436
425000.0,3,2.5,1950,4345,2.0,0,0,2,7,1950,0,2007,0.0,98065,47.5202,-121.87299999999999,2260,4345,2395,0.5512082853855006,3802500,18879025,15076525
405000.0,2,3.0,1160,1073,2.0,0,0,2,7,880,280,2007,0.0,98144,47.5788,-122.315,1250,4812,-87,-0.08108108108108109,1345600,1151329,-194271
356250.0,3,2.5,2060,5115,2.0,0,0,2,9,2060,0,2014,0.0,98092,47.3261,-122.163,2648,4500,3055,0.5972629521016618,4243600,26163225,21919625
550000.0,3,2.25,1230,875,3.0,0,0,2,8,1230,0,2013,0.0,98199,47.6521,-122.4,1760,5664,-355,-0.4057142857142857,1512900,765625,-747275
340000.0,2,1.5,1160,1438,2.0,0,0,2,7,1160,0,2001,0.0,98144,47.5917,-122.295,1220,1740,278,0.1933240611961057,1345600,2067844,722244
362865.0,4,2.5,2245,4301,2.0,0,0,2,8,2245,0,2014,0.0,98038,47.3555,-122.06299999999999,2530,4478,2056,0.4780283654963962,5040025,18498601,13458576
1360000.0,4,3.5,4120,12626,2.0,0,1,2,11,3970,150,2014,0.0,98034,47.7089,-122.245,4120,11913,8506,0.6736892127356249,16974400,159415876,142441476
830000.0,4,2.5,3400,9692,2.0,0,0,2,9,3400,0,2007,0.0,98052,47.708,-122.109,3070,7375,6292,0.6491952125464301,11560000,93934864,82374864
1600000.0,5,3.75,4270,7500,2.0,0,0,2,10,3210,1060,2014,0.0,98033,47.6845,-122.20700000000001,2410,8350,3230,0.43066666666666664,18232900,56250000,38017100
855000.0,4,3.5,2890,5911,2.0,0,0,2,9,2370,520,2014,0.0,98075,47.5754,-122.071,3490,6093,3021,0.5110810353578075,8352100,34939921,26587821
1210000.0,5,3.5,3220,8000,2.0,0,0,2,9,2900,320,2008,0.0,98033,47.6834,-122.2,2100,9680,4780,0.5975,10368400,64000000,53631600
1390000.0,4,3.5,4010,15365,2.0,0,1,2,11,4010,0,2006,0.0,98027,47.5528,-122.09299999999999,3550,13429,11355,0.7390172469899121,16080100,236083225,220003125
400200.0,4,3.5,2260,30250,2.0,0,0,2,7,2260,0,2013,0.0,98188,47.4493,-122.281,1270,16350,27990,0.9252892561983471,5107600,915062500,909954900
235000.0,2,1.0,1140,1730,1.5,0,0,2,8,1010,130,2007,0.0,98126,47.5494,-122.37200000000001,1360,1730,590,0.34104046242774566,1299600,2992900,1693300
349950.0,3,2.0,1640,4714,1.0,0,0,2,8,1640,0,2009,0.0,98038,47.3539,-122.021,1770,4802,3074,0.6521001272804412,2689600,22221796,19532196
659950.0,4,2.75,3510,9400,2.0,0,0,2,9,3510,0,2014,0.0,98059,47.4827,-122.131,3550,9429,5890,0.6265957446808511,12320100,88360000,76039900
785000.0,3,2.75,3010,1842,2.0,0,0,2,9,3010,0,2011,0.0,98075,47.5836,-121.994,2950,4200,-1168,-0.6340933767643865,9060100,3392964,-5667136
475000.0,2,2.25,1060,925,2.0,0,0,2,8,980,80,2006,0.0,98199,47.6386,-122.38799999999999,1020,4000,-135,-0.14594594594594595,1123600,855625,-267975
263900.0,3,2.5,1658,2700,2.0,0,0,2,8,1658,0,2014,0.0,98198,47.3667,-122.307,1658,2700,1042,0.38592592592592595,2748964,7290000,4541036
342000.0,3,2.5,1960,3540,2.0,0,0,2,8,1960,0,2012,0.0,98038,47.3568,-122.055,1840,3825,1580,0.4463276836158192,3841600,12531600,8690000
367899.0,3,2.5,2420,4725,2.0,0,0,2,8,2420,0,2014,0.0,98038,47.371,-122.01799999999999,2370,4200,2305,0.48783068783068784,5856400,22325625,16469225
657044.0,3,3.5,3420,23786,1.5,0,0,2,9,3420,0,2014,0.0,98059,47.4739,-122.11,1590,23774,20366,0.856217943328008,11696400,565773796,554077396
359950.0,2,1.5,893,965,2.0,0,0,2,8,893,0,2007,0.0,98122,47.6187,-122.301,1340,1436,72,0.07461139896373056,797449,931225,133776
879950.0,4,2.75,3020,7203,2.0,0,0,2,9,3020,0,2014,0.0,98033,47.6948,-122.178,3010,7215,4183,0.5807302512841871,9120400,51883209,42762809
550000.0,4,2.5,2470,5954,2.0,0,0,2,8,2470,0,2013,0.0,98028,47.7685,-122.236,2470,4800,3484,0.5851528384279476,6100900,35450116,29349216
279000.0,4,2.5,2009,4800,2.0,0,0,2,8,2009,0,2012,0.0,98092,47.2586,-122.2,1798,4800,2791,0.5814583333333333,4036081,23040000,19003919
255000.0,3,2.5,1530,1116,2.5,0,0,2,7,1530,0,2005,0.0,98028,47.7385,-122.25,1530,7780,-414,-0.3709677419354839,2340900,1245456,-1095444
609500.0,3,1.75,1590,1113,3.0,0,0,2,8,1590,0,2014,0.0,98107,47.6691,-122.402,1520,1357,-477,-0.42857142857142855,2528100,1238769,-1289331
420000.0,5,3.0,2630,3149,2.0,0,0,2,8,1670,960,2013,0.0,98056,47.5065,-122.171,2240,4825,519,0.16481422673864718,6916900,9916201,2999301
570000.0,4,2.5,3230,7187,2.0,0,0,2,9,3230,0,2008,0.0,98059,47.4995,-122.15,2950,6537,3957,0.5505774314734938,10432900,51652969,41220069
439000.0,3,2.25,1430,2343,2.0,0,0,2,8,1430,0,2012,0.0,98108,47.5648,-122.294,1270,1916,913,0.38967136150234744,2044900,5489649,3444749
310000.0,3,2.5,2242,5744,2.0,0,0,2,8,2242,0,2012,0.0,98092,47.2597,-122.199,2009,5712,3502,0.6096796657381616,5026564,32993536,27966972
635000.0,4,2.5,2500,4000,2.0,0,0,2,8,2500,0,2014,0.0,98144,47.5902,-122.311,1480,4300,1500,0.375,6250000,16000000,9750000
399950.0,3,2.5,1230,922,2.0,0,0,2,8,1080,150,2009,0.0,98199,47.6518,-122.384,1230,1237,-308,-0.33405639913232105,1512900,850084,-662816
805000.0,4,2.5,3020,3600,2.5,0,0,2,9,3020,0,2009,0.0,98029,47.5407,-121.993,2570,3600,580,0.16111111111111112,9120400,12960000,3839600
1800000.0,4,3.5,3480,4000,2.0,0,0,2,9,2460,1020,2015,0.0,98112,47.6356,-122.281,2620,4000,520,0.13,12110400,16000000,3889600
1210000.0,4,3.0,3330,7650,1.0,0,0,2,9,1830,1500,2008,0.0,98103,47.6889,-122.352,1200,3876,4320,0.5647058823529412,11088900,58522500,47433600
745000.0,4,2.5,3400,4840,2.0,0,0,2,10,3190,210,2006,0.0,98059,47.5066,-122.146,3400,5710,1440,0.2975206611570248,11560000,23425600,11865600
329445.0,2,1.5,830,1119,2.0,0,0,2,7,830,0,2005,0.0,98144,47.5828,-122.314,1480,3622,289,0.258266309204647,688900,1252161,563261
588000.0,5,3.0,3110,4464,2.0,0,0,2,8,3110,0,2007,0.0,98011,47.7719,-122.16799999999999,2450,4221,1354,0.3033154121863799,9672100,19927296,10255196
494815.0,3,2.5,1910,2091,2.0,0,0,2,8,1910,0,2014,0.0,98029,47.5445,-122.01299999999999,1630,1546,181,0.08656145384983262,3648100,4372281,724181
591975.0,3,2.75,3230,5250,2.0,0,0,2,9,2680,550,2014,0.0,98065,47.5196,-121.87799999999999,2710,5250,2020,0.38476190476190475,10432900,27562500,17129600
600000.0,5,2.75,3380,8179,2.0,0,0,2,9,3380,0,2011,0.0,98059,47.4827,-122.135,2840,8179,4799,0.5867465460325223,11424400,66896041,55471641
673000.0,3,2.75,2830,3496,2.0,0,0,2,8,2830,0,2012,0.0,98029,47.5606,-122.01100000000001,2160,3501,666,0.19050343249427917,8008900,12222016,4213116
889950.0,5,3.5,3700,7055,2.0,0,0,2,9,3700,0,2014,0.0,98074,47.5929,-122.057,3170,6527,3355,0.4755492558469171,13690000,49773025,36083025
500000.0,4,3.0,2520,4104,2.0,0,0,2,7,2520,0,2002,0.0,98065,47.5352,-121.88,2510,5015,1584,0.38596491228070173,6350400,16842816,10492416
500000.0,3,2.25,1530,1396,2.0,0,0,2,8,1240,290,2007,0.0,98107,47.666000000000004,-122.367,1690,2500,-134,-0.09598853868194843,2340900,1948816,-392084
890000.0,4,4.25,4420,5750,2.0,0,0,2,10,3410,1010,2006,0.0,98027,47.5404,-122.073,4420,5750,1330,0.23130434782608697,19536400,33062500,13526100
437000.0,3,3.0,1460,1180,3.0,0,0,2,8,1460,0,2006,0.0,98117,47.6998,-122.367,1460,1224,-280,-0.23728813559322035,2131600,1392400,-739200
419700.0,3,2.25,1450,1486,2.0,0,0,2,8,1160,290,2006,0.0,98116,47.5694,-122.387,1370,1437,36,0.024226110363391656,2102500,2208196,105696
394000.0,3,2.0,1160,3441,1.0,0,0,3,6,580,580,1930,0.0,98136,47.5314,-122.39200000000001,1160,4000,2281,0.6628886951467596,1345600,11840481,10494881
342000.0,3,2.0,1640,4802,1.0,0,0,2,8,1640,0,2010,0.0,98038,47.3538,-122.021,1940,4802,3162,0.65847563515202,2689600,23059204,20369604
420000.0,3,1.75,1444,249126,1.5,0,0,2,7,1444,0,2008,0.0,98070,47.4104,-122.486,1760,224770,247682,0.9942037362619719,2085136,62063763876,62061678740
580000.0,3,2.5,1620,1173,3.0,0,4,2,8,1470,150,2008,0.0,98103,47.6681,-122.355,1620,1505,-447,-0.38107416879795397,2624400,1375929,-1248471
343000.0,2,1.5,1100,1228,2.0,0,0,2,7,900,200,2007,0.0,98118,47.5538,-122.28200000000001,1340,1380,128,0.10423452768729642,1210000,1507984,297984
390000.0,2,1.5,1340,1402,2.0,0,0,2,8,1120,220,2008,0.0,98144,47.588,-122.304,1340,1213,62,0.0442225392296719,1795600,1965604,170004
274000.0,3,1.5,1450,4694,2.0,0,0,2,7,1450,0,2011,0.0,98038,47.3654,-122.021,1870,4198,3244,0.6910950149126545,2102500,22033636,19931136
700000.0,4,2.5,3040,7200,2.0,0,0,2,9,3040,0,2008,0.0,98177,47.7747,-122.366,2360,8245,4160,0.5777777777777777,9241600,51840000,42598400
838000.0,4,2.5,2560,7210,2.0,0,0,2,9,2560,0,2006,0.0,98136,47.5535,-122.395,2160,10439,4650,0.6449375866851595,6553600,51984100,45430500
300000.0,6,3.0,2744,9926,2.0,0,0,2,7,2744,0,2006,0.0,98002,47.2773,-122.21600000000001,2470,9926,7182,0.7235543018335684,7529536,98525476,90995940
467000.0,3,2.25,1420,990,3.0,0,0,2,8,1420,0,2008,0.0,98103,47.6801,-122.348,1350,1415,-430,-0.43434343434343436,2016400,980100,-1036300
395000.0,2,1.0,700,7457,1.0,0,0,2,6,700,0,1943,0.0,98108,47.5348,-122.295,1500,7130,6757,0.9061284698940593,490000,55606849,55116849
734000.0,5,4.25,4110,42755,2.0,0,0,2,10,2970,1140,2000,0.0,98023,47.3375,-122.337,2730,12750,38645,0.903870892293299,16892100,1827990025,1811097925
480000.0,5,2.75,2670,4780,2.0,0,0,2,8,2670,0,2013,0.0,98059,47.4866,-122.155,2560,5380,2110,0.44142259414225943,7128900,22848400,15719500
539000.0,3,2.75,2130,1400,2.0,0,0,2,9,1080,1050,2010,0.0,98118,47.5661,-122.29,1520,3132,-730,-0.5214285714285715,4536900,1960000,-2576900
459950.0,5,2.75,3078,6371,2.0,0,0,2,9,3078,0,2014,0.0,98042,47.3587,-122.163,1979,19030,3293,0.5168733322869251,9474084,40589641,31115557
306500.0,2,1.0,840,892,2.0,0,0,2,7,840,0,2006,0.0,98136,47.5396,-122.387,1030,1007,52,0.05829596412556054,705600,795664,90064
408474.0,3,2.5,1800,2731,2.0,0,0,2,8,1800,0,2014,0.0,98065,47.5342,-121.84100000000001,1800,3265,931,0.3409007689491029,3240000,7458361,4218361
437000.0,3,2.75,2580,5200,2.0,0,0,2,8,2580,0,2008,0.0,98059,47.496,-122.15100000000001,2700,5602,2620,0.5038461538461538,6656400,27040000,20383600
160797.0,3,1.5,1270,2356,2.0,0,0,2,7,1270,0,2012,0.0,98108,47.5671,-122.29799999999999,1490,2175,1086,0.4609507640067912,1612900,5550736,3937836
729000.0,4,3.5,3065,5440,3.0,0,0,2,9,3065,0,2014,0.0,98056,47.523999999999994,-122.2,2210,8400,2375,0.4365808823529412,9394225,29593600,20199375
499000.0,3,2.5,1861,1587,2.0,0,0,2,8,1578,283,2007,0.0,98034,47.7043,-122.209,2090,10454,-274,-0.17265280403276623,3463321,2518569,-944752
359950.0,4,2.75,2260,5705,2.0,0,0,2,8,2260,0,2014,0.0,98042,47.3726,-122.15899999999999,2260,5727,3445,0.6038562664329535,5107600,32547025,27439425
929000.0,5,3.25,4150,7100,2.0,0,0,2,10,4150,0,2013,0.0,98074,47.6026,-122.06,3560,7214,2950,0.4154929577464789,17222500,50410000,33187500
529950.0,2,2.5,1500,1174,2.0,0,0,2,8,1140,360,2014,0.0,98107,47.6689,-122.363,1550,1519,-326,-0.2776831345826235,2250000,1378276,-871724
461000.0,3,2.25,1620,998,2.5,0,0,2,8,1540,80,2012,0.0,98027,47.5394,-122.027,1620,1068,-622,-0.6232464929859719,2624400,996004,-1628396
271115.0,2,1.5,830,1325,2.0,0,0,2,7,830,0,2005,0.0,98136,47.5472,-122.384,1310,1485,495,0.37358490566037733,688900,1755625,1066725
653000.0,4,2.5,3120,5137,2.0,0,0,2,7,3120,0,2003,0.0,98053,47.6842,-122.04,2755,5137,2017,0.39264161962234767,9734400,26388769,16654369
565000.0,3,2.5,1870,1058,3.0,0,0,2,8,1380,490,2007,0.0,98103,47.6512,-122.345,1440,1136,-812,-0.7674858223062382,3496900,1119364,-2377536
529950.0,3,2.25,1240,1250,3.0,0,0,2,8,1240,0,2014,0.0,98107,47.6748,-122.37700000000001,1470,1250,10,0.008,1537600,1562500,24900
585000.0,4,2.5,2820,5612,2.0,0,0,2,9,2820,0,2007,0.0,98028,47.7477,-122.236,1620,14881,2792,0.49750534568781185,7952400,31494544,23542144
609000.0,3,1.75,1630,1526,3.0,0,0,2,8,1630,0,2014,0.0,98103,47.6536,-122.354,1570,1274,-104,-0.06815203145478375,2656900,2328676,-328224
267000.0,3,2.25,1584,2800,2.0,0,0,2,7,1584,0,2012,0.0,98002,47.3454,-122.214,1584,2800,1216,0.4342857142857143,2509056,7840000,5330944
557000.0,4,2.5,2840,4500,2.0,0,0,2,8,2840,0,2012,0.0,98028,47.7678,-122.23700000000001,2840,4939,1660,0.3688888888888889,8065600,20250000,12184400
709950.0,4,3.25,3910,6293,2.0,0,0,2,9,3130,780,2006,0.0,98065,47.5389,-121.86,4410,6015,2383,0.3786747179405689,15288100,39601849,24313749
625000.0,3,2.5,1730,1301,3.0,0,0,2,9,1730,0,2011,0.0,98103,47.653,-122.352,1330,1240,-429,-0.3297463489623367,2992900,1692601,-1300299
599000.0,3,2.75,1840,2060,2.0,0,0,2,10,1700,140,2013,0.0,98027,47.53,-122.073,2590,2680,220,0.10679611650485436,3385600,4243600,858000
920000.0,4,3.75,4030,503989,2.0,0,0,2,10,4030,0,2008,0.0,98045,47.4807,-121.795,2110,71874,499959,0.9920037937335934,16240900,254004912121,253988671221
1290000.0,4,3.5,3440,3800,3.0,0,0,2,9,3440,0,2014,0.0,98112,47.6408,-122.307,1760,3800,360,0.09473684210526316,11833600,14440000,2606400
324500.0,4,2.5,2110,3825,2.0,0,0,2,7,2110,0,2012,0.0,98042,47.3602,-122.08200000000001,2110,3825,1715,0.44836601307189544,4452100,14630625,10178525
471500.0,3,2.5,2430,5866,2.0,0,0,2,7,2430,0,2009,0.0,98065,47.5158,-121.87100000000001,2380,5866,3436,0.5857483804977839,5904900,34409956,28505056
1020000.0,4,3.75,4690,207141,2.0,0,0,2,10,4030,660,2007,0.0,98019,47.7072,-121.98299999999999,2890,200527,202451,0.9773584176961586,21996100,42907393881,42885397781
998000.0,4,3.5,3500,43560,2.0,0,0,2,9,2850,650,2014,0.0,98006,47.5481,-122.103,3640,40545,40060,0.9196510560146923,12250000,1897473600,1885223600
262000.0,4,2.5,2070,8685,2.0,0,0,2,7,2070,0,2006,0.0,98188,47.4697,-122.26700000000001,2170,9715,6615,0.7616580310880829,4284900,75429225,71144325
844000.0,4,3.5,3350,6350,2.0,0,2,2,8,2610,740,2009,0.0,98116,47.5602,-122.39,1820,6350,3000,0.47244094488188976,11222500,40322500,29100000
745641.0,4,2.5,2440,4850,2.0,0,0,2,8,2440,0,2013,0.0,98052,47.7043,-122.11399999999999,2970,5450,2410,0.49690721649484537,5953600,23522500,17568900
659950.0,5,3.0,3010,7357,2.0,0,0,2,9,3010,0,2008,0.0,98133,47.7226,-122.33,2370,8050,4347,0.5908658420551856,9060100,54125449,45065349
339989.0,3,2.5,2060,4200,2.0,0,0,2,8,2060,0,2014,0.0,98038,47.3706,-122.01799999999999,2370,4200,2140,0.5095238095238095,4243600,17640000,13396400
352500.0,2,2.5,1570,2399,2.0,0,0,2,7,1180,390,2009,0.0,98106,47.5488,-122.36399999999999,1590,2306,829,0.34556065027094623,2464900,5755201,3290301
525000.0,3,2.5,1580,1161,2.0,0,0,2,8,1010,570,2008,0.0,98112,47.6206,-122.29899999999999,1680,1177,-419,-0.36089577950043067,2496400,1347921,-1148479
1140000.0,5,3.5,4280,6530,2.0,0,3,2,10,4280,0,2014,0.0,98075,47.5941,-121.973,3960,6863,2250,0.3445635528330781,18318400,42640900,24322500
491000.0,5,3.5,2815,4900,2.0,0,0,2,9,2815,0,2011,0.0,98030,47.3424,-122.179,2798,4900,2085,0.42551020408163265,7924225,24010000,16085775
675000.0,4,2.5,2620,6114,2.0,0,0,2,9,2620,0,2011,0.0,98029,47.5603,-122.01299999999999,2620,5808,3494,0.571475302584233,6864400,37380996,30516596
344000.0,3,2.25,1250,1033,3.0,0,0,2,8,1250,0,2007,0.0,98103,47.6907,-122.34299999999999,1250,1150,-217,-0.21006776379477252,1562500,1067089,-495411
530000.0,4,2.5,3250,4500,2.0,0,0,2,8,3250,0,2008,0.0,98059,47.4944,-122.15,3030,4598,1250,0.2777777777777778,10562500,20250000,9687500
290500.0,4,3.25,2510,7686,2.0,0,0,2,9,2510,0,2003,0.0,98055,47.4785,-122.228,2510,6732,5176,0.673432214415821,6300100,59074596,52774496
335000.0,2,1.75,1270,1685,2.0,0,0,2,8,1270,0,2012,0.0,98108,47.5646,-122.295,1270,1843,415,0.24629080118694363,1612900,2839225,1226325
3000000.0,5,4.0,6670,16481,2.0,0,0,2,12,4960,1710,2007,0.0,98004,47.6409,-122.221,4800,16607,9811,0.5952915478429707,44488900,271623361,227134461
379000.0,3,2.5,1580,3075,2.0,0,0,2,8,1580,0,2013,0.0,98126,47.545,-122.368,1710,2934,1495,0.4861788617886179,2496400,9455625,6959225
385000.0,3,1.5,1360,2030,3.0,0,0,2,8,1360,0,2008,0.0,98103,47.6961,-122.34899999999999,1360,1167,670,0.33004926108374383,1849600,4120900,2271300
500012.0,4,2.5,2400,9612,1.0,0,0,2,8,1230,1170,1962,2009.0,98059,47.4799,-122.12700000000001,2430,5539,7212,0.7503121098626716,5760000,92390544,86630544
366750.0,3,3.0,1571,2017,3.0,0,0,2,8,1571,0,2008,0.0,98125,47.7338,-122.309,1520,1497,446,0.2211204759543877,2468041,4068289,1600248
405000.0,2,2.0,1405,1073,2.0,0,0,2,8,1140,265,2007,0.0,98122,47.611999999999995,-122.295,1405,3000,-332,-0.30941286113699906,1974025,1151329,-822696
356999.0,3,1.5,1010,1546,2.0,0,0,2,8,1010,0,1971,2014.0,98144,47.5998,-122.311,1010,1517,536,0.34670116429495473,1020100,2390116,1370016
590000.0,2,2.5,1450,1281,2.0,0,0,2,8,1220,230,2006,0.0,98105,47.665,-122.285,1440,1281,-169,-0.13192818110850899,2102500,1640961,-461539
294000.0,3,1.75,1420,1361,2.0,0,0,2,7,960,460,2014,0.0,98108,47.5684,-122.314,1340,1343,-59,-0.04335047759000735,2016400,1852321,-164079
731500.0,4,2.5,2650,4644,2.0,0,0,2,8,2650,0,2013,0.0,98053,47.6945,-122.01799999999999,2640,5099,1994,0.42937123169681307,7022500,21566736,14544236
837219.0,5,2.75,3030,7679,2.0,0,0,2,9,3030,0,2014,0.0,98074,47.593,-122.057,3080,6341,4649,0.6054173720536529,9180900,58967041,49786141
1600000.0,4,5.5,6530,871200,2.0,0,2,2,11,6530,0,2008,0.0,98014,47.663999999999994,-121.87799999999999,1280,858132,864670,0.9925045913682278,42640900,758989440000,758946799100
798800.0,3,2.75,2670,3738,1.0,0,0,2,10,1720,950,2013,0.0,98056,47.5299,-122.20299999999999,2610,3734,1068,0.2857142857142857,7128900,13972644,6843744
482500.0,2,2.5,1170,809,2.0,0,0,2,9,1170,0,2007,0.0,98103,47.6875,-122.339,1170,1121,-361,-0.446229913473424,1368900,654481,-714419
820000.0,4,2.5,3260,26772,2.0,0,0,2,9,3260,0,2007,0.0,98027,47.5115,-122.031,3260,14491,23512,0.878230987598984,10627600,716739984,706112384
319000.0,3,1.5,1480,1722,3.0,0,0,2,7,1480,0,2007,0.0,98125,47.728,-122.292,1480,5764,242,0.140534262485482,2190400,2965284,774884
950000.0,3,2.5,2700,6947,2.0,0,3,2,9,2700,0,2013,0.0,98056,47.5172,-122.208,2500,6947,4247,0.6113430257665179,7290000,48260809,40970809
1270000.0,4,3.5,4640,13404,2.0,0,0,2,10,4640,0,2007,0.0,98059,47.53100000000001,-122.134,4690,13590,8764,0.653834676216055,21529600,179667216,158137616
378000.0,3,2.5,1601,2491,3.0,0,0,2,7,1536,65,2007,0.0,98125,47.718999999999994,-122.31700000000001,1420,1156,890,0.3572862304295464,2563201,6205081,3641880
3350000.0,5,3.75,5350,15360,1.0,0,1,2,11,3040,2310,2008,0.0,98004,47.648,-122.21799999999999,3740,15940,10010,0.6516927083333334,28622500,235929600,207307100
489950.0,3,2.5,2540,5237,2.0,0,0,2,8,2540,0,2011,0.0,98118,47.5492,-122.27600000000001,1800,4097,2697,0.5149894978040863,6451600,27426169,20974569
345000.0,2,1.75,1030,1106,2.0,0,0,2,7,765,265,2006,0.0,98136,47.5397,-122.387,1030,1066,76,0.06871609403254973,1060900,1223236,162336
510000.0,3,2.5,2730,7136,2.0,0,0,2,8,2730,0,2012,0.0,98198,47.3938,-122.321,2130,8932,4406,0.617432735426009,7452900,50922496,43469596
432500.0,4,2.5,3172,5033,2.0,0,0,2,8,3172,0,2014,0.0,98023,47.2961,-122.348,2704,5232,1861,0.36975958672759784,10061584,25331089,15269505
650000.0,4,2.5,3160,8530,2.0,0,0,2,9,3160,0,2006,0.0,98059,47.5075,-122.148,3160,6460,5370,0.6295427901524033,9985600,72760900,62775300
750000.0,4,2.5,2850,12429,2.0,0,0,2,9,2850,0,2008,0.0,98033,47.6915,-122.177,2540,12000,9579,0.7706975621530292,8122500,154480041,146357541
870000.0,4,3.5,2780,3100,2.0,0,0,2,8,2120,660,2014,0.0,98117,47.6886,-122.36399999999999,1740,3600,320,0.1032258064516129,7728400,9610000,1881600
900000.0,4,3.5,3860,6543,2.0,0,0,2,10,3860,0,2014,0.0,98075,47.5934,-121.97399999999999,3760,6888,2683,0.41005654898364663,14899600,42810849,27911249
664950.0,2,1.75,1180,900,2.0,0,0,2,10,780,400,2014,0.0,98102,47.6395,-122.329,1380,3610,-280,-0.3111111111111111,1392400,810000,-582400
391000.0,3,2.25,1410,1290,2.0,0,0,2,7,1290,120,2004,0.0,98027,47.5345,-122.069,1490,1380,-120,-0.09302325581395349,1988100,1664100,-324000
1800000.0,4,3.5,6370,205603,2.0,0,0,2,12,6370,0,2008,0.0,98027,47.5016,-121.905,1490,33580,199233,0.9690179618001683,40576900,42272593609,42232016709
479349.0,5,3.0,3223,6371,2.0,0,0,2,9,3223,0,2014,0.0,98042,47.3584,-122.163,1979,9008,3148,0.49411395385339824,10387729,40589641,30201912
661000.0,4,3.25,2600,2074,2.0,0,0,2,8,2150,450,2011,0.0,98027,47.5402,-122.02799999999999,2510,2074,-526,-0.2536162005785921,6760000,4301476,-2458524
379000.0,3,3.25,1380,1234,3.0,0,0,2,8,1380,0,2006,0.0,98103,47.6935,-122.34200000000001,1370,1282,-146,-0.11831442463533225,1904400,1522756,-381644
415000.0,3,2.25,1620,998,2.5,0,0,2,8,1540,80,2010,0.0,98027,47.5401,-122.027,1620,1299,-622,-0.6232464929859719,2624400,996004,-1628396
375000.0,3,3.25,1370,1227,3.0,0,0,2,8,1370,0,2007,0.0,98103,47.6964,-122.34100000000001,1370,1236,-143,-0.1165444172779136,1876900,1505529,-371371
355000.0,3,2.0,1220,1186,3.0,0,0,2,8,1220,0,2007,0.0,98103,47.6972,-122.34100000000001,1280,1251,-34,-0.02866779089376054,1488400,1406596,-81804
540000.0,3,2.5,1280,1889,3.0,0,0,2,8,1280,0,2009,0.0,98105,47.6619,-122.324,1450,1889,609,0.3223928004235045,1638400,3568321,1929921
290000.0,2,1.5,770,850,2.0,0,0,2,7,770,0,2006,0.0,98116,47.5644,-122.38799999999999,1350,915,80,0.09411764705882353,592900,722500,129600
500000.0,3,2.5,1210,1200,3.0,0,0,2,8,1210,0,2008,0.0,98103,47.6543,-122.345,1210,1200,-10,-0.008333333333333333,1464100,1440000,-24100
416000.0,4,2.5,2890,6322,2.0,0,0,2,8,2890,0,2011,0.0,98038,47.3494,-122.044,2380,5738,3432,0.5428661815881051,8352100,39967684,31615584
349900.0,3,2.5,1580,2765,2.0,0,0,2,8,1580,0,2011,0.0,98126,47.5444,-122.369,1580,1820,1185,0.42857142857142855,2496400,7645225,5148825
465000.0,3,2.25,1530,1245,2.0,0,0,2,9,1050,480,2014,0.0,98122,47.6018,-122.29700000000001,1530,2307,-285,-0.2289156626506024,2340900,1550025,-790875
950000.0,4,2.5,3670,7680,2.5,0,0,2,10,3670,0,2007,0.0,98029,47.5401,-121.993,3130,6112,4010,0.5221354166666666,13468900,58982400,45513500
496800.0,4,2.25,1850,2340,2.5,0,0,2,8,1850,0,2014,0.0,98126,47.543,-122.37200000000001,1850,2340,490,0.2094017094017094,3422500,5475600,2053100
680000.0,4,2.5,2440,6581,2.0,0,0,2,8,2440,0,2014,0.0,98133,47.7321,-122.334,1480,7432,4141,0.6292356784683178,5953600,43309561,37355961
920000.0,4,3.25,2190,4265,2.0,0,0,2,9,1540,650,2015,0.0,98122,47.6178,-122.29,1730,4265,2075,0.48651817116060964,4796100,18190225,13394125
1290000.0,5,4.0,4360,8030,2.0,0,0,2,10,4360,0,2015,0.0,98075,47.5923,-121.973,3570,6185,3670,0.45703611457036114,19009600,64480900,45471300
825000.0,4,2.75,3990,6637,2.0,0,0,2,9,3990,0,2003,0.0,98053,47.6835,-122.045,3500,7074,2647,0.39882477022751245,15920100,44049769,28129669
292000.0,3,2.5,1270,1283,3.0,0,0,2,7,1270,0,2007,0.0,98125,47.7209,-122.291,1270,1512,13,0.010132501948558068,1612900,1646089,33189
576000.0,4,2.5,3340,6924,2.0,0,0,2,8,3340,0,2009,0.0,98059,47.495,-122.149,3030,6119,3584,0.5176198729058348,11155600,47941776,36786176
670000.0,2,2.0,1500,761,3.0,0,3,2,8,1500,0,2008,0.0,98103,47.6522,-122.346,1360,1527,-739,-0.9710906701708278,2250000,579121,-1670879
953007.0,4,3.5,3120,5086,2.0,0,0,2,9,2480,640,2008,0.0,98115,47.6762,-122.288,1880,5092,1966,0.3865513173417224,9734400,25867396,16132996
399000.0,4,2.5,2480,4334,2.0,0,0,2,8,2480,0,2012,0.0,98038,47.3826,-122.036,2480,5632,1854,0.42778034148592525,6150400,18783556,12633156
399000.0,2,2.0,1110,1155,3.0,0,0,2,7,980,130,2008,0.0,98136,47.5496,-122.38799999999999,1110,1089,45,0.03896103896103896,1232100,1334025,101925
847093.0,4,2.75,2760,5670,2.0,0,0,2,10,2760,0,2014,0.0,98075,47.5819,-122.04700000000001,2760,6600,2910,0.5132275132275133,7617600,32148900,24531300
599950.0,3,2.5,1510,1493,3.0,0,0,2,8,1510,0,2014,0.0,98107,47.669,-122.402,1530,1357,-17,-0.011386470194239785,2280100,2229049,-51051
499000.0,3,2.5,1460,1614,2.0,0,0,2,8,1180,280,2007,0.0,98117,47.6781,-122.374,1380,1402,154,0.09541511771995044,2131600,2604996,473396
760000.0,4,2.75,3980,285318,2.0,0,2,2,9,3980,0,2006,0.0,98045,47.4803,-121.795,2100,105415,281338,0.9860506522546773,15840400,81406361124,81390520724
1700000.0,4,3.75,3320,8234,2.0,0,0,2,10,3320,0,2014,0.0,98004,47.5963,-122.2,1560,8240,4914,0.5967937818800098,11022400,67798756,56776356
1030000.0,4,3.25,3270,5187,2.0,0,0,2,9,3110,160,2014,0.0,98052,47.6966,-122.133,3600,5825,1917,0.36957779063042223,10692900,26904969,16212069
515000.0,4,2.5,2670,8765,2.0,0,0,2,9,2670,0,2006,0.0,98059,47.4876,-122.146,2880,8765,6095,0.6953793496862521,7128900,76825225,69696325
355000.0,3,2.25,1410,1332,2.0,0,0,2,7,1290,120,2004,0.0,98027,47.5345,-122.069,1445,1290,-78,-0.05855855855855856,1988100,1774224,-213876
319900.0,4,2.75,2475,4000,2.0,0,0,2,7,2475,0,2014,0.0,98002,47.3452,-122.21,2166,4000,1525,0.38125,6125625,16000000,9874375
460000.0,3,3.5,1600,1431,2.0,0,0,2,8,1240,360,2006,0.0,98117,47.6865,-122.363,1500,4120,-169,-0.11809923130677848,2560000,2047761,-512239
305000.0,2,1.0,1290,3383,2.0,0,0,2,7,1290,0,2008,0.0,98053,47.6968,-122.025,1290,2828,2093,0.618681643511676,1664100,11444689,9780589
280000.0,3,2.5,1608,4818,2.0,0,0,2,8,1608,0,2012,0.0,98092,47.2583,-122.20299999999999,2009,5200,3210,0.6662515566625156,2585664,23213124,20627460
394950.0,2,2.25,1300,2104,2.0,0,0,2,8,1010,290,2011,0.0,98136,47.5477,-122.38799999999999,1430,1850,804,0.3821292775665399,1690000,4426816,2736816
382000.0,4,3.5,2530,3000,2.0,0,0,2,8,1850,680,2014,0.0,98146,47.4919,-122.336,1470,6000,470,0.15666666666666668,6400900,9000000,2599100
560000.0,3,2.5,1390,1411,3.0,0,0,2,8,1390,0,2008,0.0,98103,47.6485,-122.334,1350,1266,21,0.014883061658398299,1932100,1990921,58821
772000.0,3,2.25,1640,1204,3.0,0,0,2,8,1640,0,2014,0.0,98112,47.6196,-122.29700000000001,1630,3136,-436,-0.36212624584717606,2689600,1449616,-1239984
324950.0,4,2.5,2229,5723,2.0,0,0,2,7,2229,0,2012,0.0,98032,47.3693,-122.286,2738,5742,3494,0.6105189585881531,4968441,32752729,27784288
530000.0,3,2.5,1790,3078,2.0,0,0,2,8,1790,0,2010,0.0,98027,47.5638,-122.094,1890,3078,1288,0.4184535412605588,3204100,9474084,6269984
384000.0,3,2.25,990,736,2.5,0,0,2,8,880,110,2009,0.0,98105,47.6605,-122.319,1030,1201,-254,-0.3451086956521739,980100,541696,-438404
719950.0,5,2.75,3240,6863,2.0,0,0,2,10,3240,0,2013,0.0,98056,47.5033,-122.193,2360,6002,3623,0.5279032493078829,10497600,47100769,36603169
319950.0,2,2.5,1280,819,2.0,0,0,2,8,1060,220,2006,0.0,98103,47.6905,-122.36399999999999,1290,2900,-461,-0.5628815628815629,1638400,670761,-967639
292000.0,3,2.5,1610,3848,2.0,0,0,2,8,1610,0,2006,0.0,98055,47.4497,-122.18799999999999,1610,3049,2238,0.5816008316008316,2592100,14807104,12215004
1500000.0,6,3.5,3670,3959,2.0,0,0,2,10,2410,1260,2008,0.0,98119,47.6356,-122.37299999999999,2060,3625,289,0.07299823187673656,13468900,15673681,2204781
425000.0,2,2.5,1150,1027,3.0,0,0,2,8,1150,0,2008,0.0,98103,47.6534,-122.35600000000001,1360,1210,-123,-0.11976630963972736,1322500,1054729,-267771
799950.0,5,3.75,3760,4702,2.0,0,0,2,9,2780,980,2014,0.0,98034,47.7202,-122.223,2950,5981,942,0.20034028073160356,14137600,22108804,7971204
499000.0,2,2.5,1320,1157,2.0,0,0,2,8,990,330,2014,0.0,98107,47.6689,-122.363,1550,1519,-163,-0.14088159031979255,1742400,1338649,-403751
572000.0,4,2.75,2700,7992,2.0,0,0,2,9,2700,0,2012,0.0,98059,47.4831,-122.135,2840,7992,5292,0.6621621621621622,7290000,63872064,56582064
459000.0,2,2.0,1480,804,3.0,0,0,2,8,1480,0,2008,0.0,98122,47.602,-122.30799999999999,1380,1751,-676,-0.8407960199004975,2190400,646416,-1543984
529500.0,3,2.25,1410,905,3.0,0,0,2,9,1410,0,2014,0.0,98116,47.5818,-122.402,1510,1352,-505,-0.5580110497237569,1988100,819025,-1169075
374500.0,4,2.5,3135,5811,2.0,0,0,2,9,3135,0,2005,0.0,98092,47.3263,-122.18,3008,5799,2676,0.4605059370160041,9828225,33767721,23939496
584000.0,3,2.5,1480,1485,2.0,0,0,2,8,1280,0,2007,0.0,98102,47.6376,-122.32600000000001,1470,1277,5,0.003367003367003367,2190400,2205225,14825
1900000.0,4,4.5,4020,9656,2.0,0,0,2,10,4020,0,2007,0.0,98004,47.6358,-122.20700000000001,1960,9520,5636,0.5836785418392709,16160400,93238336,77077936
505000.0,2,2.25,1060,1209,2.0,0,0,2,8,940,120,2006,0.0,98102,47.6369,-122.32700000000001,1300,1169,149,0.12324234904880066,1123600,1461681,338081
565000.0,2,2.5,1950,2457,3.0,0,0,2,8,1950,0,2009,0.0,98144,47.5925,-122.302,1650,1639,507,0.20634920634920634,3802500,6036849,2234349
799000.0,4,2.75,3340,5677,2.0,0,0,2,9,3340,0,2011,0.0,98052,47.708999999999996,-122.118,3240,5643,2337,0.41166108860313544,11155600,32228329,21072729
547000.0,3,2.5,1570,1452,2.5,0,0,2,9,1240,330,2007,0.0,98199,47.648,-122.396,1670,1596,-118,-0.081267217630854,2464900,2108304,-356596
550000.0,3,2.5,1930,6604,2.0,0,0,2,7,1930,0,2014,0.0,98166,47.4692,-122.351,910,6604,4674,0.7077528770442156,3724900,43612816,39887916
250000.0,3,2.0,1590,8100,1.0,0,0,2,7,1060,530,1996,0.0,98038,47.3611,-122.04700000000001,1590,8100,6510,0.8037037037037037,2528100,65610000,63081900
960000.0,4,4.5,3720,7746,2.0,0,0,2,10,3720,0,2014,0.0,98034,47.7323,-122.165,3080,11067,4026,0.5197521301316809,13838400,60000516,46162116
2950000.0,4,4.25,4470,5884,2.0,0,1,2,11,3230,1240,2010,0.0,98199,47.6387,-122.405,2570,6000,1414,0.24031271244051666,19980900,34621456,14640556
441000.0,2,1.0,1290,1289,2.0,0,0,2,7,1030,260,2005,0.0,98144,47.6006,-122.305,1290,1332,-1,-0.0007757951900698216,1664100,1661521,-2579
265000.0,3,2.25,1489,2800,2.0,0,0,2,7,1489,0,2012,0.0,98002,47.3454,-122.214,1584,2800,1311,0.4682142857142857,2217121,7840000,5622879
430000.0,3,2.5,2075,39553,1.0,0,0,2,7,2075,0,2012,0.0,98038,47.3601,-122.03200000000001,1960,9047,37478,0.9475387454807473,4305625,1564439809,1560134184
286800.0,3,2.5,1413,3600,2.0,0,0,2,8,1413,0,2011,0.0,98031,47.4222,-122.193,2150,3869,2187,0.6075,1996569,12960000,10963431
375000.0,3,2.5,1300,1362,2.0,0,0,2,8,880,420,2008,0.0,98144,47.5893,-122.31700000000001,1300,1251,62,0.04552129221732746,1690000,1855044,165044
312500.0,3,3.25,1480,983,2.0,0,0,2,8,1180,300,2013,0.0,98106,47.5555,-122.363,1330,1062,-497,-0.5055951169888098,2190400,966289,-1224111
850000.0,4,2.75,3320,5559,2.0,0,0,2,9,3320,0,2012,0.0,98075,47.5607,-122.031,3400,6854,2239,0.40277028242489654,11022400,30902481,19880081
390500.0,3,2.25,1530,1279,2.0,0,0,2,7,1116,414,2007,0.0,98177,47.7035,-122.35700000000001,1320,1427,-251,-0.1962470680218921,2340900,1635841,-705059
455000.0,3,2.5,1180,932,3.0,0,0,2,8,1180,0,2010,0.0,98119,47.63800000000001,-122.375,1180,2632,-248,-0.26609442060085836,1392400,868624,-523776
455000.0,2,2.0,1190,1303,2.0,0,0,2,8,800,390,2009,0.0,98107,47.6675,-122.368,1670,2425,113,0.08672294704528012,1416100,1697809,281709
515000.0,3,2.25,1300,1180,3.0,0,0,2,8,1300,0,2008,0.0,98103,47.6871,-122.339,1300,1174,-120,-0.1016949152542373,1690000,1392400,-297600
362500.0,3,3.5,1710,2212,2.0,0,0,2,7,1400,310,2013,0.0,98126,47.5459,-122.368,1580,2212,502,0.22694394213381555,2924100,4892944,1968844
460000.0,3,2.5,2390,47480,2.0,0,0,2,9,2390,0,2007,0.0,98058,47.4517,-122.084,1720,44866,45090,0.9496630160067396,5712100,2254350400,2248638300
540000.0,4,3.5,3510,6005,2.0,0,0,2,8,2750,760,2010,0.0,98065,47.5168,-121.87,3090,5866,2495,0.4154870940882598,12320100,36060025,23739925
230000.0,3,1.75,1140,1165,2.0,0,0,2,8,1140,0,2014,0.0,98108,47.5638,-122.295,1150,1552,25,0.02145922746781116,1299600,1357225,57625
425000.0,2,2.5,1320,1329,2.0,0,0,2,8,1180,140,2007,0.0,98107,47.6728,-122.374,1490,5000,9,0.006772009029345372,1742400,1766241,23841
298450.0,5,3.0,2100,9752,1.0,0,0,2,8,1200,900,2007,0.0,98003,47.3341,-122.304,1270,10200,7652,0.7846595570139459,4410000,95101504,90691504
344000.0,4,2.5,2400,4848,2.0,0,0,2,8,2400,0,2004,0.0,98038,47.3626,-122.04,1980,5199,2448,0.504950495049505,5760000,23503104,17743104
416286.0,3,2.5,1408,989,3.0,0,0,2,8,1408,0,2005,0.0,98115,47.6856,-122.315,1408,1342,-419,-0.4236602628918099,1982464,978121,-1004343
379500.0,4,2.5,2560,5102,2.0,0,0,2,8,2560,0,2013,0.0,98092,47.3404,-122.181,2586,5059,2542,0.4982359858878871,6553600,26030404,19476804
350000.0,2,2.5,1260,1347,3.0,0,0,2,8,1260,0,2005,0.0,98103,47.6994,-122.34100000000001,1260,1356,87,0.0645879732739421,1587600,1814409,226809
258800.0,2,1.75,1290,1624,2.0,0,0,2,8,1290,0,2014,0.0,98106,47.5171,-122.34700000000001,1410,1963,334,0.20566502463054187,1664100,2637376,973276
620000.0,4,2.5,2730,9260,2.0,0,0,2,8,2730,0,2008,0.0,98133,47.7222,-122.331,2730,7357,6530,0.7051835853131749,7452900,85747600,78294700
295000.0,2,2.5,1630,1368,2.0,0,0,2,7,1280,350,2009,0.0,98106,47.5489,-122.363,1590,2306,-262,-0.1915204678362573,2656900,1871424,-785476
908990.0,4,2.75,3530,6844,2.0,0,0,2,10,3530,0,2014,0.0,98075,47.5975,-121.985,3530,10038,3314,0.4842197545295149,12460900,46840336,34379436
485230.0,4,2.5,2714,12558,2.0,0,0,2,9,2714,0,2014,0.0,98031,47.3522,-122.20100000000001,2873,8269,9844,0.7838827838827839,7365796,157703364,150337568
475000.0,3,2.25,1630,2520,2.0,0,0,2,7,1630,0,2005,0.0,98029,47.5493,-121.99799999999999,1630,3131,890,0.3531746031746032,2656900,6350400,3693500
1240000.0,5,3.25,5790,13726,2.0,0,3,2,10,4430,1360,2014,0.0,98006,47.5388,-122.11399999999999,5790,13726,7936,0.5781728107241731,33524100,188403076,154878976
635000.0,3,3.0,2230,1407,2.5,0,0,2,8,1850,380,2013,0.0,98027,47.5446,-122.01700000000001,2290,1407,-823,-0.5849324804548686,4972900,1979649,-2993251
350000.0,3,2.5,1380,1590,2.0,0,0,2,9,1160,220,2012,0.0,98126,47.5444,-122.375,1380,1590,210,0.1320754716981132,1904400,2528100,623700
345000.0,3,3.5,1320,1161,3.0,0,0,2,8,1320,0,2010,0.0,98125,47.7162,-122.294,1320,1161,-159,-0.13695090439276486,1742400,1347921,-394479
700000.0,2,2.0,1490,713,3.0,0,0,2,9,1490,0,2014,0.0,98109,47.6356,-122.346,1490,1110,-777,-1.0897615708274895,2220100,508369,-1711731
490000.0,3,2.25,1280,1520,2.0,0,0,2,8,1080,200,2008,0.0,98107,47.6651,-122.368,1280,1681,240,0.15789473684210525,1638400,2310400,672000
1300000.0,5,4.0,3870,5929,2.0,0,0,2,10,3870,0,2014,0.0,98052,47.6965,-122.134,3600,5625,2059,0.3472761005228538,14976900,35153041,20176141
579000.0,2,2.5,1280,1051,2.0,0,0,2,8,1080,0,2009,0.0,98119,47.6273,-122.359,1580,1279,-229,-0.21788772597526165,1638400,1104601,-533799
552500.0,3,1.5,1300,1435,2.0,0,0,2,8,1120,180,2007,0.0,98122,47.6114,-122.31,1320,1652,135,0.09407665505226481,1690000,2059225,369225
467000.0,4,2.75,2170,5024,2.0,0,0,2,8,2170,0,2012,0.0,98059,47.495,-122.145,2460,5024,2854,0.5680732484076433,4708900,25240576,20531676
305000.0,4,2.25,1763,3717,2.0,0,0,2,8,1763,0,2012,0.0,98031,47.4213,-122.194,1763,3666,1954,0.5256927629808986,3108169,13816089,10707920
212000.0,2,1.5,1020,1525,2.0,0,0,2,7,1020,0,2004,0.0,98133,47.70399999999999,-122.34700000000001,1020,3844,505,0.33114754098360655,1040400,2325625,1285225
429000.0,4,2.5,1840,4593,2.0,0,0,2,7,1840,0,2010,0.0,98053,47.6866,-122.01299999999999,1740,3600,2753,0.599390376660135,3385600,21095649,17710049
479950.0,3,2.0,1820,1358,3.0,0,0,2,9,1820,0,2014,0.0,98126,47.5433,-122.376,1710,1367,-462,-0.3402061855670103,3312400,1844164,-1468236
825000.0,3,3.5,2670,3000,2.0,0,0,2,9,1870,800,2014,0.0,98117,47.6813,-122.37200000000001,1750,5000,330,0.11,7128900,9000000,1871100
1180000.0,6,6.5,6260,10955,2.0,0,0,2,11,4840,1420,2007,0.0,98075,47.5947,-122.039,2710,12550,4695,0.42857142857142855,39187600,120012025,80824425
250000.0,3,2.25,1400,3814,2.0,0,0,2,7,1400,0,2012,0.0,98042,47.3584,-122.083,1610,3814,2414,0.6329313057157839,1960000,14546596,12586596
289000.0,2,1.5,1160,2158,2.0,0,0,2,7,1160,0,1982,0.0,98034,47.7178,-122.19,1150,2158,998,0.46246524559777574,1345600,4656964,3311364
265000.0,3,2.5,1400,3368,2.0,0,0,2,7,1400,0,2013,0.0,98146,47.5134,-122.34200000000001,1400,4316,1968,0.5843230403800475,1960000,11343424,9383424
344000.0,3,2.5,1232,1130,3.0,0,0,2,7,1232,0,2007,0.0,98125,47.7185,-122.31700000000001,1232,1202,-102,-0.09026548672566372,1517824,1276900,-240924
749000.0,4,2.75,2700,6000,2.0,0,0,3,8,2100,600,1910,0.0,98116,47.58600000000001,-122.383,2050,5400,3300,0.55,7290000,36000000,28710000
492000.0,4,2.5,2550,6382,2.0,0,0,2,7,2550,0,2007,0.0,98065,47.5202,-121.87,2430,5900,3832,0.600438733939204,6502500,40729924,34227424
552500.0,4,2.5,3260,6902,2.0,0,0,2,8,3260,0,2008,0.0,98059,47.4829,-122.156,3130,6588,3642,0.5276731382208055,10627600,47637604,37010004
653500.0,2,2.5,1680,1240,2.0,0,0,2,8,1120,560,2014,0.0,98102,47.6372,-122.324,2060,3630,-440,-0.3548387096774194,2822400,1537600,-1284800
855000.0,4,3.25,2630,2550,2.0,0,0,2,10,2030,600,2006,0.0,98117,47.6775,-122.385,1810,2600,-80,-0.03137254901960784,6916900,6502500,-414400
333000.0,3,1.5,1260,5758,2.0,0,0,2,7,1260,0,1999,0.0,98006,47.5524,-122.139,3090,10142,4498,0.7811740187565127,1587600,33154564,31566964
415000.0,4,2.5,2550,4500,2.0,0,0,2,7,2550,0,2009,0.0,98059,47.4916,-122.15299999999999,2340,4526,1950,0.43333333333333335,6502500,20250000,13747500
445000.0,4,3.25,3450,5000,2.0,0,0,2,8,3450,0,2008,0.0,98178,47.4925,-122.273,1420,5000,1550,0.31,11902500,25000000,13097500
273500.0,3,2.5,1550,3402,2.0,0,0,2,7,1550,0,2009,0.0,98002,47.3523,-122.212,2095,3402,1852,0.5443856554967667,2402500,11573604,9171104
969990.0,4,2.5,4150,8436,2.0,0,0,2,10,4150,0,2014,0.0,98075,47.5802,-122.039,4070,8438,4286,0.5080606922712186,17222500,71166096,53943596
1200000.0,5,3.5,3900,4400,2.0,0,0,2,9,2650,1250,2014,0.0,98107,47.6607,-122.36200000000001,1190,4400,500,0.11363636363636363,15210000,19360000,4150000
430000.0,3,3.25,1550,1444,3.0,0,0,2,8,1550,0,2006,0.0,98115,47.6767,-122.291,1550,1444,-106,-0.07340720221606649,2402500,2085136,-317364
392000.0,4,2.5,2130,4000,2.0,0,0,2,8,2130,0,2014,0.0,98146,47.5108,-122.36200000000001,1830,7217,1870,0.4675,4536900,16000000,11463100
795000.0,4,2.5,2890,7798,2.0,0,0,2,9,2890,0,2005,0.0,98006,47.5456,-122.12899999999999,3300,30950,4908,0.6293921518338036,8352100,60808804,52456704
457000.0,3,2.5,1220,1330,2.0,0,0,2,8,1010,210,2008,0.0,98117,47.6904,-122.37,1360,3750,110,0.08270676691729323,1488400,1768900,280500
453000.0,4,2.5,2502,8306,2.0,0,0,2,9,2502,0,2013,0.0,98001,47.2953,-122.265,2597,6983,5804,0.6987719720683843,6260004,68989636,62729632
376000.0,3,2.0,1340,1384,3.0,0,0,2,8,1340,0,2008,0.0,98103,47.6973,-122.35,1110,1384,44,0.031791907514450865,1795600,1915456,119856
469995.0,4,2.5,2350,3800,2.0,0,0,2,8,2350,0,2014,0.0,98059,47.4783,-122.12299999999999,2670,4180,1450,0.3815789473684211,5522500,14440000,8917500
540000.0,3,2.5,1810,3930,2.0,0,0,2,8,1810,0,2008,0.0,98053,47.7169,-122.02,1560,5100,2120,0.539440203562341,3276100,15444900,12168800
555000.0,4,2.5,3310,6500,2.0,0,0,2,8,3310,0,2012,0.0,98065,47.515,-121.87,2380,5000,3190,0.4907692307692308,10956100,42250000,31293900
445000.0,3,2.0,1620,5101,1.0,0,0,2,7,590,1030,2006,0.0,98118,47.5448,-122.288,1700,7750,3481,0.6824152127033914,2624400,26020201,23395801
256950.0,2,2.0,1070,635,2.0,0,0,2,9,720,350,2008,0.0,98106,47.5212,-122.35700000000001,1070,928,-435,-0.6850393700787402,1144900,403225,-741675
297000.0,4,2.5,2230,4952,2.0,0,0,2,8,2230,0,2011,0.0,98002,47.3363,-122.211,2030,3721,2722,0.5496768982229402,4972900,24522304,19549404
320000.0,4,2.5,1970,4558,2.0,0,0,2,8,1970,0,2005,0.0,98038,47.3627,-122.04,1980,5123,2588,0.5677928916191312,3880900,20775364,16894464
805000.0,5,4.5,4600,7810,2.0,0,0,2,9,3200,1400,2006,0.0,98065,47.5381,-121.86,4480,6324,3210,0.41101152368758004,21160000,60996100,39836100
799990.0,4,2.75,3110,6050,2.0,0,0,2,9,3110,0,2014,0.0,98052,47.705,-122.126,3590,6054,2940,0.4859504132231405,9672100,36602500,26930400
680000.0,4,2.5,3490,3677,2.0,0,0,2,9,2850,640,2007,0.0,98072,47.773999999999994,-122.162,3440,3600,187,0.050856676638564045,12180100,13520329,1340229
395000.0,3,2.5,1600,1936,2.0,0,0,2,7,1600,0,2007,0.0,98108,47.5629,-122.29700000000001,1600,1936,336,0.17355371900826447,2560000,3748096,1188096
732000.0,3,2.5,1960,3060,2.0,0,0,2,8,1960,0,2010,0.0,98117,47.6764,-122.389,1220,3060,1100,0.35947712418300654,3841600,9363600,5522000
163800.0,2,2.5,1000,1092,2.0,0,0,2,7,990,10,2004,0.0,98118,47.5419,-122.271,1330,1466,92,0.08424908424908426,1000000,1192464,192464
220000.0,2,2.5,1000,1092,2.0,0,0,2,7,990,10,2004,0.0,98118,47.5419,-122.271,1330,1466,92,0.08424908424908426,1000000,1192464,192464
308625.0,2,2.0,1500,1408,3.0,0,0,2,7,1500,0,1999,0.0,98133,47.7293,-122.34299999999999,1500,1245,-92,-0.06534090909090909,2250000,1982464,-267536
375000.0,3,2.5,2424,5931,2.0,0,0,2,9,2424,0,2014,0.0,98042,47.3515,-122.134,2424,6036,3507,0.5912999494183105,5875776,35176761,29300985
300000.0,4,2.5,2303,3826,2.0,0,0,2,8,2303,0,2006,0.0,98092,47.3258,-122.165,2516,4500,1523,0.3980658651332985,5303809,14638276,9334467
284000.0,3,2.5,1880,6008,2.0,0,0,2,7,1880,0,2009,0.0,98042,47.3366,-122.052,2180,5185,4128,0.6870838881491345,3534400,36096064,32561664
610000.0,2,2.0,1210,740,2.0,0,0,2,8,780,430,2014,0.0,98112,47.6206,-122.3,1480,1171,-470,-0.6351351351351351,1464100,547600,-916500
955000.0,4,3.25,3720,6765,2.0,0,0,2,9,3720,0,2012,0.0,98053,47.688,-122.01799999999999,3100,6790,3045,0.4501108647450111,13838400,45765225,31926825
982000.0,4,2.75,3610,8580,2.0,0,0,2,9,3610,0,2014,0.0,98033,47.6706,-122.17299999999999,2360,8580,4970,0.5792540792540792,13032100,73616400,60584300
359000.0,3,1.5,1360,885,3.0,0,0,2,8,1360,0,2008,0.0,98103,47.6961,-122.34899999999999,1360,1167,-475,-0.536723163841808,1849600,783225,-1066375
779380.0,5,2.5,2590,7084,2.0,0,0,2,8,2590,0,2014,0.0,98052,47.7053,-122.113,3010,4823,4494,0.6343873517786561,6708100,50183056,43474956
1510000.0,5,3.25,4390,11250,2.0,0,0,2,10,4390,0,2007,0.0,98040,47.5785,-122.225,2160,9249,6860,0.6097777777777778,19272100,126562500,107290400
635000.0,3,3.0,2290,1407,2.5,0,0,2,8,1890,400,2014,0.0,98027,47.5446,-122.01700000000001,2230,1407,-883,-0.6275764036958067,5244100,1979649,-3264451
1060000.0,4,3.75,3880,9979,2.5,0,0,2,10,3880,0,2007,0.0,98029,47.5408,-121.992,3130,6112,6099,0.6111834853191702,15054400,99580441,84526041
389500.0,3,2.5,1350,874,3.0,0,0,2,8,1270,80,2006,0.0,98136,47.549,-122.387,1350,886,-476,-0.5446224256292906,1822500,763876,-1058624
359800.0,5,2.5,2170,2752,2.0,0,0,2,8,2170,0,2014,0.0,98106,47.5165,-122.346,1800,2752,582,0.21148255813953487,4708900,7573504,2864604
399950.0,3,3.0,1296,1051,3.0,0,0,2,8,1296,0,2009,0.0,98125,47.7175,-122.28399999999999,1520,1939,-245,-0.23311132254995243,1679616,1104601,-575015
320000.0,3,3.25,1530,1602,2.0,0,0,2,8,1140,390,2013,0.0,98106,47.5555,-122.36200000000001,1450,1198,72,0.0449438202247191,2340900,2566404,225504
255900.0,3,2.5,1489,3266,2.0,0,0,2,7,1489,0,2014,0.0,98002,47.3452,-122.21700000000001,1537,3273,1777,0.5440906307409675,2217121,10666756,8449635
380000.0,4,2.5,2130,4467,2.0,0,0,2,8,2130,0,2014,0.0,98146,47.5108,-122.363,1830,8160,2337,0.5231699126930826,4536900,19954089,15417189
580000.0,3,2.75,1430,1521,2.0,0,0,2,9,1130,300,2009,0.0,98119,47.6353,-122.37100000000001,1930,2700,91,0.05982905982905983,2044900,2313441,268541
545000.0,5,3.75,2380,7268,1.0,0,0,2,8,1430,950,2008,0.0,98106,47.5571,-122.35700000000001,2040,10810,4888,0.6725371491469455,5664400,52823824,47159424
451300.0,3,2.5,1420,814,2.0,0,0,2,8,1140,280,2008,0.0,98136,47.5429,-122.387,1340,1382,-606,-0.7444717444717445,2016400,662596,-1353804
852880.0,4,3.25,3450,6184,2.0,0,0,2,9,3450,0,2014,0.0,98074,47.6072,-122.054,3020,5369,2734,0.4421086675291074,11902500,38241856,26339356
305000.0,4,2.5,1914,3150,2.0,0,0,2,8,1914,0,2009,0.0,98055,47.43,-122.18799999999999,1714,3164,1236,0.3923809523809524,3663396,9922500,6259104
295000.0,2,1.5,988,1080,3.0,0,0,2,7,988,0,2007,0.0,98125,47.7123,-122.301,1128,1080,92,0.08518518518518518,976144,1166400,190256
261000.0,3,2.25,1584,2800,2.0,0,0,2,7,1584,0,2012,0.0,98002,47.3451,-122.214,1584,2800,1216,0.4342857142857143,2509056,7840000,5330944
560000.0,4,2.5,2630,5710,2.0,0,0,2,8,2630,0,2001,0.0,98065,47.5342,-121.876,2550,5500,3080,0.5394045534150613,6916900,32604100,25687200
795000.0,4,3.25,3520,5250,2.0,0,0,2,9,3520,0,2012,0.0,98053,47.6869,-122.01899999999999,3220,5781,1730,0.3295238095238095,12390400,27562500,15172100
384950.0,4,2.5,2380,4913,2.0,0,0,2,8,2380,0,2006,0.0,98038,47.3607,-122.038,2580,5311,2533,0.5155709342560554,5664400,24137569,18473169
500000.0,3,1.75,1410,1197,3.0,0,0,2,8,1410,0,2012,0.0,98103,47.6558,-122.348,1350,2512,-213,-0.17794486215538846,1988100,1432809,-555291
640000.0,4,3.5,3220,5741,2.0,0,0,2,9,3220,0,2013,0.0,98065,47.5169,-121.88600000000001,2960,6534,2521,0.4391221041630378,10368400,32959081,22590681
418000.0,4,3.25,3266,5969,2.0,0,0,2,8,3266,0,2014,0.0,98023,47.2975,-122.35,3087,5169,2703,0.45283967163679006,10666756,35628961,24962205
799000.0,3,2.0,2550,4794,2.0,0,0,2,9,2550,0,2007,0.0,98115,47.6955,-122.29,1630,5100,2244,0.46808510638297873,6502500,22982436,16479936
552900.0,4,3.5,3828,18900,2.5,0,0,2,9,3828,0,2014,0.0,98001,47.2851,-122.277,2120,18900,15072,0.7974603174603174,14653584,357210000,342556416
539950.0,3,2.25,1670,1596,3.0,0,0,2,8,1670,0,2014,0.0,98136,47.5402,-122.387,1640,1310,-74,-0.046365914786967416,2788900,2547216,-241684
524225.0,4,2.5,3056,11385,2.0,0,0,2,9,3056,0,2014,0.0,98001,47.2905,-122.264,2849,8607,8329,0.731576635924462,9339136,129618225,120279089
424950.0,2,1.5,1000,1188,3.0,0,0,2,8,1000,0,2005,0.0,98115,47.6823,-122.32700000000001,2300,3500,188,0.15824915824915825,1000000,1411344,411344
560000.0,3,3.25,1530,1786,2.0,0,0,2,8,1200,330,2007,0.0,98117,47.6783,-122.366,1390,2900,256,0.1433370660694289,2340900,3189796,848896
715000.0,5,3.0,3490,6091,2.0,0,0,2,9,3490,0,2009,0.0,98011,47.7744,-122.225,2870,5932,2601,0.4270234772615334,12180100,37100281,24920181
300000.0,5,2.5,2760,6000,2.0,0,0,2,8,2760,0,2006,0.0,98108,47.5289,-122.321,1360,6000,3240,0.54,7617600,36000000,28382400
405000.0,3,2.5,1440,2163,2.0,0,0,2,7,1440,0,2005,0.0,98029,47.553999999999995,-121.99799999999999,1440,2207,723,0.3342579750346741,2073600,4678569,2604969
327000.0,3,3.0,1370,1001,3.0,0,0,2,8,1370,0,2009,0.0,98133,47.7302,-122.355,1399,1151,-369,-0.36863136863136864,1876900,1002001,-874899
859950.0,6,4.0,3180,6551,2.0,0,0,2,9,3180,0,2014,0.0,98074,47.6236,-122.023,3230,7602,3371,0.5145779270340406,10112400,42915601,32803201
560000.0,4,3.0,2720,7570,2.0,0,0,2,9,2720,0,2008,0.0,98133,47.7113,-122.34899999999999,1770,5705,4850,0.6406869220607662,7398400,57304900,49906500
379900.0,3,2.5,1800,2792,2.0,0,0,2,8,1800,0,2011,0.0,98126,47.5442,-122.37100000000001,1580,2617,992,0.3553008595988539,3240000,7795264,4555264
625000.0,3,2.5,3220,6409,2.0,0,0,2,9,3220,0,2008,0.0,98059,47.4815,-122.12700000000001,3330,6231,3189,0.4975815259790919,10368400,41075281,30706881
398096.0,3,2.5,2370,5321,2.0,0,0,2,8,2370,0,2014,0.0,98038,47.37,-122.01899999999999,2370,4357,2951,0.554595000939673,5616900,28313041,22696141
315000.0,3,2.5,1410,1325,2.0,0,0,2,7,1180,230,2007,0.0,98106,47.5582,-122.363,1270,1282,-85,-0.06415094339622641,1988100,1755625,-232475
939000.0,4,3.5,3640,6049,2.0,0,0,2,9,3640,0,2014,0.0,98052,47.7049,-122.125,3590,6104,2409,0.39824764423871717,13249600,36590401,23340801
674000.0,3,2.5,1920,3624,2.0,0,0,2,9,1920,0,2003,0.0,98052,47.6647,-122.087,1930,3533,1704,0.47019867549668876,3686400,13133376,9446976
306000.0,4,2.5,2267,3577,2.0,0,0,2,7,2267,0,2014,0.0,98092,47.3384,-122.18,2056,3577,1310,0.36622868325412355,5139289,12794929,7655640
2320000.0,5,4.75,5780,17004,2.0,0,0,2,11,4260,1520,2006,0.0,98040,47.5802,-122.212,3460,10855,11224,0.6600799811808986,33408400,289136016,255727616
394950.0,2,1.0,1131,1304,3.0,0,0,2,7,1131,0,2011,0.0,98115,47.6912,-122.31299999999999,1131,1992,173,0.13266871165644173,1279161,1700416,421255
914154.0,3,3.5,2940,6431,2.0,0,0,2,10,2940,0,2014,0.0,98075,47.5818,-122.04700000000001,2760,6695,3491,0.5428393717928782,8643600,41357761,32714161
496000.0,3,2.5,2180,4533,2.0,0,0,2,7,2180,0,2010,0.0,98011,47.754,-122.215,2180,7347,2353,0.5190822854621663,4752400,20548089,15795689
430100.0,3,2.25,1400,1078,2.0,0,0,2,8,940,460,2009,0.0,98144,47.5701,-122.288,1420,1230,-322,-0.2987012987012987,1960000,1162084,-797916
449990.0,4,2.5,2680,5539,2.0,0,0,2,8,2680,0,2013,0.0,98045,47.4759,-121.734,2680,5992,2859,0.5161581512908467,7182400,30680521,23498121
502000.0,4,2.5,2680,5539,2.0,0,0,2,8,2680,0,2013,0.0,98045,47.4759,-121.734,2680,5992,2859,0.5161581512908467,7182400,30680521,23498121
310000.0,3,2.5,1300,3612,2.0,0,0,2,7,1300,0,2005,0.0,98118,47.5328,-122.28200000000001,1390,2943,2312,0.6400885935769657,1690000,13046544,11356544
349950.0,4,3.5,2796,3520,2.5,0,0,2,8,2796,0,2013,0.0,98001,47.3427,-122.27799999999999,2040,5195,724,0.2056818181818182,7817616,12390400,4572784
625000.0,2,1.75,1460,1500,2.0,0,0,2,8,1000,460,2008,0.0,98103,47.6853,-122.35600000000001,1440,4120,40,0.02666666666666667,2131600,2250000,118400
1050000.0,4,3.5,4210,6481,2.0,0,3,2,9,3260,950,2014,0.0,98075,47.5765,-122.072,3920,5331,2271,0.35040888751735844,17724100,42003361,24279261
680000.0,4,2.75,2330,3920,2.0,0,0,2,9,2330,0,2005,0.0,98029,47.5525,-121.99,2410,4063,1590,0.40561224489795916,5428900,15366400,9937500
828950.0,4,3.5,3930,5680,2.0,0,1,2,9,2820,1110,2013,0.0,98027,47.5528,-122.07600000000001,3700,5816,1750,0.30809859154929575,15444900,32262400,16817500
274950.0,3,2.5,1608,4000,2.0,0,0,2,8,1608,0,2014,0.0,98092,47.2582,-122.198,2009,4983,2392,0.598,2585664,16000000,13414336
293000.0,2,2.25,1610,1968,2.0,0,0,3,7,1610,0,1979,0.0,98056,47.5184,-122.196,1950,1968,358,0.18191056910569106,2592100,3873024,1280924
795000.0,4,3.5,3200,3250,2.0,0,0,2,9,2670,530,2007,0.0,98029,47.5515,-122.0,3400,3663,50,0.015384615384615385,10240000,10562500,322500
282900.0,4,2.5,1710,3500,2.0,0,0,2,7,1710,0,2014,0.0,98002,47.3448,-122.21700000000001,1710,3500,1790,0.5114285714285715,2924100,12250000,9325900
909950.0,5,3.75,3050,8972,2.0,0,0,2,9,3050,0,2014,0.0,98033,47.6819,-122.17200000000001,2750,8979,5922,0.6600534997770843,9302500,80496784,71194284
922755.0,4,3.5,3560,4951,2.0,0,0,2,9,3560,0,2014,0.0,98074,47.6178,-122.055,3540,5500,1391,0.2809533427590386,12673600,24512401,11838801
424000.0,4,2.5,2650,8685,2.0,0,0,2,9,2650,0,2006,0.0,98001,47.343999999999994,-122.26899999999999,2650,7932,6035,0.6948762233736328,7022500,75429225,68406725
630000.0,3,2.5,3490,12410,2.0,0,0,2,8,2590,900,2009,0.0,98059,47.4714,-122.071,1740,14448,8920,0.7187751813053989,12180100,154008100,141828000
810000.0,4,3.25,4140,46173,2.0,0,0,2,9,4140,0,2007,0.0,98011,47.7647,-122.213,2060,43103,42033,0.910337210057826,17139600,2131945929,2114806329
256703.0,3,2.0,1670,4441,1.0,0,0,2,7,1670,0,2014,0.0,98022,47.1948,-121.975,1670,4622,2771,0.6239585678901148,2788900,19722481,16933581
386380.0,3,2.5,1720,3600,2.0,0,0,2,7,1720,0,2010,0.0,98053,47.6856,-122.01299999999999,1720,3600,1880,0.5222222222222223,2958400,12960000,10001600
485000.0,2,2.0,1510,3961,1.0,0,0,2,8,1510,0,2010,0.0,98053,47.708999999999996,-122.01799999999999,1510,3962,2451,0.6187831355718253,2280100,15689521,13409421
275000.0,3,2.25,1450,4040,2.0,0,0,2,7,1450,0,2010,0.0,98038,47.3665,-122.022,1610,4040,2590,0.6410891089108911,2102500,16321600,14219100
370000.0,4,2.5,1812,5026,2.0,0,0,2,8,1812,0,2011,0.0,98055,47.4513,-122.20200000000001,2440,6007,3214,0.6394747313967369,3283344,25260676,21977332
499950.0,2,2.25,1060,1208,2.0,0,0,2,8,940,120,2005,0.0,98102,47.6371,-122.32700000000001,1300,1169,148,0.12251655629139073,1123600,1459264,335664
502000.0,3,2.5,1600,3073,3.0,0,0,2,8,1600,0,2009,0.0,98144,47.5934,-122.29799999999999,1130,2921,1473,0.4793361535958347,2560000,9443329,6883329
654000.0,3,3.25,1530,1565,2.0,0,0,2,8,1280,250,2005,0.0,98122,47.6179,-122.31200000000001,1530,1381,35,0.022364217252396165,2340900,2449225,108325
575000.0,4,2.25,2070,1230,3.0,0,0,2,9,1500,570,2013,0.0,98116,47.5775,-122.41,1569,4802,-840,-0.6829268292682927,4284900,1512900,-2772000
500000.0,4,2.5,3630,7482,2.0,0,0,2,10,3630,0,2008,0.0,98188,47.4565,-122.287,1600,15716,3852,0.5148356054530874,13176900,55980324,42803424
554000.0,3,2.5,2140,4126,2.0,0,0,2,8,1960,180,2005,0.0,98027,47.5368,-122.073,2280,2615,1986,0.4813378574890936,4579600,17023876,12444276
360000.0,4,1.75,2010,12188,1.0,0,0,3,7,1150,860,1960,0.0,98059,47.5013,-122.147,1720,8475,10178,0.8350836888743026,4040100,148547344,144507244
619990.0,4,2.75,2630,4501,2.0,0,0,2,8,2630,0,2015,0.0,98028,47.7748,-122.244,2380,4599,1871,0.4156854032437236,6916900,20259001,13342101
317500.0,4,2.5,2233,6025,2.0,0,0,2,7,2233,0,2012,0.0,98001,47.2599,-122.256,1544,6036,3792,0.6293775933609959,4986289,36300625,31314336
564950.0,4,2.75,2990,4521,2.0,0,0,2,7,2990,0,2014,0.0,98028,47.7401,-122.226,2580,7539,1531,0.3386418933864189,8940100,20439441,11499341
545000.0,2,1.25,1240,2150,2.0,0,0,2,8,1240,0,2014,0.0,98117,47.6884,-122.374,1340,5289,910,0.4232558139534884,1537600,4622500,3084900
333700.0,3,2.5,2230,5050,2.0,0,0,2,7,2230,0,2006,0.0,98042,47.3359,-122.055,2260,5050,2820,0.5584158415841585,4972900,25502500,20529600
1480000.0,3,3.25,3700,2264,2.0,0,0,2,11,2280,1420,1998,0.0,98033,47.6653,-122.205,3930,2567,-1436,-0.6342756183745583,13690000,5125696,-8564304
530000.0,4,3.0,2290,5105,2.0,0,0,2,8,2290,0,2012,0.0,98028,47.7727,-122.23700000000001,2450,5105,2815,0.5514201762977473,5244100,26061025,20816925
396000.0,2,1.5,950,865,3.0,0,0,2,8,950,0,2006,0.0,98107,47.6714,-122.382,1290,1189,-85,-0.09826589595375723,902500,748225,-154275
305000.0,2,1.75,1120,758,2.0,0,0,2,7,1120,0,2012,0.0,98027,47.5325,-122.072,1150,758,-362,-0.47757255936675463,1254400,574564,-679836
380000.0,5,3.5,2420,4670,2.0,0,0,2,7,2420,0,2013,0.0,98118,47.5241,-122.285,1430,4468,2250,0.4817987152034261,5856400,21808900,15952500
305000.0,4,2.5,1714,3250,2.0,0,0,2,8,1714,0,2010,0.0,98055,47.428999999999995,-122.189,1714,3250,1536,0.4726153846153846,2937796,10562500,7624704
440000.0,4,2.5,2230,5650,2.0,0,0,2,7,2230,0,2011,0.0,98056,47.5073,-122.16799999999999,1590,7241,3420,0.6053097345132743,4972900,31922500,26949600
459000.0,4,3.0,2530,10000,2.0,0,0,2,7,2530,0,2013,0.0,98148,47.431000000000004,-122.335,1420,9898,7470,0.747,6400900,100000000,93599100
530000.0,3,3.5,1550,1233,2.0,0,0,2,8,1160,390,2005,0.0,98122,47.6034,-122.309,1490,1539,-317,-0.2570965125709651,2402500,1520289,-882211
600000.0,4,2.75,3110,11225,2.0,0,0,2,8,3110,0,2012,0.0,98059,47.4865,-122.14299999999999,2610,8535,8115,0.7229398663697104,9672100,126000625,116328525
515000.0,3,3.0,2100,2409,2.0,0,0,2,8,1660,440,2008,0.0,98144,47.5973,-122.29799999999999,1900,2400,309,0.12826899128268993,4410000,5803281,1393281
275000.0,4,2.5,2150,3721,2.0,0,0,2,8,2150,0,2007,0.0,98002,47.3363,-122.215,2150,3721,1571,0.4221983337812416,4622500,13845841,9223341
540000.0,3,1.75,1630,1404,2.0,0,0,2,8,1020,610,2014,0.0,98107,47.6646,-122.367,1420,1670,-226,-0.16096866096866097,2656900,1971216,-685684
445000.0,3,2.5,2230,7934,2.0,0,0,2,7,2230,0,2005,0.0,98065,47.5439,-121.88,2310,4818,5704,0.7189311822535921,4972900,62948356,57975456
285000.0,3,2.5,1320,955,3.0,0,0,2,7,1320,0,2009,0.0,98106,47.5202,-122.35700000000001,1300,1003,-365,-0.38219895287958117,1742400,912025,-830375
480000.0,3,2.5,1590,1431,2.0,0,0,2,8,1060,0,2010,0.0,98144,47.5893,-122.309,1620,1548,-159,-0.1111111111111111,2528100,2047761,-480339
440000.0,5,3.25,2610,3642,2.0,0,0,2,8,2080,530,2005,0.0,98118,47.535,-122.28399999999999,1750,3118,1032,0.2833607907742998,6812100,13264164,6452064
287450.0,3,2.5,1440,2500,2.0,0,0,2,7,1440,0,2008,0.0,98146,47.5123,-122.35799999999999,1440,5000,1060,0.424,2073600,6250000,4176400
507950.0,4,2.5,2630,6283,2.0,0,0,2,9,2630,0,2006,0.0,98059,47.5079,-122.15799999999999,2630,7210,3653,0.581410154384848,6916900,39476089,32559189
750000.0,3,3.5,3390,10078,2.0,0,0,2,10,3040,350,2012,0.0,98056,47.537,-122.185,3290,12332,6688,0.6636237348680294,11492100,101566084,90073984
425000.0,3,1.5,1400,1022,3.0,0,0,2,8,1400,0,2007,0.0,98115,47.6989,-122.31700000000001,1270,1205,-378,-0.3698630136986301,1960000,1044484,-915516
420000.0,3,3.5,1900,2133,2.0,0,0,2,8,1520,380,2009,0.0,98126,47.5675,-122.369,1530,3264,233,0.10923581809657759,3610000,4549689,939689
394950.0,3,2.5,1350,1250,3.0,0,0,2,8,1270,80,2006,0.0,98136,47.5491,-122.387,1350,886,-100,-0.08,1822500,1562500,-260000
635000.0,4,3.25,3420,6752,2.0,0,2,2,9,3030,390,2012,0.0,98065,47.516999999999996,-121.876,3010,5172,3332,0.4934834123222749,11696400,45589504,33893104
513000.0,3,2.5,2150,161607,2.0,0,0,2,7,1330,820,1995,0.0,98038,47.4178,-121.93700000000001,2400,207781,159457,0.9866961208363499,4622500,26116822449,26112199949
380000.0,4,2.5,2110,5306,2.0,0,0,2,8,2110,0,2012,0.0,98038,47.356,-122.057,2250,5306,3196,0.6023369770071617,4452100,28153636,23701536
1130000.0,4,3.25,3810,8519,1.0,0,1,2,10,2680,1130,2007,0.0,98033,47.699,-122.20700000000001,3240,10748,4709,0.5527644089681888,14516100,72573361,58057261
540000.0,5,3.0,2870,4369,2.0,0,0,2,8,2090,780,2007,0.0,98011,47.7449,-122.19200000000001,2640,4610,1499,0.34309910734721905,8236900,19088161,10851261
352499.0,2,2.25,1240,705,2.0,0,0,2,7,1150,90,2009,0.0,98027,47.5321,-122.073,1240,750,-535,-0.7588652482269503,1537600,497025,-1040575
603000.0,4,3.5,3610,6345,2.0,0,0,2,9,2370,1240,2008,0.0,98058,47.4283,-122.102,3010,29279,2735,0.4310480693459417,13032100,40259025,27226925
685000.0,4,2.5,2310,5100,2.0,0,0,2,9,2310,0,2013,0.0,98177,47.7039,-122.36,1260,5100,2790,0.5470588235294118,5336100,26010000,20673900
330675.0,4,3.0,1930,3031,1.0,0,0,2,7,1200,730,2006,0.0,98019,47.7457,-121.985,1930,2611,1101,0.3632464533157374,3724900,9186961,5462061
275000.0,3,3.0,1390,1080,2.0,0,0,2,7,1140,250,2006,0.0,98118,47.5323,-122.281,1450,1081,-310,-0.28703703703703703,1932100,1166400,-765700
259950.0,3,2.5,1578,7340,2.0,0,0,2,7,1578,0,2010,0.0,98030,47.3771,-122.186,1850,7200,5762,0.7850136239782016,2490084,53875600,51385516
441000.0,3,2.0,1720,15000,1.0,0,0,2,9,1720,0,2011,0.0,98014,47.6927,-121.92,1900,15337,13280,0.8853333333333333,2958400,225000000,222041600
1140000.0,5,3.75,4700,11237,2.0,0,0,2,10,2930,1770,2006,0.0,98033,47.6624,-122.197,3180,13140,6537,0.5817388982824597,22090000,126270169,104180169
590000.0,3,3.5,1970,5079,2.0,0,0,2,8,1680,290,2007,0.0,98144,47.5816,-122.296,1940,6000,3109,0.6121283717267179,3880900,25796241,21915341
497000.0,3,2.25,1460,1353,2.0,0,0,2,8,1050,410,2012,0.0,98116,47.5774,-122.412,1690,3776,-107,-0.07908351810790835,2131600,1830609,-300991
345500.0,3,2.5,1930,4000,2.0,0,0,2,8,1930,0,2014,0.0,98001,47.3518,-122.275,2050,4000,2070,0.5175,3724900,16000000,12275100
562500.0,3,2.25,1300,907,2.0,0,0,2,8,1000,300,2006,0.0,98102,47.6371,-122.32700000000001,1300,1169,-393,-0.43329658213891953,1690000,822649,-867351
355000.0,3,2.25,1445,1087,2.0,0,0,2,7,1300,145,2005,0.0,98027,47.5339,-122.06700000000001,1410,1336,-358,-0.32934682612695493,2088025,1181569,-906456
345000.0,2,2.25,860,696,2.0,0,0,2,9,860,0,2009,0.0,98118,47.5663,-122.29,1100,3000,-164,-0.23563218390804597,739600,484416,-255184
478000.0,3,2.5,3040,4535,2.0,0,0,2,9,3040,0,2007,0.0,98056,47.51,-122.185,2670,4666,1495,0.3296582138919515,9241600,20566225,11324625
391500.0,3,2.5,2424,6143,2.0,0,0,2,9,2424,0,2014,0.0,98030,47.3512,-122.135,2381,6036,3719,0.6054045254761518,5875776,37736449,31860673
265000.0,2,1.5,1084,3427,2.0,0,0,2,7,1084,0,1976,0.0,98125,47.7117,-122.32600000000001,1084,6250,2343,0.6836883571637,1175056,11744329,10569273
395000.0,3,2.5,2510,5320,2.0,0,0,2,8,2510,0,2005,0.0,98106,47.5374,-122.35700000000001,1820,5736,2810,0.5281954887218046,6300100,28302400,22002300
286308.0,2,1.5,1220,1036,3.0,0,0,2,7,1220,0,2006,0.0,98133,47.7348,-122.34700000000001,1210,659,-184,-0.1776061776061776,1488400,1073296,-415104
370000.0,2,2.25,1280,835,2.0,0,0,2,7,1080,200,2009,0.0,98118,47.5592,-122.28399999999999,1280,1246,-445,-0.5329341317365269,1638400,697225,-941175
1080000.0,5,3.5,3740,5610,2.0,0,0,2,9,2860,880,2014,0.0,98117,47.6764,-122.39200000000001,1520,4590,1870,0.3333333333333333,13987600,31472100,17484500
298900.0,3,2.5,1852,4000,2.0,0,0,2,7,1852,0,2014,0.0,98002,47.3451,-122.209,2475,4000,2148,0.537,3429904,16000000,12570096
775000.0,4,2.5,2580,5787,2.0,0,0,2,9,2580,0,2007,0.0,98029,47.5416,-121.994,2580,4410,3207,0.5541731467081389,6656400,33489369,26832969
790000.0,4,3.5,3190,31450,2.0,0,0,2,9,3190,0,2010,0.0,98027,47.50100000000001,-121.902,3000,72745,28260,0.8985691573926868,10176100,989102500,978926400
1050000.0,3,2.5,3400,5119,2.0,0,0,2,8,2300,1100,2014,0.0,98115,47.6843,-122.305,1740,5969,1719,0.3358077749560461,11560000,26204161,14644161
249000.0,2,1.5,1090,2686,2.0,0,0,2,7,1090,0,1982,0.0,98034,47.717,-122.19,1160,2158,1596,0.5941921072226359,1188100,7214596,6026496
348000.0,3,2.0,2360,6145,1.0,0,0,2,8,2360,0,2011,0.0,98030,47.3564,-122.198,2304,5880,3785,0.6159479251423922,5569600,37761025,32191425
358000.0,5,2.5,2460,5604,2.0,0,0,2,8,2460,0,2011,0.0,98038,47.3658,-122.037,2210,6395,3144,0.5610278372591007,6051600,31404816,25353216
260000.0,5,2.5,2025,7760,2.0,0,0,2,7,2025,0,2007,0.0,98001,47.2671,-122.256,1664,9000,5735,0.7390463917525774,4100625,60217600,56116975
765000.0,4,3.0,4410,5104,2.0,0,0,2,9,3400,1010,2006,0.0,98065,47.5392,-121.861,4390,5537,694,0.1359717868338558,19448100,26050816,6602716
739000.0,3,2.5,2810,5400,2.0,0,0,2,9,2810,0,2005,0.0,98052,47.7065,-122.118,2870,5400,2590,0.47962962962962963,7896100,29160000,21263900
890000.0,5,3.5,4490,6000,2.0,0,0,2,10,3200,1290,2006,0.0,98027,47.5396,-122.073,4530,6000,1510,0.25166666666666665,20160100,36000000,15839900
462000.0,4,2.5,3070,6432,2.0,0,0,2,9,3070,0,2006,0.0,98055,47.4487,-122.205,2910,5106,3362,0.5226990049751243,9424900,41370624,31945724
380000.0,4,2.5,1984,32400,1.0,0,0,2,8,1564,420,1962,0.0,98198,47.36,-122.318,1390,9152,30416,0.9387654320987654,3936256,1049760000,1045823744
770000.0,5,3.5,4750,8234,2.0,0,2,2,10,3350,1400,2013,0.0,98198,47.3574,-122.318,2160,14496,3484,0.4231236337138693,22562500,67798756,45236256
641000.0,4,3.25,2760,4104,2.0,0,0,2,8,1900,860,2014,0.0,98056,47.5286,-122.18700000000001,2760,5186,1344,0.32748538011695905,7617600,16842816,9225216
2300000.0,4,4.0,4360,8175,2.5,1,4,2,10,3940,420,2007,0.0,98008,47.5724,-122.104,2670,8525,3815,0.4666666666666667,19009600,66830625,47821025
369000.0,4,2.5,3060,27251,1.5,0,0,2,8,3060,0,2008,0.0,98022,47.1967,-121.96600000000001,1760,27251,24191,0.8877105427323768,9363600,742617001,733253401
1110000.0,4,3.0,2770,2650,2.0,0,0,2,9,2180,590,2014,0.0,98109,47.6435,-122.354,1820,2960,-120,-0.045283018867924525,7672900,7022500,-650400
357000.0,5,2.5,2990,9240,2.0,0,0,2,8,2990,0,2015,0.0,98133,47.7384,-122.348,1970,18110,6250,0.6764069264069265,8940100,85377600,76437500
650000.0,3,2.75,1540,1251,2.0,0,0,2,8,1230,310,2002,0.0,98102,47.6298,-122.321,1540,1287,-289,-0.23101518784972022,2371600,1565001,-806599
563500.0,3,2.5,1400,1312,3.5,0,0,2,8,1400,0,2007,0.0,98103,47.6534,-122.355,1350,1312,-88,-0.06707317073170732,1960000,1721344,-238656
345000.0,3,2.5,1680,2229,2.0,0,0,2,7,1680,0,2007,0.0,98155,47.7484,-122.322,1230,9300,549,0.24629878869448182,2822400,4968441,2146041
479950.0,3,2.0,2260,7163,1.0,0,0,2,9,2260,0,2012,0.0,98058,47.4593,-122.13600000000001,2340,6730,4903,0.6844897389361999,5107600,51308569,46200969
660000.0,4,3.5,3400,5196,2.0,0,0,2,9,3400,0,2012,0.0,98065,47.5169,-121.884,3170,5260,1796,0.34565050038491146,11560000,26998416,15438416
800000.0,4,2.5,2930,5000,2.0,0,0,2,9,2760,170,2007,0.0,98006,47.5424,-122.12,3230,5778,2070,0.414,8584900,25000000,16415100
253101.0,3,2.0,1239,6036,1.0,0,0,2,7,1239,0,2009,0.0,98030,47.3689,-122.175,2060,5746,4797,0.7947316103379721,1535121,36433296,34898175
555000.0,3,3.5,2100,2479,2.0,0,0,2,9,1450,650,2011,0.0,98118,47.562,-122.292,1800,2457,379,0.15288422751109318,4410000,6145441,1735441
240000.0,4,1.0,1200,2171,1.5,0,0,2,7,1200,0,1933,0.0,98133,47.7076,-122.34200000000001,1130,1598,971,0.44725932749884845,1440000,4713241,3273241
380000.0,4,1.0,1200,2171,1.5,0,0,2,7,1200,0,1933,0.0,98133,47.7076,-122.34200000000001,1130,1598,971,0.44725932749884845,1440000,4713241,3273241
239000.0,2,1.5,680,772,2.0,0,0,2,7,680,0,2005,0.0,98103,47.695,-122.34299999999999,690,1059,92,0.11917098445595854,462400,595984,133584
760000.0,4,3.25,2690,3995,2.0,0,0,2,9,2060,0,2014,0.0,98136,47.532,-122.384,1810,4590,1305,0.32665832290362956,7236100,15960025,8723925
430000.0,4,2.5,2750,7200,2.0,0,0,2,8,2750,0,2011,0.0,98019,47.7327,-121.96600000000001,2750,7200,4450,0.6180555555555556,7562500,51840000,44277500
660000.0,3,2.5,2450,4332,2.0,0,0,2,8,2450,0,2010,0.0,98053,47.6942,-122.016,2450,4154,1882,0.4344413665743306,6002500,18766224,12763724
399963.0,4,2.5,2620,4050,2.0,0,0,2,8,2620,0,2014,0.0,98146,47.5017,-122.34,2030,3944,1430,0.3530864197530864,6864400,16402500,9538100
411000.0,2,2.0,1130,1148,2.0,0,0,2,9,800,330,2007,0.0,98122,47.6023,-122.314,1350,1201,18,0.0156794425087108,1276900,1317904,41004
483453.0,4,2.75,2790,5527,2.0,0,0,2,8,2790,0,2014,0.0,98045,47.4827,-121.773,2620,5509,2737,0.4952053555274109,7784100,30547729,22763629
469950.0,3,2.0,1820,1357,3.0,0,0,2,9,1820,0,2014,0.0,98126,47.5432,-122.376,1710,1372,-463,-0.34119380987472364,3312400,1841449,-1470951
504058.0,4,2.75,2910,7467,2.0,0,0,2,8,2910,0,2013,0.0,98045,47.4841,-121.772,2790,7868,4557,0.6102852551225392,8468100,55756089,47287989
425996.0,4,2.5,2568,5000,2.0,0,0,2,9,2568,0,2014,0.0,98092,47.2596,-122.194,2547,4500,2432,0.4864,6594624,25000000,18405376
760005.0,4,2.75,3090,5859,2.0,0,0,2,9,3090,0,2010,0.0,98074,47.6057,-122.04700000000001,2960,5250,2769,0.4726062467997952,9548100,34327881,24779781
699999.0,2,2.0,1460,1085,2.0,0,0,2,8,950,510,2014,0.0,98112,47.6205,-122.29899999999999,1580,1202,-375,-0.3456221198156682,2131600,1177225,-954375
749950.0,3,2.5,2010,2263,2.0,0,0,2,8,1340,670,2014,0.0,98122,47.6088,-122.311,1500,2670,253,0.11179849756959788,4040100,5121169,1081069
674600.0,4,2.5,2610,5140,2.0,0,0,2,8,2610,0,2006,0.0,98103,47.6951,-122.346,1190,5101,2530,0.49221789883268485,6812100,26419600,19607500
450000.0,2,1.5,960,1000,2.0,0,0,2,8,920,40,2008,0.0,98103,47.6489,-122.335,1200,1297,40,0.04,921600,1000000,78400
272000.0,3,2.5,1528,7616,2.0,0,0,2,7,1528,0,2011,0.0,98030,47.3774,-122.186,1850,7340,6088,0.7993697478991597,2334784,58003456,55668672
450000.0,2,1.5,1310,1264,2.0,0,0,2,8,1120,190,2006,0.0,98106,47.5772,-122.40899999999999,1330,1265,-46,-0.03639240506329114,1716100,1597696,-118404
643950.0,3,2.25,1760,2122,3.0,0,0,2,9,1760,0,2015,0.0,98116,47.5633,-122.385,1420,1618,362,0.1705937794533459,3097600,4502884,1405284
290000.0,3,2.5,1420,3542,2.0,0,0,2,8,1310,110,2007,0.0,98133,47.7731,-122.34299999999999,1180,1622,2122,0.5990965556182948,2016400,12545764,10529364
378000.0,3,2.5,1650,2082,3.0,0,0,2,8,1650,0,2007,0.0,98133,47.7108,-122.33200000000001,1650,1965,432,0.207492795389049,2722500,4334724,1612224
728050.0,3,2.5,2320,6775,1.0,0,0,2,8,2320,0,2008,0.0,98053,47.7158,-122.016,1680,4750,4455,0.6575645756457564,5382400,45900625,40518225
499160.0,4,2.5,2628,11466,2.0,0,0,2,9,2628,0,2014,0.0,98001,47.2904,-122.264,2849,10909,8838,0.7708006279434851,6906384,131469156,124562772
536000.0,4,2.5,2520,4831,2.0,0,0,2,8,2520,0,2009,0.0,98072,47.7711,-122.16799999999999,2430,3937,2311,0.4783688677292486,6350400,23338561,16988161
419900.0,5,3.5,2880,5000,2.0,0,0,2,8,2260,620,2012,0.0,98038,47.3455,-122.023,2590,4800,2120,0.424,8294400,25000000,16705600
469000.0,3,2.25,1440,1362,3.0,0,0,2,7,1440,0,2014,0.0,98117,47.6908,-122.365,1180,2603,-78,-0.05726872246696035,2073600,1855044,-218556
374000.0,3,2.5,2185,6042,2.0,0,0,2,9,2185,0,2009,0.0,98030,47.3573,-122.20200000000001,2297,5876,3857,0.6383647798742138,4774225,36505764,31731539
182568.0,4,1.5,1500,2106,2.0,0,0,2,7,1500,0,2014,0.0,98108,47.5669,-122.29700000000001,1490,2175,606,0.28774928774928776,2250000,4435236,2185236
334888.0,3,2.5,1769,7324,2.0,0,0,2,9,1769,0,2012,0.0,98092,47.3307,-122.18799999999999,2502,6017,5555,0.7584653194975424,3129361,53640976,50511615
799900.0,4,4.0,3650,18223,2.0,0,3,2,9,3330,320,2013,0.0,98006,47.5442,-122.116,3220,11022,14573,0.7997036711847665,13322500,332077729,318755229
383000.0,4,2.5,2160,6223,2.0,0,0,2,8,2160,0,2010,0.0,98038,47.3494,-122.042,2160,5555,4063,0.6529005302908565,4665600,38725729,34060129
580000.0,3,2.5,1820,374616,2.0,0,0,2,7,1820,0,1999,0.0,98014,47.6539,-121.959,1870,220654,372796,0.9951416917590279,3312400,140337147456,140333835056
351999.0,3,2.5,2370,4200,2.0,0,0,2,8,2370,0,2014,0.0,98038,47.3706,-122.01700000000001,2370,4200,1830,0.4357142857142857,5616900,17640000,12023100
1330000.0,3,3.0,3180,2758,2.0,0,2,2,11,2240,940,2008,0.0,98109,47.6377,-122.34200000000001,2420,2758,-422,-0.15300942712110224,10112400,7606564,-2505836
312000.0,3,2.5,1780,4077,2.0,0,0,2,8,1780,0,2011,0.0,98038,47.3568,-122.056,1970,4077,2297,0.5634044640667157,3168400,16621929,13453529
674950.0,4,3.5,2650,3127,2.0,0,0,2,8,2230,420,2011,0.0,98027,47.5381,-122.046,2330,3137,477,0.15254237288135594,7022500,9778129,2755629
1110000.0,5,2.75,3300,7560,2.0,0,0,2,10,3300,0,2007,0.0,98052,47.6467,-122.118,3150,8580,4260,0.5634920634920635,10890000,57153600,46263600
415000.0,2,2.5,1160,1219,3.0,0,0,2,8,1160,0,2007,0.0,98107,47.6543,-122.35799999999999,1320,2800,59,0.04840032813781788,1345600,1485961,140361
1250000.0,3,3.0,3460,5353,2.0,0,0,2,10,2850,610,2007,0.0,98116,47.5858,-122.39299999999999,2460,6325,1893,0.35363347655520266,11971600,28654609,16683009
208800.0,3,2.5,1390,2450,2.0,0,0,2,7,1390,0,2009,0.0,98118,47.5298,-122.26899999999999,1390,2450,1060,0.4326530612244898,1932100,6002500,4070400
452000.0,2,2.5,1260,1131,3.0,0,0,2,8,1260,0,2006,0.0,98107,47.6715,-122.384,1490,2500,-129,-0.11405835543766578,1587600,1279161,-308439
837000.0,5,2.75,2940,5225,2.0,0,0,2,8,2760,180,2010,0.0,98052,47.6879,-122.10700000000001,3090,6261,2285,0.43732057416267944,8643600,27300625,18657025
780000.0,5,3.5,3190,4247,2.0,0,0,2,8,2430,760,2013,0.0,98052,47.7016,-122.103,2580,3989,1057,0.24888156345655757,10176100,18037009,7860909
1490000.0,4,3.5,3930,6120,2.0,0,0,2,10,3310,620,2007,0.0,98105,47.6646,-122.28,3390,6120,2190,0.35784313725490197,15444900,37454400,22009500
1600000.0,5,3.75,3570,10125,2.0,0,0,2,10,3570,0,2014,0.0,98040,47.5639,-122.223,1760,10125,6555,0.6474074074074074,12744900,102515625,89770725
369946.0,3,2.5,2420,4725,2.0,0,0,2,8,2420,0,2014,0.0,98038,47.371,-122.01799999999999,2370,4200,2305,0.48783068783068784,5856400,22325625,16469225
530000.0,3,2.75,3400,7200,2.0,0,2,2,9,2470,930,2009,0.0,98056,47.4878,-122.191,1580,8676,3800,0.5277777777777778,11560000,51840000,40280000
386000.0,4,2.5,2478,6079,2.0,0,0,2,8,2478,0,2012,0.0,98030,47.3524,-122.175,2279,6079,3601,0.5923671656522455,6140484,36954241,30813757
1900000.0,4,2.5,3070,7830,2.0,0,2,2,11,1970,1100,2009,0.0,98144,47.593,-122.291,2440,4682,4760,0.6079182630906769,9424900,61308900,51884000
735000.0,4,3.5,3200,7605,2.0,0,2,2,9,2500,700,2013,0.0,98198,47.3443,-122.32700000000001,2240,4416,4405,0.57922419460881,10240000,57836025,47596025
1750000.0,5,3.25,5790,12739,2.0,0,3,2,10,4430,1360,2014,0.0,98006,47.538000000000004,-122.11399999999999,5790,13928,6949,0.5454902268623911,33524100,162282121,128758021
489950.0,3,2.25,1590,926,3.0,0,0,2,8,1590,0,2014,0.0,98136,47.5402,-122.387,1640,1321,-664,-0.7170626349892009,2528100,857476,-1670624
357500.0,3,3.0,1730,1442,2.0,0,0,2,8,1440,290,2008,0.0,98106,47.5344,-122.348,1370,1524,-288,-0.19972260748959778,2992900,2079364,-913536
329995.0,4,2.5,2303,3680,2.0,0,0,2,8,2303,0,2013,0.0,98001,47.2599,-122.28299999999999,2303,3760,1377,0.37418478260869564,5303809,13542400,8238591
414000.0,3,2.5,1790,3754,2.0,0,0,2,8,1790,0,2013,0.0,98065,47.534,-121.84100000000001,1800,3393,1964,0.5231752797016516,3204100,14092516,10888416
533500.0,3,3.5,2490,3517,2.0,0,0,2,8,1720,770,2005,0.0,98027,47.5341,-122.06700000000001,1600,2378,1027,0.292010235996588,6200100,12369289,6169189
402395.0,4,2.5,2669,5385,2.0,0,0,2,9,2669,0,2014,0.0,98092,47.3262,-122.165,2669,4645,2716,0.5043639740018571,7123561,28998225,21874664
725000.0,4,3.25,2610,2552,2.0,0,0,2,10,2160,450,2008,0.0,98027,47.5322,-122.07600000000001,2610,2664,-58,-0.022727272727272728,6812100,6512704,-299396
1280000.0,6,5.25,6160,27490,2.0,0,0,2,11,4040,2120,2007,0.0,98074,47.6094,-122.023,4225,9100,21330,0.775918515823936,37945600,755700100,717754500
239800.0,2,1.75,1290,1493,2.0,0,0,2,8,1290,0,2014,0.0,98106,47.5171,-122.346,1410,1875,203,0.13596784996651037,1664100,2229049,564949
616950.0,5,3.5,3560,5008,2.0,0,0,2,8,2810,750,2013,0.0,98106,47.5542,-122.359,2910,5026,1448,0.28913738019169327,12673600,25080064,12406464
1260000.0,4,3.25,4360,6000,2.0,0,3,2,11,3400,960,2007,0.0,98027,47.5408,-121.994,4310,6000,1640,0.2733333333333333,19009600,36000000,16990400
435000.0,3,2.25,1230,1238,2.0,0,0,2,8,1080,150,2009,0.0,98199,47.6519,-122.384,1230,953,8,0.006462035541195477,1512900,1532644,19744
925000.0,4,3.25,3640,60086,2.0,0,0,2,10,3640,0,2005,0.0,98074,47.6328,-122.016,2900,51721,56446,0.9394201644309823,13249600,3610327396,3597077796
631500.0,2,2.5,1780,2493,3.0,0,0,2,8,1780,0,1981,0.0,98107,47.6704,-122.35799999999999,2050,4400,713,0.2860008022462896,3168400,6215049,3046649
399995.0,3,1.5,1140,1069,3.0,0,0,2,8,1140,0,2005,0.0,98103,47.6907,-122.34200000000001,1230,1276,-71,-0.06641721234798878,1299600,1142761,-156839
369950.0,3,2.0,1270,1320,3.0,0,0,2,8,1270,0,2006,0.0,98103,47.6937,-122.34200000000001,1370,1320,50,0.03787878787878788,1612900,1742400,129500
475000.0,5,3.5,2780,3583,2.0,0,0,2,8,2180,600,2005,0.0,98059,47.4879,-122.152,2640,3850,803,0.2241138710577728,7728400,12837889,5109489
353000.0,4,2.5,1912,5000,2.0,0,0,2,8,1912,0,2012,0.0,98001,47.3511,-122.275,2020,5000,3088,0.6176,3655744,25000000,21344256
329950.0,4,2.5,2300,9690,2.0,0,0,2,8,2300,0,2006,0.0,98023,47.2793,-122.352,1200,9085,7390,0.762641898864809,5290000,93896100,88606100
367000.0,3,2.5,2828,4050,2.0,0,0,2,8,2828,0,2013,0.0,98030,47.382,-122.197,2513,4507,1222,0.3017283950617284,7997584,16402500,8404916
447500.0,4,2.5,2425,9017,2.0,0,0,2,9,2425,0,2013,0.0,98001,47.3003,-122.26299999999999,2725,7019,6592,0.7310635466341355,5880625,81306289,75425664
595000.0,4,3.25,3730,4560,2.0,0,0,2,9,2760,970,2015,0.0,98103,47.6725,-122.33,1800,4560,830,0.18201754385964913,13912900,20793600,6880700
325000.0,1,1.0,730,1942,1.0,0,0,2,7,730,0,2009,0.0,98144,47.5943,-122.29899999999999,1020,2044,1212,0.6240988671472708,532900,3771364,3238464
690000.0,2,2.5,1990,1756,3.0,0,0,2,9,1780,210,2005,0.0,98102,47.6264,-122.323,1955,1438,-234,-0.13325740318906606,3960100,3083536,-876564
329950.0,3,2.5,1300,812,2.0,0,0,2,8,880,420,2008,0.0,98144,47.5893,-122.31700000000001,1300,824,-488,-0.6009852216748769,1690000,659344,-1030656
399500.0,4,2.5,2560,7492,2.0,0,0,2,8,2560,0,2014,0.0,98188,47.4467,-122.287,1260,11541,4932,0.6583021890016018,6553600,56130064,49576464
555000.0,5,2.5,2450,5047,2.0,0,0,2,8,2450,0,2007,0.0,98011,47.7724,-122.16799999999999,2450,4478,2597,0.5145631067961165,6002500,25472209,19469709
427000.0,2,1.5,1440,725,2.0,0,0,2,8,1100,340,2011,0.0,98126,47.5607,-122.37799999999999,1440,4255,-715,-0.9862068965517241,2073600,525625,-1547975
375000.0,3,2.25,1140,1557,3.0,0,0,2,8,1140,0,2007,0.0,98103,47.6947,-122.34200000000001,1140,1245,417,0.2678227360308285,1299600,2424249,1124649
499000.0,2,1.5,1110,957,2.0,0,0,2,8,930,180,2005,0.0,98119,47.6319,-122.36200000000001,1680,1104,-153,-0.15987460815047022,1232100,915849,-316251
750000.0,3,2.5,2620,43832,2.0,0,0,2,8,2620,0,2013,0.0,98053,47.655,-122.009,2620,120686,41212,0.9402263186712904,6864400,1921244224,1914379824
336900.0,3,2.5,1690,1200,2.0,0,0,2,8,1410,280,2014,0.0,98106,47.5388,-122.367,1740,1664,-490,-0.4083333333333333,2856100,1440000,-1416100
555000.0,2,2.75,1950,1610,3.0,0,0,2,8,1950,0,2009,0.0,98144,47.5925,-122.302,910,1745,-340,-0.2111801242236025,3802500,2592100,-1210400
1280000.0,4,3.5,3530,8126,2.0,0,0,2,10,3530,0,2007,0.0,98033,47.6847,-122.2,2660,8126,4596,0.565591927147428,12460900,66031876,53570976
999950.0,4,3.5,3310,4684,2.0,0,0,2,9,2290,1020,2014,0.0,98116,47.57899999999999,-122.389,1850,4750,1374,0.2933390264730999,10956100,21939856,10983756
975000.0,5,3.0,2620,5477,2.0,0,0,2,10,2620,0,2009,0.0,98115,47.6804,-122.288,1680,5217,2857,0.5216359320796056,6864400,29997529,23133129
299000.0,3,2.25,1350,3582,2.0,0,0,2,8,1350,0,2010,0.0,98031,47.4214,-122.191,1940,3860,2232,0.6231155778894473,1822500,12830724,11008224
479000.0,2,2.5,1741,1439,2.0,0,0,2,8,1446,295,2007,0.0,98034,47.7043,-122.209,2090,10454,-302,-0.2098679638637943,3031081,2070721,-960360
428000.0,3,2.5,1650,2201,3.0,0,0,2,8,1650,0,2007,0.0,98133,47.7108,-122.333,1650,1965,551,0.2503407542026352,2722500,4844401,2121901
409000.0,3,2.5,1890,6500,2.0,0,0,2,7,1890,0,2012,0.0,98074,47.6225,-122.05799999999999,2340,7500,4610,0.7092307692307692,3572100,42250000,38677900
798500.0,3,3.0,1950,1833,3.0,0,0,2,9,1610,340,2009,0.0,98004,47.6078,-122.20200000000001,2040,2131,-117,-0.06382978723404255,3802500,3359889,-442611
689000.0,4,3.5,4490,5805,2.0,0,0,2,9,3390,1100,2006,0.0,98065,47.5389,-121.86,4410,6299,1315,0.22652885443583118,20160100,33698025,13537925
375000.0,6,2.25,3206,5793,2.0,0,0,2,7,3206,0,2012,0.0,98032,47.369,-122.287,2527,5804,2587,0.4465734507163818,10278436,33558849,23280413
775000.0,4,3.5,4130,77832,2.0,0,2,2,10,4130,0,2011,0.0,98042,47.3229,-122.045,4130,87476,73702,0.9469369924966595,17056900,6057820224,6040763324
639983.0,5,3.0,2800,5700,2.0,0,0,2,8,2800,0,2014,0.0,98059,47.4969,-122.145,2910,5349,2900,0.5087719298245614,7840000,32490000,24650000
300000.0,4,3.0,1984,4419,2.0,0,0,2,7,1984,0,2010,0.0,98002,47.3514,-122.213,2440,4418,2435,0.5510296447159991,3936256,19527561,15591305
627000.0,4,2.5,2750,11830,2.0,0,0,2,9,2750,0,2014,0.0,98059,47.4698,-122.12100000000001,2310,11830,9080,0.7675401521555367,7562500,139948900,132386400
275000.0,3,2.75,1740,5757,1.0,0,0,2,7,1740,0,2010,0.0,98022,47.1941,-121.979,2380,5647,4017,0.6977592496091715,3027600,33143049,30115449
352800.0,4,2.25,1800,2752,2.0,0,0,2,8,1800,0,2014,0.0,98106,47.5167,-122.346,1650,2752,952,0.34593023255813954,3240000,7573504,4333504
565000.0,3,2.25,1540,1005,3.0,0,0,2,8,1540,0,2008,0.0,98103,47.6828,-122.346,1510,1501,-535,-0.5323383084577115,2371600,1010025,-1361575
765000.0,4,2.25,2030,2222,2.0,0,0,2,9,1610,420,2015,0.0,98117,47.678999999999995,-122.375,1420,2222,192,0.08640864086408641,4120900,4937284,816384
644000.0,4,2.5,3310,4839,2.0,0,0,2,9,3310,0,2007,0.0,98072,47.773,-122.161,3240,5280,1529,0.31597437487084107,10956100,23415921,12459821
461000.0,3,1.5,1270,1416,3.0,0,0,2,8,1270,0,2007,0.0,98115,47.6988,-122.31700000000001,1270,1413,146,0.10310734463276836,1612900,2005056,392156
270500.0,5,2.5,2406,7093,2.0,0,0,2,8,2406,0,2006,0.0,98001,47.2615,-122.25200000000001,1767,7093,4687,0.6607923304666573,5788836,50310649,44521813
640000.0,2,2.25,1540,965,3.0,0,0,2,9,1540,0,2007,0.0,98122,47.6181,-122.318,1410,964,-575,-0.5958549222797928,2371600,931225,-1440375
457000.0,4,2.5,2820,6983,2.0,0,0,2,9,2820,0,2013,0.0,98001,47.2958,-122.265,2597,7222,4163,0.5961621079765144,7952400,48762289,40809889
355000.0,5,2.5,2540,5100,2.0,0,0,2,7,2540,0,2014,0.0,98168,47.5123,-122.316,1400,9440,2560,0.5019607843137255,6451600,26010000,19558400
356000.0,2,2.25,1230,989,3.0,0,0,2,8,1230,0,2007,0.0,98103,47.6975,-122.348,1230,1223,-241,-0.243680485338726,1512900,978121,-534779
425000.0,4,2.5,1900,2766,2.0,0,0,2,8,1900,0,2014,0.0,98106,47.543,-122.368,1900,2604,866,0.31308749096167754,3610000,7650756,4040756
562500.0,5,2.75,2920,6327,2.0,0,0,2,8,2920,0,2007,0.0,98059,47.4935,-122.145,2520,5026,3407,0.5384858542753279,8526400,40030929,31504529
460000.0,3,2.5,1450,1053,2.0,0,0,2,8,940,510,2008,0.0,98107,47.6754,-122.374,1410,1080,-397,-0.37701804368471037,2102500,1108809,-993691
790000.0,4,3.0,5370,69848,2.0,0,0,2,10,3500,1870,2005,0.0,98042,47.3166,-122.046,4443,94403,64478,0.9231187721910434,28836900,4878743104,4849906204
401000.0,3,2.0,1270,1333,3.0,0,0,2,8,1270,0,2006,0.0,98103,47.6933,-122.34200000000001,1330,1333,63,0.047261815453863466,1612900,1776889,163989
1100000.0,3,2.5,2550,5100,2.0,0,0,2,9,2550,0,2014,0.0,98115,47.6757,-122.32600000000001,1250,4080,2550,0.5,6502500,26010000,19507500
850000.0,4,3.0,3070,7150,2.0,0,0,2,9,3070,0,2007,0.0,98052,47.7079,-122.10700000000001,3200,6984,4080,0.5706293706293706,9424900,51122500,41697600
274500.0,3,2.25,1450,4050,2.0,0,0,2,7,1450,0,2010,0.0,98038,47.367,-122.01899999999999,1660,3800,2600,0.6419753086419753,2102500,16402500,14300000
1940000.0,5,3.5,4230,16526,2.0,0,0,2,10,4230,0,2008,0.0,98004,47.5933,-122.199,3000,12362,12296,0.7440396950260196,17892900,273108676,255215776
808000.0,4,2.5,3480,6262,2.0,0,0,2,9,3480,0,2003,0.0,98053,47.6857,-122.045,3490,6629,2782,0.44426700734589586,12110400,39212644,27102244
312000.0,3,2.25,1490,974,2.0,0,0,2,7,1220,270,2009,0.0,98106,47.5567,-122.363,1490,1283,-516,-0.5297741273100616,2220100,948676,-1271424
320000.0,3,2.25,1200,1400,3.0,0,0,2,8,1200,0,2005,0.0,98133,47.7046,-122.35700000000001,1370,6552,200,0.14285714285714285,1440000,1960000,520000
410000.0,3,2.5,2150,4332,2.0,0,0,2,8,2150,0,2013,0.0,98019,47.7373,-121.969,2140,4332,2182,0.5036934441366574,4622500,18766224,14143724
725000.0,3,3.5,3690,8837,2.0,0,0,2,10,3690,0,2001,0.0,98065,47.5402,-121.876,3690,9585,5147,0.5824374787823922,13616100,78092569,64476469
335000.0,4,2.5,1900,3301,2.0,0,0,2,7,1900,0,2007,0.0,98178,47.489,-122.249,1960,3379,1401,0.4244168433807937,3610000,10896601,7286601
519990.0,4,3.25,1690,1321,2.0,0,0,2,8,1320,370,2014,0.0,98052,47.678000000000004,-122.117,3080,4558,-369,-0.279333838001514,2856100,1745041,-1111059
533112.0,4,2.75,2790,8853,2.0,0,0,2,8,2790,0,2013,0.0,98045,47.4842,-121.772,2790,8092,6063,0.6848525923415791,7784100,78375609,70591509
274900.0,3,2.0,1936,6612,2.0,0,0,2,7,1936,0,2014,0.0,98001,47.2602,-122.24600000000001,1620,21600,4676,0.7071990320629159,3748096,43718544,39970448
325000.0,2,2.25,1150,711,2.0,0,0,2,7,1150,0,2013,0.0,98027,47.5323,-122.07,1150,748,-439,-0.6174402250351617,1322500,505521,-816979
350000.0,4,2.5,2040,22653,2.0,0,0,2,7,2040,0,2011,0.0,98168,47.4991,-122.29899999999999,2020,20502,20613,0.9099457025559529,4161600,513158409,508996809
550000.0,4,2.5,2470,7539,2.0,0,0,2,9,2470,0,2006,0.0,98028,47.7407,-122.226,2580,7539,5069,0.6723703408940178,6100900,56836521,50735621
311850.0,4,2.5,1890,4158,2.0,0,0,2,8,1890,0,2014,0.0,98042,47.343,-122.056,2720,4549,2268,0.5454545454545454,3572100,17288964,13716864
526000.0,3,2.5,1626,1583,2.5,0,0,2,8,1419,207,2007,0.0,98122,47.6031,-122.309,1400,1583,-43,-0.027163613392293114,2643876,2505889,-137987
375000.0,4,2.5,2250,5306,2.0,0,0,2,8,2250,0,2012,0.0,98038,47.356,-122.057,2250,5306,3056,0.5759517527327553,5062500,28153636,23091136
299999.0,3,2.25,1350,1234,2.0,0,0,2,7,1160,190,2007,0.0,98106,47.5565,-122.363,1420,1234,-116,-0.0940032414910859,1822500,1522756,-299744
436000.0,3,2.5,1460,1238,2.0,0,0,2,8,1200,260,2008,0.0,98107,47.6719,-122.374,1280,1257,-222,-0.17932148626817448,2131600,1532644,-598956
303000.0,3,2.5,2056,3564,2.0,0,0,2,7,2056,0,2014,0.0,98092,47.338,-122.181,2056,3577,1508,0.42312008978675647,4227136,12702096,8474960
525000.0,2,2.5,1160,1458,2.0,0,0,2,8,1040,120,2012,0.0,98119,47.6384,-122.37299999999999,1650,2311,298,0.20438957475994513,1345600,2125764,780164
575000.0,3,3.0,1384,1287,2.0,0,0,2,8,1144,240,2006,0.0,98102,47.6295,-122.32,1570,1288,-97,-0.07536907536907538,1915456,1656369,-259087
420000.0,2,1.5,1100,1107,3.0,0,0,2,8,1100,0,2008,0.0,98103,47.6584,-122.35,1110,2750,7,0.006323396567299007,1210000,1225449,15449
329950.0,3,2.5,2456,7566,2.0,0,0,2,8,2456,0,2012,0.0,98023,47.297,-122.351,2478,7212,5110,0.675389902194026,6031936,57244356,51212420
1830000.0,4,4.25,4500,215186,2.0,0,3,2,11,2630,1870,2009,0.0,98029,47.559,-122.045,3030,25447,210686,0.9790878588755774,20250000,46305014596,46284764596
1180000.0,4,3.25,3780,10099,1.0,0,1,2,11,2240,1540,2006,0.0,98006,47.5508,-122.19200000000001,3120,10669,6319,0.6257055153975641,14288400,101989801,87701401
499950.0,2,2.5,1320,1157,2.0,0,0,2,8,990,330,2014,0.0,98107,47.6689,-122.363,1550,1519,-163,-0.14088159031979255,1742400,1338649,-403751
1150000.0,4,3.0,5940,11533,2.0,0,4,2,11,4950,990,2004,0.0,98065,47.5443,-121.87,4240,12813,5593,0.48495621260730076,35283600,133010089,97726489
400000.0,3,2.0,1650,5027,1.5,0,0,2,7,1650,0,2009,0.0,98065,47.515,-121.874,2430,6000,3377,0.6717724288840262,2722500,25270729,22548229
246950.0,3,3.0,1670,4440,1.0,0,0,2,7,1670,0,2014,0.0,98022,47.1948,-121.975,1670,4622,2770,0.6238738738738738,2788900,19713600,16924700
630000.0,3,3.25,1610,1275,2.0,0,0,2,8,1220,390,2005,0.0,98102,47.6236,-122.318,1750,3000,-335,-0.2627450980392157,2592100,1625625,-966475
561000.0,5,2.75,3370,10315,2.0,0,0,2,9,3370,0,2006,0.0,98059,47.4893,-122.146,3010,8296,6945,0.6732913233155599,11356900,106399225,95042325
287000.0,4,2.5,2660,4082,2.0,0,0,2,7,2660,0,2010,0.0,98042,47.3414,-122.055,2390,4876,1422,0.34835864772170505,7075600,16662724,9587124
600000.0,3,3.25,1690,1473,2.0,0,0,2,8,1380,310,2008,0.0,98109,47.6397,-122.345,1670,2594,-217,-0.14731839782756279,2856100,2169729,-686371
490000.0,3,2.25,1620,1062,3.0,0,0,2,8,1620,0,2014,0.0,98122,47.6051,-122.304,1560,1728,-558,-0.5254237288135594,2624400,1127844,-1496556
330000.0,3,1.75,1300,958,2.0,0,0,2,7,840,460,2011,0.0,98108,47.5677,-122.314,1340,1254,-342,-0.3569937369519833,1690000,917764,-772236
286950.0,4,2.5,1610,4052,2.0,0,0,2,7,1610,0,2013,0.0,98042,47.3603,-122.081,2110,4034,2442,0.6026653504442251,2592100,16418704,13826604
1550000.0,3,3.25,3530,4920,2.0,0,0,2,9,2660,870,2015,0.0,98109,47.64100000000001,-122.35700000000001,1900,4200,1390,0.28252032520325204,12460900,24206400,11745500
880000.0,4,2.5,3550,8618,2.0,0,0,2,10,3550,0,2007,0.0,98052,47.6776,-122.161,1310,9746,5068,0.58807147830123,12602500,74269924,61667424
577450.0,3,3.0,1730,1755,3.0,0,0,2,8,1730,0,2014,0.0,98117,47.6944,-122.37700000000001,1830,1804,25,0.014245014245014245,2992900,3080025,87125
405000.0,5,2.75,2400,4900,2.0,0,0,2,8,2400,0,2011,0.0,98038,47.355,-122.057,2110,5696,2500,0.5102040816326531,5760000,24010000,18250000
510000.0,3,2.5,1420,1237,3.0,0,0,2,8,1420,0,2014,0.0,98107,47.674,-122.387,1510,2501,-183,-0.14793856103476152,2016400,1530169,-486231
465000.0,2,1.5,1220,1120,2.5,0,0,2,8,1110,110,2008,0.0,98199,47.6374,-122.38799999999999,2010,3175,-100,-0.08928571428571429,1488400,1254400,-234000
1300000.0,4,2.25,2360,4000,2.0,0,0,2,9,2360,0,2013,0.0,98112,47.6198,-122.289,3040,4400,1640,0.41,5569600,16000000,10430400
609000.0,4,3.5,3990,11270,2.0,0,3,2,9,2930,1060,2007,0.0,98055,47.488,-122.225,1980,11328,7280,0.6459627329192547,15920100,127012900,111092800
336000.0,3,2.5,1260,1211,3.0,0,0,2,8,1260,0,2004,0.0,98103,47.6969,-122.34299999999999,1270,1211,-49,-0.04046242774566474,1587600,1466521,-121079
375000.0,3,2.5,1580,2407,2.0,0,0,2,8,1580,0,2013,0.0,98126,47.5455,-122.368,1580,2212,827,0.34358122143747405,2496400,5793649,3297249
294500.0,3,2.5,1760,2688,2.0,0,0,2,7,1760,0,2005,0.0,98059,47.4903,-122.166,1760,2329,928,0.34523809523809523,3097600,7225344,4127744
925000.0,5,3.5,3420,4216,2.0,0,0,2,9,2520,900,2008,0.0,98115,47.6799,-122.304,1420,4500,796,0.1888045540796964,11696400,17774656,6078256
730000.0,5,2.75,2870,6593,2.0,0,0,2,9,2870,0,2006,0.0,98052,47.7075,-122.102,3150,6593,3723,0.5646898225390565,8236900,43467649,35230749
280000.0,4,2.5,1934,5677,2.0,0,0,2,8,1934,0,2013,0.0,98001,47.2602,-122.25200000000001,1919,5049,3743,0.6593271093887617,3740356,32228329,28487973
500000.0,3,1.5,1220,962,3.0,0,0,2,8,1220,0,2014,0.0,98107,47.674,-122.387,1510,2501,-258,-0.2681912681912682,1488400,925444,-562956
605000.0,3,2.75,2450,5750,2.0,0,0,2,9,2450,0,2013,0.0,98065,47.5439,-121.86200000000001,3200,8036,3300,0.5739130434782609,6002500,33062500,27060000
379950.0,3,3.25,1860,1787,3.0,0,0,2,8,1860,0,2007,0.0,98155,47.7563,-122.316,1830,1787,-73,-0.0408505875769446,3459600,3193369,-266231
605000.0,3,2.5,1500,1119,3.0,0,2,2,7,1110,0,2008,0.0,98109,47.6327,-122.346,1500,1057,-381,-0.34048257372654156,2250000,1252161,-997839
720000.0,2,1.75,1570,1108,3.0,0,0,2,9,1570,0,2007,0.0,98004,47.6215,-122.2,1940,1160,-462,-0.41696750902527074,2464900,1227664,-1237236
549900.0,3,2.0,1280,960,2.0,0,0,2,9,1040,240,2014,0.0,98122,47.602,-122.311,1280,1173,-320,-0.3333333333333333,1638400,921600,-716800
427000.0,3,2.5,3192,5653,2.0,0,0,2,8,3192,0,2014,0.0,98023,47.2956,-122.35,3000,5134,2461,0.43534406509817797,10188864,31956409,21767545
492000.0,3,2.5,1690,1479,3.0,0,0,2,8,1420,270,2005,0.0,98122,47.6022,-122.311,1280,1253,-211,-0.14266396213657878,2856100,2187441,-668659
419190.0,2,2.5,1590,1426,2.0,0,0,2,8,1590,0,2014,0.0,98029,47.5441,-122.01299999999999,1590,1426,-164,-0.1150070126227209,2528100,2033476,-494624
650000.0,3,2.5,2870,7288,2.0,0,0,2,9,2870,0,2012,0.0,98011,47.7745,-122.225,2870,5998,4418,0.6062019758507134,8236900,53114944,44878044
379950.0,4,2.5,2580,4818,2.0,0,0,2,8,2580,0,2005,0.0,98038,47.3607,-122.038,2570,5386,2238,0.46450809464508097,6656400,23213124,16556724
269800.0,4,2.75,1830,3420,2.0,0,0,2,8,1830,0,2012,0.0,98198,47.36600000000001,-122.30799999999999,1813,3420,1590,0.4649122807017544,3348900,11696400,8347500
407000.0,4,2.5,2927,6000,2.0,0,0,2,7,2927,0,2011,0.0,98042,47.3737,-122.16,2533,6000,3073,0.5121666666666667,8567329,36000000,27432671
580000.0,3,1.5,1320,1250,3.0,0,0,2,8,1320,0,2008,0.0,98103,47.6536,-122.34100000000001,1560,1694,-70,-0.056,1742400,1562500,-179900
389700.0,3,2.5,1720,3581,2.0,0,0,2,7,1720,0,2011,0.0,98053,47.6861,-122.01299999999999,1720,3600,1861,0.5196872382016197,2958400,12823561,9865161
110000.0,2,1.0,828,4524,1.0,0,0,2,6,828,0,1968,2007.0,98001,47.2655,-122.244,828,5402,3696,0.8169761273209549,685584,20466576,19780992
230000.0,3,1.5,1040,1264,2.0,0,0,2,9,900,140,2015,0.0,98144,47.5951,-122.301,1350,3000,224,0.17721518987341772,1081600,1597696,516096
533380.0,4,2.75,2790,6685,2.0,0,0,2,8,2790,0,2014,0.0,98045,47.4838,-121.773,2790,6444,3895,0.5826477187733732,7784100,44689225,36905125
295500.0,3,2.5,1410,1332,2.0,0,0,2,7,960,450,2014,0.0,98108,47.5683,-122.314,1410,1343,-78,-0.05855855855855856,1988100,1774224,-213876
860000.0,4,4.5,4040,8400,2.0,0,0,2,9,3220,820,2006,0.0,98052,47.7067,-122.131,3940,8400,4360,0.5190476190476191,16321600,70560000,54238400
812000.0,4,3.5,3370,3634,2.0,0,0,2,9,2750,620,2007,0.0,98029,47.5519,-122.001,3200,3650,264,0.07264722069345074,11356900,13205956,1849056
324500.0,3,2.5,1660,3990,2.0,0,0,2,7,1660,0,2009,0.0,98118,47.5298,-122.26799999999999,1670,4050,2330,0.5839598997493735,2755600,15920100,13164500
193000.0,2,1.75,910,2550,1.0,0,0,2,6,910,0,2004,0.0,98038,47.3494,-122.022,1310,2550,1640,0.6431372549019608,828100,6502500,5674400
355000.0,3,2.25,1280,959,3.0,0,0,2,8,1280,0,2005,0.0,98103,47.6914,-122.34299999999999,1130,1126,-321,-0.3347236704900938,1638400,919681,-718719
525000.0,4,2.75,2360,4924,2.0,0,0,2,8,2360,0,2008,0.0,98028,47.7737,-122.235,2360,4670,2564,0.5207148659626321,5569600,24245776,18676176
370950.0,3,2.5,2529,9653,2.0,0,0,2,7,2529,0,2012,0.0,98042,47.3738,-122.161,2533,6125,7124,0.7380089091474153,6395841,93180409,86784568
1240000.0,4,3.5,4700,10183,1.0,0,2,2,11,2660,2040,2002,0.0,98033,47.6728,-122.189,3770,9000,5483,0.5384464303250516,22090000,103693489,81603489
950000.0,3,2.5,2780,275033,1.0,0,0,2,10,2780,0,2006,0.0,98045,47.4496,-121.766,1680,16340,272253,0.9898921220362648,7728400,75643151089,75635422689
888990.0,4,2.75,3540,5500,2.0,0,0,2,9,3540,0,2014,0.0,98074,47.6181,-122.056,3540,5500,1960,0.3563636363636364,12531600,30250000,17718400
705000.0,3,2.5,1580,1321,2.0,0,2,2,8,1080,500,2014,0.0,98107,47.6688,-122.402,1530,1357,-259,-0.19606358819076458,2496400,1745041,-751359
268000.0,3,2.5,1700,2250,2.0,0,0,2,7,1700,0,2014,0.0,98168,47.4914,-122.334,1520,4500,550,0.24444444444444444,2890000,5062500,2172500
305450.0,3,2.5,1600,3573,2.0,0,0,2,7,1600,0,2013,0.0,98056,47.507,-122.181,1500,11089,1973,0.5521970333053456,2560000,12766329,10206329
399900.0,2,1.75,1410,1005,1.5,0,0,2,9,900,510,2011,0.0,98027,47.5446,-122.01799999999999,1440,1188,-405,-0.40298507462686567,1988100,1010025,-978075
495000.0,3,1.5,1580,1228,3.0,0,0,2,8,1580,0,2014,0.0,98115,47.6765,-122.32,1580,3605,-352,-0.28664495114006516,2496400,1507984,-988416
857326.0,3,3.5,3940,11632,2.0,0,0,2,10,3940,0,2014,0.0,98166,47.438,-122.344,2015,11632,7692,0.6612792297111417,15523600,135303424,119779824
845950.0,5,2.75,4450,9600,2.0,0,0,2,9,3650,800,2014,0.0,98011,47.7336,-122.21,4000,9750,5150,0.5364583333333334,19802500,92160000,72357500
303210.0,4,2.5,2009,5000,2.0,0,0,2,8,2009,0,2014,0.0,98092,47.2577,-122.198,2009,5182,2991,0.5982,4036081,25000000,20963919
343000.0,6,5.0,2732,7655,2.0,0,0,2,7,2732,0,2009,0.0,98002,47.3045,-122.211,3078,69993,4923,0.6431090790333116,7463824,58599025,51135201
300000.0,3,2.5,2090,4590,2.0,0,0,2,7,2090,0,2005,0.0,98042,47.3992,-122.163,2190,4060,2500,0.5446623093681917,4368100,21068100,16700000
334900.0,2,2.5,980,1013,3.0,0,0,2,8,980,0,2008,0.0,98117,47.6844,-122.387,980,1023,33,0.03257650542941757,960400,1026169,65769
477500.0,5,3.5,2815,5619,2.0,0,0,2,9,2815,0,2012,0.0,98055,47.4299,-122.20700000000001,2583,5295,2804,0.4990211781455775,7924225,31573161,23648936
820000.0,4,2.5,3170,8523,2.0,0,0,2,9,3170,0,2008,0.0,98033,47.6854,-122.184,3230,8523,5353,0.6280652352458055,10048900,72641529,62592629
580000.0,5,3.25,3030,7410,2.0,0,0,2,8,2150,880,2014,0.0,98106,47.553000000000004,-122.354,2020,7410,4380,0.5910931174089069,9180900,54908100,45727200
350000.0,2,2.5,1280,940,2.0,0,0,2,8,1060,220,2006,0.0,98103,47.6904,-122.36399999999999,1290,2900,-340,-0.3617021276595745,1638400,883600,-754800
910000.0,3,2.5,2030,1160,3.0,0,0,2,9,1970,60,2007,0.0,98004,47.6213,-122.2,1950,1160,-870,-0.75,4120900,1345600,-2775300
414000.0,3,2.5,2490,4540,2.5,0,0,2,8,2490,0,2012,0.0,98059,47.5051,-122.155,2640,3844,2050,0.45154185022026433,6200100,20611600,14411500
525000.0,3,2.5,3030,4500,2.0,0,0,2,8,3030,0,2009,0.0,98059,47.4944,-122.15,3030,4501,1470,0.32666666666666666,9180900,20250000,11069100
650000.0,2,2.5,1470,690,3.0,0,3,2,8,1470,0,2008,0.0,98103,47.6523,-122.346,1480,1284,-780,-1.1304347826086956,2160900,476100,-1684800
450000.0,3,2.25,1620,997,2.5,0,0,2,8,1540,80,2012,0.0,98027,47.5394,-122.027,1620,1068,-623,-0.6248746238716149,2624400,994009,-1630391
1270000.0,4,3.0,5520,8313,2.0,0,3,2,9,3570,1950,2008,0.0,98006,47.5655,-122.12899999999999,3770,8278,2793,0.33597979068928185,30470400,69105969,38635569
699000.0,3,3.5,3200,10344,2.0,0,0,2,10,3200,0,2007,0.0,98011,47.7636,-122.21600000000001,2550,20152,7144,0.6906419180201083,10240000,106998336,96758336
899000.0,4,2.5,2580,3943,2.0,0,0,2,8,2580,0,2013,0.0,98033,47.6853,-122.21,1700,5772,1363,0.34567588130864824,6656400,15547249,8890849
353500.0,4,3.0,2050,4000,2.0,0,0,2,8,2050,0,2014,0.0,98001,47.3523,-122.275,2050,4000,1950,0.4875,4202500,16000000,11797500
485000.0,3,2.5,2430,5867,2.0,0,0,2,7,2430,0,2011,0.0,98065,47.5162,-121.87200000000001,2620,5866,3437,0.5858189875575252,5904900,34421689,28516789
782900.0,4,3.25,3060,3898,2.0,0,0,2,10,2300,760,2014,0.0,98027,47.5311,-122.073,2920,3448,838,0.21498204207285787,9363600,15194404,5830804
529000.0,2,2.0,1540,9714,2.0,0,0,2,8,1540,0,2008,0.0,98177,47.7628,-122.359,1840,8179,8174,0.8414659254683962,2371600,94361796,91990196
514700.0,3,3.25,1310,1072,2.0,0,0,2,8,1060,250,2008,0.0,98107,47.6744,-122.374,1160,1266,-238,-0.22201492537313433,1716100,1149184,-566916
409316.0,3,2.5,1800,3168,2.0,0,0,2,8,1800,0,2014,0.0,98065,47.5342,-121.84100000000001,1800,3393,1368,0.4318181818181818,3240000,10036224,6796224
388598.0,3,2.5,2370,4200,2.0,0,0,2,8,2370,0,2014,0.0,98038,47.3699,-122.01899999999999,2370,4370,1830,0.4357142857142857,5616900,17640000,12023100
415000.0,3,2.25,1445,1512,2.0,0,0,2,7,1300,145,2004,0.0,98027,47.5341,-122.069,1445,1082,67,0.04431216931216931,2088025,2286144,198119
521500.0,3,2.25,1450,1619,2.0,0,0,2,8,1140,310,2006,0.0,98122,47.6076,-122.304,1580,3472,169,0.10438542310067943,2102500,2621161,518661
580000.0,3,2.5,1740,1236,3.0,0,2,2,8,1740,0,2008,0.0,98116,47.5891,-122.387,1740,1280,-504,-0.4077669902912621,3027600,1527696,-1499904
882566.0,4,2.5,3560,5265,3.0,0,0,2,8,3560,0,2014,0.0,98052,47.7047,-122.113,3220,4892,1705,0.3238366571699905,12673600,27720225,15046625
525000.0,3,2.75,2130,1400,2.0,0,0,2,9,1080,1050,2010,0.0,98118,47.5661,-122.29,1880,3132,-730,-0.5214285714285715,4536900,1960000,-2576900
515000.0,5,2.75,2980,4502,2.0,0,0,2,9,2980,0,2007,0.0,98028,47.7698,-122.235,2850,4501,1522,0.3380719680142159,8880400,20268004,11387604
589410.0,3,3.0,2840,7201,2.0,0,0,2,9,2840,0,2014,0.0,98065,47.5165,-121.883,2540,5260,4361,0.6056103318983475,8065600,51854401,43788801
757500.0,4,2.5,3420,6845,2.0,0,0,2,9,3420,0,2009,0.0,98052,47.6777,-122.156,2800,5715,3425,0.5003652300949598,11696400,46854025,35157625
284000.0,3,2.5,1660,4083,2.0,0,0,2,7,1660,0,2013,0.0,98038,47.3595,-122.045,1800,4087,2423,0.5934361988733774,2755600,16670889,13915289
338500.0,2,2.25,1150,711,2.0,0,0,2,7,1150,0,2013,0.0,98027,47.5323,-122.071,1150,748,-439,-0.6174402250351617,1322500,505521,-816979
379500.0,3,2.25,1410,1287,2.0,0,0,2,7,1290,0,2005,0.0,98027,47.5344,-122.068,1490,1435,-123,-0.09557109557109557,1988100,1656369,-331731
550000.0,3,2.0,1420,1369,2.5,0,0,2,9,1340,80,2007,0.0,98109,47.6472,-122.35700000000001,1540,2168,-51,-0.03725346968590212,2016400,1874161,-142239
294900.0,3,2.5,1860,5025,2.0,0,0,2,8,1860,0,2010,0.0,98038,47.3557,-122.059,2000,5550,3165,0.6298507462686567,3459600,25250625,21791025
345000.0,2,1.5,1340,1210,2.0,0,0,2,8,1120,220,2008,0.0,98144,47.588,-122.305,1340,1213,-130,-0.10743801652892562,1795600,1464100,-331500
450000.0,2,1.5,1530,1012,2.0,0,0,2,8,1200,330,2005,0.0,98122,47.602,-122.306,1530,1425,-518,-0.5118577075098815,2340900,1024144,-1316756
420000.0,3,2.5,1509,1114,3.0,0,0,2,8,1509,0,2014,0.0,98133,47.7049,-122.34,1509,2431,-395,-0.35457809694793535,2277081,1240996,-1036085
740000.0,3,2.5,2350,3798,2.0,0,0,2,8,2350,0,2013,0.0,98029,47.543,-122.01,2020,3532,1448,0.38125329120589785,5522500,14424804,8902304
286000.0,2,1.5,1010,825,3.0,0,0,2,7,1010,0,2007,0.0,98125,47.7124,-122.301,1128,1080,-185,-0.22424242424242424,1020100,680625,-339475
870000.0,5,3.5,4495,10079,2.0,0,0,2,9,3580,915,2013,0.0,98011,47.7339,-122.209,4495,10079,5584,0.5540232165889473,20205025,101586241,81381216
727000.0,3,2.5,1580,991,3.0,0,0,2,9,1580,0,2009,0.0,98119,47.6276,-122.359,1610,1297,-589,-0.5943491422805247,2496400,982081,-1514319
395000.0,4,3.0,2750,7965,2.0,0,0,2,9,2750,0,2012,0.0,98038,47.3479,-122.02799999999999,2750,6000,5215,0.6547394852479598,7562500,63441225,55878725
535000.0,4,2.25,1890,3615,2.0,0,0,2,7,1890,0,2005,0.0,98029,47.5493,-121.999,1630,3280,1725,0.47717842323651455,3572100,13068225,9496125
255000.0,3,2.25,1320,963,2.0,0,0,2,7,1040,280,2007,0.0,98106,47.5199,-122.35700000000001,1300,1285,-357,-0.3707165109034268,1742400,927369,-815031
260000.0,4,2.5,2150,3721,2.0,0,0,2,8,2150,0,2006,0.0,98002,47.3363,-122.21700000000001,2150,3721,1571,0.4221983337812416,4622500,13845841,9223341
810000.0,4,2.5,3340,8384,2.0,0,0,2,9,3340,0,2014,0.0,98052,47.6761,-122.152,1560,9429,5044,0.6016221374045801,11155600,70291456,59135856
359782.0,3,2.5,1850,3400,2.0,0,0,2,7,1850,0,2010,0.0,98053,47.6871,-122.014,1850,3400,1550,0.45588235294117646,3422500,11560000,8137500
500000.0,2,2.5,1950,2162,2.0,0,0,2,9,1500,450,2012,0.0,98118,47.5622,-122.292,1800,2457,212,0.09805735430157261,3802500,4674244,871744
1050000.0,5,3.25,4240,9588,2.0,0,0,2,9,4240,0,2014,0.0,98053,47.6901,-122.01799999999999,4080,8425,5348,0.5577805590321235,17977600,91929744,73952144
810000.0,4,3.5,2700,2868,2.0,0,0,2,11,1920,780,2006,0.0,98118,47.5685,-122.286,1430,3858,168,0.058577405857740586,7290000,8225424,935424
605000.0,5,4.0,3040,6000,2.0,0,0,2,8,2280,760,2011,0.0,98065,47.5189,-121.876,3070,5558,2960,0.49333333333333335,9241600,36000000,26758400
730000.0,4,2.5,2460,7930,2.0,0,0,2,8,2460,0,2005,0.0,98033,47.6684,-122.175,1850,9000,5470,0.6897856242118537,6051600,62884900,56833300
327000.0,4,2.5,2110,3825,2.0,0,0,2,7,2110,0,2013,0.0,98042,47.358999999999995,-122.08200000000001,1950,3825,1715,0.44836601307189544,4452100,14630625,10178525
370000.0,2,1.0,780,1133,2.0,0,0,2,7,780,0,2009,0.0,98144,47.5924,-122.295,1130,1270,353,0.3115622241835834,608400,1283689,675289
459000.0,5,3.5,2640,6895,2.0,0,0,2,7,2640,0,2001,0.0,98065,47.5298,-121.87899999999999,2640,5267,4255,0.6171138506163887,6969600,47541025,40571425
2900000.0,5,4.0,5190,14600,2.0,0,1,2,11,5190,0,2013,0.0,98039,47.6102,-122.225,3840,19250,9410,0.6445205479452055,26936100,213160000,186223900
365000.0,4,2.5,2420,8404,2.0,0,0,2,8,2420,0,2013,0.0,98042,47.372,-122.13,2440,4822,5984,0.7120418848167539,5856400,70627216,64770816
255000.0,4,2.5,1987,6000,2.0,0,0,2,7,1987,0,2011,0.0,98001,47.2679,-122.255,1880,9589,4013,0.6688333333333333,3948169,36000000,32051831
375000.0,1,1.0,720,3166,1.0,0,0,2,6,720,0,1920,0.0,98116,47.5811,-122.389,1140,6250,2446,0.7725837018319647,518400,10023556,9505156
375000.0,2,1.5,1130,912,2.0,0,0,2,8,1000,130,2006,0.0,98116,47.5638,-122.38799999999999,1500,1474,-218,-0.23903508771929824,1276900,831744,-445156
518380.0,4,2.5,2810,4500,2.0,0,0,2,9,2810,0,2014,0.0,98038,47.3552,-122.023,2980,5046,1690,0.37555555555555553,7896100,20250000,12353900
346000.0,3,3.25,1500,1442,2.0,0,0,2,8,1150,350,2007,0.0,98106,47.5592,-122.36200000000001,1500,1533,-58,-0.04022191400832178,2250000,2079364,-170636
302059.0,4,2.0,1390,745,3.0,0,0,2,7,1390,0,2008,0.0,98027,47.5393,-122.02600000000001,1390,942,-645,-0.8657718120805369,1932100,555025,-1377075
575000.0,4,2.5,2500,4945,2.0,0,0,2,9,2500,0,2013,0.0,98065,47.5185,-121.885,2760,6000,2445,0.49443882709807885,6250000,24453025,18203025
549950.0,4,3.5,3906,9674,2.0,0,2,2,9,3906,0,2014,0.0,98001,47.2931,-122.264,2673,6500,5768,0.5962373371924746,15256836,93586276,78329440
900000.0,5,6.0,7120,40806,2.0,0,4,2,12,5480,1640,2007,0.0,98006,47.5451,-122.11399999999999,3440,36859,33686,0.8255158555114444,50694400,1665129636,1614435236
397500.0,3,2.5,1470,1256,2.0,0,0,2,8,930,540,2006,0.0,98122,47.6033,-122.309,1510,1797,-214,-0.17038216560509553,2160900,1577536,-583364
1080000.0,5,3.5,3230,7560,2.0,0,0,2,10,3230,0,2007,0.0,98052,47.6467,-122.118,3230,8580,4330,0.5727513227513228,10432900,57153600,46720700
775900.0,3,2.5,2700,5764,2.0,0,0,2,9,2700,0,2014,0.0,98075,47.5618,-122.027,3270,14700,3064,0.5315752949340735,7290000,33223696,25933696
510000.0,4,2.5,4073,17334,2.0,0,0,2,8,4073,0,2008,0.0,98001,47.2949,-122.27,1780,9625,13261,0.765028268143533,16589329,300467556,283878227
471275.0,4,2.5,3361,5038,2.0,0,0,2,9,3361,0,2014,0.0,98092,47.3269,-122.165,2316,4105,1677,0.332870186581977,11296321,25381444,14085123
288000.0,4,2.25,1610,3560,2.0,0,0,2,7,1610,0,2010,0.0,98038,47.3669,-122.02,1760,3692,1950,0.547752808988764,2592100,12673600,10081500
989990.0,4,3.5,3830,7150,2.0,0,0,2,9,3830,0,2014,0.0,98052,47.7049,-122.126,3640,6055,3320,0.4643356643356643,14668900,51122500,36453600
300000.0,3,3.25,1470,1235,2.0,0,0,2,7,1180,290,2008,0.0,98108,47.5537,-122.31299999999999,1470,1243,-235,-0.1902834008097166,2160900,1525225,-635675
664950.0,5,3.0,3190,7081,1.0,0,2,2,9,1890,1300,2013,0.0,98178,47.50899999999999,-122.24,2270,7623,3891,0.5494986583815845,10176100,50140561,39964461
699188.0,4,3.25,3250,5478,2.0,0,0,2,9,3250,0,2014,0.0,98065,47.5178,-121.887,3250,5482,2228,0.40671778021175614,10562500,30008484,19445984
390000.0,3,2.25,1490,4539,2.0,0,0,2,7,1490,0,2009,0.0,98028,47.7607,-122.23299999999999,1750,4667,3049,0.6717338620841595,2220100,20602521,18382421
670000.0,5,2.75,2900,5155,2.0,0,0,2,8,2900,0,2008,0.0,98075,47.5977,-122.008,2900,6176,2255,0.43743937924345294,8410000,26574025,18164025
487000.0,4,2.5,2540,5001,2.0,0,0,2,9,2540,0,2005,0.0,98108,47.5423,-122.302,2360,6834,2461,0.4921015796840632,6451600,25010001,18558401
769995.0,5,2.75,3360,12080,2.0,0,0,2,9,3360,0,2014,0.0,98011,47.7757,-122.17299999999999,3360,9724,8720,0.7218543046357616,11289600,145926400,134636800
321950.0,2,1.25,860,1277,2.0,0,0,2,7,860,0,2007,0.0,98144,47.5842,-122.314,1280,1265,417,0.3265465935787001,739600,1630729,891129
613500.0,4,2.5,3020,6068,2.0,0,0,2,9,3020,0,2006,0.0,98072,47.773,-122.16,3240,5757,3048,0.5023071852340145,9120400,36820624,27700224
300000.0,3,2.5,1330,1200,3.0,0,0,2,7,1330,0,2002,0.0,98133,47.7034,-122.344,1330,1206,-130,-0.10833333333333334,1768900,1440000,-328900
400950.0,4,2.5,2578,4554,2.0,0,0,2,9,2578,0,2014,0.0,98092,47.2603,-122.194,2647,4554,1976,0.4339042599912165,6646084,20738916,14092832
389517.0,4,2.5,2640,4725,2.0,0,0,2,8,2640,0,2014,0.0,98038,47.371,-122.01700000000001,2370,4725,2085,0.44126984126984126,6969600,22325625,15356025
255000.0,3,1.75,1260,1133,2.0,0,0,2,7,810,450,2011,0.0,98106,47.5261,-122.361,1260,1172,-127,-0.11209179170344219,1587600,1283689,-303911
1080000.0,3,2.5,1990,1891,3.0,0,0,2,9,1990,0,2012,0.0,98102,47.6271,-122.324,1990,3600,-99,-0.0523532522474881,3960100,3575881,-384219
637850.0,5,3.25,3340,4900,2.0,0,2,2,9,2500,840,2014,0.0,98065,47.5193,-121.87700000000001,3220,5200,1560,0.3183673469387755,11155600,24010000,12854400
636230.0,4,2.5,2840,6284,2.0,0,0,2,9,2840,0,2013,0.0,98056,47.5135,-122.169,2790,7168,3444,0.5480585614258434,8065600,39488656,31423056
375000.0,3,2.5,1530,1131,3.0,0,0,2,8,1530,0,2009,0.0,98103,47.6993,-122.346,1530,1445,-399,-0.35278514588859416,2340900,1279161,-1061739
586500.0,3,2.5,1780,1487,3.0,0,0,2,8,1600,180,2006,0.0,98107,47.6539,-122.351,1780,1300,-293,-0.19704102219233355,3168400,2211169,-957231
544000.0,4,2.5,2340,6973,2.0,0,0,2,8,1930,410,2005,0.0,98065,47.5451,-121.882,2950,6908,4633,0.664419905349204,5475600,48622729,43147129
425000.0,4,2.5,2390,5021,2.0,0,0,2,7,2390,0,2002,0.0,98065,47.5353,-121.87899999999999,2520,5333,2631,0.5239992033459471,5712100,25210441,19498341
374950.0,4,2.5,2090,3777,2.0,0,0,2,8,2090,0,2012,0.0,98038,47.3595,-122.042,2160,3993,1687,0.4466507810431559,4368100,14265729,9897629
294570.0,3,1.0,1140,8400,1.0,0,0,3,7,1140,0,1960,0.0,98059,47.5022,-122.14399999999999,1400,9000,7260,0.8642857142857143,1299600,70560000,69260400
300000.0,3,2.5,1960,1477,2.0,0,0,2,7,1670,290,2012,0.0,98059,47.4873,-122.166,1980,1467,-483,-0.32701421800947866,3841600,2181529,-1660071
395950.0,5,3.5,2738,6031,2.0,0,0,2,8,2738,0,2014,0.0,98023,47.2962,-122.35,2738,5201,3293,0.5460122699386503,7496644,36372961,28876317
800000.0,4,2.5,3691,11088,2.0,0,1,2,8,3691,0,2013,0.0,98074,47.6122,-122.059,3190,11270,7397,0.6671176046176046,13623481,122943744,109320263
439990.0,3,2.5,2340,5171,2.0,0,0,2,8,2340,0,2013,0.0,98045,47.4832,-121.772,2790,5684,2831,0.5474763101914524,5475600,26739241,21263641
680000.0,4,3.5,2510,3763,2.0,0,0,2,8,1990,520,2013,0.0,98052,47.7002,-122.103,2560,3820,1253,0.3329790061121446,6300100,14160169,7860069
677790.0,6,3.0,2800,4213,2.0,0,0,2,8,2800,0,1998,0.0,98117,47.6892,-122.389,1440,3960,1413,0.3353904581058628,7840000,17749369,9909369
424950.0,3,2.5,1650,4777,2.0,0,0,2,8,1650,0,2013,0.0,98065,47.5336,-121.84100000000001,1800,3331,3127,0.6545949340590329,2722500,22819729,20097229
223990.0,2,2.25,1061,2884,2.0,0,0,2,7,1061,0,2013,0.0,98002,47.346000000000004,-122.21799999999999,1481,2887,1823,0.6321081830790569,1125721,8317456,7191735
498000.0,4,2.5,3402,14355,2.0,0,0,2,10,2846,556,2014,0.0,98023,47.3009,-122.385,3402,8487,10953,0.7630094043887148,11573604,206066025,194492421
359950.0,4,2.5,2542,6120,2.0,0,0,2,8,2542,0,2014,0.0,98030,47.3751,-122.18799999999999,2419,8984,3578,0.584640522875817,6461764,37454400,30992636
720000.0,3,2.5,3150,151588,2.0,0,0,2,9,3150,0,2007,0.0,98024,47.571999999999996,-121.926,2410,208652,148438,0.9792199910283136,9922500,22978921744,22968999244
530000.0,4,2.5,3010,9000,2.0,0,0,2,8,3010,0,2008,0.0,98059,47.4987,-122.147,3250,5531,5990,0.6655555555555556,9060100,81000000,71939900
295000.0,3,2.5,1660,4898,2.0,0,0,2,7,1660,0,2011,0.0,98038,47.3588,-122.044,1810,4462,3238,0.6610861576153532,2755600,23990404,21234804
255500.0,3,2.5,1770,5000,2.0,0,0,2,7,1770,0,2009,0.0,98042,47.3358,-122.051,2230,5200,3230,0.646,3132900,25000000,21867100
556000.0,3,3.0,1960,1168,2.0,0,0,2,9,1600,360,2007,0.0,98027,47.5445,-122.014,2080,1423,-792,-0.678082191780822,3841600,1364224,-2477376
277950.0,4,2.5,1889,6000,2.0,0,0,2,7,1889,0,2012,0.0,98001,47.2676,-122.256,1990,6350,4111,0.6851666666666667,3568321,36000000,32431679
431000.0,4,2.5,3040,6000,2.0,0,0,2,9,3040,0,2007,0.0,98038,47.3473,-122.03,2640,6000,2960,0.49333333333333335,9241600,36000000,26758400
780000.0,4,2.75,3420,6787,2.0,0,0,2,9,3420,0,2010,0.0,98053,47.6962,-122.023,3450,6137,3367,0.49609547664653014,11696400,46063369,34366969
649000.0,3,3.25,1720,936,2.0,0,0,2,8,1030,690,2004,0.0,98112,47.6201,-122.309,1720,1527,-784,-0.8376068376068376,2958400,876096,-2082304
447000.0,3,2.5,1740,3043,2.0,0,0,2,7,1740,0,2012,0.0,98011,47.744,-122.181,1920,2869,1303,0.4281958593493263,3027600,9259849,6232249
712198.0,4,2.5,2450,4247,2.0,0,0,2,8,2450,0,2013,0.0,98052,47.7048,-122.113,2970,4685,1797,0.4231222039086414,6002500,18037009,12034509
277140.0,3,1.5,1190,785,2.0,0,0,2,8,920,270,2014,0.0,98052,47.6781,-122.117,2820,5626,-405,-0.5159235668789809,1416100,616225,-799875
363000.0,4,2.5,3753,7204,2.0,0,0,2,10,3336,417,2008,0.0,98023,47.3011,-122.385,3494,9375,3451,0.47903942254303167,14085009,51897616,37812607
598992.0,5,3.5,3440,6037,2.0,0,0,2,9,3440,0,2014,0.0,98045,47.4765,-121.734,3270,6037,2597,0.43018055325492793,11833600,36445369,24611769
585000.0,3,2.5,2160,1250,3.0,0,0,2,8,1830,330,2010,0.0,98119,47.6515,-122.375,1870,2825,-910,-0.728,4665600,1562500,-3103100
1270000.0,4,2.75,3820,8850,2.0,0,0,2,10,3820,0,2014,0.0,98033,47.6506,-122.195,2330,12000,5030,0.5683615819209039,14592400,78322500,63730100
380950.0,2,2.0,1120,1039,2.0,0,0,2,7,840,280,2007,0.0,98144,47.5788,-122.315,1130,5400,-81,-0.07795957651588066,1254400,1079521,-174879
333490.0,4,2.5,2250,3916,2.0,0,0,2,8,2250,0,2014,0.0,98003,47.3413,-122.18,2156,3920,1666,0.4254341164453524,5062500,15335056,10272556
520000.0,3,3.25,1540,1487,2.0,0,0,2,8,1540,0,2011,0.0,98027,47.5397,-122.027,1620,1104,-53,-0.03564223268325487,2371600,2211169,-160431
315000.0,2,2.25,1240,705,2.0,0,0,2,7,1150,90,2009,0.0,98027,47.5321,-122.073,1240,750,-535,-0.7588652482269503,1537600,497025,-1040575
487000.0,2,1.5,1160,1118,2.0,0,0,2,8,1020,140,2007,0.0,98117,47.6754,-122.375,1210,1118,-42,-0.03756708407871199,1345600,1249924,-95676
424950.0,5,3.5,2760,3865,2.5,0,0,2,8,2760,0,2013,0.0,98056,47.5049,-122.17,2590,4587,1105,0.2858990944372574,7617600,14938225,7320625
542300.0,3,2.25,1580,1487,3.0,0,0,2,9,1580,0,2013,0.0,98199,47.6514,-122.38600000000001,1600,1525,-93,-0.06254203093476798,2496400,2211169,-285231
320000.0,3,3.25,1480,1192,2.0,0,0,2,8,1180,300,2013,0.0,98106,47.5556,-122.363,1330,1094,-288,-0.24161073825503357,2190400,1420864,-769536
1140000.0,4,3.25,3740,11467,2.0,0,0,2,10,3740,0,2014,0.0,98029,47.581,-122.022,2510,27520,7727,0.673846690503183,13987600,131492089,117504489
425000.0,4,2.5,1950,5000,2.0,0,0,2,8,1950,0,2012,0.0,98065,47.515,-121.87200000000001,2710,5000,3050,0.61,3802500,25000000,21197500
474950.0,3,3.0,1530,1568,3.0,0,0,2,8,1530,0,2012,0.0,98117,47.6998,-122.367,1460,1224,38,0.02423469387755102,2340900,2458624,117724
307635.0,3,2.5,1820,4200,2.0,0,0,2,8,1820,0,2014,0.0,98038,47.3693,-122.01700000000001,2370,4200,2380,0.5666666666666667,3312400,17640000,14327600
834538.0,3,2.5,2760,6187,2.0,0,0,2,10,2760,0,2014,0.0,98075,47.5821,-122.04700000000001,2760,6600,3427,0.5539033457249071,7617600,38278969,30661369
769995.0,5,2.75,3010,5398,2.0,0,0,2,9,3010,0,2014,0.0,98074,47.6067,-122.053,3360,5407,2388,0.44238606891441273,9060100,29138404,20078304
820875.0,5,3.25,3860,9387,2.0,0,2,2,9,3860,0,2006,0.0,98065,47.538000000000004,-121.85799999999999,3860,8979,5527,0.5887930116118035,14899600,88115769,73216169
595500.0,4,2.5,2490,6537,2.0,0,0,2,8,2490,0,2013,0.0,98065,47.5185,-121.884,2520,5848,4047,0.6190913262964662,6200100,42732369,36532269
450000.0,4,2.5,3236,9608,2.0,0,0,2,10,3236,0,2005,0.0,98030,47.3838,-122.195,3236,9660,6372,0.6631973355537052,10471696,92313664,81841968
695000.0,4,2.5,2830,14538,2.0,0,0,2,8,2830,0,2003,0.0,98065,47.5405,-121.882,2270,6939,11708,0.8053377355894896,8008900,211353444,203344544
300000.0,3,2.0,1451,7159,1.0,0,0,2,7,1451,0,2010,0.0,98042,47.3754,-122.163,2303,6126,5708,0.7973180611817293,2105401,51251281,49145880
515000.0,5,3.25,2910,5027,2.0,0,0,2,8,2040,0,2013,0.0,98106,47.5543,-122.359,2910,5027,2117,0.42112592003182814,8468100,25270729,16802629
545000.0,3,2.5,1280,1845,3.0,0,0,2,8,1280,0,2009,0.0,98105,47.662,-122.324,1450,1889,565,0.3062330623306233,1638400,3404025,1765625
365000.0,3,2.25,1110,979,2.0,0,0,2,7,960,150,2008,0.0,98144,47.5999,-122.3,1170,1400,-131,-0.1338100102145046,1232100,958441,-273659
718500.0,4,2.75,2840,8800,2.0,0,0,2,9,2840,0,2008,0.0,98033,47.7029,-122.171,1840,7700,5960,0.6772727272727272,8065600,77440000,69374400
279800.0,3,1.75,1410,2052,2.0,0,0,2,8,1410,0,2014,0.0,98106,47.5171,-122.34700000000001,1410,1988,642,0.3128654970760234,1988100,4210704,2222604
486940.0,4,2.5,3250,13360,2.0,0,0,2,9,3250,0,2014,0.0,98030,47.3524,-122.198,2612,14448,10110,0.7567365269461078,10562500,178489600,167927100
525000.0,4,2.75,3030,6625,2.0,0,0,2,8,3030,0,2011,0.0,98059,47.4815,-122.152,3030,9620,3595,0.5426415094339623,9180900,43890625,34709725
345000.0,4,2.5,1983,6002,2.0,0,0,2,9,1983,0,2012,0.0,98092,47.3281,-122.164,2502,4750,4019,0.6696101299566811,3932289,36024004,32091715
613000.0,3,3.25,2440,2812,2.0,0,0,2,8,1710,730,2005,0.0,98027,47.5362,-122.072,2440,2836,372,0.13229018492176386,5953600,7907344,1953744
370000.0,3,2.5,2313,5700,2.0,0,0,2,9,2313,0,2011,0.0,98030,47.3572,-122.20200000000001,2323,5701,3387,0.5942105263157895,5349969,32490000,27140031
449500.0,3,2.25,1260,2556,2.0,0,0,2,7,1260,0,2005,0.0,98029,47.5482,-121.99799999999999,1630,2844,1296,0.5070422535211268,1587600,6533136,4945536
515000.0,3,2.5,2000,3837,2.0,0,0,2,8,2000,0,2011,0.0,98072,47.7713,-122.167,2210,4075,1837,0.4787594474850143,4000000,14722569,10722569
346100.0,2,1.75,1150,698,2.0,0,0,2,7,1150,0,2013,0.0,98027,47.5323,-122.071,1150,757,-452,-0.6475644699140402,1322500,487204,-835296
398500.0,4,2.5,2820,6666,2.0,0,0,2,9,2820,0,2007,0.0,98038,47.3473,-122.031,1880,7200,3846,0.576957695769577,7952400,44435556,36483156
310000.0,2,1.75,1160,2500,2.0,0,0,2,7,1160,0,2008,0.0,98014,47.6489,-121.911,970,7500,1340,0.536,1345600,6250000,4904400
250000.0,3,2.25,1481,2820,2.0,0,0,2,7,1481,0,2012,0.0,98002,47.3457,-122.21700000000001,1481,2889,1339,0.474822695035461,2193361,7952400,5759039
1880000.0,5,3.5,4390,6220,2.0,0,3,2,9,3170,1220,2013,0.0,98115,47.6789,-122.273,2740,6448,1830,0.2942122186495177,19272100,38688400,19416300
695000.0,2,1.75,1570,1207,3.0,0,0,2,9,1570,0,2007,0.0,98004,47.6215,-122.20100000000001,1570,1206,-363,-0.3007456503728252,2464900,1456849,-1008051
1090000.0,4,3.0,3410,6541,2.0,0,2,2,9,2680,730,2007,0.0,98126,47.5416,-122.38,2300,6345,3131,0.4786729857819905,11628100,42784681,31156581
864327.0,5,3.25,3480,6507,2.0,0,0,2,9,3480,0,2014,0.0,98074,47.607,-122.053,3360,5398,3027,0.46519133241124944,12110400,42341049,30230649
749995.0,4,3.25,3430,9870,2.0,0,0,2,9,3430,0,2014,0.0,98011,47.776,-122.17299999999999,3360,9724,6440,0.6524822695035462,11764900,97416900,85652000
525000.0,5,2.75,2880,8364,2.0,0,0,2,9,2880,0,2006,0.0,98059,47.4893,-122.147,3010,8296,5484,0.6556671449067432,8294400,69956496,61662096
659950.0,3,2.5,2990,9413,2.0,0,0,2,10,2990,0,2006,0.0,98028,47.7341,-122.234,1940,9600,6423,0.6823541910124297,8940100,88604569,79664469
1800000.0,5,5.0,4490,10279,2.0,0,0,2,10,3930,560,2013,0.0,98004,47.5974,-122.20200000000001,2490,10279,5789,0.5631870804552972,20160100,105657841,85497741
950000.0,5,4.0,4100,8120,2.0,0,0,2,9,4100,0,2011,0.0,98053,47.6917,-122.02,4100,7625,4020,0.49507389162561577,16810000,65934400,49124400
1400000.0,4,2.75,3870,10046,2.0,0,0,2,11,3870,0,2005,0.0,98033,47.6651,-122.191,3560,10046,6176,0.6147720485765479,14976900,100922116,85945216
265050.0,2,1.5,800,2119,2.0,0,0,2,7,800,0,2008,0.0,98106,47.553999999999995,-122.36200000000001,1020,4800,1319,0.6224634261444077,640000,4490161,3850161
450000.0,3,2.25,1620,1057,3.0,0,0,2,8,1540,80,2009,0.0,98027,47.5396,-122.02600000000001,1390,942,-563,-0.532639545884579,2624400,1117249,-1507151
915000.0,4,2.5,2910,4356,3.0,0,0,2,8,2910,0,2010,0.0,98034,47.6705,-122.146,2840,4181,1446,0.3319559228650138,8468100,18974736,10506636
963000.0,4,3.25,3530,8589,2.0,0,0,2,10,3530,0,2007,0.0,98033,47.6975,-122.195,2470,9019,5059,0.5890091978111538,12460900,73770921,61310021
270000.0,4,2.5,2701,5821,2.0,0,0,2,7,2701,0,2013,0.0,98092,47.2873,-122.177,2566,5843,3120,0.5359903796598523,7295401,33884041,26588640
294000.0,2,2.5,1380,889,2.0,0,0,2,7,1140,240,2012,0.0,98126,47.5441,-122.369,1580,1397,-491,-0.5523059617547806,1904400,790321,-1114079
700000.0,3,2.5,2050,4185,2.0,0,0,2,9,2050,0,2011,0.0,98117,47.6922,-122.37100000000001,1150,5000,2135,0.5101553166069295,4202500,17514225,13311725
1070000.0,3,4.0,3370,8252,2.0,0,0,2,10,3370,0,2014,0.0,98075,47.5965,-122.01299999999999,3710,8252,4882,0.5916141541444498,11356900,68095504,56738604
494900.0,3,2.5,2040,2500,2.0,0,0,2,7,1470,570,2008,0.0,98126,47.573,-122.37200000000001,1410,2500,460,0.184,4161600,6250000,2088400
415000.0,3,2.5,1610,3600,2.0,0,0,2,8,1610,0,2010,0.0,98072,47.771,-122.169,2210,3600,1990,0.5527777777777778,2592100,12960000,10367900
459990.0,3,2.5,2680,5539,2.0,0,0,2,8,2680,0,2013,0.0,98045,47.4761,-121.734,2990,6037,2859,0.5161581512908467,7182400,30680521,23498121
882990.0,4,3.5,3560,6562,2.0,0,0,2,10,3560,0,2014,0.0,98075,47.5929,-121.97399999999999,3710,6562,3002,0.4574824748552271,12673600,43059844,30386244
620000.0,4,3.5,3880,8244,2.0,0,0,2,10,3060,820,2007,0.0,98019,47.7426,-121.976,3180,10947,4364,0.5293546821931101,15054400,67963536,52909136
375900.0,3,2.0,1824,7120,1.0,0,0,2,9,1824,0,2010,0.0,98001,47.3457,-122.27,2409,6264,5296,0.7438202247191011,3326976,50694400,47367424
654000.0,3,2.5,2220,2873,2.0,0,0,2,10,2010,210,2012,0.0,98027,47.5311,-122.074,2290,3213,653,0.2272885485555169,4928400,8254129,3325729
1840000.0,4,3.25,4140,11007,2.0,0,0,2,10,4140,0,2013,0.0,98040,47.5707,-122.21700000000001,2150,9663,6867,0.6238757154538022,17139600,121154049,104014449
215000.0,3,2.5,1322,6006,2.0,0,0,2,7,1322,0,2009,0.0,98001,47.2706,-122.25399999999999,1440,6796,4684,0.7798867798867799,1747684,36072036,34324352
630500.0,3,2.5,1909,1300,3.0,0,0,2,8,1766,143,2006,0.0,98103,47.6538,-122.352,1780,1248,-609,-0.4684615384615385,3644281,1690000,-1954281
855000.0,4,3.5,3460,7702,2.0,0,0,2,10,3460,0,2010,0.0,98075,47.5942,-121.977,3380,7464,4242,0.5507660347961568,11971600,59320804,47349204
235245.0,4,2.5,1954,5075,2.0,0,0,2,8,1954,0,2007,0.0,98001,47.2606,-122.25299999999999,1934,5000,3121,0.614975369458128,3818116,25755625,21937509
770000.0,5,2.5,3000,7912,1.0,0,0,2,9,1610,1390,2007,0.0,98033,47.6765,-122.175,2700,7205,4912,0.6208291203235592,9000000,62599744,53599744
734990.0,4,2.5,2650,6884,2.0,0,0,2,8,2650,0,2012,0.0,98053,47.6901,-122.015,2520,5866,4234,0.6150493898895991,7022500,47389456,40366956
880000.0,4,2.5,2580,3436,2.0,0,0,2,8,2580,0,2013,0.0,98033,47.6853,-122.21,1780,5772,856,0.24912689173457508,6656400,11806096,5149696
525000.0,4,3.0,2650,4924,2.0,0,0,2,8,2650,0,2011,0.0,98028,47.7734,-122.238,2380,4733,2274,0.46181965881397236,7022500,24245776,17223276
775000.0,4,3.5,3390,3960,2.0,0,0,2,10,3390,0,2008,0.0,98027,47.5406,-121.995,2990,3400,570,0.14393939393939395,11492100,15681600,4189500
687015.0,3,1.75,1470,873,3.0,0,0,2,10,1470,0,2009,0.0,98119,47.6256,-122.36200000000001,1410,967,-597,-0.6838487972508591,2160900,762129,-1398771
663000.0,3,2.5,1910,5125,2.0,0,0,2,9,1910,0,2006,0.0,98029,47.5481,-121.995,1910,3215,3215,0.6273170731707317,3648100,26265625,22617525
815000.0,4,2.5,3030,7187,2.0,0,0,2,9,3030,0,2005,0.0,98033,47.6934,-122.166,3030,7187,4157,0.5784054542924725,9180900,51652969,42472069
1050000.0,4,3.25,2930,25020,2.0,0,0,2,9,2930,0,2013,0.0,98029,47.5514,-122.023,2400,32374,22090,0.8828936850519584,8584900,626000400,617415500
433190.0,3,2.5,1650,2787,2.0,0,0,2,8,1650,0,2014,0.0,98065,47.5336,-121.838,1760,2787,1137,0.40796555435952636,2722500,7767369,5044869
725000.0,4,2.5,2870,5118,2.0,0,0,2,9,2870,0,2006,0.0,98029,47.5544,-121.99,2940,4800,2248,0.4392340758108636,8236900,26193924,17957024
279950.0,3,2.5,1608,4800,2.0,0,0,2,8,1608,0,2013,0.0,98092,47.2585,-122.20100000000001,2009,4800,3192,0.665,2585664,23040000,20454336
272167.0,2,2.5,1620,3795,2.0,0,0,2,7,1620,0,2014,0.0,98027,47.5321,-122.03399999999999,1620,6000,2175,0.5731225296442688,2624400,14402025,11777625
468500.0,3,2.5,1350,1186,2.0,0,0,2,8,1120,230,2007,0.0,98117,47.6786,-122.375,1500,1605,-164,-0.13827993254637436,1822500,1406596,-415904
298000.0,3,2.5,1950,3600,2.0,0,0,2,7,1950,0,2010,0.0,98038,47.3658,-122.021,1870,4184,1650,0.4583333333333333,3802500,12960000,9157500
303500.0,6,4.5,3390,7200,2.0,0,0,2,8,2440,950,2007,0.0,98118,47.5205,-122.288,2040,7214,3810,0.5291666666666667,11492100,51840000,40347900
308000.0,3,1.75,1300,1237,2.0,0,0,2,7,1060,240,2008,0.0,98027,47.538999999999994,-122.02600000000001,1350,942,-63,-0.05092966855295069,1690000,1530169,-159831
646800.0,3,3.0,2230,1407,2.5,0,0,2,8,1850,380,2014,0.0,98027,47.5446,-122.01700000000001,2230,1407,-823,-0.5849324804548686,4972900,1979649,-2993251
530200.0,4,2.5,1880,3853,2.0,0,0,2,8,1880,0,2010,0.0,98027,47.5636,-122.094,1890,3078,1973,0.5120685180378926,3534400,14845609,11311209
405000.0,5,2.5,3370,5092,2.0,0,0,2,7,3370,0,2006,0.0,98038,47.3594,-122.036,2910,5092,1722,0.33817753338570306,11356900,25928464,14571564
529000.0,2,2.5,1320,1395,2.0,0,0,2,8,990,330,2014,0.0,98107,47.6689,-122.36200000000001,1550,1519,75,0.053763440860215055,1742400,1946025,203625
675900.0,3,2.5,2920,9096,2.0,0,0,2,9,2920,0,2013,0.0,98059,47.4855,-122.149,2930,7995,6176,0.6789797713280563,8526400,82737216,74210816
570000.0,3,3.25,1550,1280,2.0,0,0,2,9,1220,330,2013,0.0,98199,47.6493,-122.384,1550,1579,-270,-0.2109375,2402500,1638400,-764100
375500.0,4,2.5,2301,6452,2.0,0,0,2,9,2301,0,2010,0.0,98001,47.346000000000004,-122.26899999999999,2650,6054,4151,0.6433663980161191,5294601,41628304,36333703
445000.0,3,3.25,1710,1960,2.0,0,0,2,8,1360,350,2004,0.0,98029,47.5479,-122.00299999999999,1420,955,250,0.12755102040816327,2924100,3841600,917500
1100000.0,4,3.75,2890,4164,2.0,0,0,2,9,2240,650,2013,0.0,98033,47.676,-122.197,2354,3207,1274,0.3059558117195005,8352100,17338896,8986796
477000.0,3,2.5,2100,5060,2.0,0,0,2,7,2100,0,2006,0.0,98108,47.563,-122.29799999999999,1520,2468,2960,0.5849802371541502,4410000,25603600,21193600
450000.0,3,2.75,2240,3360,2.0,0,0,2,8,2100,140,2014,0.0,98178,47.4999,-122.23200000000001,1790,5873,1120,0.3333333333333333,5017600,11289600,6272000
427005.0,3,3.0,1460,1200,3.0,0,0,2,8,1460,0,2006,0.0,98117,47.7,-122.367,1460,1245,-260,-0.21666666666666667,2131600,1440000,-691600
720000.0,3,1.75,1370,1990,3.0,0,0,2,9,1370,0,2014,0.0,98102,47.6434,-122.324,1730,1990,620,0.31155778894472363,1876900,3960100,2083200
2230000.0,3,3.5,3760,5634,2.0,1,4,2,11,2830,930,2014,0.0,98056,47.5285,-122.205,3560,5762,1874,0.33262335818246364,14137600,31741956,17604356
450800.0,4,3.25,2510,5311,2.0,0,0,2,9,2510,0,2009,0.0,98056,47.5028,-122.17,1590,9583,2801,0.5273959706270006,6300100,28206721,21906621
461100.0,2,2.25,1210,1267,2.0,0,0,2,8,1120,90,2010,0.0,98117,47.6783,-122.376,1360,1349,57,0.04498816101026046,1464100,1605289,141189
1060000.0,4,3.0,2990,6695,2.0,0,0,2,10,2990,0,2014,0.0,98075,47.5817,-122.04700000000001,2760,6600,3705,0.5533980582524272,8940100,44823025,35882925
590000.0,3,2.5,1710,2875,2.0,0,0,2,8,1710,0,2006,0.0,98116,47.5787,-122.39200000000001,1640,5750,1165,0.4052173913043478,2924100,8265625,5341525
478830.0,4,2.5,3274,4950,2.0,0,0,2,9,3274,0,2014,0.0,98092,47.2603,-122.195,2578,4200,1676,0.3385858585858586,10719076,24502500,13783424
760000.0,4,2.25,3300,8365,3.0,0,0,2,9,3300,0,2014,0.0,98126,47.5363,-122.37700000000001,1290,8369,5065,0.6054991034070532,10890000,69973225,59083225
1030000.0,4,3.5,4370,10860,2.0,0,0,2,11,4370,0,2008,0.0,98059,47.5066,-122.148,3560,8070,6490,0.5976058931860037,19096900,117939600,98842700
385000.0,4,2.5,2050,5276,2.0,0,0,2,7,2050,0,2006,0.0,98059,47.49100000000001,-122.15,2480,5447,3226,0.61144806671721,4202500,27836176,23633676
500000.0,2,2.5,1310,1500,2.0,0,0,2,8,1160,150,2006,0.0,98122,47.6112,-122.309,1320,1581,190,0.12666666666666668,1716100,2250000,533900
425000.0,3,1.5,1680,8000,1.5,0,0,2,7,1680,0,2012,0.0,98014,47.6923,-121.869,1990,26336,6320,0.79,2822400,64000000,61177600
552100.0,3,3.0,1330,1379,2.0,0,0,3,8,1120,210,2005,0.0,98122,47.6126,-122.31299999999999,1810,1770,49,0.03553299492385787,1768900,1901641,132741
785000.0,3,3.0,1950,1983,3.0,0,0,2,9,1610,340,2009,0.0,98004,47.6078,-122.20200000000001,2040,2131,33,0.01664145234493192,3802500,3932289,129789
615000.0,5,3.25,3090,7069,2.0,0,0,2,9,3090,0,2012,0.0,98056,47.5114,-122.196,2480,8000,3979,0.5628801810722874,9548100,49970761,40422661
309000.0,3,2.5,1950,3825,2.0,0,0,2,7,1950,0,2013,0.0,98042,47.3588,-122.08200000000001,1950,3825,1875,0.49019607843137253,3802500,14630625,10828125
369500.0,3,2.0,1108,1128,3.0,0,0,2,7,1108,0,2009,0.0,98115,47.6961,-122.318,1285,1253,20,0.01773049645390071,1227664,1272384,44720
391000.0,4,2.25,2190,3850,2.0,0,0,2,7,2190,0,2006,0.0,98059,47.4861,-122.161,2190,3980,1660,0.43116883116883115,4796100,14822500,10026400
465000.0,3,1.75,1590,1322,2.0,0,0,2,8,1060,530,2014,0.0,98144,47.5753,-122.294,1530,5400,-268,-0.2027231467473525,2528100,1747684,-780416
879950.0,4,2.75,3010,7215,2.0,0,0,2,9,3010,0,2014,0.0,98033,47.6952,-122.178,3010,7215,4205,0.5828135828135829,9060100,52056225,42996125
372000.0,3,2.0,1330,1042,2.0,0,0,2,8,1060,270,2014,0.0,98136,47.5522,-122.382,1440,2428,-288,-0.2763915547024952,1768900,1085764,-683136
259000.0,3,2.5,1550,3569,2.0,0,0,2,7,1550,0,2011,0.0,98002,47.3528,-122.211,2095,3402,2019,0.5657046791818436,2402500,12737761,10335261
374000.0,2,1.5,1260,1575,2.0,0,0,2,7,1260,0,2001,0.0,98144,47.5914,-122.295,1220,1740,315,0.2,1587600,2480625,893025
561000.0,4,2.5,2550,5395,2.0,0,0,2,8,2550,0,2001,0.0,98065,47.5355,-121.874,2850,6109,2845,0.5273401297497683,6502500,29106025,22603525
610000.0,3,2.5,1300,1331,3.0,0,0,2,8,1300,0,2007,0.0,98103,47.6607,-122.352,1450,5270,31,0.02329075882794891,1690000,1771561,81561
635000.0,3,3.0,2230,1407,2.5,0,0,2,8,1850,380,2014,0.0,98027,47.5446,-122.01700000000001,2290,1407,-823,-0.5849324804548686,4972900,1979649,-2993251
235000.0,1,1.5,1170,1456,2.0,0,0,2,8,1070,0,2007,0.0,98126,47.5493,-122.37200000000001,1360,1730,286,0.19642857142857142,1368900,2119936,751036
623300.0,4,3.5,4170,4524,2.0,0,0,2,9,3500,670,2007,0.0,98072,47.7726,-122.162,3510,5001,354,0.07824933687002653,17388900,20466576,3077676
412500.0,3,2.0,1680,5246,1.0,0,0,2,7,1680,0,2007,0.0,98065,47.5206,-121.868,2430,6883,3566,0.6797560045749143,2822400,27520516,24698116
380000.0,4,3.25,2864,8035,3.0,0,0,2,8,2864,0,2014,0.0,98030,47.3746,-122.189,2419,8984,5171,0.6435594275046671,8202496,64561225,56358729
497000.0,3,2.25,1630,3817,2.0,0,0,2,7,1630,0,2005,0.0,98029,47.5485,-121.999,1630,3348,2187,0.5729630599947603,2656900,14569489,11912589
452000.0,4,2.5,2716,7850,2.0,0,0,2,9,2716,0,2014,0.0,98030,47.352,-122.197,2580,14448,5134,0.6540127388535032,7376656,61622500,54245844
312000.0,3,2.5,1750,4076,2.0,0,0,2,7,1750,0,2013,0.0,98038,47.3597,-122.045,1810,4090,2326,0.570657507360157,3062500,16613776,13551276
469950.0,5,3.0,3223,6371,2.0,0,0,2,9,3223,0,2014,0.0,98042,47.3588,-122.163,1979,19030,3148,0.49411395385339824,10387729,40589641,30201912
775000.0,5,2.5,2600,4284,2.0,0,0,2,9,2600,0,2014,0.0,98136,47.5409,-122.39,1620,5000,1684,0.3930905695611578,6760000,18352656,11592656
679990.0,4,2.75,3320,8653,2.0,0,0,2,8,3320,0,2014,0.0,98133,47.7521,-122.334,2140,8727,5333,0.616318039986132,11022400,74874409,63852009
288790.0,4,2.0,1350,942,3.0,0,0,2,7,1350,0,2008,0.0,98027,47.5401,-122.02600000000001,1390,942,-408,-0.43312101910828027,1822500,887364,-935136
800000.0,5,2.5,3410,4726,2.0,0,0,2,9,3410,0,2007,0.0,98006,47.5459,-122.184,2810,5129,1316,0.2784595852729581,11628100,22335076,10706976
299000.0,3,2.5,1572,4000,2.0,0,0,2,8,1572,0,2013,0.0,98092,47.2615,-122.198,1608,5175,2428,0.607,2471184,16000000,13528816
332000.0,4,2.5,2300,4482,2.0,0,0,2,7,2300,0,2013,0.0,98042,47.3599,-122.08200000000001,2300,3825,2182,0.4868362338241856,5290000,20088324,14798324
525000.0,1,1.5,1030,5923,1.0,0,0,2,8,1030,0,1940,0.0,98105,47.6653,-122.305,2650,5000,4893,0.8261016376836062,1060900,35081929,34021029
620000.0,3,1.75,1458,858,2.0,0,0,2,8,950,508,2014,0.0,98144,47.592,-122.29299999999999,1458,3000,-600,-0.6993006993006993,2125764,736164,-1389600
452000.0,4,2.5,2190,6896,2.0,0,0,2,7,2190,0,2007,0.0,98065,47.5191,-121.869,2190,5900,4706,0.6824245939675174,4796100,47554816,42758716
630000.0,4,3.0,3640,5096,2.0,0,0,2,8,2740,900,2010,0.0,98118,47.5428,-122.27,1910,9189,1456,0.2857142857142857,13249600,25969216,12719616
485000.0,4,2.75,2790,7803,2.0,0,0,2,8,2790,0,2013,0.0,98045,47.4823,-121.772,2620,6178,5013,0.6424452133794695,7784100,60886809,53102709
349950.0,4,2.5,2632,4117,2.0,0,0,2,8,2632,0,2013,0.0,98001,47.3428,-122.27799999999999,2040,5195,1485,0.36069953849890696,6927424,16949689,10022265
499990.0,4,2.75,2910,6334,2.0,0,0,2,8,2910,0,2013,0.0,98045,47.4826,-121.771,2790,6352,3424,0.5405746763498579,8468100,40119556,31651456
510000.0,2,2.25,1470,1101,2.0,0,0,2,8,1340,130,2005,0.0,98115,47.6768,-122.301,1470,1582,-369,-0.335149863760218,2160900,1212201,-948699
1080000.0,3,2.5,2240,21477,2.0,0,2,2,8,2240,0,1995,0.0,98006,47.5745,-122.18,2930,21569,19237,0.8957023792894725,5017600,461261529,456243929
494000.0,3,2.5,2310,4729,2.0,0,0,2,8,2310,0,2011,0.0,98028,47.7734,-122.23700000000001,2440,4711,2419,0.5115246352294354,5336100,22363441,17027341
429900.0,3,2.5,2370,5353,2.0,0,0,2,8,2370,0,2009,0.0,98019,47.7333,-121.975,2130,6850,2983,0.5572576125537082,5616900,28654609,23037709
505000.0,4,2.75,2980,9825,1.0,0,0,2,8,1910,1070,2007,0.0,98056,47.5073,-122.17200000000001,2580,12231,6845,0.6966921119592875,8880400,96530625,87650225
272000.0,4,2.0,1870,6551,1.0,0,3,2,7,1870,0,2009,0.0,98022,47.1934,-121.977,2280,5331,4681,0.7145473973439169,3496900,42915601,39418701
671500.0,3,2.5,1770,1714,3.0,0,0,2,8,1770,0,2012,0.0,98103,47.6532,-122.348,1720,3360,-56,-0.03267211201866978,3132900,2937796,-195104
729950.0,4,3.5,3510,10010,2.0,0,0,2,10,3510,0,2001,0.0,98065,47.5412,-121.876,4200,9935,6500,0.6493506493506493,12320100,100200100,87880000
471835.0,4,2.5,3281,5354,2.0,0,0,2,9,3281,0,2014,0.0,98092,47.3273,-122.163,2598,4815,2073,0.38718714979454616,10764961,28665316,17900355
249950.0,3,2.0,1670,4438,1.0,0,0,2,7,1670,0,2014,0.0,98022,47.1948,-121.97399999999999,1670,4558,2768,0.6237043713384407,2788900,19695844,16906944
424950.0,5,3.5,2760,3846,2.5,0,0,2,8,2760,0,2013,0.0,98056,47.5047,-122.17,2760,4587,1086,0.2823712948517941,7617600,14791716,7174116
1240000.0,5,3.5,5430,10327,2.0,0,2,2,10,4010,1420,2007,0.0,98006,47.5476,-122.116,4340,10324,4897,0.47419386075336495,29484900,106646929,77162029
440000.0,4,2.5,2990,7928,2.0,0,0,2,9,2990,0,2011,0.0,98010,47.3139,-122.024,2810,7401,4938,0.6228557013118062,8940100,62853184,53913084
495000.0,4,3.5,3170,3858,2.0,0,0,2,8,2530,640,2008,0.0,98059,47.5049,-122.155,2640,3844,688,0.17833074131674442,10048900,14884164,4835264
870000.0,4,2.5,3520,6773,2.5,0,0,2,9,2650,870,2006,0.0,98136,47.5317,-122.391,2930,6458,3253,0.4802893843200945,12390400,45873529,33483129
559000.0,2,3.0,1650,960,3.0,0,0,2,8,1350,300,2015,0.0,98103,47.6611,-122.346,1650,3000,-690,-0.71875,2722500,921600,-1800900
495000.0,4,2.75,2656,21195,2.0,0,0,2,9,2656,0,2014,0.0,98001,47.3162,-122.272,1860,16510,18539,0.874687426279783,7054336,449228025,442173689
722000.0,3,2.5,2230,4850,2.0,0,0,2,8,2230,0,2014,0.0,98133,47.7295,-122.334,2230,4513,2620,0.5402061855670103,4972900,23522500,18549600
567500.0,3,2.5,2280,2502,2.0,0,0,2,8,1880,400,2006,0.0,98027,47.5364,-122.073,2280,2812,222,0.08872901678657075,5198400,6260004,1061604
440000.0,4,2.5,2798,5085,2.0,0,0,2,9,2798,0,2011,0.0,98092,47.3308,-122.18700000000001,2502,5707,2287,0.4497541789577188,7828804,25857225,18028421
400000.0,4,2.5,2398,5988,2.0,0,0,2,8,2398,0,2008,0.0,98055,47.452,-122.204,2370,5988,3590,0.5995323981295925,5750404,35856144,30105740
459995.0,4,2.5,2350,3760,2.0,0,0,2,8,2350,0,2014,0.0,98059,47.4786,-122.12299999999999,2590,4136,1410,0.375,5522500,14137600,8615100
365000.0,5,2.75,2410,5003,1.0,0,0,2,7,1410,1000,2008,0.0,98118,47.5298,-122.274,1590,5003,2593,0.5182890265840495,5808100,25030009,19221909
389950.0,3,2.25,1580,920,3.0,0,0,2,8,1580,0,2015,0.0,98106,47.5578,-122.363,1250,1150,-660,-0.717391304347826,2496400,846400,-1650000
320000.0,3,3.25,1450,1387,2.0,0,0,2,8,1180,270,2013,0.0,98106,47.5556,-122.36200000000001,1450,1198,-63,-0.04542177361211247,2102500,1923769,-178731
415500.0,4,2.5,1750,4779,2.0,0,0,2,7,1750,0,2009,0.0,98028,47.7608,-122.23200000000001,1580,4687,3029,0.633814605566018,3062500,22838841,19776341
775000.0,3,2.5,3020,4120,2.0,0,0,2,9,2360,660,2008,0.0,98126,47.5714,-122.37299999999999,2280,4120,1100,0.2669902912621359,9120400,16974400,7854000
590000.0,3,3.0,1740,1100,3.0,0,0,2,8,1740,0,2007,0.0,98107,47.67,-122.391,1370,1180,-640,-0.5818181818181818,3027600,1210000,-1817600
950000.0,2,2.25,2200,2043,2.0,0,0,2,9,1760,440,2007,0.0,98004,47.6213,-122.2,2020,1957,-157,-0.07684777288301517,4840000,4173849,-666151
378950.0,4,2.5,1867,15314,2.0,0,0,2,9,1867,0,2013,0.0,98030,47.3524,-122.198,2616,8048,13447,0.8780854120412694,3485689,234518596,231032907
441750.0,2,1.5,1020,1060,3.0,0,0,2,8,1020,0,2008,0.0,98103,47.6801,-122.348,1340,1415,40,0.03773584905660377,1040400,1123600,83200
335900.0,4,2.75,2475,4000,2.0,0,0,2,7,2475,0,2014,0.0,98002,47.345,-122.209,2475,4000,1525,0.38125,6125625,16000000,9874375
229800.0,2,1.75,1110,1773,2.0,0,0,2,8,1110,0,2014,0.0,98108,47.5647,-122.29299999999999,1420,2855,663,0.3739424703891709,1232100,3143529,1911429
645000.0,3,2.5,1900,1258,2.5,0,0,2,7,1700,200,2007,0.0,98119,47.6465,-122.35799999999999,1780,1877,-642,-0.5103338632750397,3610000,1582564,-2027436
448000.0,3,3.25,1560,1345,2.0,0,0,2,8,1260,300,2009,0.0,98126,47.5637,-122.375,1560,4800,-215,-0.15985130111524162,2433600,1809025,-624575
706000.0,4,2.5,2510,5436,2.0,0,0,2,8,2510,0,2011,0.0,98053,47.6894,-122.016,2520,5436,2926,0.5382634289919058,6300100,29550096,23249996
988990.0,4,4.75,4150,6303,3.0,0,0,2,9,4150,0,2014,0.0,98052,47.7047,-122.12299999999999,3570,6285,2153,0.34158337299698555,17222500,39727809,22505309
716000.0,3,3.0,1660,1849,3.0,0,0,2,9,1660,0,2013,0.0,98103,47.6649,-122.353,1660,3300,189,0.10221741481882099,2755600,3418801,663201
319000.0,2,1.5,1090,847,3.0,0,0,2,8,1090,0,2009,0.0,98133,47.7235,-122.352,1090,1118,-243,-0.28689492325855964,1188100,717409,-470691
300000.0,4,2.5,1914,3272,2.0,0,0,2,8,1914,0,2009,0.0,98055,47.4297,-122.189,1714,3250,1358,0.41503667481662593,3663396,10705984,7042588
625000.0,4,3.25,2730,54014,1.0,0,0,2,9,1560,1170,2007,0.0,98059,47.5133,-122.11,2730,111274,51284,0.9494575480430999,7452900,2917512196,2910059296
773000.0,3,2.75,2470,3600,2.0,0,0,2,9,2470,0,2007,0.0,98029,47.5406,-121.994,2570,3600,1130,0.3138888888888889,6100900,12960000,6859100
392000.0,5,2.5,2340,5670,2.0,0,0,2,7,2340,0,2009,0.0,98059,47.4913,-122.152,2190,4869,3330,0.5873015873015873,5475600,32148900,26673300
549995.0,4,3.5,2660,5690,2.0,0,0,2,8,1920,740,2014,0.0,98059,47.4775,-122.12200000000001,2970,5690,3030,0.5325131810193322,7075600,32376100,25300500
480000.0,3,2.5,2410,4656,2.0,0,0,2,7,2410,0,2009,0.0,98065,47.5203,-121.874,2410,4840,2246,0.48238831615120276,5808100,21678336,15870236
355000.0,3,2.25,1430,4777,2.0,0,0,2,7,1430,0,2010,0.0,98059,47.4867,-122.152,1639,3854,3347,0.7006489428511619,2044900,22819729,20774829
208400.0,2,2.5,1570,1268,3.0,0,0,2,7,1570,0,2007,0.0,98106,47.534,-122.365,1570,1300,-302,-0.23817034700315456,2464900,1607824,-857076
831548.0,5,2.75,3010,4919,2.0,0,0,2,9,3010,0,2014,0.0,98074,47.6067,-122.052,3230,5415,1909,0.38808700955478753,9060100,24196561,15136461
279500.0,4,2.5,1613,4338,2.0,0,0,2,7,1613,0,2009,0.0,98042,47.3859,-122.162,1427,4341,2725,0.628169663439373,2601769,18818244,16216475
445000.0,3,2.5,2380,5269,2.0,0,0,2,8,2380,0,2008,0.0,98056,47.5066,-122.19200000000001,2150,7600,2889,0.548301385462137,5664400,27762361,22097961
492500.0,5,2.5,2570,9962,2.0,0,0,2,8,2570,0,2006,0.0,98019,47.7275,-121.95700000000001,2890,9075,7392,0.7420196747641036,6604900,99241444,92636544
435000.0,4,2.5,2550,5200,2.0,0,0,2,7,2550,0,2009,0.0,98059,47.4919,-122.15299999999999,2550,4660,2650,0.5096153846153846,6502500,27040000,20537500
325000.0,3,2.25,1330,969,3.0,0,0,2,7,1330,0,2007,0.0,98125,47.7177,-122.292,1310,1941,-361,-0.37254901960784315,1768900,938961,-829939
453000.0,2,1.5,1160,1269,2.0,0,0,2,7,970,190,2005,0.0,98103,47.6608,-122.335,1700,3150,109,0.08589440504334121,1345600,1610361,264761
612995.0,5,3.5,3240,6919,2.0,0,0,2,8,2760,480,2014,0.0,98059,47.4779,-122.12200000000001,2970,5690,3679,0.5317242376065906,10497600,47872561,37374961
540000.0,4,2.5,2710,9248,2.0,0,0,2,7,2710,0,2011,0.0,98065,47.5164,-121.875,2710,5000,6538,0.7069636678200693,7344100,85525504,78181404
465000.0,3,1.0,1150,18200,1.0,0,0,4,7,1150,0,1959,0.0,98058,47.4262,-122.18700000000001,1714,18200,17050,0.9368131868131868,1322500,331240000,329917500
799950.0,3,2.25,1860,1386,3.0,0,0,2,9,1860,0,2014,0.0,98112,47.6368,-122.279,1680,3080,-474,-0.341991341991342,3459600,1920996,-1538604
495000.0,3,2.25,1280,1517,2.0,0,0,2,8,1080,200,2008,0.0,98107,47.6651,-122.368,1280,1681,237,0.15622940013183917,1638400,2301289,662889
579950.0,3,2.5,1810,1585,3.0,0,0,2,7,1810,0,2014,0.0,98117,47.6957,-122.376,1560,1586,-225,-0.14195583596214512,3276100,2512225,-763875
331000.0,2,2.25,1240,720,2.0,0,0,2,7,1150,90,2008,0.0,98027,47.5322,-122.072,1260,810,-520,-0.7222222222222222,1537600,518400,-1019200
580000.0,4,3.5,1460,951,3.0,0,0,2,8,1460,0,2008,0.0,98115,47.6821,-122.32600000000001,1430,1282,-509,-0.5352260778128286,2131600,904401,-1227199
669000.0,2,2.5,1640,1953,2.0,0,0,2,10,1640,0,2014,0.0,98118,47.5639,-122.292,1820,2653,313,0.16026625704045058,2689600,3814209,1124609
2350000.0,4,4.25,5010,19412,2.0,0,1,2,11,4000,1010,2014,0.0,98040,47.5455,-122.211,3820,17064,14402,0.7419122192458273,25100100,376825744,351725644
539900.0,3,3.25,1300,1325,2.0,0,0,2,8,1080,220,2005,0.0,98103,47.6584,-122.346,1290,1323,25,0.018867924528301886,1690000,1755625,65625
490000.0,4,2.5,2510,4349,2.0,0,0,2,8,2510,0,2010,0.0,98059,47.4927,-122.147,2510,4314,1839,0.42285582892618995,6300100,18913801,12613701
627000.0,3,3.5,2710,3475,2.0,0,0,2,8,1650,1060,2005,0.0,98027,47.5359,-122.072,2440,2867,765,0.22014388489208633,7344100,12075625,4731525
458000.0,4,3.5,3217,4000,2.0,0,0,2,8,2587,630,2008,0.0,98055,47.4483,-122.20299999999999,2996,5418,783,0.19575,10349089,16000000,5650911
440000.0,3,2.5,1650,4929,2.0,0,0,2,7,1520,130,2007,0.0,98108,47.5634,-122.29799999999999,1520,2287,3279,0.6652465003043213,2722500,24295041,21572541
1700000.0,4,3.5,3950,6240,2.0,0,0,2,11,3950,0,2015,0.0,98112,47.6221,-122.29,2040,6240,2290,0.36698717948717946,15602500,38937600,23335100
935000.0,2,2.5,1680,977,3.0,0,0,2,9,1680,0,2009,0.0,98119,47.632,-122.361,1680,977,-703,-0.7195496417604913,2822400,954529,-1867871
641000.0,5,3.5,3420,6403,2.0,0,2,2,8,2700,720,2013,0.0,98065,47.5162,-121.874,2710,6038,2983,0.4658753709198813,11696400,40998409,29302009
452000.0,3,2.75,2300,5090,2.0,0,0,2,8,1700,600,2007,0.0,98106,47.545,-122.36,1530,9100,2790,0.5481335952848723,5290000,25908100,20618100
625000.0,4,2.75,3010,6854,2.0,0,2,2,9,2570,440,2012,0.0,98065,47.5171,-121.876,1830,2952,3844,0.5608403851765392,9060100,46977316,37917216
1350000.0,4,3.5,4680,12495,2.0,0,0,2,10,3040,1640,2008,0.0,98033,47.6984,-122.206,3240,10749,7815,0.6254501800720288,21902400,156125025,134222625
834950.0,5,3.5,3630,4911,2.0,0,0,2,9,2790,840,2014,0.0,98034,47.718,-122.156,3600,4992,1281,0.26084300549786194,13176900,24117921,10941021
1500000.0,3,3.5,3530,3610,2.0,0,0,2,10,2370,1160,2008,0.0,98103,47.6857,-122.339,1780,3610,80,0.0221606648199446,12460900,13032100,571200
305000.0,4,2.5,2280,3800,2.0,0,0,2,7,2280,0,2006,0.0,98038,47.3586,-122.036,2630,4045,1520,0.4,5198400,14440000,9241600
659000.0,3,2.5,3090,384634,2.0,0,0,2,8,3090,0,2007,0.0,98019,47.7072,-121.927,2200,292645,381544,0.9919663888267808,9548100,147943313956,147933765856
353000.0,1,1.0,550,1279,2.0,0,0,2,7,550,0,2008,0.0,98122,47.61600000000001,-122.314,1460,1385,729,0.5699765441751369,302500,1635841,1333341
535000.0,4,3.25,2840,4000,2.0,0,3,2,9,2330,510,2014,0.0,98108,47.5529,-122.29299999999999,2160,4867,1160,0.29,8065600,16000000,7934400
999000.0,4,2.5,3130,10849,2.0,0,0,2,10,3130,0,2013,0.0,98033,47.6828,-122.186,2470,9131,7719,0.711494146925984,9796900,117700801,107903901
375000.0,3,2.5,1440,1102,3.0,0,0,2,8,1440,0,2009,0.0,98103,47.6995,-122.346,1440,1434,-338,-0.30671506352087113,2073600,1214404,-859196
685000.0,4,3.5,2840,4637,3.0,0,0,2,8,2840,0,2008,0.0,98125,47.7033,-122.321,1730,5279,1797,0.38753504420961826,8065600,21501769,13436169
333000.0,4,2.5,2623,7184,2.0,0,0,2,8,2623,0,2012,0.0,98092,47.25899999999999,-122.20200000000001,2010,4939,4561,0.6348830734966593,6880129,51609856,44729727
245000.0,1,1.0,390,2000,1.0,0,0,3,6,390,0,1920,0.0,98103,47.6938,-122.34700000000001,1340,5100,1610,0.805,152100,4000000,3847900
2000000.0,4,3.25,5640,35006,2.0,0,2,2,11,4900,740,2015,0.0,98006,47.5491,-122.104,4920,35033,29366,0.8388847626121236,31809600,1225420036,1193610436
329950.0,2,2.25,1260,1032,2.0,0,0,2,7,1170,90,2008,0.0,98027,47.5323,-122.072,1240,809,-228,-0.22093023255813954,1587600,1065024,-522576
403000.0,2,1.0,894,1552,2.0,0,0,2,7,894,0,2011,0.0,98115,47.6911,-122.31299999999999,1131,1992,658,0.42396907216494845,799236,2408704,1609468
559630.0,4,2.5,3370,4934,2.0,0,0,2,9,3370,0,2014,0.0,98038,47.3562,-122.022,2980,5046,1564,0.31698419132549654,11356900,24344356,12987456
344000.0,3,2.25,1250,871,3.0,0,0,2,8,1250,0,2007,0.0,98103,47.6907,-122.34299999999999,1250,1158,-379,-0.4351320321469575,1562500,758641,-803859
435000.0,3,1.5,1180,1231,3.0,0,0,2,7,1180,0,2008,0.0,98115,47.6845,-122.315,1280,3360,51,0.041429731925264016,1392400,1515361,122961
430000.0,2,2.5,1520,1588,2.0,0,0,2,8,1240,280,2007,0.0,98144,47.5825,-122.31299999999999,1660,6000,68,0.042821158690176324,2310400,2521744,211344
417000.0,3,2.5,2000,4500,2.0,0,0,2,7,2000,0,2010,0.0,98059,47.4937,-122.149,2230,4501,2500,0.5555555555555556,4000000,20250000,16250000
895950.0,5,2.75,3180,9255,2.0,0,0,2,9,3180,0,2014,0.0,98074,47.6232,-122.023,3180,7782,6075,0.6564019448946515,10112400,85655025,75542625
563950.0,4,2.75,3050,4750,2.0,0,0,2,8,3050,0,2014,0.0,98059,47.4857,-122.15299999999999,2730,5480,1700,0.35789473684210527,9302500,22562500,13260000
332220.0,3,1.5,2580,47480,1.0,0,0,2,7,1360,1220,1953,0.0,98024,47.5333,-121.93299999999999,1760,48181,44900,0.9456613310867734,6656400,2254350400,2247694000
1490000.0,5,6.0,6880,279968,2.0,0,3,2,12,4070,2810,2007,0.0,98045,47.4624,-121.779,4690,256803,273088,0.9754257629443365,47334400,78382081024,78334746624
680000.0,3,2.5,2570,3600,2.5,0,0,2,9,2570,0,2007,0.0,98027,47.5412,-121.994,2570,3600,1030,0.2861111111111111,6604900,12960000,6355100
825750.0,4,3.5,2950,3737,2.0,0,0,2,10,2270,680,2012,0.0,98027,47.5313,-122.074,2580,3581,787,0.21059673534921058,8702500,13965169,5262669
338000.0,3,2.5,1690,1760,2.0,0,0,2,8,1410,280,2014,0.0,98106,47.5387,-122.367,1740,1760,70,0.03977272727272727,2856100,3097600,241500
535365.0,4,2.75,2790,6969,2.0,0,0,2,8,2790,0,2012,0.0,98045,47.4836,-121.76899999999999,2620,6307,4179,0.5996556177356867,7784100,48566961,40782861
608000.0,3,2.25,1720,5234,2.0,0,0,2,9,1240,480,2011,0.0,98118,47.5547,-122.27799999999999,1720,5825,3514,0.6713794421092855,2958400,27394756,24436356
930000.0,3,2.25,2890,5000,3.0,0,0,2,9,2890,0,2014,0.0,98117,47.6983,-122.389,2020,5000,2110,0.422,8352100,25000000,16647900
565000.0,2,1.75,1130,276170,1.0,0,0,2,8,1130,0,2006,0.0,98022,47.2673,-122.027,2092,217800,275040,0.9959083173407683,1276900,76269868900,76268592000
495000.0,2,2.25,1460,1623,2.0,0,0,2,8,1260,200,2005,0.0,98115,47.6764,-122.301,1460,1137,163,0.1004313000616143,2131600,2634129,502529
667000.0,3,2.5,2510,3819,2.0,0,0,2,8,2510,0,2007,0.0,98052,47.6987,-122.096,2520,3990,1309,0.34275988478659336,6300100,14584761,8284661
495000.0,4,2.5,3390,7870,2.0,0,0,2,8,3390,0,2014,0.0,98188,47.4536,-122.274,1960,10069,4480,0.5692503176620076,11492100,61936900,50444800
928990.0,4,2.5,3570,6054,2.0,0,0,2,9,3570,0,2014,0.0,98052,47.7053,-122.126,3600,6050,2484,0.4103072348860258,12744900,36650916,23906016
345000.0,4,2.5,2280,5000,2.0,0,0,2,7,2280,0,2006,0.0,98038,47.3593,-122.037,2910,5000,2720,0.544,5198400,25000000,19801600
1070000.0,5,3.5,2920,3000,2.0,0,0,2,9,2260,660,2014,0.0,98103,47.6846,-122.34899999999999,1580,4000,80,0.02666666666666667,8526400,9000000,473600
519995.0,4,3.0,2590,6160,2.0,0,0,2,8,2590,0,2014,0.0,98059,47.4784,-122.12200000000001,2670,5600,3570,0.5795454545454546,6708100,37945600,31237500
924000.0,5,2.75,3210,8001,2.0,0,0,2,9,3210,0,2014,0.0,98074,47.5935,-122.061,3190,6624,4791,0.5988001499812523,10304100,64016001,53711901
295000.0,3,2.0,1230,3405,1.0,0,0,2,7,1230,0,2010,0.0,98058,47.438,-122.179,1440,4066,2175,0.6387665198237885,1512900,11594025,10081125
472000.0,3,2.5,3800,104979,2.0,0,0,2,8,3210,590,2005,0.0,98045,47.4304,-121.84100000000001,2040,109771,101179,0.963802284266377,14440000,11020590441,11006150441
405000.0,3,2.5,1500,2314,2.0,0,0,2,7,1500,0,2005,0.0,98029,47.5537,-121.99799999999999,1440,2170,814,0.35177182368193605,2250000,5354596,3104596
410000.0,4,2.25,2510,4090,2.0,0,0,2,8,1840,670,2012,0.0,98019,47.7345,-121.96700000000001,2070,4090,1580,0.3863080684596577,6300100,16728100,10428000
419500.0,3,1.5,1400,1091,3.0,0,0,2,8,1400,0,2007,0.0,98115,47.6989,-122.31700000000001,1270,1413,-309,-0.2832263978001833,1960000,1190281,-769719
382000.0,3,2.25,1450,4667,2.0,0,0,2,7,1450,0,2009,0.0,98028,47.7611,-122.23299999999999,1490,4667,3217,0.6893079065781016,2102500,21780889,19678389
370000.0,2,2.5,1390,1821,2.0,0,0,2,7,1180,210,2007,0.0,98118,47.5537,-122.28200000000001,1350,1821,431,0.23668314113124655,1932100,3316041,1383941
553000.0,3,2.75,3160,9072,2.0,0,0,2,9,3160,0,2005,0.0,98056,47.5147,-122.177,3160,9072,5912,0.6516754850088183,9985600,82301184,72315584
2070000.0,4,3.75,4350,7965,2.0,0,0,2,10,4350,0,2013,0.0,98004,47.6289,-122.205,2190,8557,3615,0.4538606403013183,18922500,63441225,44518725
455950.0,4,2.5,2720,5771,2.0,0,0,2,8,2720,0,2015,0.0,98056,47.4917,-122.17,1940,4184,3051,0.5286778721192168,7398400,33304441,25906041
331000.0,3,3.25,1290,1153,3.0,0,0,2,7,1290,0,2008,0.0,98103,47.6904,-122.346,1290,1200,-137,-0.11882046834345186,1664100,1329409,-334691
417250.0,3,2.25,1606,1452,3.0,0,0,2,8,1606,0,2009,0.0,98125,47.7175,-122.28399999999999,1516,1939,-154,-0.10606060606060606,2579236,2108304,-470932
490000.0,5,3.5,4460,2975,3.0,0,2,2,10,3280,0,2015,0.0,98119,47.6313,-122.37,2490,4231,-1485,-0.4991596638655462,19891600,8850625,-11040975
325000.0,4,3.25,2800,5291,2.0,0,0,2,7,2800,0,2011,0.0,98022,47.1937,-121.977,2380,5291,2491,0.4707994707994708,7840000,27994681,20154681
705000.0,5,3.5,3250,4800,2.0,0,0,2,9,2410,840,2010,0.0,98106,47.5618,-122.36200000000001,1330,4920,1550,0.3229166666666667,10562500,23040000,12477500
1170000.0,6,3.5,4310,7760,2.0,0,0,2,10,3260,1050,2013,0.0,98059,47.5297,-122.155,4620,10217,3450,0.44458762886597936,18576100,60217600,41641500
365000.0,3,2.25,1310,915,2.0,0,0,2,7,1060,250,2007,0.0,98144,47.5738,-122.29299999999999,1500,1215,-395,-0.43169398907103823,1716100,837225,-878875
403000.0,2,1.5,1240,1101,2.0,0,0,2,8,1080,160,2009,0.0,98144,47.5758,-122.309,1530,1209,-139,-0.1262488646684832,1537600,1212201,-325399
409000.0,3,2.5,1950,7263,2.0,0,0,2,7,1950,0,2007,0.0,98065,47.5194,-121.869,2190,5900,5313,0.73151590251962,3802500,52751169,48948669
391000.0,3,2.5,1800,1120,2.0,0,0,2,8,1800,0,2011,0.0,98126,47.5436,-122.369,1800,2380,-680,-0.6071428571428571,3240000,1254400,-1985600
542525.0,4,2.5,2650,5600,2.0,0,0,2,8,2650,0,2014,0.0,98059,47.4786,-122.12200000000001,2650,5600,2950,0.5267857142857143,7022500,31360000,24337500
339950.0,2,1.0,820,681,3.0,0,0,2,8,820,0,2006,0.0,98103,47.6619,-122.352,820,1156,-139,-0.20411160058737152,672400,463761,-208639
499990.0,4,2.75,2620,7001,2.0,0,0,2,8,2620,0,2012,0.0,98045,47.4838,-121.76899999999999,2620,6543,4381,0.6257677474646479,6864400,49014001,42149601
1770000.0,4,3.25,3980,10249,2.0,0,0,2,10,3980,0,2011,0.0,98004,47.5873,-122.196,2450,10912,6269,0.611669431164016,15840400,105042001,89201601
608000.0,3,3.5,1660,2298,2.0,0,0,2,8,1260,400,2009,0.0,98116,47.5809,-122.40299999999999,1500,2198,638,0.27763272410791995,2755600,5280804,2525204
392000.0,4,2.5,2130,4028,2.0,0,0,2,8,2130,0,2014,0.0,98146,47.5108,-122.363,1830,7817,1898,0.471201588877855,4536900,16224784,11687884
320000.0,3,1.75,1790,66250,1.5,0,0,2,7,1790,0,2003,0.0,98014,47.7179,-121.40299999999999,1440,59346,64460,0.9729811320754717,3204100,4389062500,4385858400
274800.0,3,1.75,1410,1988,2.0,0,0,2,8,1410,0,2014,0.0,98106,47.5171,-122.34700000000001,1410,1899,578,0.29074446680080485,1988100,3952144,1964044
325000.0,3,2.25,1330,1198,2.0,0,0,2,8,1080,250,2007,0.0,98106,47.555,-122.36200000000001,1260,1062,-132,-0.11018363939899833,1768900,1435204,-333696
418500.0,4,2.5,2190,4866,2.0,0,0,2,7,2190,0,2009,0.0,98059,47.4907,-122.152,2190,5670,2676,0.5499383477188656,4796100,23677956,18881856
300000.0,3,2.5,2540,5050,2.0,0,0,2,7,2540,0,2006,0.0,98042,47.3358,-122.055,2280,5050,2510,0.497029702970297,6451600,25502500,19050900
269950.0,3,2.5,2244,4079,2.0,0,0,2,7,2244,0,2012,0.0,98001,47.2606,-122.25399999999999,2077,4078,1835,0.44986516303015445,5035536,16638241,11602705
358000.0,3,2.5,2026,7611,2.0,0,0,2,8,2026,0,2010,0.0,98042,47.3733,-122.162,2270,7611,5585,0.733806332939167,4104676,57927321,53822645
350000.0,3,2.5,1730,4086,2.0,0,0,2,8,1730,0,2013,0.0,98146,47.5016,-122.34100000000001,2030,4086,2356,0.5766030347528145,2992900,16695396,13702496
782000.0,4,3.5,3910,8095,2.0,0,0,2,9,3130,780,2007,0.0,98029,47.5588,-122.036,3770,7021,4185,0.5169857936998147,15288100,65529025,50240925
779000.0,3,2.5,1580,1487,3.0,0,1,2,9,1580,0,2009,0.0,98119,47.6276,-122.359,1610,1297,-93,-0.06254203093476798,2496400,2211169,-285231
685000.0,4,2.5,2510,3479,2.0,0,0,2,8,2510,0,2007,0.0,98052,47.6981,-122.09899999999999,2540,4171,969,0.2785283127335441,6300100,12103441,5803341
305000.0,2,2.25,1000,905,3.0,0,0,2,8,1000,0,2006,0.0,98117,47.6842,-122.387,980,1023,-95,-0.10497237569060773,1000000,819025,-180975
350000.0,4,2.5,1660,2500,2.0,0,0,2,7,1660,0,2007,0.0,98118,47.5437,-122.28299999999999,1030,5000,840,0.336,2755600,6250000,3494400
775000.0,4,3.5,3060,4573,2.0,0,0,2,9,2410,650,2012,0.0,98029,47.5522,-122.001,3170,3634,1513,0.3308550185873606,9363600,20912329,11548729
317750.0,3,2.5,1980,4500,2.0,0,0,2,7,1980,0,2012,0.0,98042,47.3682,-122.117,1980,4500,2520,0.56,3920400,20250000,16329600
438000.0,2,1.0,980,1179,2.0,0,0,2,8,980,0,2010,0.0,98119,47.6381,-122.375,1190,1600,199,0.16878710771840544,960400,1390041,429641
325000.0,2,2.5,1050,1609,2.0,0,0,2,7,1050,0,2005,0.0,98144,47.5854,-122.31299999999999,1120,1693,559,0.3474207582349285,1102500,2588881,1486381
830000.0,4,3.25,3080,4287,2.0,0,0,2,10,2230,850,2012,0.0,98027,47.5313,-122.07600000000001,2250,2520,1207,0.2815488686727315,9486400,18378369,8891969
353000.0,3,2.25,1900,3800,2.0,0,0,2,7,1900,0,2006,0.0,98059,47.4866,-122.16,1950,3800,1900,0.5,3610000,14440000,10830000
460000.0,4,2.5,2200,6400,2.0,0,0,2,8,2200,0,2010,0.0,98059,47.4856,-122.156,2600,5870,4200,0.65625,4840000,40960000,36120000
370000.0,3,1.5,1360,1167,3.0,0,0,2,8,1360,0,2008,0.0,98103,47.6962,-122.34899999999999,1360,1167,-193,-0.16538131962296487,1849600,1361889,-487711
330000.0,3,2.5,2238,7209,2.0,0,0,2,8,2238,0,2011,0.0,98023,47.2966,-122.353,2456,7212,4971,0.6895547232625884,5008644,51969681,46961037
569888.0,4,2.5,2590,6474,2.0,0,0,2,8,2590,0,2014,0.0,98056,47.5164,-122.19,1960,8679,3884,0.5999382143960457,6708100,41912676,35204576
353900.0,3,2.5,2517,3900,2.0,0,0,2,8,2517,0,2014,0.0,98092,47.3211,-122.182,2390,7108,1383,0.3546153846153846,6335289,15210000,8874711
695000.0,4,3.5,3510,9084,2.0,0,0,2,10,3510,0,2001,0.0,98065,47.5402,-121.875,3690,9568,5574,0.6136063408190224,12320100,82519056,70198956
288790.0,3,1.75,1290,1237,2.0,0,0,2,7,1060,230,2008,0.0,98027,47.54,-122.02600000000001,1370,942,-53,-0.04284559417946645,1664100,1530169,-133931
334950.0,5,3.0,2230,8642,1.0,0,0,2,7,1330,900,2014,0.0,98168,47.486999999999995,-122.32,2100,11056,6412,0.7419578801203425,4972900,74684164,69711264
869950.0,4,2.75,3140,7928,2.0,0,0,2,9,3140,0,2013,0.0,98074,47.5923,-122.05799999999999,3500,7055,4788,0.6039354187689203,9859600,62853184,52993584
557500.0,3,3.5,3350,5025,2.0,0,2,2,8,2670,680,2014,0.0,98144,47.5699,-122.296,2030,5117,1675,0.3333333333333333,11222500,25250625,14028125
389990.0,4,2.5,2245,4330,2.0,0,0,2,8,2245,0,2014,0.0,98038,47.3557,-122.06299999999999,2530,4478,2085,0.4815242494226328,5040025,18748900,13708875
455000.0,3,1.75,1420,1189,3.0,0,0,2,8,1420,0,2006,0.0,98103,47.6625,-122.352,1380,1196,-231,-0.19428090832632464,2016400,1413721,-602679
598500.0,3,3.0,1560,2091,3.0,0,0,2,8,1560,0,2006,0.0,98103,47.6604,-122.352,1530,2091,531,0.2539454806312769,2433600,4372281,1938681
750000.0,4,2.75,2810,5497,2.0,0,0,2,9,2810,0,2011,0.0,98052,47.7081,-122.116,2990,5842,2687,0.4888120793159905,7896100,30217009,22320909
729999.0,2,2.25,1630,1686,2.0,0,0,2,10,1330,300,2014,0.0,98122,47.6113,-122.314,1570,2580,56,0.033214709371293,2656900,2842596,185696
299950.0,3,2.5,1740,4497,2.0,0,0,2,7,1740,0,2012,0.0,98042,47.3697,-122.117,1950,4486,2757,0.6130753835890593,3027600,20223009,17195409
374950.0,3,2.25,1390,1484,3.0,0,0,2,8,1390,0,2007,0.0,98103,47.6912,-122.34299999999999,1250,1087,94,0.06334231805929919,1932100,2202256,270156
386950.0,3,2.5,1070,1089,2.0,0,0,2,7,900,170,2009,0.0,98116,47.5902,-122.387,1450,1437,19,0.017447199265381085,1144900,1185921,41021
535000.0,5,3.25,2850,4551,2.0,0,0,2,8,2370,480,2006,0.0,98059,47.4916,-122.14399999999999,2850,4849,1701,0.37376400791034936,8122500,20711601,12589101
890000.0,5,3.25,4100,7578,2.0,0,2,2,10,4100,0,2011,0.0,98075,47.5955,-121.97399999999999,3710,8156,3478,0.4589601477962523,16810000,57426084,40616084
1050000.0,4,2.5,3260,5974,2.0,0,1,2,9,2820,440,2007,0.0,98115,47.6772,-122.26700000000001,2260,6780,2714,0.45430197522597926,10627600,35688676,25061076
1110000.0,4,3.5,3660,4760,2.0,0,0,2,9,2840,820,2014,0.0,98199,47.6482,-122.40899999999999,3210,4640,1100,0.23109243697478993,13395600,22657600,9262000
436952.0,4,2.5,2708,4772,2.0,0,0,2,9,2708,0,2014,0.0,98092,47.3413,-122.178,2502,4900,2064,0.432523051131601,7333264,22771984,15438720
365000.0,3,2.5,1800,2700,2.0,0,0,2,8,1800,0,2011,0.0,98126,47.5458,-122.369,1580,2036,900,0.3333333333333333,3240000,7290000,4050000
288000.0,3,2.5,1150,887,3.0,0,0,2,7,1150,0,2007,0.0,98133,47.7072,-122.35600000000001,1180,915,-263,-0.2965050732807215,1322500,786769,-535731
700000.0,3,2.5,2230,4006,2.0,0,0,2,8,2230,0,2014,0.0,98133,47.73,-122.335,2230,4180,1776,0.4433349975037444,4972900,16048036,11075136
800000.0,4,3.25,3540,159430,2.0,0,0,2,9,3540,0,2007,0.0,98014,47.6285,-121.899,1940,392040,155890,0.9777958978862197,12531600,25417924900,25405393300
899000.0,4,3.5,2490,5500,2.0,0,0,2,9,1780,710,2015,0.0,98136,47.5499,-122.39299999999999,1710,5500,3010,0.5472727272727272,6200100,30250000,24049900
465750.0,3,2.5,2670,4534,2.0,0,0,2,9,2670,0,2007,0.0,98056,47.51,-122.184,3040,5079,1864,0.4111160123511248,7128900,20557156,13428256
485000.0,2,2.5,1430,923,3.0,0,0,2,8,1410,20,2008,0.0,98103,47.6683,-122.355,1620,1505,-507,-0.5492957746478874,2044900,851929,-1192971
494995.0,5,2.75,2670,3800,2.0,0,0,2,8,2670,0,2014,0.0,98059,47.4783,-122.12299999999999,2670,3800,1130,0.29736842105263156,7128900,14440000,7311100
255000.0,3,2.5,2555,5720,2.0,0,0,2,8,2555,0,2006,0.0,98031,47.386,-122.184,2844,5769,3165,0.5533216783216783,6528025,32718400,26190375
530000.0,3,2.5,1970,6295,2.0,0,0,2,7,1970,0,2011,0.0,98065,47.5158,-121.874,2710,6009,4325,0.687053216838761,3880900,39627025,35746125
435000.0,3,2.0,1980,2674,3.0,0,0,2,8,1980,0,2007,0.0,98136,47.5524,-122.382,1440,2674,694,0.25953627524308154,3920400,7150276,3229876
639000.0,3,2.5,2010,3300,2.0,0,0,2,9,1610,400,2014,0.0,98118,47.5573,-122.287,1660,4950,1290,0.39090909090909093,4040100,10890000,6849900
440000.0,3,1.5,1270,1413,3.0,0,0,2,8,1270,0,2007,0.0,98115,47.6989,-122.31700000000001,1270,1413,143,0.10120311394196745,1612900,1996569,383669
914500.0,4,2.5,3950,10856,3.0,0,0,2,10,3950,0,2013,0.0,98075,47.5818,-121.99600000000001,3200,10856,6906,0.6361459100957996,15602500,117852736,102250236
580000.0,3,2.0,1870,5300,1.0,0,0,2,8,1870,0,2009,0.0,98053,47.7106,-122.02,1870,5050,3430,0.6471698113207547,3496900,28090000,24593100
250000.0,1,1.5,1180,1688,2.0,0,0,2,8,1070,110,2007,0.0,98126,47.549,-122.37200000000001,1380,2059,508,0.3009478672985782,1392400,2849344,1456944
410000.0,3,2.5,1420,1269,3.0,0,0,2,7,1420,0,2007,0.0,98103,47.6904,-122.34200000000001,1420,1300,-151,-0.11899133175728921,2016400,1610361,-406039
531155.0,4,2.75,2810,5046,2.0,0,0,2,9,2810,0,2014,0.0,98038,47.3559,-122.022,3060,4934,2236,0.44312326595323026,7896100,25462116,17566016
358000.0,3,2.5,1400,1529,2.0,0,0,2,7,1400,0,2005,0.0,98029,47.5535,-121.99700000000001,1440,1536,129,0.08436886854153042,1960000,2337841,377841
425000.0,3,2.5,1950,5689,2.0,0,0,2,7,1950,0,2009,0.0,98065,47.5158,-121.87299999999999,2190,5653,3739,0.657233257162946,3802500,32364721,28562221
326000.0,3,2.25,1930,3462,2.0,0,0,2,7,1930,0,2004,0.0,98019,47.7453,-121.985,1930,2952,1532,0.44251877527440786,3724900,11985444,8260544
650000.0,4,2.5,2210,4861,2.0,0,0,2,9,2210,0,2013,0.0,98117,47.6959,-122.36399999999999,1590,5080,2651,0.5453610368236989,4884100,23629321,18745221
749950.0,4,3.5,2630,3757,2.0,0,0,2,10,2200,430,2008,0.0,98027,47.5322,-122.075,2620,2699,1127,0.29997338301836574,6916900,14115049,7198149
239950.0,3,1.75,1600,4888,1.0,0,0,2,6,1600,0,2014,0.0,98042,47.383,-122.09700000000001,2520,5700,3288,0.6726677577741408,2560000,23892544,21332544
315000.0,3,2.5,1480,1590,2.0,0,0,2,8,1150,330,2010,0.0,98106,47.5302,-122.36200000000001,1480,5761,110,0.06918238993710692,2190400,2528100,337700
375000.0,2,2.5,750,1430,2.0,0,0,2,8,750,0,2006,0.0,98122,47.6093,-122.31,1320,2790,680,0.4755244755244755,562500,2044900,1482400
375000.0,3,1.5,1290,1213,3.0,0,0,2,8,1290,0,2007,0.0,98103,47.6965,-122.34,1360,1227,-77,-0.06347897774113767,1664100,1471369,-192731
349000.0,3,3.25,1340,1151,3.0,0,0,2,7,1340,0,2008,0.0,98103,47.6904,-122.346,1290,1200,-189,-0.16420503909643788,1795600,1324801,-470799
450000.0,2,1.5,1020,1049,3.0,0,0,2,8,1020,0,2008,0.0,98103,47.68,-122.348,1350,1395,29,0.027645376549094377,1040400,1100401,60001
669950.0,3,3.0,2330,1944,2.5,0,0,2,8,1950,380,2014,0.0,98027,47.5446,-122.016,2290,1407,-386,-0.19855967078189302,5428900,3779136,-1649764
504600.0,5,3.0,2360,5000,1.0,0,0,2,7,1390,0,2008,0.0,98103,47.6931,-122.33,2180,5009,2640,0.528,5569600,25000000,19430400
400000.0,3,2.5,1495,936,3.0,0,0,2,8,1405,90,2006,0.0,98144,47.593,-122.295,1495,1186,-559,-0.5972222222222222,2235025,876096,-1358929
1020000.0,4,3.5,3770,8501,2.0,0,0,2,10,3770,0,2008,0.0,98033,47.6744,-122.196,1520,9660,4731,0.5565227620279967,14212900,72267001,58054101
518000.0,5,2.5,2890,13104,2.0,0,0,2,8,2890,0,2006,0.0,98019,47.7277,-121.958,3020,9300,10214,0.7794566544566545,8352100,171714816,163362716
535000.0,3,2.75,1320,1125,3.0,0,0,2,8,1320,0,2008,0.0,98103,47.6598,-122.348,1320,1266,-195,-0.17333333333333334,1742400,1265625,-476775
337500.0,4,2.5,2330,4907,2.0,0,0,2,7,2330,0,2013,0.0,98042,47.358999999999995,-122.081,2300,3836,2577,0.5251681271652741,5428900,24078649,18649749
380000.0,4,2.5,3120,5001,2.0,0,0,2,9,3120,0,2005,0.0,98023,47.2779,-122.34899999999999,3120,5244,1881,0.376124775044991,9734400,25010001,15275601
875000.0,5,3.0,2960,15152,2.0,0,0,2,9,2960,0,2004,0.0,98033,47.6689,-122.179,1850,9453,12192,0.8046462513199577,8761600,229583104,220821504
385000.0,3,2.25,1630,1598,3.0,0,0,2,8,1630,0,2008,0.0,98103,47.6904,-122.34700000000001,1320,1605,-32,-0.02002503128911139,2656900,2553604,-103296
1990000.0,5,3.5,5230,8960,2.0,0,0,2,11,4450,780,2014,0.0,98004,47.5964,-122.20100000000001,2310,9603,3730,0.41629464285714285,27352900,80281600,52928700
649500.0,4,3.0,3150,6599,2.0,0,0,2,9,3150,0,2008,0.0,98056,47.5279,-122.199,2680,9430,3449,0.5226549477193514,9922500,43546801,33624301
1050000.0,4,3.75,3280,11000,2.0,0,0,2,10,2320,960,2008,0.0,98033,47.6855,-122.20100000000001,2400,8351,7720,0.7018181818181818,10758400,121000000,110241600
249000.0,3,1.0,1030,24750,1.0,0,2,2,5,1030,0,1943,0.0,98023,47.3343,-122.36200000000001,2810,28800,23720,0.9583838383838383,1060900,612562500,611501600
525000.0,4,2.5,3130,5795,2.0,0,0,2,9,3130,0,2008,0.0,98059,47.4997,-122.15100000000001,2950,5259,2665,0.4598792062122519,9796900,33582025,23785125
402000.0,3,3.5,1240,1666,2.0,0,0,2,7,1000,240,2008,0.0,98136,47.5496,-122.38799999999999,1110,1027,426,0.25570228091236497,1537600,2775556,1237956
1750000.0,4,2.75,3560,8975,2.0,0,0,2,10,3560,0,2014,0.0,98004,47.6322,-122.209,3440,12825,5415,0.6033426183844011,12673600,80550625,67877025
359800.0,5,2.5,2170,2752,2.0,0,0,2,8,2170,0,2014,0.0,98106,47.5167,-122.34700000000001,1800,2752,582,0.21148255813953487,4708900,7573504,2864604
330000.0,3,2.5,1520,3003,2.0,0,0,2,7,1520,0,2009,0.0,98059,47.4876,-122.15299999999999,1820,3030,1483,0.4938394938394938,2310400,9018009,6707609
433000.0,3,2.5,1270,1062,2.0,0,0,2,8,1060,210,2008,0.0,98105,47.6568,-122.321,1260,1112,-208,-0.1958568738229755,1612900,1127844,-485056
1010000.0,4,3.25,3610,4000,2.0,0,0,2,9,2640,970,2007,0.0,98199,47.658,-122.396,1980,4000,390,0.0975,13032100,16000000,2967900
599832.0,3,2.75,3230,5200,2.0,0,0,2,9,2680,550,2014,0.0,98065,47.519,-121.87799999999999,3100,4900,1970,0.37884615384615383,10432900,27040000,16607100
312891.0,5,3.0,2300,8214,2.0,0,0,2,8,2300,0,2013,0.0,98001,47.3052,-122.27600000000001,2594,4950,5914,0.7199902605308011,5290000,67469796,62179796
449000.0,2,2.5,1460,1296,2.0,0,0,2,8,1160,300,2008,0.0,98144,47.5923,-122.296,1460,1296,-164,-0.12654320987654322,2131600,1679616,-451984
495000.0,3,2.5,1750,1548,3.0,0,0,2,9,1750,0,2013,0.0,98118,47.5532,-122.28200000000001,1750,3960,-202,-0.13049095607235142,3062500,2396304,-666196
819995.0,5,2.75,3030,10335,2.0,0,0,2,9,3030,0,2013,0.0,98056,47.5305,-122.184,2720,11213,7305,0.706821480406386,9180900,106812225,97631325
407500.0,3,3.5,1522,1465,2.0,0,0,2,8,1248,274,2006,0.0,98117,47.6922,-122.375,1522,1341,-57,-0.03890784982935153,2316484,2146225,-170259
850000.0,4,3.75,3890,22000,2.0,0,0,2,10,3890,0,2007,0.0,98027,47.5052,-121.906,1610,23142,18110,0.8231818181818182,15132100,484000000,468867900
1720000.0,5,4.0,4590,35046,2.0,0,0,2,10,4590,0,2008,0.0,98033,47.6647,-122.16,3350,35857,30456,0.8690292758089369,21068100,1228222116,1207154016
1460000.0,4,4.0,4620,130208,2.0,0,0,2,10,4620,0,2014,0.0,98024,47.5885,-121.939,4620,131007,125588,0.9645183091668714,21344400,16954123264,16932778864
579000.0,4,2.75,3220,9825,2.0,0,0,2,8,3220,0,2012,0.0,98059,47.4863,-122.14299999999999,2820,8566,6605,0.672264631043257,10368400,96530625,86162225
890776.0,5,2.75,3170,8093,2.0,0,0,2,9,3170,0,2014,0.0,98075,47.5933,-122.06,3210,7062,4923,0.6083034721364142,10048900,65496649,55447749
352500.0,2,2.5,980,1010,3.0,0,0,2,8,980,0,2008,0.0,98117,47.6844,-122.387,980,1023,30,0.0297029702970297,960400,1020100,59700
529000.0,3,1.75,2340,7724,1.0,0,0,2,10,2340,0,2010,0.0,98058,47.4593,-122.134,3040,5787,5384,0.6970481615743138,5475600,59660176,54184576
484000.0,3,2.25,1620,1425,3.0,0,0,2,8,1540,80,2009,0.0,98027,47.5405,-122.02600000000001,1620,1237,-195,-0.1368421052631579,2624400,2030625,-593775
400000.0,3,2.5,1910,4408,3.0,0,0,2,8,1910,0,2007,0.0,98133,47.7634,-122.35,1910,8154,2498,0.5666969147005445,3648100,19430464,15782364
649950.0,3,2.5,2420,6847,2.0,0,0,2,9,2420,0,2009,0.0,98133,47.7329,-122.35600000000001,1180,8100,4427,0.6465605374616621,5856400,46881409,41025009
915000.0,3,4.5,3850,62726,2.0,0,0,2,10,3120,730,2013,0.0,98053,47.6735,-122.05799999999999,2630,46609,58876,0.938621943053917,14822500,3934551076,3919728576
534950.0,5,2.5,3220,10572,2.0,0,0,2,8,3220,0,2006,0.0,98019,47.7268,-121.95700000000001,2890,9090,7352,0.6954218690881574,10368400,111767184,101398784
776000.0,4,2.5,3040,6425,2.0,0,0,2,8,3040,0,2008,0.0,98052,47.6788,-122.117,3040,7800,3385,0.5268482490272374,9241600,41280625,32039025
370000.0,3,1.75,1496,1423,2.0,0,0,2,8,1248,248,2006,0.0,98133,47.715,-122.355,1460,1423,-73,-0.05130007027406887,2238016,2024929,-213087
610000.0,3,1.75,1630,1500,3.0,0,0,2,8,1630,0,2014,0.0,98103,47.6536,-122.354,1570,1335,-130,-0.08666666666666667,2656900,2250000,-406900
850000.0,5,3.5,4200,5400,2.0,0,0,2,9,3140,1060,2012,0.0,98052,47.7077,-122.12,3300,5564,1200,0.2222222222222222,17640000,29160000,11520000
443000.0,3,2.5,2430,7049,2.0,0,0,2,8,2430,0,2007,0.0,98106,47.5399,-122.352,1770,7049,4619,0.6552702510994467,5904900,49688401,43783501
1150000.0,5,4.25,4010,8252,2.0,0,0,2,10,4010,0,2015,0.0,98075,47.5974,-122.01299999999999,3370,8252,4242,0.5140571982549685,16080100,68095504,52015404
453000.0,3,2.5,1510,1618,2.5,0,0,2,8,1330,180,2011,0.0,98199,47.6515,-122.384,1350,1397,108,0.06674907292954264,2280100,2617924,337824
735000.0,4,3.5,2340,2810,2.0,0,2,2,8,1730,610,2011,0.0,98027,47.5403,-122.02799999999999,2600,2843,470,0.16725978647686832,5475600,7896100,2420500
810000.0,2,2.75,2700,8572,1.0,0,0,2,9,2700,0,2007,0.0,98053,47.7236,-122.03299999999999,2680,8569,5872,0.6850209986000934,7290000,73479184,66189184
1560000.0,3,3.5,4360,6240,2.0,0,3,2,10,2960,1400,2008,0.0,98103,47.6791,-122.354,1920,3910,1880,0.30128205128205127,19009600,38937600,19928000
2240000.0,5,6.5,7270,130017,2.0,0,0,2,12,6420,850,2010,0.0,98027,47.5371,-121.98200000000001,1800,44890,122747,0.9440842351384819,52852900,16904420289,16851567389
377500.0,3,2.5,1350,886,3.0,0,0,2,8,1270,80,2006,0.0,98136,47.5491,-122.387,1350,886,-464,-0.5237020316027088,1822500,784996,-1037504
482000.0,3,3.25,1380,1120,3.0,0,0,2,8,1380,0,2008,0.0,98103,47.6617,-122.34899999999999,1310,1405,-260,-0.23214285714285715,1904400,1254400,-650000
600000.0,2,2.5,1830,1988,2.0,0,0,2,9,1530,300,2011,0.0,98116,47.5779,-122.40899999999999,1800,2467,158,0.079476861167002,3348900,3952144,603244
420000.0,3,2.5,1470,1571,2.0,0,0,2,8,1180,290,2007,0.0,98116,47.5722,-122.387,1580,4329,101,0.06429026098026734,2160900,2468041,307141
480000.0,4,2.5,2940,9172,2.0,0,0,2,9,2940,0,2006,0.0,98001,47.3444,-122.26899999999999,2660,7955,6232,0.6794592237243785,8643600,84125584,75481984
406000.0,2,2.0,1110,1095,3.0,0,0,2,7,980,130,2008,0.0,98136,47.5494,-122.38799999999999,1110,1083,-15,-0.0136986301369863,1232100,1199025,-33075
505000.0,4,2.5,2790,5602,2.0,0,0,2,8,2790,0,2009,0.0,98059,47.4959,-122.15,2790,5309,2812,0.5019635844341307,7784100,31382404,23598304
1870000.0,4,3.75,3790,8797,2.0,0,0,2,11,3290,500,2006,0.0,98039,47.6351,-122.236,2660,12150,5007,0.5691713084005912,14364100,77387209,63023109
942990.0,4,2.5,3570,6218,2.0,0,0,2,9,3570,0,2014,0.0,98052,47.7046,-122.12299999999999,3230,5972,2648,0.425860405275008,12744900,38663524,25918624
440000.0,3,2.25,1230,1097,3.0,0,0,2,8,1230,0,2009,0.0,98107,47.6697,-122.37200000000001,1420,1437,-133,-0.12123974475843209,1512900,1203409,-309491
390000.0,3,3.25,1370,913,2.0,0,0,2,8,1100,270,2006,0.0,98116,47.5636,-122.38799999999999,1370,915,-457,-0.5005476451259584,1876900,833569,-1043331
475000.0,3,3.25,1380,1121,3.0,0,0,2,8,1380,0,2008,0.0,98103,47.6617,-122.34899999999999,1310,1405,-259,-0.2310437109723461,1904400,1256641,-647759
420000.0,1,2.0,1070,675,2.0,0,0,2,8,880,190,2007,0.0,98118,47.5574,-122.28399999999999,1220,788,-395,-0.5851851851851851,1144900,455625,-689275
1410000.0,4,4.0,4920,50621,2.0,0,0,2,10,4280,640,2012,0.0,98053,47.6575,-122.006,4920,74052,45701,0.9028071353785978,24206400,2562485641,2538279241
1380000.0,5,3.5,5150,12230,2.0,0,2,2,10,3700,1450,2007,0.0,98008,47.6249,-122.09,2940,13462,7080,0.5789043336058871,26522500,149572900,123050400
462500.0,6,3.0,2390,4000,2.0,0,0,2,7,2390,0,2014,0.0,98118,47.5173,-122.286,1680,5000,1610,0.4025,5712100,16000000,10287900
579950.0,4,2.75,2460,8643,2.0,0,0,2,9,2460,0,2011,0.0,98059,47.4828,-122.133,3110,8626,6183,0.7153766053453662,6051600,74701449,68649849
861111.0,4,2.5,3650,7090,2.0,0,0,2,10,3650,0,2008,0.0,98074,47.606,-122.052,3860,7272,3440,0.48519040902679833,13322500,50268100,36945600
1450000.0,4,3.5,4300,108865,2.0,0,0,2,11,4300,0,2014,0.0,98074,47.6258,-122.005,4650,107498,104565,0.9605015386028567,18490000,11851588225,11833098225
290000.0,3,2.25,1610,3764,2.0,0,0,2,7,1610,0,2012,0.0,98042,47.3589,-122.083,1610,3825,2154,0.5722635494155154,2592100,14167696,11575596
535000.0,4,2.5,2610,4595,2.0,0,0,2,8,2610,0,2008,0.0,98028,47.7728,-122.235,2440,4588,1985,0.4319912948857454,6812100,21114025,14301925
585000.0,3,2.5,1750,1381,3.0,0,0,2,8,1750,0,2008,0.0,98122,47.6021,-122.294,1940,4800,-369,-0.2671976828385228,3062500,1907161,-1155339
670000.0,3,2.5,3310,5300,2.0,0,2,2,8,2440,870,2008,0.0,98136,47.5178,-122.389,2140,7500,1990,0.3754716981132076,10956100,28090000,17133900
3000000.0,4,3.75,5090,14823,1.0,0,0,2,11,4180,910,2013,0.0,98004,47.62,-122.20700000000001,3030,12752,9733,0.6566147203669972,25908100,219721329,193813229
346000.0,3,2.0,1060,1184,2.0,0,0,2,7,730,330,2006,0.0,98136,47.5443,-122.385,1270,1601,124,0.10472972972972973,1123600,1401856,278256
1330000.0,4,4.0,4420,16526,2.0,0,0,2,11,4420,0,2013,0.0,98075,47.5914,-122.027,3510,50447,12106,0.732542660050829,19536400,273108676,253572276
999999.0,3,2.5,2100,4097,2.0,0,0,2,9,2100,0,2008,0.0,98004,47.5983,-122.2,1780,4764,1997,0.4874298267024652,4410000,16785409,12375409
599000.0,3,1.75,1650,1180,3.0,0,0,2,8,1650,0,2014,0.0,98105,47.6636,-122.319,1720,1960,-470,-0.3983050847457627,2722500,1392400,-1330100
332000.0,4,2.5,2380,5737,2.0,0,0,2,7,2380,0,2010,0.0,98023,47.2815,-122.35600000000001,2380,5396,3357,0.5851490325954332,5664400,32913169,27248769
336750.0,2,2.25,1170,1011,2.0,0,0,2,7,1170,0,2009,0.0,98027,47.5321,-122.073,1240,750,-159,-0.1572700296735905,1368900,1022121,-346779
370000.0,4,2.5,2531,6843,2.0,0,0,2,8,2531,0,2013,0.0,98030,47.385,-122.189,2604,6238,4312,0.6301329826099664,6405961,46826649,40420688
324000.0,3,2.25,998,904,2.0,0,0,2,7,798,200,2007,0.0,98117,47.6983,-122.367,998,1110,-94,-0.10398230088495575,996004,817216,-178788
338500.0,3,2.25,1333,1470,3.0,0,3,2,7,1333,0,2009,0.0,98125,47.7058,-122.302,1360,1680,137,0.09319727891156462,1776889,2160900,384011
1880000.0,5,3.5,4410,13000,2.0,0,3,2,10,2920,1490,2014,0.0,98006,47.5382,-122.111,5790,12969,8590,0.6607692307692308,19448100,169000000,149551900
402723.0,3,2.75,1160,1073,2.0,0,0,2,7,880,280,2007,0.0,98144,47.5788,-122.315,1250,5400,-87,-0.08108108108108109,1345600,1151329,-194271
715000.0,4,3.25,2630,7770,2.0,0,0,2,9,2630,0,2014,0.0,98126,47.5459,-122.37700000000001,1370,7770,5140,0.6615186615186616,6916900,60372900,53456000
459000.0,3,1.5,1160,1031,3.0,0,0,2,8,1160,0,2008,0.0,98103,47.6538,-122.35700000000001,1268,1688,-129,-0.1251212415130941,1345600,1062961,-282639
589999.0,3,2.5,2140,3628,2.0,0,0,2,8,1960,180,2006,0.0,98027,47.537,-122.074,2280,2812,1488,0.4101433296582139,4579600,13162384,8582784
405000.0,4,2.5,1980,5020,2.0,0,0,2,7,1980,0,2007,0.0,98056,47.5147,-122.19,1980,5064,3040,0.6055776892430279,3920400,25200400,21280000
509900.0,3,2.5,3030,9053,2.0,0,0,2,8,3030,0,2009,0.0,98059,47.4945,-122.149,3010,6026,6023,0.6653043190102729,9180900,81956809,72775909
327000.0,2,2.0,1490,1627,2.0,0,0,2,8,1190,300,2009,0.0,98126,47.5455,-122.375,1400,1498,137,0.0842040565457898,2220100,2647129,427029
1060000.0,2,1.5,2370,184231,2.0,0,0,2,11,2370,0,2005,0.0,98045,47.4543,-121.77799999999999,3860,151081,181861,0.9871357154876215,5616900,33941061361,33935444461
327500.0,3,2.5,1820,1866,2.0,0,0,2,8,1570,250,2008,0.0,98166,47.4643,-122.346,1660,6900,46,0.02465166130760986,3312400,3481956,169556
249000.0,3,2.0,1260,1125,2.0,0,0,2,7,810,450,2011,0.0,98106,47.5262,-122.361,1260,1172,-135,-0.12,1587600,1265625,-321975
1380000.0,5,4.5,4350,13405,2.0,0,0,2,11,4350,0,2014,0.0,98074,47.6018,-122.06,3990,7208,9055,0.6754942185751586,18922500,179694025,160771525
516500.0,1,1.25,1100,638,3.0,0,0,2,9,1100,0,2014,0.0,98112,47.6228,-122.307,1110,1933,-462,-0.7241379310344828,1210000,407044,-802956
465000.0,3,2.5,2050,15035,2.0,0,0,2,9,2050,0,2006,0.0,98042,47.3619,-122.12200000000001,1300,15836,12985,0.8636514798802793,4202500,226051225,221848725
388000.0,3,2.5,2198,6222,2.0,0,2,2,8,2198,0,2010,0.0,98198,47.3906,-122.304,2198,7621,4024,0.6467373834779814,4831204,38713284,33882080
549000.0,3,2.25,1230,1380,3.0,0,0,2,8,1230,0,2013,0.0,98199,47.6521,-122.4,1760,5664,150,0.10869565217391304,1512900,1904400,391500
553000.0,2,2.0,1400,1512,2.0,0,0,2,8,940,460,2006,0.0,98107,47.6719,-122.39200000000001,1400,3500,112,0.07407407407407407,1960000,2286144,326144
530000.0,3,2.5,1410,1250,2.0,0,0,2,8,1140,270,2010,0.0,98119,47.6515,-122.375,1720,2825,-160,-0.128,1988100,1562500,-425600
747450.0,3,2.5,2110,1339,2.0,0,0,2,8,1410,700,2014,0.0,98122,47.6088,-122.311,1630,2670,-771,-0.5758028379387603,4452100,1792921,-2659179
305000.0,2,2.5,1590,2656,2.0,0,0,2,7,1220,370,2009,0.0,98106,47.5489,-122.36399999999999,1590,2306,1066,0.401355421686747,2528100,7054336,4526236
540000.0,5,2.5,3370,4850,2.0,0,0,2,9,3370,0,2007,0.0,98056,47.5078,-122.169,2900,5570,1480,0.30515463917525776,11356900,23522500,12165600
750000.0,5,4.0,4500,8130,2.0,0,0,2,10,4500,0,2007,0.0,98059,47.4832,-122.145,2840,8402,3630,0.44649446494464945,20250000,66096900,45846900
422000.0,4,2.5,2930,5973,2.0,0,0,2,10,2930,0,2008,0.0,98030,47.3846,-122.186,3038,7095,3043,0.5094592332161393,8584900,35676729,27091829
337000.0,4,2.5,2470,5100,2.0,0,0,2,8,2470,0,2005,0.0,98038,47.3622,-122.041,2240,5123,2630,0.515686274509804,6100900,26010000,19909100
579950.0,5,2.75,3080,5752,2.0,0,0,2,9,3080,0,2014,0.0,98059,47.4922,-122.15299999999999,3000,4650,2672,0.46453407510431155,9486400,33085504,23599104
341780.0,4,2.75,2260,4440,2.0,0,0,2,7,2260,0,2014,0.0,98001,47.3507,-122.291,2260,4563,2180,0.49099099099099097,5107600,19713600,14606000
710200.0,4,3.0,1670,2642,2.0,0,0,2,8,1350,320,2008,0.0,98109,47.6397,-122.345,1670,2594,972,0.3679031037093111,2788900,6980164,4191264
690000.0,3,3.25,1540,1428,3.0,0,0,2,9,1540,0,2013,0.0,98103,47.6648,-122.353,1660,3300,-112,-0.0784313725490196,2371600,2039184,-332416
1700000.0,4,3.5,3830,8963,2.0,0,0,2,10,3120,710,2014,0.0,98004,47.599,-122.197,2190,10777,5133,0.5726877161664621,14668900,80335369,65666469
329000.0,2,2.5,980,1020,3.0,0,0,2,8,980,0,2008,0.0,98117,47.6844,-122.387,980,1023,40,0.0392156862745098,960400,1040400,80000
330000.0,3,2.5,1450,5008,1.0,0,0,2,7,840,610,2007,0.0,98106,47.5435,-122.35700000000001,2120,5019,3558,0.7104632587859425,2102500,25080064,22977564
608500.0,4,3.5,2850,5577,2.0,0,0,2,8,1950,900,2014,0.0,98056,47.5252,-122.19200000000001,2850,5708,2727,0.4889725658956428,8122500,31102929,22980429
230000.0,3,1.75,1140,1201,2.0,0,0,2,8,1140,0,2014,0.0,98108,47.5637,-122.295,1210,1552,61,0.0507910074937552,1299600,1442401,142801
785000.0,4,3.5,3070,4684,2.0,0,0,2,10,2190,880,2009,0.0,98027,47.5316,-122.07600000000001,2290,2664,1614,0.3445772843723313,9424900,21939856,12514956
610950.0,3,3.0,1680,1570,3.0,0,0,2,8,1680,0,2014,0.0,98103,47.6572,-122.346,1640,4800,-110,-0.07006369426751592,2822400,2464900,-357500
399950.0,3,2.5,3087,5002,2.0,0,0,2,8,3087,0,2014,0.0,98023,47.2974,-122.34899999999999,2927,5183,1915,0.38284686125549783,9529569,25020004,15490435
3570000.0,5,4.5,4850,10584,2.0,1,4,2,10,3540,1310,2007,0.0,98008,47.5943,-122.11,3470,18270,5734,0.5417611489040061,23522500,112021056,88498556
579000.0,4,3.25,1900,2631,2.0,0,0,2,9,1250,650,2014,0.0,98144,47.5869,-122.311,1710,4502,731,0.27784112504751046,3610000,6922161,3312161
362500.0,2,1.5,940,1768,2.0,0,0,2,7,940,0,2009,0.0,98144,47.5925,-122.295,1130,1159,828,0.4683257918552036,883600,3125824,2242224
645000.0,3,3.25,1730,1229,2.0,0,2,2,9,1320,410,2008,0.0,98119,47.6374,-122.369,1710,1686,-501,-0.4076484947111473,2992900,1510441,-1482459
594866.0,3,3.0,2780,6000,2.0,0,0,2,9,2780,0,2013,0.0,98065,47.5184,-121.88600000000001,2850,6000,3220,0.5366666666666666,7728400,36000000,28271600
625000.0,3,3.0,2780,6000,2.0,0,0,2,9,2780,0,2013,0.0,98065,47.5184,-121.88600000000001,2850,6000,3220,0.5366666666666666,7728400,36000000,28271600
490000.0,3,2.25,1500,1290,2.0,0,0,2,8,1220,280,2006,0.0,98117,47.6785,-122.375,1460,1375,-210,-0.16279069767441862,2250000,1664100,-585900
399950.0,2,1.0,710,1157,2.0,0,0,3,7,710,0,1943,0.0,98102,47.6413,-122.329,1370,1173,447,0.3863439930855661,504100,1338649,834549
380000.0,3,2.5,1260,900,2.0,0,0,2,7,940,320,2007,0.0,98116,47.5621,-122.384,1310,1415,-360,-0.4,1587600,810000,-777600
270000.0,3,2.5,1870,5000,2.0,0,0,2,7,1870,0,2009,0.0,98042,47.3339,-122.055,2170,5399,3130,0.626,3496900,25000000,21503100
505000.0,2,2.5,1430,1201,3.0,0,0,2,8,1430,0,2009,0.0,98107,47.6707,-122.381,1430,1249,-229,-0.1906744379683597,2044900,1442401,-602499
385000.0,3,2.5,1520,1488,3.0,0,0,2,8,1520,0,2006,0.0,98125,47.7337,-122.309,1520,1497,-32,-0.021505376344086023,2310400,2214144,-96256
414500.0,2,1.5,1210,1278,2.0,0,0,2,8,1020,190,2007,0.0,98117,47.6756,-122.375,1210,1118,68,0.053208137715179966,1464100,1633284,169184
347500.0,3,2.5,2540,4760,2.0,0,0,2,8,2540,0,2010,0.0,98038,47.3452,-122.022,2540,4571,2220,0.46638655462184875,6451600,22657600,16206000
1220000.0,4,3.5,4910,9444,1.5,0,0,2,11,3110,1800,2007,0.0,98074,47.6502,-122.066,4560,11063,4534,0.4800931808555697,24108100,89189136,65081036
572000.0,4,2.75,2770,3852,2.0,0,0,2,8,2770,0,2014,0.0,98178,47.5001,-122.23200000000001,1810,5641,1082,0.2808930425752856,7672900,14837904,7165004
475000.0,3,2.25,1190,1200,3.0,0,0,2,8,1190,0,2008,0.0,98103,47.6542,-122.346,1180,1224,10,0.008333333333333333,1416100,1440000,23900
1090000.0,5,3.75,4170,8142,2.0,0,2,2,10,4170,0,2006,0.0,98056,47.5354,-122.181,3030,7980,3972,0.48784082535003687,17388900,66292164,48903264
350000.0,4,2.75,2500,5995,2.0,0,0,2,8,2500,0,2008,0.0,98042,47.3749,-122.10700000000001,2530,5988,3495,0.5829858215179317,6250000,35940025,29690025
520000.0,2,2.25,1530,981,3.0,0,0,2,8,1480,50,2006,0.0,98103,47.6533,-122.346,1530,1282,-549,-0.5596330275229358,2340900,962361,-1378539
679950.0,5,2.75,3600,9437,2.0,0,0,2,9,3600,0,2014,0.0,98059,47.4822,-122.131,3550,9421,5837,0.6185228356469217,12960000,89056969,76096969
1580000.0,4,3.25,3410,10125,2.0,0,0,2,10,3410,0,2007,0.0,98040,47.5653,-122.223,2290,10125,6715,0.6632098765432098,11628100,102515625,90887525
541800.0,4,2.5,3118,7866,2.0,0,2,2,9,3118,0,2014,0.0,98001,47.2931,-122.264,2673,6500,4748,0.6036104754640224,9721924,61873956,52152032
810000.0,4,3.0,3990,7838,2.0,0,0,2,9,3990,0,2003,0.0,98053,47.6857,-122.046,3370,6814,3848,0.49094156672620565,15920100,61434244,45514144
1540000.0,5,3.75,4470,8088,2.0,0,0,2,11,4470,0,2008,0.0,98004,47.6321,-122.2,2780,8964,3618,0.4473293768545994,19980900,65415744,45434844
467000.0,3,2.5,1425,1179,3.0,0,0,2,8,1425,0,2008,0.0,98125,47.6963,-122.318,1285,1253,-246,-0.20865139949109415,2030625,1390041,-640584
224000.0,3,1.75,1500,11968,1.0,0,0,2,6,1500,0,2014,0.0,98010,47.3095,-122.00200000000001,1320,11303,10468,0.8746657754010695,2250000,143233024,140983024
507250.0,3,2.5,2270,5536,2.0,0,0,2,8,2270,0,2003,0.0,98065,47.5389,-121.881,2270,5731,3266,0.5899566473988439,5152900,30647296,25494396
429000.0,3,2.0,1490,1126,3.0,0,0,2,8,1490,0,2014,0.0,98144,47.5699,-122.288,1400,1230,-364,-0.32326820603907636,2220100,1267876,-952224
610685.0,4,2.5,2520,6023,2.0,0,0,2,9,2520,0,2014,0.0,98056,47.5137,-122.167,2520,6023,3503,0.581603851901046,6350400,36276529,29926129
1010000.0,4,3.5,3510,7200,2.0,0,0,2,9,2600,910,2009,0.0,98136,47.5537,-122.398,2050,6200,3690,0.5125,12320100,51840000,39519900
475000.0,3,2.5,1310,1294,2.0,0,0,2,8,1180,130,2008,0.0,98116,47.5773,-122.40899999999999,1330,1265,-16,-0.012364760432766615,1716100,1674436,-41664
360000.0,3,2.5,1530,1131,3.0,0,0,2,8,1530,0,2009,0.0,98103,47.6993,-122.346,1530,1509,-399,-0.35278514588859416,2340900,1279161,-1061739
400000.0,4,2.5,2310,5813,2.0,0,0,2,8,2310,0,2014,0.0,98146,47.5107,-122.36200000000001,1830,7200,3503,0.6026148288319284,5336100,33790969,28454869
402101.0,2,0.75,1020,1350,2.0,0,0,2,7,1020,0,2009,0.0,98144,47.5944,-122.29899999999999,1020,2007,330,0.24444444444444444,1040400,1822500,782100
400000.0,3,2.5,1600,2388,2.0,0,0,2,8,1600,0,2004,0.0,98027,47.5345,-122.069,1410,1287,788,0.32998324958123953,2560000,5702544,3142544
325000.0,2,0.75,1020,1076,2.0,0,0,2,7,1020,0,2008,0.0,98144,47.5941,-122.29899999999999,1020,1357,56,0.05204460966542751,1040400,1157776,117376
